"","County","Age","Male","Female","Total"
"1","KWALE","Total",362726,377650,740376
"2","KWALE","0",10626,10664,21290
"3","KWALE","1",11099,10811,21910
"4","KWALE","2",11621,11393,23014
"5","KWALE","3",11717,11924,23641
"6","KWALE","4",12551,12166,24717
"7","KWALE","0 - 4",57614,56958,114572
"8","KWALE","5",12964,12565,25529
"9","KWALE","6",12303,11966,24269
"10","KWALE","7",11651,11145,22796
"11","KWALE","8",11080,11054,22134
"12","KWALE","9",11625,11215,22840
"13","KWALE","5-9",59623,57945,117568
"14","KWALE","10",11787,11695,23482
"15","KWALE","11",10653,10749,21402
"16","KWALE","12",11892,11346,23238
"17","KWALE","13",11807,11528,23335
"18","KWALE","14",10470,10002,20472
"19","KWALE","10-14",56609,55320,111929
"20","KWALE","15",9835,9356,19191
"21","KWALE","16",9116,8814,17930
"22","KWALE","17",9005,8041,17046
"23","KWALE","18",8165,7460,15625
"24","KWALE","19",7707,7881,15588
"25","KWALE","15-19",43828,41552,85380
"26","KWALE","20",7111,7960,15071
"27","KWALE","21",4954,5631,10585
"28","KWALE","22",5124,6145,11269
"29","KWALE","23",4927,6093,11020
"30","KWALE","24",4426,5408,9834
"31","KWALE","20-24",26542,31237,57779
"32","KWALE","25",5498,6437,11935
"33","KWALE","26",4328,5497,9825
"34","KWALE","27",4356,5138,9494
"35","KWALE","28",3756,4918,8674
"36","KWALE","29",3652,4965,8617
"37","KWALE","25-29",21590,26955,48545
"38","KWALE","30",5233,7134,12367
"39","KWALE","31",3244,4254,7498
"40","KWALE","32",3984,5050,9034
"41","KWALE","33",3296,4189,7485
"42","KWALE","34",3280,3838,7118
"43","KWALE","30-34",19037,24465,43502
"44","KWALE","35",4537,5096,9633
"45","KWALE","36",2988,3336,6324
"46","KWALE","37",2811,3014,5825
"47","KWALE","38",2210,2397,4607
"48","KWALE","39",2447,2514,4961
"49","KWALE","35-39",14993,16357,31350
"50","KWALE","40",3725,4089,7814
"51","KWALE","41",2915,3234,6149
"52","KWALE","42",3114,3633,6747
"53","KWALE","43",2586,3050,5636
"54","KWALE","44",2252,2374,4626
"55","KWALE","40-44",14592,16380,30972
"56","KWALE","45",3626,3561,7187
"57","KWALE","46",2167,2371,4538
"58","KWALE","47",2414,2240,4654
"59","KWALE","48",1771,1673,3444
"60","KWALE","49",1960,1635,3595
"61","KWALE","45-49",11938,11480,23418
"62","KWALE","50",3097,3117,6214
"63","KWALE","51",1926,1485,3411
"64","KWALE","52",1495,1153,2648
"65","KWALE","53",956,695,1651
"66","KWALE","54",1199,852,2051
"67","KWALE","50-54",8673,7302,15975
"68","KWALE","55",1440,1166,2606
"69","KWALE","56",1651,1504,3155
"70","KWALE","57",1432,1431,2863
"71","KWALE","58",1200,1147,2347
"72","KWALE","59",1447,1833,3280
"73","KWALE","55-59",7170,7081,14251
"74","KWALE","60",2101,3121,5222
"75","KWALE","61",1148,1566,2714
"76","KWALE","62",1198,1251,2449
"77","KWALE","63",1195,1445,2640
"78","KWALE","64",995,1100,2095
"79","KWALE","60-64",6637,8483,15120
"80","KWALE","65",1616,1845,3461
"81","KWALE","66",937,804,1741
"82","KWALE","67",1297,1194,2491
"83","KWALE","68",717,697,1414
"84","KWALE","69",1037,1402,2439
"85","KWALE","65-69",5604,5942,11546
"86","KWALE","70",1525,2354,3879
"87","KWALE","71",573,689,1262
"88","KWALE","72",589,643,1232
"89","KWALE","73",507,465,972
"90","KWALE","74",555,614,1169
"91","KWALE","70-74",3749,4765,8514
"92","KWALE","75",683,682,1365
"93","KWALE","76",346,330,676
"94","KWALE","77",381,387,768
"95","KWALE","78",305,250,555
"96","KWALE","79",405,504,909
"97","KWALE","75-79",2120,2153,4273
"98","KWALE","80",523,918,1441
"99","KWALE","81",197,216,413
"100","KWALE","82",179,172,351
"101","KWALE","83",170,209,379
"102","KWALE","84",185,235,420
"103","KWALE","80-84",1254,1750,3004
"104","KWALE","85",189,274,463
"105","KWALE","86",107,89,196
"106","KWALE","87",120,136,256
"107","KWALE","88",70,73,143
"108","KWALE","89",173,256,429
"109","KWALE","85-89",659,828,1487
"110","KWALE","90",125,233,358
"111","KWALE","91",49,55,104
"112","KWALE","92",39,28,67
"113","KWALE","93",22,28,50
"114","KWALE","94",34,38,72
"115","KWALE","90-94",269,382,651
"116","KWALE","95",34,39,73
"117","KWALE","96",21,23,44
"118","KWALE","97",15,24,39
"119","KWALE","98",15,22,37
"120","KWALE","99",42,55,97
"121","KWALE","95-99",127,163,290
"122","KWALE","100+",93,146,239
"123","KWALE","Not Stated",5,6,11
"124","KILIFI","Total",512765,547115,1059880
"125","KILIFI","0",13702,13741,27443
"126","KILIFI","1",14789,14475,29264
"127","KILIFI","2",15309,15168,30477
"128","KILIFI","3",15661,15691,31352
"129","KILIFI","4",16404,16093,32497
"130","KILIFI","0 - 4",75865,75168,151033
"131","KILIFI","5",17086,16873,33959
"132","KILIFI","6",16436,16295,32731
"133","KILIFI","7",15688,14980,30668
"134","KILIFI","8",15794,15606,31400
"135","KILIFI","9",16177,15950,32127
"136","KILIFI","5-9",81181,79704,160885
"137","KILIFI","10",17028,16672,33700
"138","KILIFI","11",16006,16182,32188
"139","KILIFI","12",16987,16636,33623
"140","KILIFI","13",16829,16856,33685
"141","KILIFI","14",15629,14999,30628
"142","KILIFI","10-14",82479,81345,163824
"143","KILIFI","15",15132,14732,29864
"144","KILIFI","16",14060,13954,28014
"145","KILIFI","17",14498,13198,27696
"146","KILIFI","18",12540,11529,24069
"147","KILIFI","19",12713,11938,24651
"148","KILIFI","15-19",68943,65351,134294
"149","KILIFI","20",11460,11532,22992
"150","KILIFI","21",8752,8817,17569
"151","KILIFI","22",8431,9165,17596
"152","KILIFI","23",8168,9090,17258
"153","KILIFI","24",6935,7813,14748
"154","KILIFI","20-24",43746,46417,90163
"155","KILIFI","25",7854,8454,16308
"156","KILIFI","26",6503,7685,14188
"157","KILIFI","27",6307,7358,13665
"158","KILIFI","28",5337,6640,11977
"159","KILIFI","29",5220,6636,11856
"160","KILIFI","25-29",31221,36773,67994
"161","KILIFI","30",6341,8470,14811
"162","KILIFI","31",4485,6483,10968
"163","KILIFI","32",5306,7633,12939
"164","KILIFI","33",4423,6447,10870
"165","KILIFI","34",4313,6455,10768
"166","KILIFI","30-34",24868,35488,60356
"167","KILIFI","35",5507,6473,11980
"168","KILIFI","36",3679,4122,7801
"169","KILIFI","37",3788,3726,7514
"170","KILIFI","38",2633,2724,5357
"171","KILIFI","39",3194,3006,6200
"172","KILIFI","35-39",18801,20051,38852
"173","KILIFI","40",4025,3917,7942
"174","KILIFI","41",4575,6005,10580
"175","KILIFI","42",3933,5622,9555
"176","KILIFI","43",3185,4574,7759
"177","KILIFI","44",2920,3333,6253
"178","KILIFI","40-44",18638,23451,42089
"179","KILIFI","45",4551,4754,9305
"180","KILIFI","46",2915,3082,5997
"181","KILIFI","47",3247,3097,6344
"182","KILIFI","48",2263,2183,4446
"183","KILIFI","49",2604,2508,5112
"184","KILIFI","45-49",15580,15624,31204
"185","KILIFI","50",3634,4973,8607
"186","KILIFI","51",2665,3191,5856
"187","KILIFI","52",2184,2420,4604
"188","KILIFI","53",1658,1450,3108
"189","KILIFI","54",1832,1448,3280
"190","KILIFI","50-54",11973,13482,25455
"191","KILIFI","55",1854,1317,3171
"192","KILIFI","56",2377,2238,4615
"193","KILIFI","57",2231,2529,4760
"194","KILIFI","58",1827,2199,4026
"195","KILIFI","59",2073,3801,5874
"196","KILIFI","55-59",10362,12084,22446
"197","KILIFI","60",2416,4524,6940
"198","KILIFI","61",1754,3152,4906
"199","KILIFI","62",1637,2504,4141
"200","KILIFI","63",1737,2931,4668
"201","KILIFI","64",1482,1867,3349
"202","KILIFI","60-64",9026,14978,24004
"203","KILIFI","65",2169,2876,5045
"204","KILIFI","66",1477,1232,2709
"205","KILIFI","67",1931,1877,3808
"206","KILIFI","68",1004,1021,2025
"207","KILIFI","69",1524,2625,4149
"208","KILIFI","65-69",8105,9631,17736
"209","KILIFI","70",1627,2954,4581
"210","KILIFI","71",1185,1531,2716
"211","KILIFI","72",888,960,1848
"212","KILIFI","73",774,944,1718
"213","KILIFI","74",919,1174,2093
"214","KILIFI","70-74",5393,7563,12956
"215","KILIFI","75",941,1421,2362
"216","KILIFI","76",526,621,1147
"217","KILIFI","77",644,690,1334
"218","KILIFI","78",371,384,755
"219","KILIFI","79",689,1177,1866
"220","KILIFI","75-79",3171,4293,7464
"221","KILIFI","80",596,1188,1784
"222","KILIFI","81",326,523,849
"223","KILIFI","82",245,313,558
"224","KILIFI","83",278,389,667
"225","KILIFI","84",281,435,716
"226","KILIFI","80-84",1726,2848,4574
"227","KILIFI","85",250,466,716
"228","KILIFI","86",128,159,287
"229","KILIFI","87",226,347,573
"230","KILIFI","88",101,118,219
"231","KILIFI","89",297,563,860
"232","KILIFI","85-89",1002,1653,2655
"233","KILIFI","90",128,281,409
"234","KILIFI","91",87,120,207
"235","KILIFI","92",44,77,121
"236","KILIFI","93",45,74,119
"237","KILIFI","94",55,78,133
"238","KILIFI","90-94",359,630,989
"239","KILIFI","95",58,125,183
"240","KILIFI","96",30,41,71
"241","KILIFI","97",39,31,70
"242","KILIFI","98",30,41,71
"243","KILIFI","99",64,128,192
"244","KILIFI","95-99",221,366,587
"245","KILIFI","100+",102,211,313
"246","KILIFI","Not Stated",3,4,7
"247","TANA RIVER","Total",120696,119524,240220
"248","TANA RIVER","0",3835,3747,7582
"249","TANA RIVER","1",3797,3468,7265
"250","TANA RIVER","2",4471,4227,8698
"251","TANA RIVER","3",4500,4401,8901
"252","TANA RIVER","4",4885,4578,9463
"253","TANA RIVER","0 - 4",21488,20421,41909
"254","TANA RIVER","5",4624,4443,9067
"255","TANA RIVER","6",4676,4506,9182
"256","TANA RIVER","7",4386,3989,8375
"257","TANA RIVER","8",4506,4294,8800
"258","TANA RIVER","9",3568,3460,7028
"259","TANA RIVER","5-9",21760,20692,42452
"260","TANA RIVER","10",4842,4702,9544
"261","TANA RIVER","11",3110,2985,6095
"262","TANA RIVER","12",4339,3910,8249
"263","TANA RIVER","13",3458,3334,6792
"264","TANA RIVER","14",3301,3119,6420
"265","TANA RIVER","10-14",19050,18050,37100
"266","TANA RIVER","15",3453,3181,6634
"267","TANA RIVER","16",2615,2456,5071
"268","TANA RIVER","17",2598,2183,4781
"269","TANA RIVER","18",2648,2423,5071
"270","TANA RIVER","19",1907,1959,3866
"271","TANA RIVER","15-19",13221,12202,25423
"272","TANA RIVER","20",2529,2767,5296
"273","TANA RIVER","21",1450,1680,3130
"274","TANA RIVER","22",1797,1950,3747
"275","TANA RIVER","23",1611,1680,3291
"276","TANA RIVER","24",1398,1643,3041
"277","TANA RIVER","20-24",8785,9720,18505
"278","TANA RIVER","25",2168,2561,4729
"279","TANA RIVER","26",1341,1431,2772
"280","TANA RIVER","27",1235,1565,2800
"281","TANA RIVER","28",1170,1551,2721
"282","TANA RIVER","29",1030,1113,2143
"283","TANA RIVER","25-29",6944,8221,15165
"284","TANA RIVER","30",2108,2602,4710
"285","TANA RIVER","31",875,1121,1996
"286","TANA RIVER","32",1133,1309,2442
"287","TANA RIVER","33",765,971,1736
"288","TANA RIVER","34",791,763,1554
"289","TANA RIVER","30-34",5672,6766,12438
"290","TANA RIVER","35",1812,1882,3694
"291","TANA RIVER","36",875,910,1785
"292","TANA RIVER","37",850,846,1696
"293","TANA RIVER","38",653,652,1305
"294","TANA RIVER","39",587,486,1073
"295","TANA RIVER","35-39",4777,4776,9553
"296","TANA RIVER","40",1675,1642,3317
"297","TANA RIVER","41",851,952,1803
"298","TANA RIVER","42",723,648,1371
"299","TANA RIVER","43",487,466,953
"300","TANA RIVER","44",415,328,743
"301","TANA RIVER","40-44",4151,4036,8187
"302","TANA RIVER","45",1315,1416,2731
"303","TANA RIVER","46",709,795,1504
"304","TANA RIVER","47",628,594,1222
"305","TANA RIVER","48",505,458,963
"306","TANA RIVER","49",473,386,859
"307","TANA RIVER","45-49",3630,3649,7279
"308","TANA RIVER","50",1117,1098,2215
"309","TANA RIVER","51",391,417,808
"310","TANA RIVER","52",478,437,915
"311","TANA RIVER","53",347,282,629
"312","TANA RIVER","54",431,418,849
"313","TANA RIVER","50-54",2764,2652,5416
"314","TANA RIVER","55",531,440,971
"315","TANA RIVER","56",528,413,941
"316","TANA RIVER","57",443,451,894
"317","TANA RIVER","58",426,483,909
"318","TANA RIVER","59",447,462,909
"319","TANA RIVER","55-59",2375,2249,4624
"320","TANA RIVER","60",850,933,1783
"321","TANA RIVER","61",403,342,745
"322","TANA RIVER","62",361,336,697
"323","TANA RIVER","63",370,341,711
"324","TANA RIVER","64",247,218,465
"325","TANA RIVER","60-64",2231,2170,4401
"326","TANA RIVER","65",454,498,952
"327","TANA RIVER","66",214,228,442
"328","TANA RIVER","67",274,236,510
"329","TANA RIVER","68",217,173,390
"330","TANA RIVER","69",252,289,541
"331","TANA RIVER","65-69",1411,1424,2835
"332","TANA RIVER","70",496,637,1133
"333","TANA RIVER","71",190,206,396
"334","TANA RIVER","72",149,125,274
"335","TANA RIVER","73",159,117,276
"336","TANA RIVER","74",113,96,209
"337","TANA RIVER","70-74",1107,1181,2288
"338","TANA RIVER","75",169,177,346
"339","TANA RIVER","76",112,109,221
"340","TANA RIVER","77",91,69,160
"341","TANA RIVER","78",98,70,168
"342","TANA RIVER","79",121,88,209
"343","TANA RIVER","75-79",591,513,1104
"344","TANA RIVER","80",200,233,433
"345","TANA RIVER","81",46,55,101
"346","TANA RIVER","82",57,33,90
"347","TANA RIVER","83",46,50,96
"348","TANA RIVER","84",43,32,75
"349","TANA RIVER","80-84",392,403,795
"350","TANA RIVER","85",72,51,123
"351","TANA RIVER","86",30,24,54
"352","TANA RIVER","87",43,35,78
"353","TANA RIVER","88",32,10,42
"354","TANA RIVER","89",37,54,91
"355","TANA RIVER","85-89",214,174,388
"356","TANA RIVER","90",44,84,128
"357","TANA RIVER","91",10,24,34
"358","TANA RIVER","92",7,12,19
"359","TANA RIVER","93",5,11,16
"360","TANA RIVER","94",5,2,7
"361","TANA RIVER","90-94",71,133,204
"362","TANA RIVER","95",11,18,29
"363","TANA RIVER","96",5,7,12
"364","TANA RIVER","97",3,8,11
"365","TANA RIVER","98",4,9,13
"366","TANA RIVER","99",9,9,18
"367","TANA RIVER","95-99",32,51,83
"368","TANA RIVER","100+",25,40,65
"369","TANA RIVER","Not Stated",5,1,6
"370","LAMU","Total",56570,48902,105472
"371","LAMU","0",1344,1282,2626
"372","LAMU","1",1318,1264,2582
"373","LAMU","2",1469,1363,2832
"374","LAMU","3",1476,1423,2899
"375","LAMU","4",1591,1456,3047
"376","LAMU","0 - 4",7198,6788,13986
"377","LAMU","5",1552,1435,2987
"378","LAMU","6",1497,1414,2911
"379","LAMU","7",1377,1402,2779
"380","LAMU","8",1452,1446,2898
"381","LAMU","9",1409,1341,2750
"382","LAMU","5-9",7287,7038,14325
"383","LAMU","10",1538,1444,2982
"384","LAMU","11",1297,1262,2559
"385","LAMU","12",1514,1356,2870
"386","LAMU","13",1530,1457,2987
"387","LAMU","14",1395,1233,2628
"388","LAMU","10-14",7274,6752,14026
"389","LAMU","15",1323,1208,2531
"390","LAMU","16",1244,1114,2358
"391","LAMU","17",1302,1052,2354
"392","LAMU","18",1091,975,2066
"393","LAMU","19",1081,928,2009
"394","LAMU","15-19",6041,5277,11318
"395","LAMU","20",1127,984,2111
"396","LAMU","21",934,739,1673
"397","LAMU","22",1122,825,1947
"398","LAMU","23",1052,791,1843
"399","LAMU","24",1056,637,1693
"400","LAMU","20-24",5291,3976,9267
"401","LAMU","25",1126,771,1897
"402","LAMU","26",980,765,1745
"403","LAMU","27",940,659,1599
"404","LAMU","28",771,552,1323
"405","LAMU","29",765,520,1285
"406","LAMU","25-29",4582,3267,7849
"407","LAMU","30",991,805,1796
"408","LAMU","31",827,671,1498
"409","LAMU","32",877,732,1609
"410","LAMU","33",695,580,1275
"411","LAMU","34",627,531,1158
"412","LAMU","30-34",4017,3319,7336
"413","LAMU","35",840,712,1552
"414","LAMU","36",687,568,1255
"415","LAMU","37",614,491,1105
"416","LAMU","38",444,351,795
"417","LAMU","39",522,359,881
"418","LAMU","35-39",3107,2481,5588
"419","LAMU","40",715,538,1253
"420","LAMU","41",769,689,1458
"421","LAMU","42",536,460,996
"422","LAMU","43",425,343,768
"423","LAMU","44",341,280,621
"424","LAMU","40-44",2786,2310,5096
"425","LAMU","45",737,654,1391
"426","LAMU","46",471,370,841
"427","LAMU","47",426,281,707
"428","LAMU","48",343,247,590
"429","LAMU","49",389,304,693
"430","LAMU","45-49",2366,1856,4222
"431","LAMU","50",546,415,961
"432","LAMU","51",389,306,695
"433","LAMU","52",314,263,577
"434","LAMU","53",206,177,383
"435","LAMU","54",242,186,428
"436","LAMU","50-54",1697,1347,3044
"437","LAMU","55",320,218,538
"438","LAMU","56",337,301,638
"439","LAMU","57",258,278,536
"440","LAMU","58",261,235,496
"441","LAMU","59",291,263,554
"442","LAMU","55-59",1467,1295,2762
"443","LAMU","60",337,356,693
"444","LAMU","61",205,240,445
"445","LAMU","62",217,161,378
"446","LAMU","63",214,161,375
"447","LAMU","64",169,129,298
"448","LAMU","60-64",1142,1047,2189
"449","LAMU","65",238,246,484
"450","LAMU","66",147,153,300
"451","LAMU","67",215,159,374
"452","LAMU","68",130,112,242
"453","LAMU","69",177,129,306
"454","LAMU","65-69",907,799,1706
"455","LAMU","70",227,266,493
"456","LAMU","71",136,170,306
"457","LAMU","72",142,83,225
"458","LAMU","73",111,59,170
"459","LAMU","74",90,67,157
"460","LAMU","70-74",706,645,1351
"461","LAMU","75",94,104,198
"462","LAMU","76",82,73,155
"463","LAMU","77",65,34,99
"464","LAMU","78",51,30,81
"465","LAMU","79",53,50,103
"466","LAMU","75-79",345,291,636
"467","LAMU","80",77,110,187
"468","LAMU","81",40,38,78
"469","LAMU","82",20,17,37
"470","LAMU","83",32,18,50
"471","LAMU","84",32,23,55
"472","LAMU","80-84",201,206,407
"473","LAMU","85",23,26,49
"474","LAMU","86",16,22,38
"475","LAMU","87",23,13,36
"476","LAMU","88",12,9,21
"477","LAMU","89",14,19,33
"478","LAMU","85-89",88,89,177
"479","LAMU","90",16,30,46
"480","LAMU","91",5,15,20
"481","LAMU","92",10,5,15
"482","LAMU","93",2,6,8
"483","LAMU","94",5,4,9
"484","LAMU","90-94",38,60,98
"485","LAMU","95",5,5,10
"486","LAMU","96",3,6,9
"487","LAMU","97",4,5,9
"488","LAMU","98",2,2,4
"489","LAMU","99",2,11,13
"490","LAMU","95-99",16,29,45
"491","LAMU","100+",11,29,40
"492","LAMU","Not Stated",3,1,4
"493","TAITA/TAVETA","Total",126717,120178,246895
"494","TAITA/TAVETA","0",2606,2644,5250
"495","TAITA/TAVETA","1",2672,2777,5449
"496","TAITA/TAVETA","2",2678,2604,5282
"497","TAITA/TAVETA","3",2815,2717,5532
"498","TAITA/TAVETA","4",2737,2704,5441
"499","TAITA/TAVETA","0 - 4",13508,13446,26954
"500","TAITA/TAVETA","5",2776,2676,5452
"501","TAITA/TAVETA","6",2671,2631,5302
"502","TAITA/TAVETA","7",2730,2711,5441
"503","TAITA/TAVETA","8",2778,2703,5481
"504","TAITA/TAVETA","9",2904,2979,5883
"505","TAITA/TAVETA","9-14",13859,13700,27559
"506","TAITA/TAVETA","10",2975,2950,5925
"507","TAITA/TAVETA","11",3082,2992,6074
"508","TAITA/TAVETA","12",3239,3025,6264
"509","TAITA/TAVETA","13",3145,3137,6282
"510","TAITA/TAVETA","14",3055,2832,5887
"511","TAITA/TAVETA","10-14",15496,14936,30432
"512","TAITA/TAVETA","15",2837,2812,5649
"513","TAITA/TAVETA","16",2797,2659,5456
"514","TAITA/TAVETA","17",3006,2629,5635
"515","TAITA/TAVETA","18",2593,2179,4772
"516","TAITA/TAVETA","19",2429,2158,4587
"517","TAITA/TAVETA","15-19",13662,12437,26099
"518","TAITA/TAVETA","20",2406,2114,4520
"519","TAITA/TAVETA","21",1984,1667,3651
"520","TAITA/TAVETA","22",2017,1758,3775
"521","TAITA/TAVETA","23",2022,1787,3809
"522","TAITA/TAVETA","24",1756,1642,3398
"523","TAITA/TAVETA","20-24",10185,8968,19153
"524","TAITA/TAVETA","25",1938,1687,3625
"525","TAITA/TAVETA","26",1612,1508,3120
"526","TAITA/TAVETA","27",1731,1570,3301
"527","TAITA/TAVETA","28",1513,1433,2946
"528","TAITA/TAVETA","29",1788,1603,3391
"529","TAITA/TAVETA","25-29",8582,7801,16383
"530","TAITA/TAVETA","30",2042,1772,3814
"531","TAITA/TAVETA","31",1536,1434,2970
"532","TAITA/TAVETA","32",1937,1649,3586
"533","TAITA/TAVETA","33",1588,1491,3079
"534","TAITA/TAVETA","34",1534,1289,2823
"535","TAITA/TAVETA","30-34",8637,7635,16272
"536","TAITA/TAVETA","35",1999,1648,3647
"537","TAITA/TAVETA","36",1636,1383,3019
"538","TAITA/TAVETA","37",1628,1411,3039
"539","TAITA/TAVETA","38",1322,1102,2424
"540","TAITA/TAVETA","39",1543,1354,2897
"541","TAITA/TAVETA","35-39",8128,6898,15026
"542","TAITA/TAVETA","40",1761,1444,3205
"543","TAITA/TAVETA","41",1526,1270,2796
"544","TAITA/TAVETA","42",1492,1197,2689
"545","TAITA/TAVETA","43",1312,1093,2405
"546","TAITA/TAVETA","44",1234,1049,2283
"547","TAITA/TAVETA","40-44",7325,6053,13378
"548","TAITA/TAVETA","45",1655,1384,3039
"549","TAITA/TAVETA","46",1262,1142,2404
"550","TAITA/TAVETA","47",1343,1232,2575
"551","TAITA/TAVETA","48",1023,924,1947
"552","TAITA/TAVETA","49",1168,1075,2243
"553","TAITA/TAVETA","45-49",6451,5757,12208
"554","TAITA/TAVETA","50",1397,1167,2564
"555","TAITA/TAVETA","51",1059,881,1940
"556","TAITA/TAVETA","52",933,822,1755
"557","TAITA/TAVETA","53",811,738,1549
"558","TAITA/TAVETA","54",969,893,1862
"559","TAITA/TAVETA","50-54",5169,4501,9670
"560","TAITA/TAVETA","55",938,882,1820
"561","TAITA/TAVETA","56",1017,919,1936
"562","TAITA/TAVETA","57",885,1193,2078
"563","TAITA/TAVETA","58",646,791,1437
"564","TAITA/TAVETA","59",784,876,1660
"565","TAITA/TAVETA","55-59",4270,4661,8931
"566","TAITA/TAVETA","60",919,1106,2025
"567","TAITA/TAVETA","61",755,800,1555
"568","TAITA/TAVETA","62",741,734,1475
"569","TAITA/TAVETA","63",694,703,1397
"570","TAITA/TAVETA","64",578,548,1126
"571","TAITA/TAVETA","60-64",3687,3891,7578
"572","TAITA/TAVETA","65",745,872,1617
"573","TAITA/TAVETA","66",613,577,1190
"574","TAITA/TAVETA","67",742,676,1418
"575","TAITA/TAVETA","68",443,350,793
"576","TAITA/TAVETA","69",538,624,1162
"577","TAITA/TAVETA","65-69",3081,3099,6180
"578","TAITA/TAVETA","70",593,948,1541
"579","TAITA/TAVETA","71",442,473,915
"580","TAITA/TAVETA","72",401,341,742
"581","TAITA/TAVETA","73",330,318,648
"582","TAITA/TAVETA","74",319,436,755
"583","TAITA/TAVETA","70-74",2085,2516,4601
"584","TAITA/TAVETA","75",286,341,627
"585","TAITA/TAVETA","76",207,246,453
"586","TAITA/TAVETA","77",287,298,585
"587","TAITA/TAVETA","78",168,171,339
"588","TAITA/TAVETA","79",227,363,590
"589","TAITA/TAVETA","75-79",1175,1419,2594
"590","TAITA/TAVETA","80",256,393,649
"591","TAITA/TAVETA","81",160,237,397
"592","TAITA/TAVETA","82",115,151,266
"593","TAITA/TAVETA","83",143,193,336
"594","TAITA/TAVETA","84",105,196,301
"595","TAITA/TAVETA","80-84",779,1170,1949
"596","TAITA/TAVETA","85",101,169,270
"597","TAITA/TAVETA","86",70,91,161
"598","TAITA/TAVETA","87",74,168,242
"599","TAITA/TAVETA","88",53,75,128
"600","TAITA/TAVETA","89",79,243,322
"601","TAITA/TAVETA","85-89",377,746,1123
"602","TAITA/TAVETA","90",51,121,172
"603","TAITA/TAVETA","91",34,72,106
"604","TAITA/TAVETA","92",27,30,57
"605","TAITA/TAVETA","93",25,38,63
"606","TAITA/TAVETA","94",16,42,58
"607","TAITA/TAVETA","90-94",153,303,456
"608","TAITA/TAVETA","95",21,41,62
"609","TAITA/TAVETA","96",7,23,30
"610","TAITA/TAVETA","97",16,23,39
"611","TAITA/TAVETA","98",7,23,30
"612","TAITA/TAVETA","99",19,55,74
"613","TAITA/TAVETA","95-99",70,165,235
"614","TAITA/TAVETA","100+",37,75,112
"615","TAITA/TAVETA","Not Stated",1,1,2
"616","GARISSA","Total",349423,281013,630436
"617","GARISSA","0",4103,4097,8200
"618","GARISSA","1",5888,5772,11660
"619","GARISSA","2",10777,10349,21126
"620","GARISSA","3",9392,8910,18302
"621","GARISSA","4",11659,10664,22323
"622","GARISSA","0 - 4",41819,39792,81611
"623","GARISSA","5",10570,9541,20111
"624","GARISSA","6",12302,11014,23316
"625","GARISSA","7",8649,7729,16378
"626","GARISSA","8",13843,12034,25877
"627","GARISSA","9",8836,7831,16667
"628","GARISSA","5-9",54200,48149,102349
"629","GARISSA","10",17765,13979,31744
"630","GARISSA","11",7373,7056,14429
"631","GARISSA","12",14214,8833,23047
"632","GARISSA","13",9567,6422,15989
"633","GARISSA","14",11805,7115,18920
"634","GARISSA","10-14",60724,43405,104129
"635","GARISSA","15",14726,8666,23392
"636","GARISSA","16",11094,6746,17840
"637","GARISSA","17",10070,6325,16395
"638","GARISSA","18",11875,7939,19814
"639","GARISSA","19",6668,5081,11749
"640","GARISSA","15-19",54433,34757,89190
"641","GARISSA","20",14692,11337,26029
"642","GARISSA","21",5253,4062,9315
"643","GARISSA","22",5948,4909,10857
"644","GARISSA","23",5264,4127,9391
"645","GARISSA","24",4570,3759,8329
"646","GARISSA","20-24",35727,28194,63921
"647","GARISSA","25",9089,7998,17087
"648","GARISSA","26",4001,3363,7364
"649","GARISSA","27",3408,2773,6181
"650","GARISSA","28",4854,4694,9548
"651","GARISSA","29",3442,3270,6712
"652","GARISSA","25-29",24794,22098,46892
"653","GARISSA","30",10137,9441,19578
"654","GARISSA","31",2272,2082,4354
"655","GARISSA","32",3338,3269,6607
"656","GARISSA","33",2141,2088,4229
"657","GARISSA","34",1935,1883,3818
"658","GARISSA","30-34",19823,18763,38586
"659","GARISSA","35",5374,5620,10994
"660","GARISSA","36",2152,2244,4396
"661","GARISSA","37",1672,1784,3456
"662","GARISSA","38",2662,2866,5528
"663","GARISSA","39",1845,1872,3717
"664","GARISSA","35-39",13705,14386,28091
"665","GARISSA","40",7849,6025,13874
"666","GARISSA","41",1564,1428,2992
"667","GARISSA","42",1989,1580,3569
"668","GARISSA","43",1441,1264,2705
"669","GARISSA","44",829,655,1484
"670","GARISSA","40-44",13672,10952,24624
"671","GARISSA","45",4052,2885,6937
"672","GARISSA","46",1022,816,1838
"673","GARISSA","47",953,700,1653
"674","GARISSA","48",1334,1012,2346
"675","GARISSA","49",973,836,1809
"676","GARISSA","45-49",8334,6249,14583
"677","GARISSA","50",4706,3024,7730
"678","GARISSA","51",661,431,1092
"679","GARISSA","52",1268,835,2103
"680","GARISSA","53",596,379,975
"681","GARISSA","54",842,518,1360
"682","GARISSA","50-54",8073,5187,13260
"683","GARISSA","55",1160,786,1946
"684","GARISSA","56",742,526,1268
"685","GARISSA","57",524,353,877
"686","GARISSA","58",725,502,1227
"687","GARISSA","59",682,475,1157
"688","GARISSA","55-59",3833,2642,6475
"689","GARISSA","60",2573,1623,4196
"690","GARISSA","61",430,252,682
"691","GARISSA","62",511,266,777
"692","GARISSA","63",441,272,713
"693","GARISSA","64",301,193,494
"694","GARISSA","60-64",4256,2606,6862
"695","GARISSA","65",787,525,1312
"696","GARISSA","66",281,159,440
"697","GARISSA","67",270,193,463
"698","GARISSA","68",367,191,558
"699","GARISSA","69",357,240,597
"700","GARISSA","65-69",2062,1308,3370
"701","GARISSA","70",1219,732,1951
"702","GARISSA","71",204,173,377
"703","GARISSA","72",220,118,338
"704","GARISSA","73",175,73,248
"705","GARISSA","74",160,92,252
"706","GARISSA","70-74",1978,1188,3166
"707","GARISSA","75",273,166,439
"708","GARISSA","76",118,65,183
"709","GARISSA","77",79,45,124
"710","GARISSA","78",151,78,229
"711","GARISSA","79",153,67,220
"712","GARISSA","75-79",774,421,1195
"713","GARISSA","80",499,361,860
"714","GARISSA","81",80,64,144
"715","GARISSA","82",63,42,105
"716","GARISSA","83",51,27,78
"717","GARISSA","84",77,36,113
"718","GARISSA","80-84",770,530,1300
"719","GARISSA","85",81,70,151
"720","GARISSA","86",37,22,59
"721","GARISSA","87",30,26,56
"722","GARISSA","88",26,22,48
"723","GARISSA","89",48,26,74
"724","GARISSA","85-89",222,166,388
"725","GARISSA","90",107,111,218
"726","GARISSA","91",16,21,37
"727","GARISSA","92",9,9,18
"728","GARISSA","93",9,5,14
"729","GARISSA","94",2,8,10
"730","GARISSA","90-94",143,154,297
"731","GARISSA","95",19,14,33
"732","GARISSA","96",10,10,20
"733","GARISSA","97",3,1,4
"734","GARISSA","98",11,8,19
"735","GARISSA","99",9,5,14
"736","GARISSA","95-99",52,38,90
"737","GARISSA","100+",28,27,55
"738","GARISSA","Not Stated",1,1,2
"739","WAJIR","Total",320562,283500,604062
"740","WAJIR","0",4340,4633,8973
"741","WAJIR","1",7497,7450,14947
"742","WAJIR","2",13624,13852,27476
"743","WAJIR","3",9876,9838,19714
"744","WAJIR","4",13875,13773,27648
"745","WAJIR","0 - 4",49212,49546,98758
"746","WAJIR","5",9819,9779,19598
"747","WAJIR","6",14410,13774,28184
"748","WAJIR","7",8580,8168,16748
"749","WAJIR","8",14755,13679,28434
"750","WAJIR","9",8129,7857,15986
"751","WAJIR","5-9",55693,53257,108950
"752","WAJIR","10",16545,14687,31232
"753","WAJIR","11",7002,7305,14307
"754","WAJIR","12",13729,9894,23623
"755","WAJIR","13",8643,6175,14818
"756","WAJIR","14",11091,7850,18941
"757","WAJIR","10-14",57010,45911,102921
"758","WAJIR","15",11435,7623,19058
"759","WAJIR","16",9923,6915,16838
"760","WAJIR","17",8918,6121,15039
"761","WAJIR","18",8974,6937,15911
"762","WAJIR","19",4227,3896,8123
"763","WAJIR","15-19",43477,31492,74969
"764","WAJIR","20",9726,8888,18614
"765","WAJIR","21",3934,3701,7635
"766","WAJIR","22",4675,4748,9423
"767","WAJIR","23",3543,3688,7231
"768","WAJIR","24",3509,3529,7038
"769","WAJIR","20-24",25387,24554,49941
"770","WAJIR","25",6787,7176,13963
"771","WAJIR","26",3476,3629,7105
"772","WAJIR","27",3022,3456,6478
"773","WAJIR","28",4265,4926,9191
"774","WAJIR","29",2684,3133,5817
"775","WAJIR","25-29",20234,22320,42554
"776","WAJIR","30",8435,8275,16710
"777","WAJIR","31",2532,2994,5526
"778","WAJIR","32",3079,3121,6200
"779","WAJIR","33",1905,2072,3977
"780","WAJIR","34",1881,1948,3829
"781","WAJIR","30-34",17832,18410,36242
"782","WAJIR","35",4598,4489,9087
"783","WAJIR","36",2060,2142,4202
"784","WAJIR","37",1644,1817,3461
"785","WAJIR","38",2327,2547,4874
"786","WAJIR","39",1631,1713,3344
"787","WAJIR","35-39",12260,12708,24968
"788","WAJIR","40",6605,4813,11418
"789","WAJIR","41",1917,1795,3712
"790","WAJIR","42",2190,1678,3868
"791","WAJIR","43",1293,951,2244
"792","WAJIR","44",744,631,1375
"793","WAJIR","40-44",12749,9868,22617
"794","WAJIR","45",3082,2093,5175
"795","WAJIR","46",977,643,1620
"796","WAJIR","47",900,583,1483
"797","WAJIR","48",1228,840,2068
"798","WAJIR","49",935,573,1508
"799","WAJIR","45-49",7122,4732,11854
"800","WAJIR","50",3714,1991,5705
"801","WAJIR","51",747,433,1180
"802","WAJIR","52",1175,620,1795
"803","WAJIR","53",583,280,863
"804","WAJIR","54",727,393,1120
"805","WAJIR","50-54",6946,3717,10663
"806","WAJIR","55",926,491,1417
"807","WAJIR","56",685,407,1092
"808","WAJIR","57",494,377,871
"809","WAJIR","58",647,407,1054
"810","WAJIR","59",732,380,1112
"811","WAJIR","55-59",3484,2062,5546
"812","WAJIR","60",2076,1032,3108
"813","WAJIR","61",623,345,968
"814","WAJIR","62",490,202,692
"815","WAJIR","63",409,203,612
"816","WAJIR","64",321,178,499
"817","WAJIR","60-64",3919,1960,5879
"818","WAJIR","65",586,336,922
"819","WAJIR","66",256,189,445
"820","WAJIR","67",252,133,385
"821","WAJIR","68",297,143,440
"822","WAJIR","69",373,156,529
"823","WAJIR","65-69",1764,957,2721
"824","WAJIR","70",945,569,1514
"825","WAJIR","71",282,228,510
"826","WAJIR","72",227,90,317
"827","WAJIR","73",142,50,192
"828","WAJIR","74",143,60,203
"829","WAJIR","70-74",1739,997,2736
"830","WAJIR","75",260,96,356
"831","WAJIR","76",116,60,176
"832","WAJIR","77",94,47,141
"833","WAJIR","78",118,58,176
"834","WAJIR","79",145,56,201
"835","WAJIR","75-79",733,317,1050
"836","WAJIR","80",364,260,624
"837","WAJIR","81",108,110,218
"838","WAJIR","82",72,24,96
"839","WAJIR","83",42,26,68
"840","WAJIR","84",43,31,74
"841","WAJIR","80-84",629,451,1080
"842","WAJIR","85",62,31,93
"843","WAJIR","86",29,19,48
"844","WAJIR","87",34,20,54
"845","WAJIR","88",27,10,37
"846","WAJIR","89",34,35,69
"847","WAJIR","85-89",186,115,301
"848","WAJIR","90",72,57,129
"849","WAJIR","91",24,19,43
"850","WAJIR","92",22,7,29
"851","WAJIR","93",10,6,16
"852","WAJIR","94",6,3,9
"853","WAJIR","90-94",134,92,226
"854","WAJIR","95",20,8,28
"855","WAJIR","96",9,6,15
"856","WAJIR","97",2,2,4
"857","WAJIR","98",8,2,10
"858","WAJIR","99",3,6,9
"859","WAJIR","95-99",42,24,66
"860","WAJIR","100+",10,9,19
"861","WAJIR","Not Stated",NA,1,1
"862","MANDERA","Total",299428,297535,596963
"863","MANDERA","0",5806,7430,13236
"864","MANDERA","1",7999,9630,17629
"865","MANDERA","2",14479,17189,31668
"866","MANDERA","3",9782,11812,21594
"867","MANDERA","4",14751,16873,31624
"868","MANDERA","0 - 4",52817,62934,115751
"869","MANDERA","5",9717,11189,20906
"870","MANDERA","6",14651,16664,31315
"871","MANDERA","7",8394,9432,17826
"872","MANDERA","8",14908,15784,30692
"873","MANDERA","9",7864,8937,16801
"874","MANDERA","5-9",55534,62006,117540
"875","MANDERA","10",16057,16007,32064
"876","MANDERA","11",6494,7976,14470
"877","MANDERA","12",13783,10588,24371
"878","MANDERA","13",7859,6294,14153
"879","MANDERA","14",10996,8224,19220
"880","MANDERA","10-14",55189,49089,104278
"881","MANDERA","15",10159,7367,17526
"882","MANDERA","16",9842,7609,17451
"883","MANDERA","17",7676,6334,14010
"884","MANDERA","18",8913,7648,16561
"885","MANDERA","19",3808,3692,7500
"886","MANDERA","15-19",40398,32650,73048
"887","MANDERA","20",9581,8818,18399
"888","MANDERA","21",3220,3216,6436
"889","MANDERA","22",4573,5177,9750
"890","MANDERA","23",3248,3275,6523
"891","MANDERA","24",3270,3539,6809
"892","MANDERA","20-24",23892,24025,47917
"893","MANDERA","25",5533,5702,11235
"894","MANDERA","26",3072,3358,6430
"895","MANDERA","27",2625,3060,5685
"896","MANDERA","28",3469,4175,7644
"897","MANDERA","29",2189,2526,4715
"898","MANDERA","25-29",16888,18821,35709
"899","MANDERA","30",6719,6854,13573
"900","MANDERA","31",1781,2192,3973
"901","MANDERA","32",2832,3092,5924
"902","MANDERA","33",1649,1919,3568
"903","MANDERA","34",1558,1528,3086
"904","MANDERA","30-34",14539,15585,30124
"905","MANDERA","35",3279,3430,6709
"906","MANDERA","36",1418,1796,3214
"907","MANDERA","37",1184,1324,2508
"908","MANDERA","38",1874,2230,4104
"909","MANDERA","39",1347,1563,2910
"910","MANDERA","35-39",9102,10343,19445
"911","MANDERA","40",5083,4200,9283
"912","MANDERA","41",1466,1487,2953
"913","MANDERA","42",1610,1332,2942
"914","MANDERA","43",1046,873,1919
"915","MANDERA","44",710,512,1222
"916","MANDERA","40-44",9915,8404,18319
"917","MANDERA","45",2342,1702,4044
"918","MANDERA","46",766,615,1381
"919","MANDERA","47",745,571,1316
"920","MANDERA","48",934,726,1660
"921","MANDERA","49",716,530,1246
"922","MANDERA","45-49",5503,4144,9647
"923","MANDERA","50",2580,1559,4139
"924","MANDERA","51",500,386,886
"925","MANDERA","52",855,531,1386
"926","MANDERA","53",486,360,846
"927","MANDERA","54",612,381,993
"928","MANDERA","50-54",5033,3217,8250
"929","MANDERA","55",841,456,1297
"930","MANDERA","56",570,335,905
"931","MANDERA","57",347,282,629
"932","MANDERA","58",479,313,792
"933","MANDERA","59",449,354,803
"934","MANDERA","55-59",2686,1740,4426
"935","MANDERA","60",1674,959,2633
"936","MANDERA","61",363,331,694
"937","MANDERA","62",470,201,671
"938","MANDERA","63",327,205,532
"939","MANDERA","64",292,149,441
"940","MANDERA","60-64",3126,1845,4971
"941","MANDERA","65",530,290,820
"942","MANDERA","66",196,149,345
"943","MANDERA","67",248,127,375
"944","MANDERA","68",197,114,311
"945","MANDERA","69",304,120,424
"946","MANDERA","65-69",1475,800,2275
"947","MANDERA","70",855,555,1410
"948","MANDERA","71",184,167,351
"949","MANDERA","72",242,99,341
"950","MANDERA","73",102,54,156
"951","MANDERA","74",132,47,179
"952","MANDERA","70-74",1515,922,2437
"953","MANDERA","75",209,100,309
"954","MANDERA","76",108,47,155
"955","MANDERA","77",88,40,128
"956","MANDERA","78",113,59,172
"957","MANDERA","79",121,57,178
"958","MANDERA","75-79",639,303,942
"959","MANDERA","80",407,278,685
"960","MANDERA","81",103,97,200
"961","MANDERA","82",103,37,140
"962","MANDERA","83",50,18,68
"963","MANDERA","84",52,22,74
"964","MANDERA","80-84",715,452,1167
"965","MANDERA","85",85,34,119
"966","MANDERA","86",36,20,56
"967","MANDERA","87",40,17,57
"968","MANDERA","88",38,13,51
"969","MANDERA","89",37,22,59
"970","MANDERA","85-89",236,106,342
"971","MANDERA","90",97,79,176
"972","MANDERA","91",25,25,50
"973","MANDERA","92",28,9,37
"974","MANDERA","93",7,3,10
"975","MANDERA","94",12,6,18
"976","MANDERA","90-94",169,122,291
"977","MANDERA","95",18,7,25
"978","MANDERA","96",7,5,12
"979","MANDERA","97",2,2,4
"980","MANDERA","98",3,3,6
"981","MANDERA","99",9,1,10
"982","MANDERA","95-99",39,18,57
"983","MANDERA","100+",16,9,25
"984","MANDERA","Not Stated",2,NA,2
"985","MARSABIT","Total",188758,163772,352530
"986","MARSABIT","0",3981,3911,7892
"987","MARSABIT","1",4620,4428,9048
"988","MARSABIT","2",6037,5733,11770
"989","MARSABIT","3",6155,5825,11980
"990","MARSABIT","4",6719,6209,12928
"991","MARSABIT","0 - 4",27512,26106,53618
"992","MARSABIT","5",6418,6070,12488
"993","MARSABIT","6",6936,6558,13494
"994","MARSABIT","7",5506,5130,10636
"995","MARSABIT","8",7114,6902,14016
"996","MARSABIT","9",4729,4517,9246
"997","MARSABIT","5-9",30703,29177,59880
"998","MARSABIT","10",8896,8104,17000
"999","MARSABIT","11",3696,4018,7714
"1000","MARSABIT","12",7416,5529,12945
"1001","MARSABIT","13",4977,4075,9052
"1002","MARSABIT","14",5427,4256,9683
"1003","MARSABIT","10-14",30412,25982,56394
"1004","MARSABIT","15",7018,4972,11990
"1005","MARSABIT","16",4968,3667,8635
"1006","MARSABIT","17",4921,3194,8115
"1007","MARSABIT","18",5034,3837,8871
"1008","MARSABIT","19",2840,2150,4990
"1009","MARSABIT","15-19",24781,17820,42601
"1010","MARSABIT","20",6183,4756,10939
"1011","MARSABIT","21",2535,2166,4701
"1012","MARSABIT","22",2995,2875,5870
"1013","MARSABIT","23",2801,2521,5322
"1014","MARSABIT","24",2666,2291,4957
"1015","MARSABIT","20-24",17180,14609,31789
"1016","MARSABIT","25",4527,3934,8461
"1017","MARSABIT","26",2324,2003,4327
"1018","MARSABIT","27",2181,1854,4035
"1019","MARSABIT","28",2670,2241,4911
"1020","MARSABIT","29",2039,1795,3834
"1021","MARSABIT","25-29",13741,11827,25568
"1022","MARSABIT","30",5121,3954,9075
"1023","MARSABIT","31",1376,1660,3036
"1024","MARSABIT","32",1885,1745,3630
"1025","MARSABIT","33",1430,1490,2920
"1026","MARSABIT","34",1274,1235,2509
"1027","MARSABIT","30-34",11086,10084,21170
"1028","MARSABIT","35",2619,2274,4893
"1029","MARSABIT","36",1262,1179,2441
"1030","MARSABIT","37",1141,992,2133
"1031","MARSABIT","38",1126,915,2041
"1032","MARSABIT","39",876,679,1555
"1033","MARSABIT","35-39",7024,6039,13063
"1034","MARSABIT","40",3121,2096,5217
"1035","MARSABIT","41",1201,1208,2409
"1036","MARSABIT","42",1082,781,1863
"1037","MARSABIT","43",817,654,1471
"1038","MARSABIT","44",422,369,791
"1039","MARSABIT","40-44",6643,5108,11751
"1040","MARSABIT","45",1877,1565,3442
"1041","MARSABIT","46",715,775,1490
"1042","MARSABIT","47",665,591,1256
"1043","MARSABIT","48",628,511,1139
"1044","MARSABIT","49",522,494,1016
"1045","MARSABIT","45-49",4407,3936,8343
"1046","MARSABIT","50",2018,1600,3618
"1047","MARSABIT","51",467,509,976
"1048","MARSABIT","52",710,573,1283
"1049","MARSABIT","53",417,357,774
"1050","MARSABIT","54",523,431,954
"1051","MARSABIT","50-54",4135,3470,7605
"1052","MARSABIT","55",753,599,1352
"1053","MARSABIT","56",554,420,974
"1054","MARSABIT","57",425,365,790
"1055","MARSABIT","58",477,428,905
"1056","MARSABIT","59",438,494,932
"1057","MARSABIT","55-59",2647,2306,4953
"1058","MARSABIT","60",1530,1142,2672
"1059","MARSABIT","61",358,386,744
"1060","MARSABIT","62",346,312,658
"1061","MARSABIT","63",299,271,570
"1062","MARSABIT","64",243,214,457
"1063","MARSABIT","60-64",2776,2325,5101
"1064","MARSABIT","65",551,440,991
"1065","MARSABIT","66",223,233,456
"1066","MARSABIT","67",264,206,470
"1067","MARSABIT","68",248,170,418
"1068","MARSABIT","69",275,362,637
"1069","MARSABIT","65-69",1561,1411,2972
"1070","MARSABIT","70",1117,900,2017
"1071","MARSABIT","71",254,297,551
"1072","MARSABIT","72",269,200,469
"1073","MARSABIT","73",171,137,308
"1074","MARSABIT","74",176,146,322
"1075","MARSABIT","70-74",1987,1680,3667
"1076","MARSABIT","75",258,201,459
"1077","MARSABIT","76",126,102,228
"1078","MARSABIT","77",100,76,176
"1079","MARSABIT","78",109,83,192
"1080","MARSABIT","79",110,136,246
"1081","MARSABIT","75-79",703,598,1301
"1082","MARSABIT","80",461,428,889
"1083","MARSABIT","81",106,125,231
"1084","MARSABIT","82",96,70,166
"1085","MARSABIT","83",53,51,104
"1086","MARSABIT","84",68,64,132
"1087","MARSABIT","80-84",784,738,1522
"1088","MARSABIT","85",90,67,157
"1089","MARSABIT","86",56,38,94
"1090","MARSABIT","87",47,39,86
"1091","MARSABIT","88",33,16,49
"1092","MARSABIT","89",58,73,131
"1093","MARSABIT","85-89",284,233,517
"1094","MARSABIT","90",170,127,297
"1095","MARSABIT","91",31,30,61
"1096","MARSABIT","92",34,22,56
"1097","MARSABIT","93",10,9,19
"1098","MARSABIT","94",17,16,33
"1099","MARSABIT","90-94",262,204,466
"1100","MARSABIT","95",22,21,43
"1101","MARSABIT","96",14,11,25
"1102","MARSABIT","97",9,6,15
"1103","MARSABIT","98",11,10,21
"1104","MARSABIT","99",10,6,16
"1105","MARSABIT","95-99",66,54,120
"1106","MARSABIT","100+",60,63,123
"1107","MARSABIT","Not Stated",4,2,6
"1108","ISIOLO","Total",76435,65894,142329
"1109","ISIOLO","0",1794,1749,3543
"1110","ISIOLO","1",1790,1754,3544
"1111","ISIOLO","2",2709,2638,5347
"1112","ISIOLO","3",2505,2479,4984
"1113","ISIOLO","4",2711,2633,5344
"1114","ISIOLO","0 - 4",11509,11253,22762
"1115","ISIOLO","5",2684,2462,5146
"1116","ISIOLO","6",2704,2564,5268
"1117","ISIOLO","7",2275,2165,4440
"1118","ISIOLO","8",2711,2549,5260
"1119","ISIOLO","9",2010,1830,3840
"1120","ISIOLO","5-9",12384,11570,23954
"1121","ISIOLO","10",3430,3021,6451
"1122","ISIOLO","11",1715,1643,3358
"1123","ISIOLO","12",2786,2148,4934
"1124","ISIOLO","13",2059,1716,3775
"1125","ISIOLO","14",2177,1662,3839
"1126","ISIOLO","10-14",12167,10190,22357
"1127","ISIOLO","15",2681,1883,4564
"1128","ISIOLO","16",1989,1469,3458
"1129","ISIOLO","17",2153,1486,3639
"1130","ISIOLO","18",1853,1345,3198
"1131","ISIOLO","19",1005,837,1842
"1132","ISIOLO","15-19",9681,7020,16701
"1133","ISIOLO","20",2249,1876,4125
"1134","ISIOLO","21",957,862,1819
"1135","ISIOLO","22",1193,1157,2350
"1136","ISIOLO","23",1094,936,2030
"1137","ISIOLO","24",951,806,1757
"1138","ISIOLO","20-24",6444,5637,12081
"1139","ISIOLO","25",1717,1448,3165
"1140","ISIOLO","26",918,872,1790
"1141","ISIOLO","27",903,792,1695
"1142","ISIOLO","28",1010,872,1882
"1143","ISIOLO","29",748,625,1373
"1144","ISIOLO","25-29",5296,4609,9905
"1145","ISIOLO","30",1987,1584,3571
"1146","ISIOLO","31",693,704,1397
"1147","ISIOLO","32",899,819,1718
"1148","ISIOLO","33",616,600,1216
"1149","ISIOLO","34",597,569,1166
"1150","ISIOLO","30-34",4792,4276,9068
"1151","ISIOLO","35",1296,1141,2437
"1152","ISIOLO","36",583,508,1091
"1153","ISIOLO","37",475,352,827
"1154","ISIOLO","38",515,411,926
"1155","ISIOLO","39",342,273,615
"1156","ISIOLO","35-39",3211,2685,5896
"1157","ISIOLO","40",1364,895,2259
"1158","ISIOLO","41",549,534,1083
"1159","ISIOLO","42",429,288,717
"1160","ISIOLO","43",306,203,509
"1161","ISIOLO","44",168,126,294
"1162","ISIOLO","40-44",2816,2046,4862
"1163","ISIOLO","45",759,586,1345
"1164","ISIOLO","46",353,314,667
"1165","ISIOLO","47",243,230,473
"1166","ISIOLO","48",263,209,472
"1167","ISIOLO","49",239,152,391
"1168","ISIOLO","45-49",1857,1491,3348
"1169","ISIOLO","50",758,574,1332
"1170","ISIOLO","51",162,129,291
"1171","ISIOLO","52",227,187,414
"1172","ISIOLO","53",180,117,297
"1173","ISIOLO","54",236,182,418
"1174","ISIOLO","50-54",1563,1189,2752
"1175","ISIOLO","55",299,199,498
"1176","ISIOLO","56",250,188,438
"1177","ISIOLO","57",163,183,346
"1178","ISIOLO","58",189,195,384
"1179","ISIOLO","59",215,239,454
"1180","ISIOLO","55-59",1116,1004,2120
"1181","ISIOLO","60",625,434,1059
"1182","ISIOLO","61",170,178,348
"1183","ISIOLO","62",191,112,303
"1184","ISIOLO","63",190,138,328
"1185","ISIOLO","64",138,104,242
"1186","ISIOLO","60-64",1314,966,2280
"1187","ISIOLO","65",223,204,427
"1188","ISIOLO","66",101,95,196
"1189","ISIOLO","67",145,114,259
"1190","ISIOLO","68",117,76,193
"1191","ISIOLO","69",152,107,259
"1192","ISIOLO","65-69",738,596,1334
"1193","ISIOLO","70",409,305,714
"1194","ISIOLO","71",93,122,215
"1195","ISIOLO","72",79,64,143
"1196","ISIOLO","73",75,52,127
"1197","ISIOLO","74",81,54,135
"1198","ISIOLO","70-74",737,597,1334
"1199","ISIOLO","75",101,92,193
"1200","ISIOLO","76",51,54,105
"1201","ISIOLO","77",49,26,75
"1202","ISIOLO","78",60,36,96
"1203","ISIOLO","79",74,58,132
"1204","ISIOLO","75-79",335,266,601
"1205","ISIOLO","80",138,128,266
"1206","ISIOLO","81",34,69,103
"1207","ISIOLO","82",40,15,55
"1208","ISIOLO","83",21,22,43
"1209","ISIOLO","84",24,26,50
"1210","ISIOLO","80-84",257,260,517
"1211","ISIOLO","85",36,40,76
"1212","ISIOLO","86",14,11,25
"1213","ISIOLO","87",20,16,36
"1214","ISIOLO","88",17,8,25
"1215","ISIOLO","89",36,35,71
"1216","ISIOLO","85-89",123,110,233
"1217","ISIOLO","90",27,42,69
"1218","ISIOLO","91",10,14,24
"1219","ISIOLO","92",10,8,18
"1220","ISIOLO","93",4,6,10
"1221","ISIOLO","94",6,5,11
"1222","ISIOLO","90-94",57,75,132
"1223","ISIOLO","95",8,13,21
"1224","ISIOLO","96",3,5,8
"1225","ISIOLO","97",6,3,9
"1226","ISIOLO","98",3,3,6
"1227","ISIOLO","99",7,9,16
"1228","ISIOLO","95-99",27,33,60
"1229","ISIOLO","100+",11,21,32
"1230","ISIOLO","Not Stated",NA,NA,NA
"1231","MERU","Total",699532,707228,1406760
"1232","MERU","0",13770,13912,27682
"1233","MERU","1",15486,15262,30748
"1234","MERU","2",15577,15578,31155
"1235","MERU","3",16416,16452,32868
"1236","MERU","4",16069,15890,31959
"1237","MERU","0 - 4",77318,77094,154412
"1238","MERU","5",16270,15547,31817
"1239","MERU","6",16308,16087,32395
"1240","MERU","7",16291,15950,32241
"1241","MERU","8",15509,15791,31300
"1242","MERU","9",17320,17332,34652
"1243","MERU","5-9",81698,80707,162405
"1244","MERU","10",19111,18292,37403
"1245","MERU","11",16622,17046,33668
"1246","MERU","12",18984,18482,37466
"1247","MERU","13",19205,19313,38518
"1248","MERU","14",18248,17875,36123
"1249","MERU","10-14",92170,91008,183178
"1250","MERU","15",17463,17374,34837
"1251","MERU","16",15776,16164,31940
"1252","MERU","17",15876,15710,31586
"1253","MERU","18",13533,13724,27257
"1254","MERU","19",14284,14307,28591
"1255","MERU","15-19",76932,77279,154211
"1256","MERU","20",14145,14200,28345
"1257","MERU","21",10755,11175,21930
"1258","MERU","22",11320,11071,22391
"1259","MERU","23",11033,11167,22200
"1260","MERU","24",10089,9769,19858
"1261","MERU","20-24",57342,57382,114724
"1262","MERU","25",12075,11238,23313
"1263","MERU","26",8812,9008,17820
"1264","MERU","27",9796,9740,19536
"1265","MERU","28",8646,8519,17165
"1266","MERU","29",8603,8766,17369
"1267","MERU","25-29",47932,47271,95203
"1268","MERU","30",13824,13955,27779
"1269","MERU","31",8072,8190,16262
"1270","MERU","32",10160,11182,21342
"1271","MERU","33",9385,10540,19925
"1272","MERU","34",8032,8928,16960
"1273","MERU","30-34",49473,52795,102268
"1274","MERU","35",15222,15000,30222
"1275","MERU","36",7924,7709,15633
"1276","MERU","37",8802,7850,16652
"1277","MERU","38",6869,7014,13883
"1278","MERU","39",8383,7875,16258
"1279","MERU","35-39",47200,45448,92648
"1280","MERU","40",12577,11731,24308
"1281","MERU","41",8160,7007,15167
"1282","MERU","42",7489,6608,14097
"1283","MERU","43",6375,6382,12757
"1284","MERU","44",5980,5704,11684
"1285","MERU","40-44",40581,37432,78013
"1286","MERU","45",9409,9042,18451
"1287","MERU","46",6459,6313,12772
"1288","MERU","47",6281,6254,12535
"1289","MERU","48",4801,4881,9682
"1290","MERU","49",5851,5996,11847
"1291","MERU","45-49",32801,32486,65287
"1292","MERU","50",8062,8644,16706
"1293","MERU","51",4812,4258,9070
"1294","MERU","52",3698,3156,6854
"1295","MERU","53",2672,2497,5169
"1296","MERU","54",3355,3011,6366
"1297","MERU","50-54",22599,21566,44165
"1298","MERU","55",4683,4576,9259
"1299","MERU","56",5003,5017,10020
"1300","MERU","57",3734,4464,8198
"1301","MERU","58",3463,3736,7199
"1302","MERU","59",3910,4341,8251
"1303","MERU","55-59",20793,22134,42927
"1304","MERU","60",5851,6695,12546
"1305","MERU","61",3098,3285,6383
"1306","MERU","62",2879,2834,5713
"1307","MERU","63",2605,2794,5399
"1308","MERU","64",1851,2047,3898
"1309","MERU","60-64",16284,17655,33939
"1310","MERU","65",3726,4470,8196
"1311","MERU","66",1846,2035,3881
"1312","MERU","67",3352,3413,6765
"1313","MERU","68",1786,1728,3514
"1314","MERU","69",2615,3142,5757
"1315","MERU","65-69",13325,14788,28113
"1316","MERU","70",4531,6321,10852
"1317","MERU","71",1811,1981,3792
"1318","MERU","72",1796,1820,3616
"1319","MERU","73",1236,1361,2597
"1320","MERU","74",1135,1701,2836
"1321","MERU","70-74",10509,13184,23693
"1322","MERU","75",1437,1877,3314
"1323","MERU","76",775,827,1602
"1324","MERU","77",1126,1226,2352
"1325","MERU","78",829,788,1617
"1326","MERU","79",924,1769,2693
"1327","MERU","75-79",5091,6487,11578
"1328","MERU","80",1646,3157,4803
"1329","MERU","81",543,718,1261
"1330","MERU","82",525,550,1075
"1331","MERU","83",518,626,1144
"1332","MERU","84",547,840,1387
"1333","MERU","80-84",3779,5891,9670
"1334","MERU","85",608,889,1497
"1335","MERU","86",400,363,763
"1336","MERU","87",348,487,835
"1337","MERU","88",218,268,486
"1338","MERU","89",438,1108,1546
"1339","MERU","85-89",2012,3115,5127
"1340","MERU","90",442,1003,1445
"1341","MERU","91",151,279,430
"1342","MERU","92",106,169,275
"1343","MERU","93",96,152,248
"1344","MERU","94",104,240,344
"1345","MERU","90-94",899,1843,2742
"1346","MERU","95",165,303,468
"1347","MERU","96",63,104,167
"1348","MERU","97",97,113,210
"1349","MERU","98",64,88,152
"1350","MERU","99",113,286,399
"1351","MERU","95-99",502,894,1396
"1352","MERU","100+",281,757,1038
"1353","MERU","Not Stated",11,12,23
"1354","THARAKA-NITHI","Total",177716,182712,360428
"1355","THARAKA-NITHI","0",3469,3486,6955
"1356","THARAKA-NITHI","1",3564,3604,7168
"1357","THARAKA-NITHI","2",3743,3679,7422
"1358","THARAKA-NITHI","3",3800,3926,7726
"1359","THARAKA-NITHI","4",3786,3787,7573
"1360","THARAKA-NITHI","0 - 4",18362,18482,36844
"1361","THARAKA-NITHI","5",3996,3868,7864
"1362","THARAKA-NITHI","6",3897,3912,7809
"1363","THARAKA-NITHI","7",4089,3982,8071
"1364","THARAKA-NITHI","8",4038,4068,8106
"1365","THARAKA-NITHI","9",4318,4259,8577
"1366","THARAKA-NITHI","5-9",20338,20089,40427
"1367","THARAKA-NITHI","10",4520,4354,8874
"1368","THARAKA-NITHI","11",4213,4307,8520
"1369","THARAKA-NITHI","12",4793,4662,9455
"1370","THARAKA-NITHI","13",4778,4719,9497
"1371","THARAKA-NITHI","14",4602,4503,9105
"1372","THARAKA-NITHI","10-14",22906,22545,45451
"1373","THARAKA-NITHI","15",4431,4455,8886
"1374","THARAKA-NITHI","16",4246,4329,8575
"1375","THARAKA-NITHI","17",4420,4037,8457
"1376","THARAKA-NITHI","18",3594,3402,6996
"1377","THARAKA-NITHI","19",3675,3527,7202
"1378","THARAKA-NITHI","15-19",20366,19750,40116
"1379","THARAKA-NITHI","20",3117,3243,6360
"1380","THARAKA-NITHI","21",2723,2753,5476
"1381","THARAKA-NITHI","22",2641,2738,5379
"1382","THARAKA-NITHI","23",2675,2901,5576
"1383","THARAKA-NITHI","24",2394,2540,4934
"1384","THARAKA-NITHI","20-24",13550,14175,27725
"1385","THARAKA-NITHI","25",2606,2633,5239
"1386","THARAKA-NITHI","26",2111,2273,4384
"1387","THARAKA-NITHI","27",2340,2477,4817
"1388","THARAKA-NITHI","28",1939,2115,4054
"1389","THARAKA-NITHI","29",2230,2407,4637
"1390","THARAKA-NITHI","25-29",11226,11905,23131
"1391","THARAKA-NITHI","30",2742,3121,5863
"1392","THARAKA-NITHI","31",2149,2169,4318
"1393","THARAKA-NITHI","32",2498,2810,5308
"1394","THARAKA-NITHI","33",2379,2658,5037
"1395","THARAKA-NITHI","34",1945,2188,4133
"1396","THARAKA-NITHI","30-34",11713,12946,24659
"1397","THARAKA-NITHI","35",2896,3004,5900
"1398","THARAKA-NITHI","36",1978,2018,3996
"1399","THARAKA-NITHI","37",2150,2047,4197
"1400","THARAKA-NITHI","38",1721,1722,3443
"1401","THARAKA-NITHI","39",2189,2193,4382
"1402","THARAKA-NITHI","35-39",10934,10984,21918
"1403","THARAKA-NITHI","40",2423,2373,4796
"1404","THARAKA-NITHI","41",2123,1950,4073
"1405","THARAKA-NITHI","42",1925,1836,3761
"1406","THARAKA-NITHI","43",1708,1751,3459
"1407","THARAKA-NITHI","44",1579,1610,3189
"1408","THARAKA-NITHI","40-44",9758,9520,19278
"1409","THARAKA-NITHI","45",2241,2377,4618
"1410","THARAKA-NITHI","46",1957,1999,3956
"1411","THARAKA-NITHI","47",1792,1793,3585
"1412","THARAKA-NITHI","48",1410,1389,2799
"1413","THARAKA-NITHI","49",1714,1769,3483
"1414","THARAKA-NITHI","45-49",9114,9327,18441
"1415","THARAKA-NITHI","50",1789,1928,3717
"1416","THARAKA-NITHI","51",1446,1350,2796
"1417","THARAKA-NITHI","52",1106,969,2075
"1418","THARAKA-NITHI","53",873,846,1719
"1419","THARAKA-NITHI","54",1174,1054,2228
"1420","THARAKA-NITHI","50-54",6388,6147,12535
"1421","THARAKA-NITHI","55",1347,1212,2559
"1422","THARAKA-NITHI","56",1466,1422,2888
"1423","THARAKA-NITHI","57",1114,1356,2470
"1424","THARAKA-NITHI","58",1095,1167,2262
"1425","THARAKA-NITHI","59",1299,1400,2699
"1426","THARAKA-NITHI","55-59",6321,6557,12878
"1427","THARAKA-NITHI","60",1562,1594,3156
"1428","THARAKA-NITHI","61",1119,1141,2260
"1429","THARAKA-NITHI","62",972,911,1883
"1430","THARAKA-NITHI","63",873,944,1817
"1431","THARAKA-NITHI","64",639,637,1276
"1432","THARAKA-NITHI","60-64",5165,5227,10392
"1433","THARAKA-NITHI","65",956,1103,2059
"1434","THARAKA-NITHI","66",662,678,1340
"1435","THARAKA-NITHI","67",1127,1183,2310
"1436","THARAKA-NITHI","68",544,583,1127
"1437","THARAKA-NITHI","69",817,1060,1877
"1438","THARAKA-NITHI","65-69",4106,4607,8713
"1439","THARAKA-NITHI","70",1053,1470,2523
"1440","THARAKA-NITHI","71",772,868,1640
"1441","THARAKA-NITHI","72",552,635,1187
"1442","THARAKA-NITHI","73",397,523,920
"1443","THARAKA-NITHI","74",440,618,1058
"1444","THARAKA-NITHI","70-74",3214,4114,7328
"1445","THARAKA-NITHI","75",409,493,902
"1446","THARAKA-NITHI","76",277,336,613
"1447","THARAKA-NITHI","77",411,514,925
"1448","THARAKA-NITHI","78",266,265,531
"1449","THARAKA-NITHI","79",329,589,918
"1450","THARAKA-NITHI","75-79",1692,2197,3889
"1451","THARAKA-NITHI","80",453,684,1137
"1452","THARAKA-NITHI","81",192,356,548
"1453","THARAKA-NITHI","82",173,183,356
"1454","THARAKA-NITHI","83",227,277,504
"1455","THARAKA-NITHI","84",176,291,467
"1456","THARAKA-NITHI","80-84",1221,1791,3012
"1457","THARAKA-NITHI","85",169,247,416
"1458","THARAKA-NITHI","86",117,145,262
"1459","THARAKA-NITHI","87",165,238,403
"1460","THARAKA-NITHI","88",93,113,206
"1461","THARAKA-NITHI","89",201,424,625
"1462","THARAKA-NITHI","85-89",745,1167,1912
"1463","THARAKA-NITHI","90",95,192,287
"1464","THARAKA-NITHI","91",80,151,231
"1465","THARAKA-NITHI","92",35,62,97
"1466","THARAKA-NITHI","93",37,65,102
"1467","THARAKA-NITHI","94",50,74,124
"1468","THARAKA-NITHI","90-94",297,544,841
"1469","THARAKA-NITHI","95",45,82,127
"1470","THARAKA-NITHI","96",19,49,68
"1471","THARAKA-NITHI","97",66,79,145
"1472","THARAKA-NITHI","98",25,45,70
"1473","THARAKA-NITHI","99",56,146,202
"1474","THARAKA-NITHI","95-99",211,401,612
"1475","THARAKA-NITHI","100+",84,233,317
"1476","THARAKA-NITHI","Not Stated",5,4,9
"1477","EMBU","Total",267126,265534,532660
"1478","EMBU","0",4831,4847,9678
"1479","EMBU","1",5693,5384,11077
"1480","EMBU","2",5332,5307,10639
"1481","EMBU","3",5644,5436,11080
"1482","EMBU","4",5514,5347,10861
"1483","EMBU","0 - 4",27014,26321,53335
"1484","EMBU","5",5384,5096,10480
"1485","EMBU","6",5201,5328,10529
"1486","EMBU","7",5457,5406,10863
"1487","EMBU","8",5511,5295,10806
"1488","EMBU","9",5992,5892,11884
"1489","EMBU","5-9",27545,27017,54562
"1490","EMBU","10",5966,5834,11800
"1491","EMBU","11",5809,5874,11683
"1492","EMBU","12",6647,6230,12877
"1493","EMBU","13",6703,6567,13270
"1494","EMBU","14",6429,6079,12508
"1495","EMBU","10-14",31554,30584,62138
"1496","EMBU","15",6292,6145,12437
"1497","EMBU","16",6349,6095,12444
"1498","EMBU","17",6351,5764,12115
"1499","EMBU","18",5269,4750,10019
"1500","EMBU","19",5453,4766,10219
"1501","EMBU","15-19",29714,27520,57234
"1502","EMBU","20",5150,4663,9813
"1503","EMBU","21",4366,3966,8332
"1504","EMBU","22",4373,4152,8525
"1505","EMBU","23",4395,4272,8667
"1506","EMBU","24",3999,3610,7609
"1507","EMBU","20-24",22283,20663,42946
"1508","EMBU","25",4215,3767,7982
"1509","EMBU","26",3453,3275,6728
"1510","EMBU","27",3800,3419,7219
"1511","EMBU","28",3416,3179,6595
"1512","EMBU","29",3779,3701,7480
"1513","EMBU","25-29",18663,17341,36004
"1514","EMBU","30",4605,4474,9079
"1515","EMBU","31",3351,3263,6614
"1516","EMBU","32",4079,4260,8339
"1517","EMBU","33",3904,3938,7842
"1518","EMBU","34",3344,3486,6830
"1519","EMBU","30-34",19283,19421,38704
"1520","EMBU","35",4722,4356,9078
"1521","EMBU","36",3399,3392,6791
"1522","EMBU","37",3695,3316,7011
"1523","EMBU","38",3021,3005,6026
"1524","EMBU","39",3542,3432,6974
"1525","EMBU","35-39",18379,17501,35880
"1526","EMBU","40",4126,3791,7917
"1527","EMBU","41",3402,3140,6542
"1528","EMBU","42",3122,3011,6133
"1529","EMBU","43",2964,2926,5890
"1530","EMBU","44",2692,2523,5215
"1531","EMBU","40-44",16306,15391,31697
"1532","EMBU","45",3509,3397,6906
"1533","EMBU","46",2760,2754,5514
"1534","EMBU","47",2717,2632,5349
"1535","EMBU","48",2244,2208,4452
"1536","EMBU","49",2458,2430,4888
"1537","EMBU","45-49",13688,13421,27109
"1538","EMBU","50",2690,2978,5668
"1539","EMBU","51",2262,2301,4563
"1540","EMBU","52",2170,2280,4450
"1541","EMBU","53",1629,1890,3519
"1542","EMBU","54",1918,1956,3874
"1543","EMBU","50-54",10669,11405,22074
"1544","EMBU","55",2219,2188,4407
"1545","EMBU","56",2508,2625,5133
"1546","EMBU","57",1866,2180,4046
"1547","EMBU","58",1407,1591,2998
"1548","EMBU","59",1781,1893,3674
"1549","EMBU","55-59",9781,10477,20258
"1550","EMBU","60",2058,2133,4191
"1551","EMBU","61",1527,1624,3151
"1552","EMBU","62",1276,1334,2610
"1553","EMBU","63",1017,1174,2191
"1554","EMBU","64",868,967,1835
"1555","EMBU","60-64",6746,7232,13978
"1556","EMBU","65",1447,1660,3107
"1557","EMBU","66",1124,1076,2200
"1558","EMBU","67",1721,1680,3401
"1559","EMBU","68",722,806,1528
"1560","EMBU","69",1014,1277,2291
"1561","EMBU","65-69",6028,6499,12527
"1562","EMBU","70",1232,1994,3226
"1563","EMBU","71",864,1090,1954
"1564","EMBU","72",676,809,1485
"1565","EMBU","73",578,720,1298
"1566","EMBU","74",518,784,1302
"1567","EMBU","70-74",3868,5397,9265
"1568","EMBU","75",520,834,1354
"1569","EMBU","76",398,468,866
"1570","EMBU","77",432,591,1023
"1571","EMBU","78",336,364,700
"1572","EMBU","79",410,733,1143
"1573","EMBU","75-79",2096,2990,5086
"1574","EMBU","80",582,1080,1662
"1575","EMBU","81",278,541,819
"1576","EMBU","82",264,283,547
"1577","EMBU","83",294,354,648
"1578","EMBU","84",279,448,727
"1579","EMBU","80-84",1697,2706,4403
"1580","EMBU","85",259,405,664
"1581","EMBU","86",179,206,385
"1582","EMBU","87",201,287,488
"1583","EMBU","88",119,166,285
"1584","EMBU","89",224,537,761
"1585","EMBU","85-89",982,1601,2583
"1586","EMBU","90",145,420,565
"1587","EMBU","91",134,330,464
"1588","EMBU","92",73,124,197
"1589","EMBU","93",41,142,183
"1590","EMBU","94",53,131,184
"1591","EMBU","90-94",446,1147,1593
"1592","EMBU","95",81,180,261
"1593","EMBU","96",32,86,118
"1594","EMBU","97",61,79,140
"1595","EMBU","98",30,66,96
"1596","EMBU","99",60,158,218
"1597","EMBU","95-99",264,569,833
"1598","EMBU","100+",116,328,444
"1599","KITUI","Total",522943,559193,1082136
"1600","KITUI","0",10791,10681,21472
"1601","KITUI","1",11890,11664,23554
"1602","KITUI","2",12193,12083,24276
"1603","KITUI","3",12613,12500,25113
"1604","KITUI","4",12922,12545,25467
"1605","KITUI","0 - 4",60409,59473,119882
"1606","KITUI","5",13612,13277,26889
"1607","KITUI","6",13706,13419,27125
"1608","KITUI","7",13131,12781,25912
"1609","KITUI","8",14860,14627,29487
"1610","KITUI","9",15275,14831,30106
"1611","KITUI","5-9",70584,68935,139519
"1612","KITUI","10",16248,15732,31980
"1613","KITUI","11",16656,17256,33912
"1614","KITUI","12",18058,16753,34811
"1615","KITUI","13",17438,17019,34457
"1616","KITUI","14",17190,16644,33834
"1617","KITUI","10-14",85590,83404,168994
"1618","KITUI","15",17414,16702,34116
"1619","KITUI","16",16513,16174,32687
"1620","KITUI","17",16288,15233,31521
"1621","KITUI","18",12425,11376,23801
"1622","KITUI","19",12754,11457,24211
"1623","KITUI","15-19",75394,70942,146336
"1624","KITUI","20",10790,10258,21048
"1625","KITUI","21",8481,8451,16932
"1626","KITUI","22",7194,7505,14699
"1627","KITUI","23",7085,8041,15126
"1628","KITUI","24",6164,6960,13124
"1629","KITUI","20-24",39714,41215,80929
"1630","KITUI","25",7005,7629,14634
"1631","KITUI","26",5035,6114,11149
"1632","KITUI","27",5769,6351,12120
"1633","KITUI","28",4573,5553,10126
"1634","KITUI","29",5555,6878,12433
"1635","KITUI","25-29",27937,32525,60462
"1636","KITUI","30",6355,8292,14647
"1637","KITUI","31",5061,6166,11227
"1638","KITUI","32",5921,7639,13560
"1639","KITUI","33",5454,7235,12689
"1640","KITUI","34",4634,6166,10800
"1641","KITUI","30-34",27425,35498,62923
"1642","KITUI","35",6390,8011,14401
"1643","KITUI","36",4314,5350,9664
"1644","KITUI","37",5006,5579,10585
"1645","KITUI","38",3416,4185,7601
"1646","KITUI","39",5000,5704,10704
"1647","KITUI","35-39",24126,28829,52955
"1648","KITUI","40",4881,5448,10329
"1649","KITUI","41",5137,5457,10594
"1650","KITUI","42",4300,4955,9255
"1651","KITUI","43",4043,5160,9203
"1652","KITUI","44",3917,5137,9054
"1653","KITUI","40-44",22278,26157,48435
"1654","KITUI","45",5871,7097,12968
"1655","KITUI","46",4098,4776,8874
"1656","KITUI","47",4013,4779,8792
"1657","KITUI","48",2889,3409,6298
"1658","KITUI","49",3838,4666,8504
"1659","KITUI","45-49",20709,24727,45436
"1660","KITUI","50",3718,4757,8475
"1661","KITUI","51",3436,4209,7645
"1662","KITUI","52",2734,3100,5834
"1663","KITUI","53",2106,2392,4498
"1664","KITUI","54",2941,2989,5930
"1665","KITUI","50-54",14935,17447,32382
"1666","KITUI","55",3088,3040,6128
"1667","KITUI","56",3349,3519,6868
"1668","KITUI","57",2478,3005,5483
"1669","KITUI","58",1751,2417,4168
"1670","KITUI","59",2544,3551,6095
"1671","KITUI","55-59",13210,15532,28742
"1672","KITUI","60",3075,3795,6870
"1673","KITUI","61",2468,2927,5395
"1674","KITUI","62",1984,2167,4151
"1675","KITUI","63",2038,2392,4430
"1676","KITUI","64",1630,1929,3559
"1677","KITUI","60-64",11195,13210,24405
"1678","KITUI","65",2349,2842,5191
"1679","KITUI","66",1641,1671,3312
"1680","KITUI","67",2769,3073,5842
"1681","KITUI","68",1343,1578,2921
"1682","KITUI","69",1885,3090,4975
"1683","KITUI","65-69",9987,12254,22241
"1684","KITUI","70",2279,3711,5990
"1685","KITUI","71",1620,2091,3711
"1686","KITUI","72",1141,1398,2539
"1687","KITUI","73",1366,2489,3855
"1688","KITUI","74",1141,1922,3063
"1689","KITUI","70-74",7547,11611,19158
"1690","KITUI","75",1149,1456,2605
"1691","KITUI","76",739,925,1664
"1692","KITUI","77",916,1089,2005
"1693","KITUI","78",757,672,1429
"1694","KITUI","79",927,1740,2667
"1695","KITUI","75-79",4488,5882,10370
"1696","KITUI","80",1120,1919,3039
"1697","KITUI","81",598,865,1463
"1698","KITUI","82",529,470,999
"1699","KITUI","83",589,763,1352
"1700","KITUI","84",711,1254,1965
"1701","KITUI","80-84",3547,5271,8818
"1702","KITUI","85",454,619,1073
"1703","KITUI","86",338,247,585
"1704","KITUI","87",375,457,832
"1705","KITUI","88",195,208,403
"1706","KITUI","89",490,1044,1534
"1707","KITUI","85-89",1852,2575,4427
"1708","KITUI","90",433,923,1356
"1709","KITUI","91",278,694,972
"1710","KITUI","92",199,288,487
"1711","KITUI","93",130,222,352
"1712","KITUI","94",154,225,379
"1713","KITUI","90-94",1194,2352,3546
"1714","KITUI","95",166,303,469
"1715","KITUI","96",71,94,165
"1716","KITUI","97",108,81,189
"1717","KITUI","98",59,105,164
"1718","KITUI","99",146,289,435
"1719","KITUI","95-99",550,872,1422
"1720","KITUI","100+",268,476,744
"1721","MACHAKOS","Total",504247,503582,1007829
"1722","MACHAKOS","0",9076,9016,18092
"1723","MACHAKOS","1",9786,9555,19341
"1724","MACHAKOS","2",9717,9647,19364
"1725","MACHAKOS","3",10296,10315,20611
"1726","MACHAKOS","4",10789,10172,20961
"1727","MACHAKOS","0 - 4",49664,48705,98369
"1728","MACHAKOS","5",10904,10319,21223
"1729","MACHAKOS","6",10667,10412,21079
"1730","MACHAKOS","7",11158,10622,21780
"1731","MACHAKOS","8",11370,11225,22595
"1732","MACHAKOS","9",12618,11727,24345
"1733","MACHAKOS","5-9",56717,54305,111022
"1734","MACHAKOS","10",12783,12291,25074
"1735","MACHAKOS","11",12690,12934,25624
"1736","MACHAKOS","12",13964,13293,27257
"1737","MACHAKOS","13",13655,13166,26821
"1738","MACHAKOS","14",13646,12508,26154
"1739","MACHAKOS","10-14",66738,64192,130930
"1740","MACHAKOS","15",13258,12712,25970
"1741","MACHAKOS","16",12745,12002,24747
"1742","MACHAKOS","17",13319,11895,25214
"1743","MACHAKOS","18",10423,8956,19379
"1744","MACHAKOS","19",10953,8849,19802
"1745","MACHAKOS","15-19",60698,54414,115112
"1746","MACHAKOS","20",10000,8438,18438
"1747","MACHAKOS","21",8825,7446,16271
"1748","MACHAKOS","22",7755,6821,14576
"1749","MACHAKOS","23",8320,7597,15917
"1750","MACHAKOS","24",7319,6563,13882
"1751","MACHAKOS","20-24",42219,36865,79084
"1752","MACHAKOS","25",7316,6638,13954
"1753","MACHAKOS","26",5993,5925,11918
"1754","MACHAKOS","27",6425,6166,12591
"1755","MACHAKOS","28",5556,5770,11326
"1756","MACHAKOS","29",6795,6818,13613
"1757","MACHAKOS","25-29",32085,31317,63402
"1758","MACHAKOS","30",7541,8094,15635
"1759","MACHAKOS","31",6130,6139,12269
"1760","MACHAKOS","32",7267,7687,14954
"1761","MACHAKOS","33",6539,7175,13714
"1762","MACHAKOS","34",5932,6147,12079
"1763","MACHAKOS","30-34",33409,35242,68651
"1764","MACHAKOS","35",7557,7759,15316
"1765","MACHAKOS","36",5873,5983,11856
"1766","MACHAKOS","37",6548,6108,12656
"1767","MACHAKOS","38",4830,4626,9456
"1768","MACHAKOS","39",6371,6272,12643
"1769","MACHAKOS","35-39",31179,30748,61927
"1770","MACHAKOS","40",6405,6271,12676
"1771","MACHAKOS","41",6621,6405,13026
"1772","MACHAKOS","42",5536,5545,11081
"1773","MACHAKOS","43",5117,5840,10957
"1774","MACHAKOS","44",4441,4445,8886
"1775","MACHAKOS","40-44",28120,28506,56626
"1776","MACHAKOS","45",6059,5875,11934
"1777","MACHAKOS","46",4811,4490,9301
"1778","MACHAKOS","47",4887,4559,9446
"1779","MACHAKOS","48",3423,3544,6967
"1780","MACHAKOS","49",4669,4769,9438
"1781","MACHAKOS","45-49",23849,23237,47086
"1782","MACHAKOS","50",4532,5116,9648
"1783","MACHAKOS","51",3922,4299,8221
"1784","MACHAKOS","52",3155,3275,6430
"1785","MACHAKOS","53",2640,2804,5444
"1786","MACHAKOS","54",3150,3306,6456
"1787","MACHAKOS","50-54",17399,18800,36199
"1788","MACHAKOS","55",3494,3490,6984
"1789","MACHAKOS","56",4010,4251,8261
"1790","MACHAKOS","57",3084,3942,7026
"1791","MACHAKOS","58",2368,2768,5136
"1792","MACHAKOS","59",3525,3859,7384
"1793","MACHAKOS","55-59",16481,18310,34791
"1794","MACHAKOS","60",4083,4447,8530
"1795","MACHAKOS","61",3594,3731,7325
"1796","MACHAKOS","62",2806,2830,5636
"1797","MACHAKOS","63",2962,3163,6125
"1798","MACHAKOS","64",1973,2144,4117
"1799","MACHAKOS","60-64",15418,16315,31733
"1800","MACHAKOS","65",2792,3164,5956
"1801","MACHAKOS","66",1838,2161,3999
"1802","MACHAKOS","67",3396,4208,7604
"1803","MACHAKOS","68",1318,1602,2920
"1804","MACHAKOS","69",2002,2712,4714
"1805","MACHAKOS","65-69",11346,13847,25193
"1806","MACHAKOS","70",2396,3165,5561
"1807","MACHAKOS","71",1846,2470,4316
"1808","MACHAKOS","72",1378,1428,2806
"1809","MACHAKOS","73",1263,1471,2734
"1810","MACHAKOS","74",1185,1634,2819
"1811","MACHAKOS","70-74",8068,10168,18236
"1812","MACHAKOS","75",917,1290,2207
"1813","MACHAKOS","76",708,1210,1918
"1814","MACHAKOS","77",929,1570,2499
"1815","MACHAKOS","78",623,729,1352
"1816","MACHAKOS","79",665,1639,2304
"1817","MACHAKOS","75-79",3842,6438,10280
"1818","MACHAKOS","80",1004,1726,2730
"1819","MACHAKOS","81",669,990,1659
"1820","MACHAKOS","82",578,600,1178
"1821","MACHAKOS","83",619,850,1469
"1822","MACHAKOS","84",507,864,1371
"1823","MACHAKOS","80-84",3377,5030,8407
"1824","MACHAKOS","85",407,649,1056
"1825","MACHAKOS","86",294,309,603
"1826","MACHAKOS","87",403,668,1071
"1827","MACHAKOS","88",198,239,437
"1828","MACHAKOS","89",383,1177,1560
"1829","MACHAKOS","85-89",1685,3042,4727
"1830","MACHAKOS","90",300,711,1011
"1831","MACHAKOS","91",408,856,1264
"1832","MACHAKOS","92",171,292,463
"1833","MACHAKOS","93",129,250,379
"1834","MACHAKOS","94",117,269,386
"1835","MACHAKOS","90-94",1125,2378,3503
"1836","MACHAKOS","95",174,358,532
"1837","MACHAKOS","96",92,143,235
"1838","MACHAKOS","97",112,132,244
"1839","MACHAKOS","98",70,129,199
"1840","MACHAKOS","99",105,360,465
"1841","MACHAKOS","95-99",553,1122,1675
"1842","MACHAKOS","100+",267,600,867
"1843","MAKUENI","Total",450482,460075,910557
"1844","MAKUENI","0",7902,7982,15884
"1845","MAKUENI","1",8888,8671,17559
"1846","MAKUENI","2",8733,8725,17458
"1847","MAKUENI","3",9341,8923,18264
"1848","MAKUENI","4",9603,9317,18920
"1849","MAKUENI","0 - 4",44467,43618,88085
"1850","MAKUENI","5",10029,9649,19678
"1851","MAKUENI","6",9841,9636,19477
"1852","MAKUENI","7",10399,10099,20498
"1853","MAKUENI","8",11009,10713,21722
"1854","MAKUENI","9",11822,11525,23347
"1855","MAKUENI","5-9",53100,51622,104722
"1856","MAKUENI","10",12410,12171,24581
"1857","MAKUENI","11",12605,12766,25371
"1858","MAKUENI","12",13892,13201,27093
"1859","MAKUENI","13",13337,13311,26648
"1860","MAKUENI","14",13350,12631,25981
"1861","MAKUENI","10-14",65594,64080,129674
"1862","MAKUENI","15",13513,12886,26399
"1863","MAKUENI","16",12812,12371,25183
"1864","MAKUENI","17",13452,12215,25667
"1865","MAKUENI","18",10423,9088,19511
"1866","MAKUENI","19",10789,8999,19788
"1867","MAKUENI","15-19",60989,55559,116548
"1868","MAKUENI","20",9313,7880,17193
"1869","MAKUENI","21",7773,6864,14637
"1870","MAKUENI","22",6713,5975,12688
"1871","MAKUENI","23",6867,6588,13455
"1872","MAKUENI","24",6279,5804,12083
"1873","MAKUENI","20-24",36945,33111,70056
"1874","MAKUENI","25",6618,6210,12828
"1875","MAKUENI","26",5357,5622,10979
"1876","MAKUENI","27",5725,5545,11270
"1877","MAKUENI","28",4575,4770,9345
"1878","MAKUENI","29",5672,5869,11541
"1879","MAKUENI","25-29",27947,28016,55963
"1880","MAKUENI","30",6365,7080,13445
"1881","MAKUENI","31",4985,5329,10314
"1882","MAKUENI","32",5773,6462,12235
"1883","MAKUENI","33",5473,6190,11663
"1884","MAKUENI","34",4606,5276,9882
"1885","MAKUENI","30-34",27202,30337,57539
"1886","MAKUENI","35",6481,6804,13285
"1887","MAKUENI","36",4592,4809,9401
"1888","MAKUENI","37",5206,5045,10251
"1889","MAKUENI","38",3533,3780,7313
"1890","MAKUENI","39",4911,5140,10051
"1891","MAKUENI","35-39",24723,25578,50301
"1892","MAKUENI","40",5016,5140,10156
"1893","MAKUENI","41",5127,5026,10153
"1894","MAKUENI","42",4333,4265,8598
"1895","MAKUENI","43",3923,4506,8429
"1896","MAKUENI","44",3756,4266,8022
"1897","MAKUENI","40-44",22155,23203,45358
"1898","MAKUENI","45",5488,6180,11668
"1899","MAKUENI","46",4045,4488,8533
"1900","MAKUENI","47",4094,4533,8627
"1901","MAKUENI","48",2881,3102,5983
"1902","MAKUENI","49",4031,4599,8630
"1903","MAKUENI","45-49",20539,22902,43441
"1904","MAKUENI","50",3804,4150,7954
"1905","MAKUENI","51",3356,3489,6845
"1906","MAKUENI","52",2577,2773,5350
"1907","MAKUENI","53",2258,2351,4609
"1908","MAKUENI","54",2842,2788,5630
"1909","MAKUENI","50-54",14837,15551,30388
"1910","MAKUENI","55",2797,2832,5629
"1911","MAKUENI","56",2758,3226,5984
"1912","MAKUENI","57",2606,3365,5971
"1913","MAKUENI","58",1907,2169,4076
"1914","MAKUENI","59",2807,3229,6036
"1915","MAKUENI","55-59",12875,14821,27696
"1916","MAKUENI","60",3176,3708,6884
"1917","MAKUENI","61",2740,3116,5856
"1918","MAKUENI","62",2167,2410,4577
"1919","MAKUENI","63",2334,2684,5018
"1920","MAKUENI","64",1668,1858,3526
"1921","MAKUENI","60-64",12085,13776,25861
"1922","MAKUENI","65",2438,3103,5541
"1923","MAKUENI","66",1563,1719,3282
"1924","MAKUENI","67",2879,3645,6524
"1925","MAKUENI","68",1171,1513,2684
"1926","MAKUENI","69",1826,2431,4257
"1927","MAKUENI","65-69",9877,12411,22288
"1928","MAKUENI","70",2145,2979,5124
"1929","MAKUENI","71",1646,2084,3730
"1930","MAKUENI","72",1230,1195,2425
"1931","MAKUENI","73",1156,1436,2592
"1932","MAKUENI","74",1076,1621,2697
"1933","MAKUENI","70-74",7253,9315,16568
"1934","MAKUENI","75",835,1241,2076
"1935","MAKUENI","76",614,836,1450
"1936","MAKUENI","77",904,1331,2235
"1937","MAKUENI","78",560,648,1208
"1938","MAKUENI","79",671,1496,2167
"1939","MAKUENI","75-79",3584,5552,9136
"1940","MAKUENI","80",907,1600,2507
"1941","MAKUENI","81",530,771,1301
"1942","MAKUENI","82",449,500,949
"1943","MAKUENI","83",569,687,1256
"1944","MAKUENI","84",445,785,1230
"1945","MAKUENI","80-84",2900,4343,7243
"1946","MAKUENI","85",353,509,862
"1947","MAKUENI","86",244,268,512
"1948","MAKUENI","87",341,533,874
"1949","MAKUENI","88",172,206,378
"1950","MAKUENI","89",403,1053,1456
"1951","MAKUENI","85-89",1513,2569,4082
"1952","MAKUENI","90",305,758,1063
"1953","MAKUENI","91",280,741,1021
"1954","MAKUENI","92",201,317,518
"1955","MAKUENI","93",113,291,404
"1956","MAKUENI","94",108,234,342
"1957","MAKUENI","90-94",1007,2341,3348
"1958","MAKUENI","95",189,279,468
"1959","MAKUENI","96",66,93,159
"1960","MAKUENI","97",111,103,214
"1961","MAKUENI","98",75,94,169
"1962","MAKUENI","99",144,267,411
"1963","MAKUENI","95-99",585,836,1421
"1964","MAKUENI","100+",301,530,831
"1965","MAKUENI","Not Stated",4,4,8
"1966","NYANDARUA","Total",282499,289240,571739
"1967","NYANDARUA","0",5907,5979,11886
"1968","NYANDARUA","1",6007,5873,11880
"1969","NYANDARUA","2",6225,6041,12266
"1970","NYANDARUA","3",6378,6271,12649
"1971","NYANDARUA","4",6562,6236,12798
"1972","NYANDARUA","0 - 4",31079,30400,61479
"1973","NYANDARUA","5",6560,6180,12740
"1974","NYANDARUA","6",6505,6555,13060
"1975","NYANDARUA","7",6984,6654,13638
"1976","NYANDARUA","8",6725,6669,13394
"1977","NYANDARUA","9",7643,7423,15066
"1978","NYANDARUA","5-9",34417,33481,67898
"1979","NYANDARUA","10",7564,7073,14637
"1980","NYANDARUA","11",7057,6954,14011
"1981","NYANDARUA","12",8043,7472,15515
"1982","NYANDARUA","13",8230,7822,16052
"1983","NYANDARUA","14",8363,7747,16110
"1984","NYANDARUA","10-14",39257,37068,76325
"1985","NYANDARUA","15",8091,7453,15544
"1986","NYANDARUA","16",7888,7528,15416
"1987","NYANDARUA","17",8083,7222,15305
"1988","NYANDARUA","18",6287,5520,11807
"1989","NYANDARUA","19",6177,5343,11520
"1990","NYANDARUA","15-19",36526,33066,69592
"1991","NYANDARUA","20",4937,4469,9406
"1992","NYANDARUA","21",4529,4199,8728
"1993","NYANDARUA","22",4231,3893,8124
"1994","NYANDARUA","23",3891,3996,7887
"1995","NYANDARUA","24",3362,3643,7005
"1996","NYANDARUA","20-24",20950,20200,41150
"1997","NYANDARUA","25",3720,3554,7274
"1998","NYANDARUA","26",2861,3154,6015
"1999","NYANDARUA","27",3030,3244,6274
"2000","NYANDARUA","28",2725,2969,5694
"2001","NYANDARUA","29",3028,3345,6373
"2002","NYANDARUA","25-29",15364,16266,31630
"2003","NYANDARUA","30",3668,4301,7969
"2004","NYANDARUA","31",2925,3193,6118
"2005","NYANDARUA","32",3588,4279,7867
"2006","NYANDARUA","33",3137,3828,6965
"2007","NYANDARUA","34",3160,3565,6725
"2008","NYANDARUA","30-34",16478,19166,35644
"2009","NYANDARUA","35",4346,4661,9007
"2010","NYANDARUA","36",3052,3499,6551
"2011","NYANDARUA","37",3193,3345,6538
"2012","NYANDARUA","38",2623,3067,5690
"2013","NYANDARUA","39",3059,3383,6442
"2014","NYANDARUA","35-39",16273,17955,34228
"2015","NYANDARUA","40",3553,3774,7327
"2016","NYANDARUA","41",3365,3582,6947
"2017","NYANDARUA","42",3163,3408,6571
"2018","NYANDARUA","43",2770,3079,5849
"2019","NYANDARUA","44",2302,2514,4816
"2020","NYANDARUA","40-44",15153,16357,31510
"2021","NYANDARUA","45",3489,3739,7228
"2022","NYANDARUA","46",2745,3043,5788
"2023","NYANDARUA","47",3044,3201,6245
"2024","NYANDARUA","48",2232,2505,4737
"2025","NYANDARUA","49",2564,2823,5387
"2026","NYANDARUA","45-49",14074,15311,29385
"2027","NYANDARUA","50",2812,3204,6016
"2028","NYANDARUA","51",2338,2490,4828
"2029","NYANDARUA","52",2595,2666,5261
"2030","NYANDARUA","53",1852,2093,3945
"2031","NYANDARUA","54",2133,2375,4508
"2032","NYANDARUA","50-54",11730,12828,24558
"2033","NYANDARUA","55",2354,2424,4778
"2034","NYANDARUA","56",2369,2357,4726
"2035","NYANDARUA","57",1814,2261,4075
"2036","NYANDARUA","58",1662,1749,3411
"2037","NYANDARUA","59",1718,1957,3675
"2038","NYANDARUA","55-59",9917,10748,20665
"2039","NYANDARUA","60",1898,2020,3918
"2040","NYANDARUA","61",1365,1545,2910
"2041","NYANDARUA","62",1349,1271,2620
"2042","NYANDARUA","63",1081,1082,2163
"2043","NYANDARUA","64",712,839,1551
"2044","NYANDARUA","60-64",6405,6757,13162
"2045","NYANDARUA","65",1288,1226,2514
"2046","NYANDARUA","66",872,919,1791
"2047","NYANDARUA","67",1433,1591,3024
"2048","NYANDARUA","68",583,768,1351
"2049","NYANDARUA","69",929,1164,2093
"2050","NYANDARUA","65-69",5105,5668,10773
"2051","NYANDARUA","70",1199,1528,2727
"2052","NYANDARUA","71",859,1048,1907
"2053","NYANDARUA","72",806,931,1737
"2054","NYANDARUA","73",642,770,1412
"2055","NYANDARUA","74",628,850,1478
"2056","NYANDARUA","70-74",4134,5127,9261
"2057","NYANDARUA","75",557,859,1416
"2058","NYANDARUA","76",719,1554,2273
"2059","NYANDARUA","77",455,643,1098
"2060","NYANDARUA","78",291,455,746
"2061","NYANDARUA","79",368,602,970
"2062","NYANDARUA","75-79",2390,4113,6503
"2063","NYANDARUA","80",507,736,1243
"2064","NYANDARUA","81",282,419,701
"2065","NYANDARUA","82",252,307,559
"2066","NYANDARUA","83",365,311,676
"2067","NYANDARUA","84",312,409,721
"2068","NYANDARUA","80-84",1718,2182,3900
"2069","NYANDARUA","85",241,341,582
"2070","NYANDARUA","86",163,282,445
"2071","NYANDARUA","87",176,243,419
"2072","NYANDARUA","88",105,129,234
"2073","NYANDARUA","89",185,345,530
"2074","NYANDARUA","85-89",870,1340,2210
"2075","NYANDARUA","90",127,216,343
"2076","NYANDARUA","91",138,174,312
"2077","NYANDARUA","92",54,102,156
"2078","NYANDARUA","93",48,70,118
"2079","NYANDARUA","94",29,101,130
"2080","NYANDARUA","90-94",396,663,1059
"2081","NYANDARUA","95",47,111,158
"2082","NYANDARUA","96",27,61,88
"2083","NYANDARUA","97",46,75,121
"2084","NYANDARUA","98",27,37,64
"2085","NYANDARUA","99",41,71,112
"2086","NYANDARUA","95-99",188,355,543
"2087","NYANDARUA","100+",71,189,260
"2088","NYANDARUA","Not Stated",4,NA,4
"2089","NYERI","Total",300893,307488,608381
"2090","NYERI","0",5496,5426,10922
"2091","NYERI","1",5507,5512,11019
"2092","NYERI","2",5662,5484,11146
"2093","NYERI","3",5947,5693,11640
"2094","NYERI","4",5971,5703,11674
"2095","NYERI","0 - 4",28583,27818,56401
"2096","NYERI","5",5945,5773,11718
"2097","NYERI","6",6059,5938,11997
"2098","NYERI","7",6290,6070,12360
"2099","NYERI","8",6148,6111,12259
"2100","NYERI","9",6543,6377,12920
"2101","NYERI","5-9",30985,30269,61254
"2102","NYERI","10",6510,6243,12753
"2103","NYERI","11",6037,5974,12011
"2104","NYERI","12",6722,6259,12981
"2105","NYERI","13",6873,6462,13335
"2106","NYERI","14",6720,6081,12801
"2107","NYERI","10-14",32862,31019,63881
"2108","NYERI","15",6649,6278,12927
"2109","NYERI","16",6581,6166,12747
"2110","NYERI","17",7107,6266,13373
"2111","NYERI","18",5873,5095,10968
"2112","NYERI","19",5768,4967,10735
"2113","NYERI","15-19",31978,28772,60750
"2114","NYERI","20",4971,4457,9428
"2115","NYERI","21",4631,4108,8739
"2116","NYERI","22",4325,4033,8358
"2117","NYERI","23",4376,4012,8388
"2118","NYERI","24",3715,3481,7196
"2119","NYERI","20-24",22018,20091,42109
"2120","NYERI","25",3764,3480,7244
"2121","NYERI","26",3120,3236,6356
"2122","NYERI","27",3210,3275,6485
"2123","NYERI","28",2929,3144,6073
"2124","NYERI","29",3320,3552,6872
"2125","NYERI","25-29",16343,16687,33030
"2126","NYERI","30",4154,4404,8558
"2127","NYERI","31",3311,3467,6778
"2128","NYERI","32",4130,4440,8570
"2129","NYERI","33",3671,4036,7707
"2130","NYERI","34",3562,3816,7378
"2131","NYERI","30-34",18828,20163,38991
"2132","NYERI","35",4845,5047,9892
"2133","NYERI","36",3735,3948,7683
"2134","NYERI","37",3920,3983,7903
"2135","NYERI","38",3468,3745,7213
"2136","NYERI","39",3685,4210,7895
"2137","NYERI","35-39",19653,20933,40586
"2138","NYERI","40",4618,4599,9217
"2139","NYERI","41",3842,3921,7763
"2140","NYERI","42",3943,3792,7735
"2141","NYERI","43",3425,3868,7293
"2142","NYERI","44",3190,3379,6569
"2143","NYERI","40-44",19018,19559,38577
"2144","NYERI","45",4354,4360,8714
"2145","NYERI","46",3514,3599,7113
"2146","NYERI","47",3687,3768,7455
"2147","NYERI","48",3170,3066,6236
"2148","NYERI","49",3321,3484,6805
"2149","NYERI","45-49",18046,18277,36323
"2150","NYERI","50",3835,4129,7964
"2151","NYERI","51",3010,3192,6202
"2152","NYERI","52",3333,3637,6970
"2153","NYERI","53",2461,2962,5423
"2154","NYERI","54",3082,3160,6242
"2155","NYERI","50-54",15721,17080,32801
"2156","NYERI","55",3101,3251,6352
"2157","NYERI","56",3079,3108,6187
"2158","NYERI","57",2706,3015,5721
"2159","NYERI","58",2366,2507,4873
"2160","NYERI","59",2456,2668,5124
"2161","NYERI","55-59",13708,14549,28257
"2162","NYERI","60",2723,3078,5801
"2163","NYERI","61",2097,2301,4398
"2164","NYERI","62",1824,1878,3702
"2165","NYERI","63",1438,1601,3039
"2166","NYERI","64",1041,1189,2230
"2167","NYERI","60-64",9123,10047,19170
"2168","NYERI","65",1724,2019,3743
"2169","NYERI","66",1242,1343,2585
"2170","NYERI","67",2263,2448,4711
"2171","NYERI","68",1083,1145,2228
"2172","NYERI","69",1586,1740,3326
"2173","NYERI","65-69",7898,8695,16593
"2174","NYERI","70",2097,2835,4932
"2175","NYERI","71",1524,1759,3283
"2176","NYERI","72",1505,1421,2926
"2177","NYERI","73",1223,1261,2484
"2178","NYERI","74",1039,1360,2399
"2179","NYERI","70-74",7388,8636,16024
"2180","NYERI","75",905,1266,2171
"2181","NYERI","76",992,1904,2896
"2182","NYERI","77",745,1152,1897
"2183","NYERI","78",532,700,1232
"2184","NYERI","79",560,1042,1602
"2185","NYERI","75-79",3734,6064,9798
"2186","NYERI","80",862,1431,2293
"2187","NYERI","81",482,712,1194
"2188","NYERI","82",460,533,993
"2189","NYERI","83",516,697,1213
"2190","NYERI","84",390,640,1030
"2191","NYERI","80-84",2710,4013,6723
"2192","NYERI","85",342,572,914
"2193","NYERI","86",300,514,814
"2194","NYERI","87",280,430,710
"2195","NYERI","88",142,254,396
"2196","NYERI","89",241,591,832
"2197","NYERI","85-89",1305,2361,3666
"2198","NYERI","90",174,476,650
"2199","NYERI","91",197,376,573
"2200","NYERI","92",85,171,256
"2201","NYERI","93",81,165,246
"2202","NYERI","94",69,171,240
"2203","NYERI","90-94",606,1359,1965
"2204","NYERI","95",95,226,321
"2205","NYERI","96",53,123,176
"2206","NYERI","97",62,105,167
"2207","NYERI","98",47,96,143
"2208","NYERI","99",42,167,209
"2209","NYERI","95-99",299,717,1016
"2210","NYERI","100+",83,377,460
"2211","NYERI","Not Stated",4,2,6
"2212","KIRINYAGA","Total",237086,237083,474169
"2213","KIRINYAGA","0",4433,4306,8739
"2214","KIRINYAGA","1",4184,4202,8386
"2215","KIRINYAGA","2",4233,4208,8441
"2216","KIRINYAGA","3",4443,4503,8946
"2217","KIRINYAGA","4",4317,4415,8732
"2218","KIRINYAGA","0 - 4",21610,21634,43244
"2219","KIRINYAGA","5",4377,4216,8593
"2220","KIRINYAGA","6",4222,4304,8526
"2221","KIRINYAGA","7",4584,4575,9159
"2222","KIRINYAGA","8",4423,4351,8774
"2223","KIRINYAGA","9",4900,4805,9705
"2224","KIRINYAGA","5-9",22506,22251,44757
"2225","KIRINYAGA","10",4796,4728,9524
"2226","KIRINYAGA","11",4542,4594,9136
"2227","KIRINYAGA","12",5070,4795,9865
"2228","KIRINYAGA","13",5228,5021,10249
"2229","KIRINYAGA","14",4937,4846,9783
"2230","KIRINYAGA","10-14",24573,23984,48557
"2231","KIRINYAGA","15",5085,4992,10077
"2232","KIRINYAGA","16",5066,4850,9916
"2233","KIRINYAGA","17",5154,4742,9896
"2234","KIRINYAGA","18",4368,3842,8210
"2235","KIRINYAGA","19",4290,3804,8094
"2236","KIRINYAGA","15-19",23963,22230,46193
"2237","KIRINYAGA","20",3770,3578,7348
"2238","KIRINYAGA","21",3386,3122,6508
"2239","KIRINYAGA","22",3459,3252,6711
"2240","KIRINYAGA","23",3386,3377,6763
"2241","KIRINYAGA","24",3166,2961,6127
"2242","KIRINYAGA","20-24",17167,16290,33457
"2243","KIRINYAGA","25",3387,3060,6447
"2244","KIRINYAGA","26",2677,2694,5371
"2245","KIRINYAGA","27",2919,2855,5774
"2246","KIRINYAGA","28",2720,2681,5401
"2247","KIRINYAGA","29",2970,3022,5992
"2248","KIRINYAGA","25-29",14673,14312,28985
"2249","KIRINYAGA","30",4052,4032,8084
"2250","KIRINYAGA","31",3013,3047,6060
"2251","KIRINYAGA","32",3877,4044,7921
"2252","KIRINYAGA","33",3717,3826,7543
"2253","KIRINYAGA","34",3288,3422,6710
"2254","KIRINYAGA","30-34",17947,18371,36318
"2255","KIRINYAGA","35",4743,4562,9305
"2256","KIRINYAGA","36",3595,3456,7051
"2257","KIRINYAGA","37",3795,3431,7226
"2258","KIRINYAGA","38",3220,3274,6494
"2259","KIRINYAGA","39",3658,3585,7243
"2260","KIRINYAGA","35-39",19011,18308,37319
"2261","KIRINYAGA","40",4264,4120,8384
"2262","KIRINYAGA","41",3517,3272,6789
"2263","KIRINYAGA","42",3337,3213,6550
"2264","KIRINYAGA","43",3049,2937,5986
"2265","KIRINYAGA","44",2937,2718,5655
"2266","KIRINYAGA","40-44",17104,16260,33364
"2267","KIRINYAGA","45",3798,3748,7546
"2268","KIRINYAGA","46",2927,2752,5679
"2269","KIRINYAGA","47",3010,2664,5674
"2270","KIRINYAGA","48",2360,2272,4632
"2271","KIRINYAGA","49",2583,2533,5116
"2272","KIRINYAGA","45-49",14678,13969,28647
"2273","KIRINYAGA","50",3202,3264,6466
"2274","KIRINYAGA","51",2538,2371,4909
"2275","KIRINYAGA","52",2412,2296,4708
"2276","KIRINYAGA","53",1807,1947,3754
"2277","KIRINYAGA","54",2234,1997,4231
"2278","KIRINYAGA","50-54",12193,11875,24068
"2279","KIRINYAGA","55",2377,2293,4670
"2280","KIRINYAGA","56",2540,2367,4907
"2281","KIRINYAGA","57",1863,2092,3955
"2282","KIRINYAGA","58",1620,1639,3259
"2283","KIRINYAGA","59",1914,1989,3903
"2284","KIRINYAGA","55-59",10314,10380,20694
"2285","KIRINYAGA","60",1991,2069,4060
"2286","KIRINYAGA","61",1560,1563,3123
"2287","KIRINYAGA","62",1310,1190,2500
"2288","KIRINYAGA","63",1112,1196,2308
"2289","KIRINYAGA","64",743,772,1515
"2290","KIRINYAGA","60-64",6716,6790,13506
"2291","KIRINYAGA","65",1313,1643,2956
"2292","KIRINYAGA","66",897,902,1799
"2293","KIRINYAGA","67",1539,1657,3196
"2294","KIRINYAGA","68",830,779,1609
"2295","KIRINYAGA","69",1035,1205,2240
"2296","KIRINYAGA","65-69",5614,6186,11800
"2297","KIRINYAGA","70",1258,2022,3280
"2298","KIRINYAGA","71",868,1179,2047
"2299","KIRINYAGA","72",783,769,1552
"2300","KIRINYAGA","73",616,622,1238
"2301","KIRINYAGA","74",588,773,1361
"2302","KIRINYAGA","70-74",4113,5365,9478
"2303","KIRINYAGA","75",483,748,1231
"2304","KIRINYAGA","76",392,553,945
"2305","KIRINYAGA","77",442,539,981
"2306","KIRINYAGA","78",322,324,646
"2307","KIRINYAGA","79",367,658,1025
"2308","KIRINYAGA","75-79",2006,2822,4828
"2309","KIRINYAGA","80",528,1052,1580
"2310","KIRINYAGA","81",206,466,672
"2311","KIRINYAGA","82",204,268,472
"2312","KIRINYAGA","83",226,324,550
"2313","KIRINYAGA","84",223,424,647
"2314","KIRINYAGA","80-84",1387,2534,3921
"2315","KIRINYAGA","85",208,364,572
"2316","KIRINYAGA","86",161,218,379
"2317","KIRINYAGA","87",155,207,362
"2318","KIRINYAGA","88",90,128,218
"2319","KIRINYAGA","89",182,516,698
"2320","KIRINYAGA","85-89",796,1433,2229
"2321","KIRINYAGA","90",125,382,507
"2322","KIRINYAGA","91",142,346,488
"2323","KIRINYAGA","92",50,119,169
"2324","KIRINYAGA","93",55,114,169
"2325","KIRINYAGA","94",43,129,172
"2326","KIRINYAGA","90-94",415,1090,1505
"2327","KIRINYAGA","95",54,185,239
"2328","KIRINYAGA","96",35,76,111
"2329","KIRINYAGA","97",41,74,115
"2330","KIRINYAGA","98",25,47,72
"2331","KIRINYAGA","99",36,171,207
"2332","KIRINYAGA","95-99",191,553,744
"2333","KIRINYAGA","100+",105,441,546
"2334","KIRINYAGA","Not Stated",4,5,9
"2335","MURANG'A","Total",467062,471121,938183
"2336","MURANG'A","0",9280,8940,18220
"2337","MURANG'A","1",9471,9306,18777
"2338","MURANG'A","2",9745,9437,19182
"2339","MURANG'A","3",9827,10060,19887
"2340","MURANG'A","4",10348,10117,20465
"2341","MURANG'A","0 - 4",48671,47860,96531
"2342","MURANG'A","5",10023,9665,19688
"2343","MURANG'A","6",9971,9940,19911
"2344","MURANG'A","7",10436,10225,20661
"2345","MURANG'A","8",10179,9919,20098
"2346","MURANG'A","9",11192,11041,22233
"2347","MURANG'A","5-9",51801,50790,102591
"2348","MURANG'A","10",10815,10436,21251
"2349","MURANG'A","11",10066,10116,20182
"2350","MURANG'A","12",11146,10610,21756
"2351","MURANG'A","13",11344,10931,22275
"2352","MURANG'A","14",11164,10211,21375
"2353","MURANG'A","10-14",54535,52304,106839
"2354","MURANG'A","15",10904,10127,21031
"2355","MURANG'A","16",10667,9959,20626
"2356","MURANG'A","17",11064,9655,20719
"2357","MURANG'A","18",9138,7722,16860
"2358","MURANG'A","19",8738,7217,15955
"2359","MURANG'A","15-19",50511,44680,95191
"2360","MURANG'A","20",7528,6657,14185
"2361","MURANG'A","21",6699,6071,12770
"2362","MURANG'A","22",6422,5906,12328
"2363","MURANG'A","23",6297,6085,12382
"2364","MURANG'A","24",5623,5423,11046
"2365","MURANG'A","20-24",32569,30142,62711
"2366","MURANG'A","25",5691,5509,11200
"2367","MURANG'A","26",4899,5017,9916
"2368","MURANG'A","27",5359,5287,10646
"2369","MURANG'A","28",4847,5119,9966
"2370","MURANG'A","29",5358,5567,10925
"2371","MURANG'A","25-29",26154,26499,52653
"2372","MURANG'A","30",6768,6749,13517
"2373","MURANG'A","31",5247,5190,10437
"2374","MURANG'A","32",6465,6740,13205
"2375","MURANG'A","33",5858,6090,11948
"2376","MURANG'A","34",5611,5666,11277
"2377","MURANG'A","30-34",29949,30435,60384
"2378","MURANG'A","35",7361,7317,14678
"2379","MURANG'A","36",5650,5776,11426
"2380","MURANG'A","37",5935,5585,11520
"2381","MURANG'A","38",5219,5409,10628
"2382","MURANG'A","39",5874,5660,11534
"2383","MURANG'A","35-39",30039,29747,59786
"2384","MURANG'A","40",7041,6770,13811
"2385","MURANG'A","41",5905,5509,11414
"2386","MURANG'A","42",5758,5539,11297
"2387","MURANG'A","43",5091,4950,10041
"2388","MURANG'A","44",4713,4571,9284
"2389","MURANG'A","40-44",28508,27339,55847
"2390","MURANG'A","45",6469,6340,12809
"2391","MURANG'A","46",5198,5030,10228
"2392","MURANG'A","47",5428,5361,10789
"2393","MURANG'A","48",4259,4230,8489
"2394","MURANG'A","49",4324,4485,8809
"2395","MURANG'A","45-49",25678,25446,51124
"2396","MURANG'A","50",4882,5303,10185
"2397","MURANG'A","51",3915,3923,7838
"2398","MURANG'A","52",4238,4607,8845
"2399","MURANG'A","53",3225,3552,6777
"2400","MURANG'A","54",3750,3987,7737
"2401","MURANG'A","50-54",20010,21372,41382
"2402","MURANG'A","55",4144,4201,8345
"2403","MURANG'A","56",4436,4581,9017
"2404","MURANG'A","57",3584,4317,7901
"2405","MURANG'A","58",2931,3468,6399
"2406","MURANG'A","59",3457,3798,7255
"2407","MURANG'A","55-59",18552,20365,38917
"2408","MURANG'A","60",3812,4269,8081
"2409","MURANG'A","61",3033,3411,6444
"2410","MURANG'A","62",2704,2747,5451
"2411","MURANG'A","63",2265,2493,4758
"2412","MURANG'A","64",1835,1918,3753
"2413","MURANG'A","60-64",13649,14838,28487
"2414","MURANG'A","65",2789,3183,5972
"2415","MURANG'A","66",2017,2320,4337
"2416","MURANG'A","67",3640,3999,7639
"2417","MURANG'A","68",1683,1826,3509
"2418","MURANG'A","69",2503,2788,5291
"2419","MURANG'A","65-69",12632,14116,26748
"2420","MURANG'A","70",3120,4240,7360
"2421","MURANG'A","71",2250,2550,4800
"2422","MURANG'A","72",2226,2072,4298
"2423","MURANG'A","73",1841,1787,3628
"2424","MURANG'A","74",1584,1932,3516
"2425","MURANG'A","70-74",11021,12581,23602
"2426","MURANG'A","75",1333,1901,3234
"2427","MURANG'A","76",1474,2874,4348
"2428","MURANG'A","77",1075,1529,2604
"2429","MURANG'A","78",760,913,1673
"2430","MURANG'A","79",953,1624,2577
"2431","MURANG'A","75-79",5595,8841,14436
"2432","MURANG'A","80",1129,2093,3222
"2433","MURANG'A","81",599,1078,1677
"2434","MURANG'A","82",617,776,1393
"2435","MURANG'A","83",713,962,1675
"2436","MURANG'A","84",613,1143,1756
"2437","MURANG'A","80-84",3671,6052,9723
"2438","MURANG'A","85",562,980,1542
"2439","MURANG'A","86",420,693,1113
"2440","MURANG'A","87",467,729,1196
"2441","MURANG'A","88",233,356,589
"2442","MURANG'A","89",401,1091,1492
"2443","MURANG'A","85-89",2083,3849,5932
"2444","MURANG'A","90",248,679,927
"2445","MURANG'A","91",250,481,731
"2446","MURANG'A","92",140,288,428
"2447","MURANG'A","93",118,273,391
"2448","MURANG'A","94",90,315,405
"2449","MURANG'A","90-94",846,2036,2882
"2450","MURANG'A","95",134,331,465
"2451","MURANG'A","96",77,185,262
"2452","MURANG'A","97",89,209,298
"2453","MURANG'A","98",63,138,201
"2454","MURANG'A","99",72,298,370
"2455","MURANG'A","95-99",435,1161,1596
"2456","MURANG'A","100+",146,663,809
"2457","MURANG'A","Not Stated",7,5,12
"2458","KIAMBU","Total",355557,355866,711423
"2459","KIAMBU","0",7276,7406,14682
"2460","KIAMBU","1",7404,7209,14613
"2461","KIAMBU","2",7363,7360,14723
"2462","KIAMBU","3",7652,7552,15204
"2463","KIAMBU","4",7634,7383,15017
"2464","KIAMBU","0 - 4",37329,36910,74239
"2465","KIAMBU","5",7306,7053,14359
"2466","KIAMBU","6",7180,7296,14476
"2467","KIAMBU","7",7618,7459,15077
"2468","KIAMBU","8",7229,7168,14397
"2469","KIAMBU","9",8368,8265,16633
"2470","KIAMBU","5-9",37701,37241,74942
"2471","KIAMBU","10",8099,7877,15976
"2472","KIAMBU","11",7315,7399,14714
"2473","KIAMBU","12",8188,8024,16212
"2474","KIAMBU","13",8370,8140,16510
"2475","KIAMBU","14",7949,7810,15759
"2476","KIAMBU","10-14",39921,39250,79171
"2477","KIAMBU","15",7979,7694,15673
"2478","KIAMBU","16",7827,7617,15444
"2479","KIAMBU","17",8534,7446,15980
"2480","KIAMBU","18",6697,6202,12899
"2481","KIAMBU","19",7026,6294,13320
"2482","KIAMBU","15-19",38063,35253,73316
"2483","KIAMBU","20",6281,5954,12235
"2484","KIAMBU","21",6150,5511,11661
"2485","KIAMBU","22",5950,5474,11424
"2486","KIAMBU","23",6157,5708,11865
"2487","KIAMBU","24",5406,5043,10449
"2488","KIAMBU","20-24",29944,27690,57634
"2489","KIAMBU","25",5320,4927,10247
"2490","KIAMBU","26",4716,4611,9327
"2491","KIAMBU","27",5110,4697,9807
"2492","KIAMBU","28",4350,4286,8636
"2493","KIAMBU","29",4791,4959,9750
"2494","KIAMBU","25-29",24287,23480,47767
"2495","KIAMBU","30",5643,5800,11443
"2496","KIAMBU","31",4383,4400,8783
"2497","KIAMBU","32",5419,5430,10849
"2498","KIAMBU","33",4655,4978,9633
"2499","KIAMBU","34",4541,4727,9268
"2500","KIAMBU","30-34",24641,25335,49976
"2501","KIAMBU","35",5764,5868,11632
"2502","KIAMBU","36",4536,4710,9246
"2503","KIAMBU","37",4904,4572,9476
"2504","KIAMBU","38",4168,4212,8380
"2505","KIAMBU","39",4605,4663,9268
"2506","KIAMBU","35-39",23977,24025,48002
"2507","KIAMBU","40",5083,5152,10235
"2508","KIAMBU","41",4798,4514,9312
"2509","KIAMBU","42",4492,4407,8899
"2510","KIAMBU","43",4117,4103,8220
"2511","KIAMBU","44",3593,3425,7018
"2512","KIAMBU","40-44",22083,21601,43684
"2513","KIAMBU","45",4941,4766,9707
"2514","KIAMBU","46",4034,3875,7909
"2515","KIAMBU","47",4115,3946,8061
"2516","KIAMBU","48",3095,2999,6094
"2517","KIAMBU","49",3415,3360,6775
"2518","KIAMBU","45-49",19600,18946,38546
"2519","KIAMBU","50",3655,4036,7691
"2520","KIAMBU","51",3045,3025,6070
"2521","KIAMBU","52",3350,3354,6704
"2522","KIAMBU","53",2364,2338,4702
"2523","KIAMBU","54",2846,2890,5736
"2524","KIAMBU","50-54",15260,15643,30903
"2525","KIAMBU","55",3004,2789,5793
"2526","KIAMBU","56",3195,3033,6228
"2527","KIAMBU","57",2510,2901,5411
"2528","KIAMBU","58",2055,2181,4236
"2529","KIAMBU","59",2220,2386,4606
"2530","KIAMBU","55-59",12984,13290,26274
"2531","KIAMBU","60",2458,2600,5058
"2532","KIAMBU","61",1998,2167,4165
"2533","KIAMBU","62",1804,1756,3560
"2534","KIAMBU","63",1556,1553,3109
"2535","KIAMBU","64",1181,1333,2514
"2536","KIAMBU","60-64",8997,9409,18406
"2537","KIAMBU","65",1814,1893,3707
"2538","KIAMBU","66",1287,1362,2649
"2539","KIAMBU","67",2120,2285,4405
"2540","KIAMBU","68",922,994,1916
"2541","KIAMBU","69",1392,1565,2957
"2542","KIAMBU","65-69",7535,8099,15634
"2543","KIAMBU","70",1670,2128,3798
"2544","KIAMBU","71",1276,1419,2695
"2545","KIAMBU","72",1312,1221,2533
"2546","KIAMBU","73",1032,1089,2121
"2547","KIAMBU","74",911,1091,2002
"2548","KIAMBU","70-74",6201,6948,13149
"2549","KIAMBU","75",717,1113,1830
"2550","KIAMBU","76",837,1560,2397
"2551","KIAMBU","77",657,892,1549
"2552","KIAMBU","78",386,579,965
"2553","KIAMBU","79",487,884,1371
"2554","KIAMBU","75-79",3084,5028,8112
"2555","KIAMBU","80",588,1226,1814
"2556","KIAMBU","81",360,591,951
"2557","KIAMBU","82",352,452,804
"2558","KIAMBU","83",405,550,955
"2559","KIAMBU","84",363,633,996
"2560","KIAMBU","80-84",2068,3452,5520
"2561","KIAMBU","85",285,655,940
"2562","KIAMBU","86",241,449,690
"2563","KIAMBU","87",249,337,586
"2564","KIAMBU","88",137,236,373
"2565","KIAMBU","89",234,547,781
"2566","KIAMBU","85-89",1146,2224,3370
"2567","KIAMBU","90",118,335,453
"2568","KIAMBU","91",131,221,352
"2569","KIAMBU","92",81,158,239
"2570","KIAMBU","93",66,164,230
"2571","KIAMBU","94",34,150,184
"2572","KIAMBU","90-94",430,1028,1458
"2573","KIAMBU","95",63,178,241
"2574","KIAMBU","96",42,134,176
"2575","KIAMBU","97",74,127,201
"2576","KIAMBU","98",24,72,96
"2577","KIAMBU","99",32,146,178
"2578","KIAMBU","95-99",235,657,892
"2579","KIAMBU","100+",61,352,413
"2580","KIAMBU","Not Stated",10,5,15
"2581","TURKANA","Total",406490,379675,786165
"2582","TURKANA","0",8006,8078,16084
"2583","TURKANA","1",9236,9013,18249
"2584","TURKANA","2",12530,12474,25004
"2585","TURKANA","3",13112,12924,26036
"2586","TURKANA","4",13480,13246,26726
"2587","TURKANA","0 - 4",56364,55735,112099
"2588","TURKANA","5",14232,13492,27724
"2589","TURKANA","6",13763,13220,26983
"2590","TURKANA","7",11882,11217,23099
"2591","TURKANA","8",14495,13737,28232
"2592","TURKANA","9",10552,10064,20616
"2593","TURKANA","5-9",64924,61730,126654
"2594","TURKANA","10",18609,17455,36064
"2595","TURKANA","11",8648,9058,17706
"2596","TURKANA","12",15267,12328,27595
"2597","TURKANA","13",11329,9272,20601
"2598","TURKANA","14",11927,9426,21353
"2599","TURKANA","10-14",65780,57539,123319
"2600","TURKANA","15",15496,11584,27080
"2601","TURKANA","16",11490,8658,20148
"2602","TURKANA","17",10536,7362,17898
"2603","TURKANA","18",11979,9094,21073
"2604","TURKANA","19",8244,6552,14796
"2605","TURKANA","15-19",57745,43250,100995
"2606","TURKANA","20",14906,11449,26355
"2607","TURKANA","21",6723,5629,12352
"2608","TURKANA","22",7433,6437,13870
"2609","TURKANA","23",6810,5867,12677
"2610","TURKANA","24",6628,5688,12316
"2611","TURKANA","20-24",42500,35070,77570
"2612","TURKANA","25",9887,8676,18563
"2613","TURKANA","26",5636,5999,11635
"2614","TURKANA","27",5513,5503,11016
"2615","TURKANA","28",5598,5164,10762
"2616","TURKANA","29",5210,5426,10636
"2617","TURKANA","25-29",31844,30768,62612
"2618","TURKANA","30",9582,9812,19394
"2619","TURKANA","31",3023,3503,6526
"2620","TURKANA","32",4080,4403,8483
"2621","TURKANA","33",2910,3549,6459
"2622","TURKANA","34",2994,3519,6513
"2623","TURKANA","30-34",22589,24786,47375
"2624","TURKANA","35",5628,5981,11609
"2625","TURKANA","36",2581,3175,5756
"2626","TURKANA","37",2254,2560,4814
"2627","TURKANA","38",2253,2511,4764
"2628","TURKANA","39",3051,3671,6722
"2629","TURKANA","35-39",15767,17898,33665
"2630","TURKANA","40",6073,5037,11110
"2631","TURKANA","41",1946,2562,4508
"2632","TURKANA","42",2515,2544,5059
"2633","TURKANA","43",1595,1971,3566
"2634","TURKANA","44",1407,1675,3082
"2635","TURKANA","40-44",13536,13789,27325
"2636","TURKANA","45",3502,3340,6842
"2637","TURKANA","46",1763,2155,3918
"2638","TURKANA","47",1482,1428,2910
"2639","TURKANA","48",1259,1211,2470
"2640","TURKANA","49",1774,2002,3776
"2641","TURKANA","45-49",9780,10136,19916
"2642","TURKANA","50",3734,3197,6931
"2643","TURKANA","51",1002,1145,2147
"2644","TURKANA","52",1101,1028,2129
"2645","TURKANA","53",762,823,1585
"2646","TURKANA","54",965,1147,2112
"2647","TURKANA","50-54",7564,7340,14904
"2648","TURKANA","55",1249,1257,2506
"2649","TURKANA","56",1070,1070,2140
"2650","TURKANA","57",669,778,1447
"2651","TURKANA","58",635,692,1327
"2652","TURKANA","59",1106,1581,2687
"2653","TURKANA","55-59",4729,5378,10107
"2654","TURKANA","60",2190,2172,4362
"2655","TURKANA","61",731,987,1718
"2656","TURKANA","62",613,709,1322
"2657","TURKANA","63",638,923,1561
"2658","TURKANA","64",484,568,1052
"2659","TURKANA","60-64",4656,5359,10015
"2660","TURKANA","65",920,1149,2069
"2661","TURKANA","66",351,396,747
"2662","TURKANA","67",518,602,1120
"2663","TURKANA","68",401,412,813
"2664","TURKANA","69",864,1216,2080
"2665","TURKANA","65-69",3054,3775,6829
"2666","TURKANA","70",1321,1446,2767
"2667","TURKANA","71",424,696,1120
"2668","TURKANA","72",372,452,824
"2669","TURKANA","73",248,380,628
"2670","TURKANA","74",489,578,1067
"2671","TURKANA","70-74",2854,3552,6406
"2672","TURKANA","75",370,398,768
"2673","TURKANA","76",182,236,418
"2674","TURKANA","77",179,242,421
"2675","TURKANA","78",164,195,359
"2676","TURKANA","79",455,586,1041
"2677","TURKANA","75-79",1350,1657,3007
"2678","TURKANA","80",451,524,975
"2679","TURKANA","81",122,196,318
"2680","TURKANA","82",69,100,169
"2681","TURKANA","83",68,131,199
"2682","TURKANA","84",93,142,235
"2683","TURKANA","80-84",803,1093,1896
"2684","TURKANA","85",110,117,227
"2685","TURKANA","86",37,58,95
"2686","TURKANA","87",66,65,131
"2687","TURKANA","88",27,38,65
"2688","TURKANA","89",175,221,396
"2689","TURKANA","85-89",415,499,914
"2690","TURKANA","90",67,102,169
"2691","TURKANA","91",33,36,69
"2692","TURKANA","92",16,11,27
"2693","TURKANA","93",7,21,28
"2694","TURKANA","94",20,19,39
"2695","TURKANA","90-94",143,189,332
"2696","TURKANA","95",18,33,51
"2697","TURKANA","96",10,13,23
"2698","TURKANA","97",9,11,20
"2699","TURKANA","98",11,8,19
"2700","TURKANA","99",20,24,44
"2701","TURKANA","95-99",68,89,157
"2702","TURKANA","100+",25,42,67
"2703","TURKANA","Not Stated",NA,1,1
"2704","WEST POKOT","Total",291469,297916,589385
"2705","WEST POKOT","0",9473,9605,19078
"2706","WEST POKOT","1",10396,10206,20602
"2707","WEST POKOT","2",11601,11414,23015
"2708","WEST POKOT","3",11557,11694,23251
"2709","WEST POKOT","4",12014,11697,23711
"2710","WEST POKOT","0 - 4",55041,54616,109657
"2711","WEST POKOT","5",11199,10917,22116
"2712","WEST POKOT","6",11666,12081,23747
"2713","WEST POKOT","7",9837,9808,19645
"2714","WEST POKOT","8",10919,11178,22097
"2715","WEST POKOT","9",8629,8411,17040
"2716","WEST POKOT","5-9",52250,52395,104645
"2717","WEST POKOT","10",12151,12282,24433
"2718","WEST POKOT","11",7057,7633,14690
"2719","WEST POKOT","12",10516,9727,20243
"2720","WEST POKOT","13",8146,7970,16116
"2721","WEST POKOT","14",8263,7717,15980
"2722","WEST POKOT","10-14",46133,45329,91462
"2723","WEST POKOT","15",8870,8080,16950
"2724","WEST POKOT","16",6997,6623,13620
"2725","WEST POKOT","17",6142,5531,11673
"2726","WEST POKOT","18",5796,5719,11515
"2727","WEST POKOT","19",5287,5275,10562
"2728","WEST POKOT","15-19",33092,31228,64320
"2729","WEST POKOT","20",6580,7620,14200
"2730","WEST POKOT","21",4367,4731,9098
"2731","WEST POKOT","22",3972,4570,8542
"2732","WEST POKOT","23",4626,4974,9600
"2733","WEST POKOT","24",3858,4278,8136
"2734","WEST POKOT","20-24",23403,26173,49576
"2735","WEST POKOT","25",5533,6032,11565
"2736","WEST POKOT","26",3437,3695,7132
"2737","WEST POKOT","27",3530,3585,7115
"2738","WEST POKOT","28",2820,3280,6100
"2739","WEST POKOT","29",2974,3407,6381
"2740","WEST POKOT","25-29",18294,19999,38293
"2741","WEST POKOT","30",5024,5633,10657
"2742","WEST POKOT","31",2775,3107,5882
"2743","WEST POKOT","32",3083,3145,6228
"2744","WEST POKOT","33",2625,2840,5465
"2745","WEST POKOT","34",2135,2292,4427
"2746","WEST POKOT","30-34",15642,17017,32659
"2747","WEST POKOT","35",4310,4413,8723
"2748","WEST POKOT","36",1662,1629,3291
"2749","WEST POKOT","37",1574,1503,3077
"2750","WEST POKOT","38",1132,1214,2346
"2751","WEST POKOT","39",1519,1458,2977
"2752","WEST POKOT","35-39",10197,10217,20414
"2753","WEST POKOT","40",2756,2722,5478
"2754","WEST POKOT","41",1844,1790,3634
"2755","WEST POKOT","42",2047,2028,4075
"2756","WEST POKOT","43",1383,1534,2917
"2757","WEST POKOT","44",970,1069,2039
"2758","WEST POKOT","40-44",9000,9143,18143
"2759","WEST POKOT","45",2753,2730,5483
"2760","WEST POKOT","46",1699,1641,3340
"2761","WEST POKOT","47",1367,1299,2666
"2762","WEST POKOT","48",951,828,1779
"2763","WEST POKOT","49",1309,1409,2718
"2764","WEST POKOT","45-49",8079,7907,15986
"2765","WEST POKOT","50",2267,2284,4551
"2766","WEST POKOT","51",943,963,1906
"2767","WEST POKOT","52",785,840,1625
"2768","WEST POKOT","53",562,589,1151
"2769","WEST POKOT","54",871,913,1784
"2770","WEST POKOT","50-54",5428,5589,11017
"2771","WEST POKOT","55",1095,1076,2171
"2772","WEST POKOT","56",853,766,1619
"2773","WEST POKOT","57",627,625,1252
"2774","WEST POKOT","58",558,611,1169
"2775","WEST POKOT","59",738,991,1729
"2776","WEST POKOT","55-59",3871,4069,7940
"2777","WEST POKOT","60",1410,1768,3178
"2778","WEST POKOT","61",618,738,1356
"2779","WEST POKOT","62",495,553,1048
"2780","WEST POKOT","63",564,752,1316
"2781","WEST POKOT","64",489,538,1027
"2782","WEST POKOT","60-64",3576,4349,7925
"2783","WEST POKOT","65",873,1236,2109
"2784","WEST POKOT","66",379,444,823
"2785","WEST POKOT","67",588,562,1150
"2786","WEST POKOT","68",333,372,705
"2787","WEST POKOT","69",700,1052,1752
"2788","WEST POKOT","65-69",2873,3666,6539
"2789","WEST POKOT","70",1045,1268,2313
"2790","WEST POKOT","71",407,577,984
"2791","WEST POKOT","72",375,372,747
"2792","WEST POKOT","73",253,317,570
"2793","WEST POKOT","74",304,449,753
"2794","WEST POKOT","70-74",2384,2983,5367
"2795","WEST POKOT","75",362,432,794
"2796","WEST POKOT","76",179,181,360
"2797","WEST POKOT","77",176,202,378
"2798","WEST POKOT","78",103,132,235
"2799","WEST POKOT","79",263,430,693
"2800","WEST POKOT","75-79",1083,1377,2460
"2801","WEST POKOT","80",296,462,758
"2802","WEST POKOT","81",96,128,224
"2803","WEST POKOT","82",66,81,147
"2804","WEST POKOT","83",69,113,182
"2805","WEST POKOT","84",71,133,204
"2806","WEST POKOT","80-84",598,917,1515
"2807","WEST POKOT","85",80,127,207
"2808","WEST POKOT","86",33,39,72
"2809","WEST POKOT","87",40,57,97
"2810","WEST POKOT","88",25,48,73
"2811","WEST POKOT","89",91,191,282
"2812","WEST POKOT","85-89",269,462,731
"2813","WEST POKOT","90",62,123,185
"2814","WEST POKOT","91",25,45,70
"2815","WEST POKOT","92",14,17,31
"2816","WEST POKOT","93",14,36,50
"2817","WEST POKOT","94",24,26,50
"2818","WEST POKOT","90-94",139,247,386
"2819","WEST POKOT","95",33,45,78
"2820","WEST POKOT","96",12,17,29
"2821","WEST POKOT","97",7,16,23
"2822","WEST POKOT","98",9,9,18
"2823","WEST POKOT","99",16,45,61
"2824","WEST POKOT","95-99",77,132,209
"2825","WEST POKOT","100+",38,100,138
"2826","WEST POKOT","Not Stated",2,1,3
"2827","SAMBURU","Total",133058,130130,263188
"2828","SAMBURU","0",3865,3741,7606
"2829","SAMBURU","1",3648,3651,7299
"2830","SAMBURU","2",4645,4795,9440
"2831","SAMBURU","3",4954,4895,9849
"2832","SAMBURU","4",5123,4967,10090
"2833","SAMBURU","0 - 4",22235,22049,44284
"2834","SAMBURU","5",5318,5233,10551
"2835","SAMBURU","6",5140,5032,10172
"2836","SAMBURU","7",4335,4173,8508
"2837","SAMBURU","8",5142,5065,10207
"2838","SAMBURU","9",3710,3624,7334
"2839","SAMBURU","5-9",23645,23127,46772
"2840","SAMBURU","10",6565,6255,12820
"2841","SAMBURU","11",2785,3102,5887
"2842","SAMBURU","12",5171,4380,9551
"2843","SAMBURU","13",3636,3207,6843
"2844","SAMBURU","14",3927,3242,7169
"2845","SAMBURU","10-14",22084,20186,42270
"2846","SAMBURU","15",4620,3730,8350
"2847","SAMBURU","16",3329,2616,5945
"2848","SAMBURU","17",3253,2239,5492
"2849","SAMBURU","18",3466,2759,6225
"2850","SAMBURU","19",2586,2127,4713
"2851","SAMBURU","15-19",17254,13471,30725
"2852","SAMBURU","20",3975,3633,7608
"2853","SAMBURU","21",1924,2082,4006
"2854","SAMBURU","22",2076,2147,4223
"2855","SAMBURU","23",2041,2334,4375
"2856","SAMBURU","24",1754,1749,3503
"2857","SAMBURU","20-24",11770,11945,23715
"2858","SAMBURU","25",2762,2823,5585
"2859","SAMBURU","26",1443,1787,3230
"2860","SAMBURU","27",1369,1696,3065
"2861","SAMBURU","28",1435,1460,2895
"2862","SAMBURU","29",1550,1588,3138
"2863","SAMBURU","25-29",8559,9354,17913
"2864","SAMBURU","30",2808,2703,5511
"2865","SAMBURU","31",947,1255,2202
"2866","SAMBURU","32",1225,1577,2802
"2867","SAMBURU","33",880,1263,2143
"2868","SAMBURU","34",661,792,1453
"2869","SAMBURU","30-34",6521,7590,14111
"2870","SAMBURU","35",1800,1996,3796
"2871","SAMBURU","36",628,854,1482
"2872","SAMBURU","37",549,487,1036
"2873","SAMBURU","38",485,440,925
"2874","SAMBURU","39",549,520,1069
"2875","SAMBURU","35-39",4011,4297,8308
"2876","SAMBURU","40",1658,1279,2937
"2877","SAMBURU","41",850,802,1652
"2878","SAMBURU","42",779,757,1536
"2879","SAMBURU","43",584,610,1194
"2880","SAMBURU","44",344,324,668
"2881","SAMBURU","40-44",4215,3772,7987
"2882","SAMBURU","45",1189,1111,2300
"2883","SAMBURU","46",598,778,1376
"2884","SAMBURU","47",625,692,1317
"2885","SAMBURU","48",397,484,881
"2886","SAMBURU","49",475,500,975
"2887","SAMBURU","45-49",3284,3565,6849
"2888","SAMBURU","50",977,1040,2017
"2889","SAMBURU","51",281,407,688
"2890","SAMBURU","52",297,366,663
"2891","SAMBURU","53",203,232,435
"2892","SAMBURU","54",334,341,675
"2893","SAMBURU","50-54",2092,2386,4478
"2894","SAMBURU","55",461,425,886
"2895","SAMBURU","56",345,305,650
"2896","SAMBURU","57",237,284,521
"2897","SAMBURU","58",270,236,506
"2898","SAMBURU","59",418,536,954
"2899","SAMBURU","55-59",1731,1786,3517
"2900","SAMBURU","60",898,893,1791
"2901","SAMBURU","61",312,339,651
"2902","SAMBURU","62",266,319,585
"2903","SAMBURU","63",270,349,619
"2904","SAMBURU","64",167,244,411
"2905","SAMBURU","60-64",1913,2144,4057
"2906","SAMBURU","65",393,463,856
"2907","SAMBURU","66",118,128,246
"2908","SAMBURU","67",176,248,424
"2909","SAMBURU","68",167,177,344
"2910","SAMBURU","69",222,348,570
"2911","SAMBURU","65-69",1076,1364,2440
"2912","SAMBURU","70",581,656,1237
"2913","SAMBURU","71",239,313,552
"2914","SAMBURU","72",139,136,275
"2915","SAMBURU","73",127,139,266
"2916","SAMBURU","74",126,139,265
"2917","SAMBURU","70-74",1212,1383,2595
"2918","SAMBURU","75",244,207,451
"2919","SAMBURU","76",62,78,140
"2920","SAMBURU","77",77,76,153
"2921","SAMBURU","78",60,77,137
"2922","SAMBURU","79",166,219,385
"2923","SAMBURU","75-79",609,657,1266
"2924","SAMBURU","80",225,305,530
"2925","SAMBURU","81",87,89,176
"2926","SAMBURU","82",47,57,104
"2927","SAMBURU","83",48,75,123
"2928","SAMBURU","84",51,59,110
"2929","SAMBURU","80-84",458,585,1043
"2930","SAMBURU","85",43,68,111
"2931","SAMBURU","86",22,28,50
"2932","SAMBURU","87",31,41,72
"2933","SAMBURU","88",23,23,46
"2934","SAMBURU","89",87,104,191
"2935","SAMBURU","85-89",206,264,470
"2936","SAMBURU","90",54,79,133
"2937","SAMBURU","91",15,18,33
"2938","SAMBURU","92",8,4,12
"2939","SAMBURU","93",13,13,26
"2940","SAMBURU","94",10,9,19
"2941","SAMBURU","90-94",100,123,223
"2942","SAMBURU","95",24,26,50
"2943","SAMBURU","96",10,7,17
"2944","SAMBURU","97",4,5,9
"2945","SAMBURU","98",7,5,12
"2946","SAMBURU","99",12,18,30
"2947","SAMBURU","95-99",57,61,118
"2948","SAMBURU","100+",25,20,45
"2949","SAMBURU","Not Stated",1,1,2
"2950","TRANS NZOIA","Total",400606,410978,811584
"2951","TRANS NZOIA","0",9714,9683,19397
"2952","TRANS NZOIA","1",10163,10260,20423
"2953","TRANS NZOIA","2",10573,10355,20928
"2954","TRANS NZOIA","3",11546,11455,23001
"2955","TRANS NZOIA","4",11867,11404,23271
"2956","TRANS NZOIA","0 - 4",53863,53157,107020
"2957","TRANS NZOIA","5",12181,11690,23871
"2958","TRANS NZOIA","6",12278,12136,24414
"2959","TRANS NZOIA","7",11983,12106,24089
"2960","TRANS NZOIA","8",11395,11568,22963
"2961","TRANS NZOIA","9",13109,12926,26035
"2962","TRANS NZOIA","5-9",60946,60426,121372
"2963","TRANS NZOIA","10",13366,12634,26000
"2964","TRANS NZOIA","11",11998,12381,24379
"2965","TRANS NZOIA","12",13318,12764,26082
"2966","TRANS NZOIA","13",13118,12951,26069
"2967","TRANS NZOIA","14",12673,12284,24957
"2968","TRANS NZOIA","10-14",64473,63014,127487
"2969","TRANS NZOIA","15",12338,11809,24147
"2970","TRANS NZOIA","16",11272,10939,22211
"2971","TRANS NZOIA","17",11898,10804,22702
"2972","TRANS NZOIA","18",8818,8089,16907
"2973","TRANS NZOIA","19",9798,8962,18760
"2974","TRANS NZOIA","15-19",54124,50603,104727
"2975","TRANS NZOIA","20",7998,7927,15925
"2976","TRANS NZOIA","21",6567,6752,13319
"2977","TRANS NZOIA","22",6153,6599,12752
"2978","TRANS NZOIA","23",6059,6733,12792
"2979","TRANS NZOIA","24",5251,5913,11164
"2980","TRANS NZOIA","20-24",32028,33924,65952
"2981","TRANS NZOIA","25",5749,6521,12270
"2982","TRANS NZOIA","26",4498,5446,9944
"2983","TRANS NZOIA","27",5004,5563,10567
"2984","TRANS NZOIA","28",3699,4351,8050
"2985","TRANS NZOIA","29",4383,5009,9392
"2986","TRANS NZOIA","25-29",23333,26890,50223
"2987","TRANS NZOIA","30",5081,5993,11074
"2988","TRANS NZOIA","31",4054,4711,8765
"2989","TRANS NZOIA","32",5138,5995,11133
"2990","TRANS NZOIA","33",4227,5228,9455
"2991","TRANS NZOIA","34",3855,4377,8232
"2992","TRANS NZOIA","30-34",22355,26304,48659
"2993","TRANS NZOIA","35",4968,5129,10097
"2994","TRANS NZOIA","36",3501,3598,7099
"2995","TRANS NZOIA","37",3733,3530,7263
"2996","TRANS NZOIA","38",2786,2737,5523
"2997","TRANS NZOIA","39",3153,3038,6191
"2998","TRANS NZOIA","35-39",18141,18032,36173
"2999","TRANS NZOIA","40",3656,3767,7423
"3000","TRANS NZOIA","41",3611,3936,7547
"3001","TRANS NZOIA","42",3767,3940,7707
"3002","TRANS NZOIA","43",3388,3708,7096
"3003","TRANS NZOIA","44",2477,2631,5108
"3004","TRANS NZOIA","40-44",16899,17982,34881
"3005","TRANS NZOIA","45",3710,3825,7535
"3006","TRANS NZOIA","46",2720,2768,5488
"3007","TRANS NZOIA","47",2766,2928,5694
"3008","TRANS NZOIA","48",1911,2000,3911
"3009","TRANS NZOIA","49",2290,2353,4643
"3010","TRANS NZOIA","45-49",13397,13874,27271
"3011","TRANS NZOIA","50",2462,2678,5140
"3012","TRANS NZOIA","51",2174,2384,4558
"3013","TRANS NZOIA","52",1929,2161,4090
"3014","TRANS NZOIA","53",1781,1949,3730
"3015","TRANS NZOIA","54",1818,2027,3845
"3016","TRANS NZOIA","50-54",10164,11199,21363
"3017","TRANS NZOIA","55",1875,1918,3793
"3018","TRANS NZOIA","56",1737,2073,3810
"3019","TRANS NZOIA","57",1813,2546,4359
"3020","TRANS NZOIA","58",1552,1881,3433
"3021","TRANS NZOIA","59",2048,2138,4186
"3022","TRANS NZOIA","55-59",9025,10556,19581
"3023","TRANS NZOIA","60",1979,2012,3991
"3024","TRANS NZOIA","61",1670,1787,3457
"3025","TRANS NZOIA","62",1336,1417,2753
"3026","TRANS NZOIA","63",1519,1654,3173
"3027","TRANS NZOIA","64",1040,1171,2211
"3028","TRANS NZOIA","60-64",7544,8041,15585
"3029","TRANS NZOIA","65",1472,1645,3117
"3030","TRANS NZOIA","66",891,975,1866
"3031","TRANS NZOIA","67",1341,1544,2885
"3032","TRANS NZOIA","68",648,624,1272
"3033","TRANS NZOIA","69",1098,1137,2235
"3034","TRANS NZOIA","65-69",5450,5925,11375
"3035","TRANS NZOIA","70",1050,1255,2305
"3036","TRANS NZOIA","71",946,1043,1989
"3037","TRANS NZOIA","72",728,679,1407
"3038","TRANS NZOIA","73",695,764,1459
"3039","TRANS NZOIA","74",528,654,1182
"3040","TRANS NZOIA","70-74",3947,4395,8342
"3041","TRANS NZOIA","75",547,668,1215
"3042","TRANS NZOIA","76",436,612,1048
"3043","TRANS NZOIA","77",538,695,1233
"3044","TRANS NZOIA","78",299,346,645
"3045","TRANS NZOIA","79",316,537,853
"3046","TRANS NZOIA","75-79",2136,2858,4994
"3047","TRANS NZOIA","80",421,533,954
"3048","TRANS NZOIA","81",251,323,574
"3049","TRANS NZOIA","82",241,291,532
"3050","TRANS NZOIA","83",326,357,683
"3051","TRANS NZOIA","84",212,261,473
"3052","TRANS NZOIA","80-84",1451,1765,3216
"3053","TRANS NZOIA","85",206,305,511
"3054","TRANS NZOIA","86",146,193,339
"3055","TRANS NZOIA","87",214,309,523
"3056","TRANS NZOIA","88",101,103,204
"3057","TRANS NZOIA","89",162,310,472
"3058","TRANS NZOIA","85-89",829,1220,2049
"3059","TRANS NZOIA","90",54,136,190
"3060","TRANS NZOIA","91",101,114,215
"3061","TRANS NZOIA","92",51,43,94
"3062","TRANS NZOIA","93",55,75,130
"3063","TRANS NZOIA","94",36,49,85
"3064","TRANS NZOIA","90-94",297,417,714
"3065","TRANS NZOIA","95",79,114,193
"3066","TRANS NZOIA","96",23,42,65
"3067","TRANS NZOIA","97",36,47,83
"3068","TRANS NZOIA","98",15,23,38
"3069","TRANS NZOIA","99",22,53,75
"3070","TRANS NZOIA","95-99",175,279,454
"3071","TRANS NZOIA","100+",28,116,144
"3072","TRANS NZOIA","Not Stated",1,1,2
"3073","UASIN GISHU","Total",326269,326700,652969
"3074","UASIN GISHU","0",7050,7273,14323
"3075","UASIN GISHU","1",7386,7389,14775
"3076","UASIN GISHU","2",7766,7662,15428
"3077","UASIN GISHU","3",8038,8309,16347
"3078","UASIN GISHU","4",8736,8320,17056
"3079","UASIN GISHU","0 - 4",38976,38953,77929
"3080","UASIN GISHU","5",8302,7809,16111
"3081","UASIN GISHU","6",8727,8494,17221
"3082","UASIN GISHU","7",8788,8512,17300
"3083","UASIN GISHU","8",8328,8241,16569
"3084","UASIN GISHU","9",9578,9438,19016
"3085","UASIN GISHU","5-9",43723,42494,86217
"3086","UASIN GISHU","10",9526,9100,18626
"3087","UASIN GISHU","11",9022,9076,18098
"3088","UASIN GISHU","12",10087,9633,19720
"3089","UASIN GISHU","13",9803,9786,19589
"3090","UASIN GISHU","14",9432,9075,18507
"3091","UASIN GISHU","10-14",47870,46670,94540
"3092","UASIN GISHU","15",9307,8953,18260
"3093","UASIN GISHU","16",8783,8550,17333
"3094","UASIN GISHU","17",9190,8488,17678
"3095","UASIN GISHU","18",6857,6259,13116
"3096","UASIN GISHU","19",8286,7404,15690
"3097","UASIN GISHU","15-19",42423,39654,82077
"3098","UASIN GISHU","20",6830,6282,13112
"3099","UASIN GISHU","21",6633,6218,12851
"3100","UASIN GISHU","22",6112,5742,11854
"3101","UASIN GISHU","23",6161,5996,12157
"3102","UASIN GISHU","24",5634,5502,11136
"3103","UASIN GISHU","20-24",31370,29740,61110
"3104","UASIN GISHU","25",5920,5712,11632
"3105","UASIN GISHU","26",4583,4849,9432
"3106","UASIN GISHU","27",4574,4932,9506
"3107","UASIN GISHU","28",3315,3464,6779
"3108","UASIN GISHU","29",3869,4353,8222
"3109","UASIN GISHU","25-29",22261,23310,45571
"3110","UASIN GISHU","30",4468,5006,9474
"3111","UASIN GISHU","31",3627,3943,7570
"3112","UASIN GISHU","32",4531,5223,9754
"3113","UASIN GISHU","33",4046,4739,8785
"3114","UASIN GISHU","34",3554,4192,7746
"3115","UASIN GISHU","30-34",20226,23103,43329
"3116","UASIN GISHU","35",4914,5023,9937
"3117","UASIN GISHU","36",3227,3048,6275
"3118","UASIN GISHU","37",3573,3187,6760
"3119","UASIN GISHU","38",2300,2186,4486
"3120","UASIN GISHU","39",3186,2954,6140
"3121","UASIN GISHU","35-39",17200,16398,33598
"3122","UASIN GISHU","40",3298,3131,6429
"3123","UASIN GISHU","41",3613,3227,6840
"3124","UASIN GISHU","42",3266,3137,6403
"3125","UASIN GISHU","43",2795,3025,5820
"3126","UASIN GISHU","44",2207,2249,4456
"3127","UASIN GISHU","40-44",15179,14769,29948
"3128","UASIN GISHU","45",3906,3696,7602
"3129","UASIN GISHU","46",2626,2813,5439
"3130","UASIN GISHU","47",2691,2881,5572
"3131","UASIN GISHU","48",1681,1747,3428
"3132","UASIN GISHU","49",2255,2359,4614
"3133","UASIN GISHU","45-49",13159,13496,26655
"3134","UASIN GISHU","50",2295,2316,4611
"3135","UASIN GISHU","51",1890,1966,3856
"3136","UASIN GISHU","52",1635,1678,3313
"3137","UASIN GISHU","53",1367,1377,2744
"3138","UASIN GISHU","54",1570,1525,3095
"3139","UASIN GISHU","50-54",8757,8862,17619
"3140","UASIN GISHU","55",1490,1257,2747
"3141","UASIN GISHU","56",1332,1553,2885
"3142","UASIN GISHU","57",1513,2063,3576
"3143","UASIN GISHU","58",1501,1873,3374
"3144","UASIN GISHU","59",1535,1568,3103
"3145","UASIN GISHU","55-59",7371,8314,15685
"3146","UASIN GISHU","60",1570,1632,3202
"3147","UASIN GISHU","61",1218,1368,2586
"3148","UASIN GISHU","62",1007,1075,2082
"3149","UASIN GISHU","63",1023,1121,2144
"3150","UASIN GISHU","64",799,882,1681
"3151","UASIN GISHU","60-64",5617,6078,11695
"3152","UASIN GISHU","65",1156,1349,2505
"3153","UASIN GISHU","66",668,810,1478
"3154","UASIN GISHU","67",1220,1386,2606
"3155","UASIN GISHU","68",480,539,1019
"3156","UASIN GISHU","69",856,934,1790
"3157","UASIN GISHU","65-69",4380,5018,9398
"3158","UASIN GISHU","70",899,1160,2059
"3159","UASIN GISHU","71",759,813,1572
"3160","UASIN GISHU","72",528,553,1081
"3161","UASIN GISHU","73",491,483,974
"3162","UASIN GISHU","74",467,594,1061
"3163","UASIN GISHU","70-74",3144,3603,6747
"3164","UASIN GISHU","75",486,627,1113
"3165","UASIN GISHU","76",515,670,1185
"3166","UASIN GISHU","77",422,473,895
"3167","UASIN GISHU","78",231,237,468
"3168","UASIN GISHU","79",370,575,945
"3169","UASIN GISHU","75-79",2024,2582,4606
"3170","UASIN GISHU","80",379,560,939
"3171","UASIN GISHU","81",221,329,550
"3172","UASIN GISHU","82",222,175,397
"3173","UASIN GISHU","83",229,249,478
"3174","UASIN GISHU","84",215,320,535
"3175","UASIN GISHU","80-84",1266,1633,2899
"3176","UASIN GISHU","85",172,274,446
"3177","UASIN GISHU","86",135,165,300
"3178","UASIN GISHU","87",159,178,337
"3179","UASIN GISHU","88",93,86,179
"3180","UASIN GISHU","89",145,327,472
"3181","UASIN GISHU","85-89",704,1030,1734
"3182","UASIN GISHU","90",88,179,267
"3183","UASIN GISHU","91",68,92,160
"3184","UASIN GISHU","92",57,64,121
"3185","UASIN GISHU","93",65,53,118
"3186","UASIN GISHU","94",40,90,130
"3187","UASIN GISHU","90-94",318,478,796
"3188","UASIN GISHU","95",107,136,243
"3189","UASIN GISHU","96",33,49,82
"3190","UASIN GISHU","97",43,51,94
"3191","UASIN GISHU","98",22,20,42
"3192","UASIN GISHU","99",33,75,108
"3193","UASIN GISHU","95-99",238,331,569
"3194","UASIN GISHU","100+",58,182,240
"3195","UASIN GISHU","Not Stated",5,2,7
"3196","ELGEYO/MARAKWET","Total",217344,216548,433892
"3197","ELGEYO/MARAKWET","0",5401,5427,10828
"3198","ELGEYO/MARAKWET","1",5606,5390,10996
"3199","ELGEYO/MARAKWET","2",5683,5617,11300
"3200","ELGEYO/MARAKWET","3",6106,6192,12298
"3201","ELGEYO/MARAKWET","4",6504,6457,12961
"3202","ELGEYO/MARAKWET","0 - 4",29300,29083,58383
"3203","ELGEYO/MARAKWET","5",6434,6266,12700
"3204","ELGEYO/MARAKWET","6",6476,6380,12856
"3205","ELGEYO/MARAKWET","7",6391,6241,12632
"3206","ELGEYO/MARAKWET","8",5722,5618,11340
"3207","ELGEYO/MARAKWET","9",6651,6308,12959
"3208","ELGEYO/MARAKWET","5-9",31674,30813,62487
"3209","ELGEYO/MARAKWET","10",6635,6379,13014
"3210","ELGEYO/MARAKWET","11",5869,6045,11914
"3211","ELGEYO/MARAKWET","12",6733,6515,13248
"3212","ELGEYO/MARAKWET","13",6381,6489,12870
"3213","ELGEYO/MARAKWET","14",6290,6090,12380
"3214","ELGEYO/MARAKWET","10-14",31908,31518,63426
"3215","ELGEYO/MARAKWET","15",6221,6015,12236
"3216","ELGEYO/MARAKWET","16",5605,5546,11151
"3217","ELGEYO/MARAKWET","17",5695,5310,11005
"3218","ELGEYO/MARAKWET","18",4299,4089,8388
"3219","ELGEYO/MARAKWET","19",5328,5013,10341
"3220","ELGEYO/MARAKWET","15-19",27148,25973,53121
"3221","ELGEYO/MARAKWET","20",4756,4523,9279
"3222","ELGEYO/MARAKWET","21",4280,4126,8406
"3223","ELGEYO/MARAKWET","22",3898,3808,7706
"3224","ELGEYO/MARAKWET","23",3862,3924,7786
"3225","ELGEYO/MARAKWET","24",3405,3534,6939
"3226","ELGEYO/MARAKWET","20-24",20201,19915,40116
"3227","ELGEYO/MARAKWET","25",3947,3926,7873
"3228","ELGEYO/MARAKWET","26",2961,3146,6107
"3229","ELGEYO/MARAKWET","27",3134,3159,6293
"3230","ELGEYO/MARAKWET","28",2281,2372,4653
"3231","ELGEYO/MARAKWET","29",2754,2798,5552
"3232","ELGEYO/MARAKWET","25-29",15077,15401,30478
"3233","ELGEYO/MARAKWET","30",3157,3391,6548
"3234","ELGEYO/MARAKWET","31",2342,2468,4810
"3235","ELGEYO/MARAKWET","32",2867,3121,5988
"3236","ELGEYO/MARAKWET","33",2468,2729,5197
"3237","ELGEYO/MARAKWET","34",2094,2332,4426
"3238","ELGEYO/MARAKWET","30-34",12928,14041,26969
"3239","ELGEYO/MARAKWET","35",3308,3136,6444
"3240","ELGEYO/MARAKWET","36",1878,1606,3484
"3241","ELGEYO/MARAKWET","37",2026,1717,3743
"3242","ELGEYO/MARAKWET","38",1222,1130,2352
"3243","ELGEYO/MARAKWET","39",1724,1644,3368
"3244","ELGEYO/MARAKWET","35-39",10158,9233,19391
"3245","ELGEYO/MARAKWET","40",2058,1771,3829
"3246","ELGEYO/MARAKWET","41",2049,1942,3991
"3247","ELGEYO/MARAKWET","42",1956,1845,3801
"3248","ELGEYO/MARAKWET","43",1685,1663,3348
"3249","ELGEYO/MARAKWET","44",1117,1198,2315
"3250","ELGEYO/MARAKWET","40-44",8865,8419,17284
"3251","ELGEYO/MARAKWET","45",2914,2632,5546
"3252","ELGEYO/MARAKWET","46",1492,1504,2996
"3253","ELGEYO/MARAKWET","47",1583,1575,3158
"3254","ELGEYO/MARAKWET","48",798,845,1643
"3255","ELGEYO/MARAKWET","49",1129,1180,2309
"3256","ELGEYO/MARAKWET","45-49",7916,7736,15652
"3257","ELGEYO/MARAKWET","50",1386,1472,2858
"3258","ELGEYO/MARAKWET","51",1005,1083,2088
"3259","ELGEYO/MARAKWET","52",835,875,1710
"3260","ELGEYO/MARAKWET","53",599,651,1250
"3261","ELGEYO/MARAKWET","54",1027,969,1996
"3262","ELGEYO/MARAKWET","50-54",4852,5050,9902
"3263","ELGEYO/MARAKWET","55",967,840,1807
"3264","ELGEYO/MARAKWET","56",900,997,1897
"3265","ELGEYO/MARAKWET","57",904,1117,2021
"3266","ELGEYO/MARAKWET","58",1058,1179,2237
"3267","ELGEYO/MARAKWET","59",1054,951,2005
"3268","ELGEYO/MARAKWET","55-59",4883,5084,9967
"3269","ELGEYO/MARAKWET","60",1186,1199,2385
"3270","ELGEYO/MARAKWET","61",944,919,1863
"3271","ELGEYO/MARAKWET","62",617,585,1202
"3272","ELGEYO/MARAKWET","63",663,769,1432
"3273","ELGEYO/MARAKWET","64",457,489,946
"3274","ELGEYO/MARAKWET","60-64",3867,3961,7828
"3275","ELGEYO/MARAKWET","65",932,940,1872
"3276","ELGEYO/MARAKWET","66",403,403,806
"3277","ELGEYO/MARAKWET","67",838,788,1626
"3278","ELGEYO/MARAKWET","68",373,352,725
"3279","ELGEYO/MARAKWET","69",719,766,1485
"3280","ELGEYO/MARAKWET","65-69",3265,3249,6514
"3281","ELGEYO/MARAKWET","70",741,922,1663
"3282","ELGEYO/MARAKWET","71",572,669,1241
"3283","ELGEYO/MARAKWET","72",379,382,761
"3284","ELGEYO/MARAKWET","73",336,388,724
"3285","ELGEYO/MARAKWET","74",341,444,785
"3286","ELGEYO/MARAKWET","70-74",2369,2805,5174
"3287","ELGEYO/MARAKWET","75",366,446,812
"3288","ELGEYO/MARAKWET","76",285,308,593
"3289","ELGEYO/MARAKWET","77",247,309,556
"3290","ELGEYO/MARAKWET","78",143,145,288
"3291","ELGEYO/MARAKWET","79",264,488,752
"3292","ELGEYO/MARAKWET","75-79",1305,1696,3001
"3293","ELGEYO/MARAKWET","80",272,445,717
"3294","ELGEYO/MARAKWET","81",153,275,428
"3295","ELGEYO/MARAKWET","82",83,136,219
"3296","ELGEYO/MARAKWET","83",146,205,351
"3297","ELGEYO/MARAKWET","84",133,201,334
"3298","ELGEYO/MARAKWET","80-84",787,1262,2049
"3299","ELGEYO/MARAKWET","85",95,152,247
"3300","ELGEYO/MARAKWET","86",74,68,142
"3301","ELGEYO/MARAKWET","87",90,109,199
"3302","ELGEYO/MARAKWET","88",52,68,120
"3303","ELGEYO/MARAKWET","89",164,272,436
"3304","ELGEYO/MARAKWET","85-89",475,669,1144
"3305","ELGEYO/MARAKWET","90",72,140,212
"3306","ELGEYO/MARAKWET","91",42,67,109
"3307","ELGEYO/MARAKWET","92",16,39,55
"3308","ELGEYO/MARAKWET","93",34,38,72
"3309","ELGEYO/MARAKWET","94",30,46,76
"3310","ELGEYO/MARAKWET","90-94",194,330,524
"3311","ELGEYO/MARAKWET","95",60,80,140
"3312","ELGEYO/MARAKWET","96",12,20,32
"3313","ELGEYO/MARAKWET","97",13,20,33
"3314","ELGEYO/MARAKWET","98",13,18,31
"3315","ELGEYO/MARAKWET","99",31,62,93
"3316","ELGEYO/MARAKWET","95-99",129,200,329
"3317","ELGEYO/MARAKWET","100+",43,109,152
"3318","ELGEYO/MARAKWET","Not Stated",NA,1,1
"3319","NANDI","Total",411715,414497,826212
"3320","NANDI","0",9239,8945,18184
"3321","NANDI","1",9663,9589,19252
"3322","NANDI","2",9940,9856,19796
"3323","NANDI","3",10243,10382,20625
"3324","NANDI","4",10697,10398,21095
"3325","NANDI","0 - 4",49782,49170,98952
"3326","NANDI","5",10612,10273,20885
"3327","NANDI","6",10557,10729,21286
"3328","NANDI","7",11222,10875,22097
"3329","NANDI","8",10910,10653,21563
"3330","NANDI","9",12047,11973,24020
"3331","NANDI","5-9",55348,54503,109851
"3332","NANDI","10",11882,11245,23127
"3333","NANDI","11",11458,11713,23171
"3334","NANDI","12",12863,12342,25205
"3335","NANDI","13",12508,12332,24840
"3336","NANDI","14",11952,11554,23506
"3337","NANDI","10-14",60663,59186,119849
"3338","NANDI","15",11657,11353,23010
"3339","NANDI","16",10957,10556,21513
"3340","NANDI","17",11192,10609,21801
"3341","NANDI","18",8795,8314,17109
"3342","NANDI","19",9991,9241,19232
"3343","NANDI","15-19",52592,50073,102665
"3344","NANDI","20",8214,8184,16398
"3345","NANDI","21",7749,7749,15498
"3346","NANDI","22",6893,7192,14085
"3347","NANDI","23",6894,7749,14643
"3348","NANDI","24",6149,6628,12777
"3349","NANDI","20-24",35899,37502,73401
"3350","NANDI","25",6587,6967,13554
"3351","NANDI","26",5423,6293,11716
"3352","NANDI","27",5921,6463,12384
"3353","NANDI","28",4366,5071,9437
"3354","NANDI","29",5333,6130,11463
"3355","NANDI","25-29",27630,30924,58554
"3356","NANDI","30",5964,6748,12712
"3357","NANDI","31",5068,5719,10787
"3358","NANDI","32",6141,7057,13198
"3359","NANDI","33",5574,6587,12161
"3360","NANDI","34",4860,5432,10292
"3361","NANDI","30-34",27607,31543,59150
"3362","NANDI","35",6105,6133,12238
"3363","NANDI","36",4222,3594,7816
"3364","NANDI","37",4507,3664,8171
"3365","NANDI","38",3060,2556,5616
"3366","NANDI","39",3981,3391,7372
"3367","NANDI","35-39",21875,19338,41213
"3368","NANDI","40",3951,3671,7622
"3369","NANDI","41",4392,3868,8260
"3370","NANDI","42",4103,3774,7877
"3371","NANDI","43",3868,3962,7830
"3372","NANDI","44",3148,3011,6159
"3373","NANDI","40-44",19462,18286,37748
"3374","NANDI","45",4455,4128,8583
"3375","NANDI","46",3414,3246,6660
"3376","NANDI","47",3452,3415,6867
"3377","NANDI","48",2159,2150,4309
"3378","NANDI","49",2949,2986,5935
"3379","NANDI","45-49",16429,15925,32354
"3380","NANDI","50",2731,2819,5550
"3381","NANDI","51",2562,2565,5127
"3382","NANDI","52",2009,2123,4132
"3383","NANDI","53",1737,1925,3662
"3384","NANDI","54",1942,1846,3788
"3385","NANDI","50-54",10981,11278,22259
"3386","NANDI","55",2056,1737,3793
"3387","NANDI","56",1885,1875,3760
"3388","NANDI","57",1872,2463,4335
"3389","NANDI","58",1877,2336,4213
"3390","NANDI","59",2036,2105,4141
"3391","NANDI","55-59",9726,10516,20242
"3392","NANDI","60",2077,2071,4148
"3393","NANDI","61",1741,1685,3426
"3394","NANDI","62",1411,1309,2720
"3395","NANDI","63",1328,1471,2799
"3396","NANDI","64",1056,1101,2157
"3397","NANDI","60-64",7613,7637,15250
"3398","NANDI","65",1524,1662,3186
"3399","NANDI","66",877,1018,1895
"3400","NANDI","67",1598,1650,3248
"3401","NANDI","68",650,718,1368
"3402","NANDI","69",1137,1297,2434
"3403","NANDI","65-69",5786,6345,12131
"3404","NANDI","70",1135,1400,2535
"3405","NANDI","71",1009,1007,2016
"3406","NANDI","72",783,700,1483
"3407","NANDI","73",646,667,1313
"3408","NANDI","74",612,752,1364
"3409","NANDI","70-74",4185,4526,8711
"3410","NANDI","75",654,727,1381
"3411","NANDI","76",621,742,1363
"3412","NANDI","77",636,623,1259
"3413","NANDI","78",310,322,632
"3414","NANDI","79",466,719,1185
"3415","NANDI","75-79",2687,3133,5820
"3416","NANDI","80",486,641,1127
"3417","NANDI","81",281,345,626
"3418","NANDI","82",294,224,518
"3419","NANDI","83",330,336,666
"3420","NANDI","84",246,355,601
"3421","NANDI","80-84",1637,1901,3538
"3422","NANDI","85",216,272,488
"3423","NANDI","86",213,219,432
"3424","NANDI","87",209,268,477
"3425","NANDI","88",105,121,226
"3426","NANDI","89",222,458,680
"3427","NANDI","85-89",965,1338,2303
"3428","NANDI","90",129,213,342
"3429","NANDI","91",96,144,240
"3430","NANDI","92",82,95,177
"3431","NANDI","93",88,90,178
"3432","NANDI","94",70,118,188
"3433","NANDI","90-94",465,660,1125
"3434","NANDI","95",140,206,346
"3435","NANDI","96",37,38,75
"3436","NANDI","97",51,62,113
"3437","NANDI","98",26,44,70
"3438","NANDI","99",52,132,184
"3439","NANDI","95-99",306,482,788
"3440","NANDI","100+",77,229,306
"3441","NANDI","Not Stated",NA,2,2
"3442","BARINGO","Total",299456,292006,591462
"3443","BARINGO","0",7195,6942,14137
"3444","BARINGO","1",7647,7385,15032
"3445","BARINGO","2",9244,8749,17993
"3446","BARINGO","3",9254,9081,18335
"3447","BARINGO","4",10078,9314,19392
"3448","BARINGO","0 - 4",43418,41471,84889
"3449","BARINGO","5",9794,9173,18967
"3450","BARINGO","6",10080,9468,19548
"3451","BARINGO","7",8702,8176,16878
"3452","BARINGO","8",9475,9224,18699
"3453","BARINGO","9",8493,8216,16709
"3454","BARINGO","5-9",46544,44257,90801
"3455","BARINGO","10",11904,11128,23032
"3456","BARINGO","11",7318,7519,14837
"3457","BARINGO","12",10988,9658,20646
"3458","BARINGO","13",8953,8244,17197
"3459","BARINGO","14",9065,8258,17323
"3460","BARINGO","10-14",48228,44807,93035
"3461","BARINGO","15",9707,8502,18209
"3462","BARINGO","16",7991,7282,15273
"3463","BARINGO","17",7691,6736,14427
"3464","BARINGO","18",6692,5940,12632
"3465","BARINGO","19",6544,5877,12421
"3466","BARINGO","15-19",38625,34337,72962
"3467","BARINGO","20",7123,6851,13974
"3468","BARINGO","21",5187,5127,10314
"3469","BARINGO","22",4888,5029,9917
"3470","BARINGO","23",4978,5014,9992
"3471","BARINGO","24",4471,4450,8921
"3472","BARINGO","20-24",26647,26471,53118
"3473","BARINGO","25",5534,5593,11127
"3474","BARINGO","26",3538,3806,7344
"3475","BARINGO","27",3635,3783,7418
"3476","BARINGO","28",3148,3565,6713
"3477","BARINGO","29",3287,3526,6813
"3478","BARINGO","25-29",19142,20273,39415
"3479","BARINGO","30",5239,5644,10883
"3480","BARINGO","31",2715,2874,5589
"3481","BARINGO","32",3165,3372,6537
"3482","BARINGO","33",2732,2915,5647
"3483","BARINGO","34",2242,2326,4568
"3484","BARINGO","30-34",16093,17131,33224
"3485","BARINGO","35",4300,4387,8687
"3486","BARINGO","36",2164,2019,4183
"3487","BARINGO","37",2229,1876,4105
"3488","BARINGO","38",1602,1729,3331
"3489","BARINGO","39",1968,1822,3790
"3490","BARINGO","35-39",12263,11833,24096
"3491","BARINGO","40",3401,3048,6449
"3492","BARINGO","41",2530,2231,4761
"3493","BARINGO","42",1964,1886,3850
"3494","BARINGO","43",1573,1781,3354
"3495","BARINGO","44",1175,1362,2537
"3496","BARINGO","40-44",10643,10308,20951
"3497","BARINGO","45",3308,3217,6525
"3498","BARINGO","46",1650,1800,3450
"3499","BARINGO","47",1770,1803,3573
"3500","BARINGO","48",1046,1115,2161
"3501","BARINGO","49",1380,1573,2953
"3502","BARINGO","45-49",9154,9508,18662
"3503","BARINGO","50",2238,2496,4734
"3504","BARINGO","51",1268,1270,2538
"3505","BARINGO","52",1089,1216,2305
"3506","BARINGO","53",861,926,1787
"3507","BARINGO","54",1258,1358,2616
"3508","BARINGO","50-54",6714,7266,13980
"3509","BARINGO","55",1144,996,2140
"3510","BARINGO","56",994,1013,2007
"3511","BARINGO","57",1032,1346,2378
"3512","BARINGO","58",1263,1389,2652
"3513","BARINGO","59",1244,1274,2518
"3514","BARINGO","55-59",5677,6018,11695
"3515","BARINGO","60",1801,1948,3749
"3516","BARINGO","61",1111,984,2095
"3517","BARINGO","62",791,801,1592
"3518","BARINGO","63",863,880,1743
"3519","BARINGO","64",583,620,1203
"3520","BARINGO","60-64",5149,5233,10382
"3521","BARINGO","65",1149,1325,2474
"3522","BARINGO","66",517,520,1037
"3523","BARINGO","67",1002,916,1918
"3524","BARINGO","68",532,530,1062
"3525","BARINGO","69",885,980,1865
"3526","BARINGO","65-69",4085,4271,8356
"3527","BARINGO","70",1209,1458,2667
"3528","BARINGO","71",834,726,1560
"3529","BARINGO","72",552,532,1084
"3530","BARINGO","73",387,458,845
"3531","BARINGO","74",462,502,964
"3532","BARINGO","70-74",3444,3676,7120
"3533","BARINGO","75",466,514,980
"3534","BARINGO","76",275,274,549
"3535","BARINGO","77",304,324,628
"3536","BARINGO","78",196,205,401
"3537","BARINGO","79",339,566,905
"3538","BARINGO","75-79",1580,1883,3463
"3539","BARINGO","80",432,649,1081
"3540","BARINGO","81",157,323,480
"3541","BARINGO","82",129,149,278
"3542","BARINGO","83",159,241,400
"3543","BARINGO","84",177,260,437
"3544","BARINGO","80-84",1054,1622,2676
"3545","BARINGO","85",129,226,355
"3546","BARINGO","86",89,122,211
"3547","BARINGO","87",116,128,244
"3548","BARINGO","88",49,65,114
"3549","BARINGO","89",178,300,478
"3550","BARINGO","85-89",561,841,1402
"3551","BARINGO","90",81,183,264
"3552","BARINGO","91",54,75,129
"3553","BARINGO","92",37,52,89
"3554","BARINGO","93",36,53,89
"3555","BARINGO","94",31,58,89
"3556","BARINGO","90-94",239,421,660
"3557","BARINGO","95",52,110,162
"3558","BARINGO","96",20,31,51
"3559","BARINGO","97",27,32,59
"3560","BARINGO","98",8,25,33
"3561","BARINGO","99",28,63,91
"3562","BARINGO","95-99",135,261,396
"3563","BARINGO","100+",60,117,177
"3564","BARINGO","Not Stated",1,1,2
"3565","LAIKIPIA","Total",196277,194909,391186
"3566","LAIKIPIA","0",4929,4751,9680
"3567","LAIKIPIA","1",4655,4538,9193
"3568","LAIKIPIA","2",5066,4911,9977
"3569","LAIKIPIA","3",5468,5371,10839
"3570","LAIKIPIA","4",5344,5284,10628
"3571","LAIKIPIA","0 - 4",25462,24855,50317
"3572","LAIKIPIA","5",5239,5068,10307
"3573","LAIKIPIA","6",5383,5145,10528
"3574","LAIKIPIA","7",5201,5171,10372
"3575","LAIKIPIA","8",5184,5009,10193
"3576","LAIKIPIA","9",5010,4945,9955
"3577","LAIKIPIA","5-9",26017,25338,51355
"3578","LAIKIPIA","10",5918,5707,11625
"3579","LAIKIPIA","11",4784,4637,9421
"3580","LAIKIPIA","12",5799,5162,10961
"3581","LAIKIPIA","13",5504,5283,10787
"3582","LAIKIPIA","14",5341,4852,10193
"3583","LAIKIPIA","10-14",27346,25641,52987
"3584","LAIKIPIA","15",5436,4879,10315
"3585","LAIKIPIA","16",4870,4535,9405
"3586","LAIKIPIA","17",5235,4435,9670
"3587","LAIKIPIA","18",4254,3683,7937
"3588","LAIKIPIA","19",4008,3551,7559
"3589","LAIKIPIA","15-19",23803,21083,44886
"3590","LAIKIPIA","20",3653,3581,7234
"3591","LAIKIPIA","21",2975,2843,5818
"3592","LAIKIPIA","22",2825,3045,5870
"3593","LAIKIPIA","23",2724,2827,5551
"3594","LAIKIPIA","24",2452,2506,4958
"3595","LAIKIPIA","20-24",14629,14802,29431
"3596","LAIKIPIA","25",2854,2811,5665
"3597","LAIKIPIA","26",2110,2360,4470
"3598","LAIKIPIA","27",2244,2399,4643
"3599","LAIKIPIA","28",2074,2239,4313
"3600","LAIKIPIA","29",2122,2316,4438
"3601","LAIKIPIA","25-29",11404,12125,23529
"3602","LAIKIPIA","30",2917,3333,6250
"3603","LAIKIPIA","31",2068,2263,4331
"3604","LAIKIPIA","32",2487,2745,5232
"3605","LAIKIPIA","33",2077,2335,4412
"3606","LAIKIPIA","34",1948,2107,4055
"3607","LAIKIPIA","30-34",11497,12783,24280
"3608","LAIKIPIA","35",3094,3113,6207
"3609","LAIKIPIA","36",1989,1863,3852
"3610","LAIKIPIA","37",2034,1774,3808
"3611","LAIKIPIA","38",1720,1574,3294
"3612","LAIKIPIA","39",1904,1795,3699
"3613","LAIKIPIA","35-39",10741,10119,20860
"3614","LAIKIPIA","40",2674,2367,5041
"3615","LAIKIPIA","41",2025,2026,4051
"3616","LAIKIPIA","42",2024,1984,4008
"3617","LAIKIPIA","43",1737,1685,3422
"3618","LAIKIPIA","44",1413,1452,2865
"3619","LAIKIPIA","40-44",9873,9514,19387
"3620","LAIKIPIA","45",2312,2208,4520
"3621","LAIKIPIA","46",1680,1715,3395
"3622","LAIKIPIA","47",1638,1664,3302
"3623","LAIKIPIA","48",1244,1279,2523
"3624","LAIKIPIA","49",1444,1463,2907
"3625","LAIKIPIA","45-49",8318,8329,16647
"3626","LAIKIPIA","50",1897,1995,3892
"3627","LAIKIPIA","51",1415,1387,2802
"3628","LAIKIPIA","52",1391,1397,2788
"3629","LAIKIPIA","53",967,1039,2006
"3630","LAIKIPIA","54",1247,1287,2534
"3631","LAIKIPIA","50-54",6917,7105,14022
"3632","LAIKIPIA","55",1426,1385,2811
"3633","LAIKIPIA","56",1361,1339,2700
"3634","LAIKIPIA","57",1060,1241,2301
"3635","LAIKIPIA","58",917,1093,2010
"3636","LAIKIPIA","59",1092,1226,2318
"3637","LAIKIPIA","55-59",5856,6284,12140
"3638","LAIKIPIA","60",1347,1558,2905
"3639","LAIKIPIA","61",880,988,1868
"3640","LAIKIPIA","62",826,826,1652
"3641","LAIKIPIA","63",674,760,1434
"3642","LAIKIPIA","64",481,546,1027
"3643","LAIKIPIA","60-64",4208,4678,8886
"3644","LAIKIPIA","65",849,942,1791
"3645","LAIKIPIA","66",558,628,1186
"3646","LAIKIPIA","67",946,1119,2065
"3647","LAIKIPIA","68",444,502,946
"3648","LAIKIPIA","69",700,779,1479
"3649","LAIKIPIA","65-69",3497,3970,7467
"3650","LAIKIPIA","70",985,1200,2185
"3651","LAIKIPIA","71",592,728,1320
"3652","LAIKIPIA","72",618,533,1151
"3653","LAIKIPIA","73",481,440,921
"3654","LAIKIPIA","74",407,472,879
"3655","LAIKIPIA","70-74",3083,3373,6456
"3656","LAIKIPIA","75",398,528,926
"3657","LAIKIPIA","76",426,700,1126
"3658","LAIKIPIA","77",309,366,675
"3659","LAIKIPIA","78",251,228,479
"3660","LAIKIPIA","79",276,359,635
"3661","LAIKIPIA","75-79",1660,2181,3841
"3662","LAIKIPIA","80",385,496,881
"3663","LAIKIPIA","81",186,242,428
"3664","LAIKIPIA","82",153,160,313
"3665","LAIKIPIA","83",172,174,346
"3666","LAIKIPIA","84",164,190,354
"3667","LAIKIPIA","80-84",1060,1262,2322
"3668","LAIKIPIA","85",139,164,303
"3669","LAIKIPIA","86",99,172,271
"3670","LAIKIPIA","87",112,120,232
"3671","LAIKIPIA","88",51,66,117
"3672","LAIKIPIA","89",124,204,328
"3673","LAIKIPIA","85-89",525,726,1251
"3674","LAIKIPIA","90",69,149,218
"3675","LAIKIPIA","91",76,105,181
"3676","LAIKIPIA","92",35,44,79
"3677","LAIKIPIA","93",23,40,63
"3678","LAIKIPIA","94",22,49,71
"3679","LAIKIPIA","90-94",225,387,612
"3680","LAIKIPIA","95",32,66,98
"3681","LAIKIPIA","96",13,33,46
"3682","LAIKIPIA","97",19,40,59
"3683","LAIKIPIA","98",15,22,37
"3684","LAIKIPIA","99",21,53,74
"3685","LAIKIPIA","95-99",100,214,314
"3686","LAIKIPIA","100+",54,138,192
"3687","LAIKIPIA","Not Stated",2,2,4
"3688","NAKURU","Total",559639,555458,1115097
"3689","NAKURU","0",13336,13151,26487
"3690","NAKURU","1",13782,13488,27270
"3691","NAKURU","2",14325,14014,28339
"3692","NAKURU","3",15208,15063,30271
"3693","NAKURU","4",15799,15031,30830
"3694","NAKURU","0 - 4",72450,70747,143197
"3695","NAKURU","5",15436,14627,30063
"3696","NAKURU","6",15044,14864,29908
"3697","NAKURU","7",16039,15244,31283
"3698","NAKURU","8",14435,14282,28717
"3699","NAKURU","9",16784,16053,32837
"3700","NAKURU","5-9",77738,75070,152808
"3701","NAKURU","10",16763,16063,32826
"3702","NAKURU","11",15232,15060,30292
"3703","NAKURU","12",17526,16457,33983
"3704","NAKURU","13",16831,16484,33315
"3705","NAKURU","14",16389,15384,31773
"3706","NAKURU","10-19",82741,79448,162189
"3707","NAKURU","15",16097,14877,30974
"3708","NAKURU","16",14631,13573,28204
"3709","NAKURU","17",14681,13237,27918
"3710","NAKURU","18",11229,10047,21276
"3711","NAKURU","19",12586,11415,24001
"3712","NAKURU","15-19",69224,63149,132373
"3713","NAKURU","20",10352,10001,20353
"3714","NAKURU","21",9847,9508,19355
"3715","NAKURU","22",9213,9095,18308
"3716","NAKURU","23",9147,9304,18451
"3717","NAKURU","24",8082,8095,16177
"3718","NAKURU","20-24",46641,46003,92644
"3719","NAKURU","25",8439,8724,17163
"3720","NAKURU","26",6744,7186,13930
"3721","NAKURU","27",7506,7891,15397
"3722","NAKURU","28",5616,6261,11877
"3723","NAKURU","29",6525,7152,13677
"3724","NAKURU","25-29",34830,37214,72044
"3725","NAKURU","30",8011,9040,17051
"3726","NAKURU","31",5988,6578,12566
"3727","NAKURU","32",7495,8415,15910
"3728","NAKURU","33",6440,7324,13764
"3729","NAKURU","34",5987,6568,12555
"3730","NAKURU","30-34",33921,37925,71846
"3731","NAKURU","35",8458,8648,17106
"3732","NAKURU","36",5428,5298,10726
"3733","NAKURU","37",5732,5245,10977
"3734","NAKURU","38",4093,4104,8197
"3735","NAKURU","39",4999,4710,9709
"3736","NAKURU","35-39",28710,28005,56715
"3737","NAKURU","40",6171,5691,11862
"3738","NAKURU","41",6684,5997,12681
"3739","NAKURU","42",5502,4979,10481
"3740","NAKURU","43",4387,4537,8924
"3741","NAKURU","44",3553,3633,7186
"3742","NAKURU","40-44",26297,24837,51134
"3743","NAKURU","45",6763,6279,13042
"3744","NAKURU","46",4257,4342,8599
"3745","NAKURU","47",4884,4780,9664
"3746","NAKURU","48",3292,3187,6479
"3747","NAKURU","49",3971,4033,8004
"3748","NAKURU","45-49",23167,22621,45788
"3749","NAKURU","50",4427,4591,9018
"3750","NAKURU","51",3566,3620,7186
"3751","NAKURU","52",3305,3168,6473
"3752","NAKURU","53",2312,2462,4774
"3753","NAKURU","54",2817,2848,5665
"3754","NAKURU","50-54",16427,16689,33116
"3755","NAKURU","55",2977,2967,5944
"3756","NAKURU","56",3060,3193,6253
"3757","NAKURU","57",2513,2919,5432
"3758","NAKURU","58",2676,3384,6060
"3759","NAKURU","59",2721,2779,5500
"3760","NAKURU","55-59",13947,15242,29189
"3761","NAKURU","60",3000,3211,6211
"3762","NAKURU","61",2246,2414,4660
"3763","NAKURU","62",1929,1923,3852
"3764","NAKURU","63",1682,1822,3504
"3765","NAKURU","64",1261,1454,2715
"3766","NAKURU","60-64",10118,10824,20942
"3767","NAKURU","65",2171,2301,4472
"3768","NAKURU","66",1417,1398,2815
"3769","NAKURU","67",2400,2458,4858
"3770","NAKURU","68",1057,1058,2115
"3771","NAKURU","69",1684,1759,3443
"3772","NAKURU","65-69",8729,8974,17703
"3773","NAKURU","70",2010,2471,4481
"3774","NAKURU","71",1503,1441,2944
"3775","NAKURU","72",1307,1073,2380
"3776","NAKURU","73",1031,1019,2050
"3777","NAKURU","74",892,1114,2006
"3778","NAKURU","70-74",6743,7118,13861
"3779","NAKURU","75",820,1187,2007
"3780","NAKURU","76",888,1372,2260
"3781","NAKURU","77",738,795,1533
"3782","NAKURU","78",473,555,1028
"3783","NAKURU","79",617,943,1560
"3784","NAKURU","75-79",3536,4852,8388
"3785","NAKURU","80",693,1108,1801
"3786","NAKURU","81",415,512,927
"3787","NAKURU","82",393,380,773
"3788","NAKURU","83",396,470,866
"3789","NAKURU","84",413,571,984
"3790","NAKURU","80-84",2310,3041,5351
"3791","NAKURU","85",304,481,785
"3792","NAKURU","86",202,382,584
"3793","NAKURU","87",267,348,615
"3794","NAKURU","88",166,193,359
"3795","NAKURU","89",287,531,818
"3796","NAKURU","85-89",1226,1935,3161
"3797","NAKURU","90",167,348,515
"3798","NAKURU","91",130,216,346
"3799","NAKURU","92",77,120,197
"3800","NAKURU","93",63,111,174
"3801","NAKURU","94",50,124,174
"3802","NAKURU","90-94",487,919,1406
"3803","NAKURU","95",90,166,256
"3804","NAKURU","96",51,82,133
"3805","NAKURU","97",65,89,154
"3806","NAKURU","98",40,62,102
"3807","NAKURU","99",55,126,181
"3808","NAKURU","95-99",301,525,826
"3809","NAKURU","100+",87,314,401
"3810","NAKURU","Not Stated",8,6,14
"3811","NAROK","Total",529224,528276,1057500
"3812","NAROK","0",14913,14860,29773
"3813","NAROK","1",16043,15630,31673
"3814","NAROK","2",17507,17347,34854
"3815","NAROK","3",19043,19072,38115
"3816","NAROK","4",20200,19785,39985
"3817","NAROK","0 - 4",87706,86694,174400
"3818","NAROK","5",20155,19353,39508
"3819","NAROK","6",20099,19690,39789
"3820","NAROK","7",18356,18262,36618
"3821","NAROK","8",18681,18246,36927
"3822","NAROK","9",17437,17052,34489
"3823","NAROK","5-9",94728,92603,187331
"3824","NAROK","10",20888,19958,40846
"3825","NAROK","11",14669,14947,29616
"3826","NAROK","12",19071,17469,36540
"3827","NAROK","13",16176,15692,31868
"3828","NAROK","14",15011,14676,29687
"3829","NAROK","10-14",85815,82742,168557
"3830","NAROK","15",15423,14375,29798
"3831","NAROK","16",12486,11347,23833
"3832","NAROK","17",12087,10149,22236
"3833","NAROK","18",10313,9150,19463
"3834","NAROK","19",10464,10159,20623
"3835","NAROK","15-19",60773,55180,115953
"3836","NAROK","20",10747,12225,22972
"3837","NAROK","21",7763,8808,16571
"3838","NAROK","22",8445,9383,17828
"3839","NAROK","23",7953,8562,16515
"3840","NAROK","24",7269,7594,14863
"3841","NAROK","20-24",42177,46572,88749
"3842","NAROK","25",9025,9818,18843
"3843","NAROK","26",6464,7357,13821
"3844","NAROK","27",6777,7632,14409
"3845","NAROK","28",5711,6804,12515
"3846","NAROK","29",5337,6215,11552
"3847","NAROK","25-29",33314,37826,71140
"3848","NAROK","30",9084,10313,19397
"3849","NAROK","31",4799,5572,10371
"3850","NAROK","32",6592,7159,13751
"3851","NAROK","33",4941,5596,10537
"3852","NAROK","34",4559,4351,8910
"3853","NAROK","30-34",29975,32991,62966
"3854","NAROK","35",7799,7393,15192
"3855","NAROK","36",3716,3215,6931
"3856","NAROK","37",4228,3693,7921
"3857","NAROK","38",2968,2725,5693
"3858","NAROK","39",3223,2815,6038
"3859","NAROK","35-39",21934,19841,41775
"3860","NAROK","40",5409,5093,10502
"3861","NAROK","41",4265,4284,8549
"3862","NAROK","42",3939,3736,7675
"3863","NAROK","43",2947,3034,5981
"3864","NAROK","44",2214,2192,4406
"3865","NAROK","40-44",18774,18339,37113
"3866","NAROK","45",5235,4879,10114
"3867","NAROK","46",3001,2849,5850
"3868","NAROK","47",3296,3372,6668
"3869","NAROK","48",2030,1758,3788
"3870","NAROK","49",2326,2370,4696
"3871","NAROK","45-49",15888,15228,31116
"3872","NAROK","50",3837,4127,7964
"3873","NAROK","51",1987,1966,3953
"3874","NAROK","52",1865,1708,3573
"3875","NAROK","53",1350,1214,2564
"3876","NAROK","54",1688,1538,3226
"3877","NAROK","50-54",10727,10553,21280
"3878","NAROK","55",1843,1837,3680
"3879","NAROK","56",1680,1637,3317
"3880","NAROK","57",1373,1448,2821
"3881","NAROK","58",1617,2107,3724
"3882","NAROK","59",1465,1788,3253
"3883","NAROK","55-59",7978,8817,16795
"3884","NAROK","60",2446,2712,5158
"3885","NAROK","61",1137,1297,2434
"3886","NAROK","62",1064,1009,2073
"3887","NAROK","63",1020,1205,2225
"3888","NAROK","64",804,790,1594
"3889","NAROK","60-64",6471,7013,13484
"3890","NAROK","65",1554,1557,3111
"3891","NAROK","66",605,475,1080
"3892","NAROK","67",1139,954,2093
"3893","NAROK","68",523,513,1036
"3894","NAROK","69",865,929,1794
"3895","NAROK","65-69",4686,4428,9114
"3896","NAROK","70",1374,1807,3181
"3897","NAROK","71",693,654,1347
"3898","NAROK","72",593,524,1117
"3899","NAROK","73",494,452,946
"3900","NAROK","74",528,587,1115
"3901","NAROK","70-74",3682,4024,7706
"3902","NAROK","75",606,661,1267
"3903","NAROK","76",347,320,667
"3904","NAROK","77",360,343,703
"3905","NAROK","78",276,235,511
"3906","NAROK","79",415,503,918
"3907","NAROK","75-79",2004,2062,4066
"3908","NAROK","80",564,821,1385
"3909","NAROK","81",210,213,423
"3910","NAROK","82",186,159,345
"3911","NAROK","83",157,155,312
"3912","NAROK","84",180,257,437
"3913","NAROK","80-84",1297,1605,2902
"3914","NAROK","85",192,219,411
"3915","NAROK","86",93,104,197
"3916","NAROK","87",128,151,279
"3917","NAROK","88",69,75,144
"3918","NAROK","89",179,275,454
"3919","NAROK","85-89",661,824,1485
"3920","NAROK","90",127,242,369
"3921","NAROK","91",46,54,100
"3922","NAROK","92",52,48,100
"3923","NAROK","93",38,41,79
"3924","NAROK","94",54,59,113
"3925","NAROK","90-94",317,444,761
"3926","NAROK","95",78,103,181
"3927","NAROK","96",19,32,51
"3928","NAROK","97",34,26,60
"3929","NAROK","98",21,28,49
"3930","NAROK","99",43,62,105
"3931","NAROK","95-99",195,251,446
"3932","NAROK","100+",116,236,352
"3933","NAROK","Not Stated",6,3,9
"3934","KAJIADO","Total",250233,244970,495203
"3935","KAJIADO","0",6560,6510,13070
"3936","KAJIADO","1",7917,7569,15486
"3937","KAJIADO","2",8331,7992,16323
"3938","KAJIADO","3",9001,8678,17679
"3939","KAJIADO","4",8931,8793,17724
"3940","KAJIADO","0 - 4",40740,39542,80282
"3941","KAJIADO","5",9084,8633,17717
"3942","KAJIADO","6",8838,8777,17615
"3943","KAJIADO","7",7757,7934,15691
"3944","KAJIADO","8",8013,7690,15703
"3945","KAJIADO","9",7175,6740,13915
"3946","KAJIADO","5-9",40867,39774,80641
"3947","KAJIADO","10",8967,8593,17560
"3948","KAJIADO","11",5942,6228,12170
"3949","KAJIADO","12",7928,7670,15598
"3950","KAJIADO","13",6906,7105,14011
"3951","KAJIADO","14",6279,6421,12700
"3952","KAJIADO","10-14",36022,36017,72039
"3953","KAJIADO","15",6610,6098,12708
"3954","KAJIADO","16",5352,5146,10498
"3955","KAJIADO","17",5258,4618,9876
"3956","KAJIADO","18",4281,4299,8580
"3957","KAJIADO","19",4633,4448,9081
"3958","KAJIADO","15-19",26134,24609,50743
"3959","KAJIADO","20",4918,5296,10214
"3960","KAJIADO","21",4028,3928,7956
"3961","KAJIADO","22",3978,4172,8150
"3962","KAJIADO","23",4033,4234,8267
"3963","KAJIADO","24",3832,3734,7566
"3964","KAJIADO","20-24",20789,21364,42153
"3965","KAJIADO","25",4722,4789,9511
"3966","KAJIADO","26",3328,3618,6946
"3967","KAJIADO","27",3645,3647,7292
"3968","KAJIADO","28",3039,3183,6222
"3969","KAJIADO","29",3018,3036,6054
"3970","KAJIADO","25-29",17752,18273,36025
"3971","KAJIADO","30",4769,4955,9724
"3972","KAJIADO","31",2598,2961,5559
"3973","KAJIADO","32",3549,3721,7270
"3974","KAJIADO","33",2733,2665,5398
"3975","KAJIADO","34",2533,2142,4675
"3976","KAJIADO","30-34",16182,16444,32626
"3977","KAJIADO","35",4311,3779,8090
"3978","KAJIADO","36",2221,1876,4097
"3979","KAJIADO","37",2262,1663,3925
"3980","KAJIADO","38",1900,1322,3222
"3981","KAJIADO","39",1652,1254,2906
"3982","KAJIADO","35-39",12346,9894,22240
"3983","KAJIADO","40",2852,2486,5338
"3984","KAJIADO","41",2017,2043,4060
"3985","KAJIADO","42",2075,2258,4333
"3986","KAJIADO","43",1460,1389,2849
"3987","KAJIADO","44",1028,883,1911
"3988","KAJIADO","40-44",9432,9059,18491
"3989","KAJIADO","45",3081,2813,5894
"3990","KAJIADO","46",1730,1725,3455
"3991","KAJIADO","47",1656,1410,3066
"3992","KAJIADO","48",1109,933,2042
"3993","KAJIADO","49",1155,1026,2181
"3994","KAJIADO","45-49",8731,7907,16638
"3995","KAJIADO","50",2056,1909,3965
"3996","KAJIADO","51",1422,1482,2904
"3997","KAJIADO","52",1182,1023,2205
"3998","KAJIADO","53",764,639,1403
"3999","KAJIADO","54",1073,1160,2233
"4000","KAJIADO","50-54",6497,6213,12710
"4001","KAJIADO","55",1140,1148,2288
"4002","KAJIADO","56",966,964,1930
"4003","KAJIADO","57",719,766,1485
"4004","KAJIADO","58",671,629,1300
"4005","KAJIADO","59",777,1029,1806
"4006","KAJIADO","55-59",4273,4536,8809
"4007","KAJIADO","60",1322,1399,2721
"4008","KAJIADO","61",660,785,1445
"4009","KAJIADO","62",601,637,1238
"4010","KAJIADO","63",603,696,1299
"4011","KAJIADO","64",463,387,850
"4012","KAJIADO","60-64",3649,3904,7553
"4013","KAJIADO","65",828,833,1661
"4014","KAJIADO","66",337,340,677
"4015","KAJIADO","67",513,465,978
"4016","KAJIADO","68",301,277,578
"4017","KAJIADO","69",376,513,889
"4018","KAJIADO","65-69",2355,2428,4783
"4019","KAJIADO","70",846,901,1747
"4020","KAJIADO","71",367,425,792
"4021","KAJIADO","72",288,266,554
"4022","KAJIADO","73",224,230,454
"4023","KAJIADO","74",254,287,541
"4024","KAJIADO","70-74",1979,2109,4088
"4025","KAJIADO","75",307,330,637
"4026","KAJIADO","76",211,171,382
"4027","KAJIADO","77",186,177,363
"4028","KAJIADO","78",132,115,247
"4029","KAJIADO","79",236,291,527
"4030","KAJIADO","75-79",1072,1084,2156
"4031","KAJIADO","80",309,412,721
"4032","KAJIADO","81",114,135,249
"4033","KAJIADO","82",93,75,168
"4034","KAJIADO","83",75,100,175
"4035","KAJIADO","84",73,117,190
"4036","KAJIADO","80-84",664,839,1503
"4037","KAJIADO","85",123,137,260
"4038","KAJIADO","86",69,70,139
"4039","KAJIADO","87",63,59,122
"4040","KAJIADO","88",32,40,72
"4041","KAJIADO","89",98,134,232
"4042","KAJIADO","85-89",385,440,825
"4043","KAJIADO","90",93,128,221
"4044","KAJIADO","91",36,37,73
"4045","KAJIADO","92",19,30,49
"4046","KAJIADO","93",19,23,42
"4047","KAJIADO","94",19,22,41
"4048","KAJIADO","90-94",186,240,426
"4049","KAJIADO","95",47,65,112
"4050","KAJIADO","96",16,24,40
"4051","KAJIADO","97",14,21,35
"4052","KAJIADO","98",14,21,35
"4053","KAJIADO","99",23,31,54
"4054","KAJIADO","95-99",114,162,276
"4055","KAJIADO","100+",61,131,192
"4056","KAJIADO","Not Stated",3,1,4
"4057","KERICHO","Total",402717,405500,808217
"4058","KERICHO","0",8777,8768,17545
"4059","KERICHO","1",9603,9388,18991
"4060","KERICHO","2",9985,9708,19693
"4061","KERICHO","3",10550,10499,21049
"4062","KERICHO","4",10793,10460,21253
"4063","KERICHO","0 - 4",49708,48823,98531
"4064","KERICHO","5",10794,10516,21310
"4065","KERICHO","6",10739,10576,21315
"4066","KERICHO","7",11098,10784,21882
"4067","KERICHO","8",10362,10103,20465
"4068","KERICHO","9",11963,11676,23639
"4069","KERICHO","5-9",54956,53655,108611
"4070","KERICHO","10",11684,11362,23046
"4071","KERICHO","11",11154,11070,22224
"4072","KERICHO","12",12856,12237,25093
"4073","KERICHO","13",11790,12234,24024
"4074","KERICHO","14",11664,11646,23310
"4075","KERICHO","10-14",59148,58549,117697
"4076","KERICHO","15",11583,11242,22825
"4077","KERICHO","16",10403,10155,20558
"4078","KERICHO","17",10349,9770,20119
"4079","KERICHO","18",8234,7879,16113
"4080","KERICHO","19",9786,9299,19085
"4081","KERICHO","15-19",50355,48345,98700
"4082","KERICHO","20",7613,8109,15722
"4083","KERICHO","21",7613,8052,15665
"4084","KERICHO","22",6768,7329,14097
"4085","KERICHO","23",7016,7922,14938
"4086","KERICHO","24",6189,6692,12881
"4087","KERICHO","20-24",35199,38104,73303
"4088","KERICHO","25",6924,7434,14358
"4089","KERICHO","26",5653,6484,12137
"4090","KERICHO","27",6324,6937,13261
"4091","KERICHO","28",4591,5252,9843
"4092","KERICHO","29",5490,6124,11614
"4093","KERICHO","25-29",28982,32231,61213
"4094","KERICHO","30",6346,7508,13854
"4095","KERICHO","31",5225,5956,11181
"4096","KERICHO","32",6154,7131,13285
"4097","KERICHO","33",5422,6315,11737
"4098","KERICHO","34",4755,5221,9976
"4099","KERICHO","30-34",27902,32131,60033
"4100","KERICHO","35",6137,5555,11692
"4101","KERICHO","36",4028,3073,7101
"4102","KERICHO","37",4368,3360,7728
"4103","KERICHO","38",2690,2148,4838
"4104","KERICHO","39",3877,3119,6996
"4105","KERICHO","35-39",21100,17255,38355
"4106","KERICHO","40",4102,3570,7672
"4107","KERICHO","41",5199,4417,9616
"4108","KERICHO","42",3806,3375,7181
"4109","KERICHO","43",3106,3258,6364
"4110","KERICHO","44",2466,2489,4955
"4111","KERICHO","40-44",18679,17109,35788
"4112","KERICHO","45",5453,4553,10006
"4113","KERICHO","46",2985,3017,6002
"4114","KERICHO","47",3334,3481,6815
"4115","KERICHO","48",1809,1767,3576
"4116","KERICHO","49",2459,2519,4978
"4117","KERICHO","45-49",16040,15337,31377
"4118","KERICHO","50",2688,2906,5594
"4119","KERICHO","51",2494,2469,4963
"4120","KERICHO","52",1649,1604,3253
"4121","KERICHO","53",1292,1191,2483
"4122","KERICHO","54",1382,1342,2724
"4123","KERICHO","50-54",9505,9512,19017
"4124","KERICHO","55",1494,1413,2907
"4125","KERICHO","56",1439,1600,3039
"4126","KERICHO","57",1776,2117,3893
"4127","KERICHO","58",2444,3063,5507
"4128","KERICHO","59",1903,1889,3792
"4129","KERICHO","55-59",9056,10082,19138
"4130","KERICHO","60",2037,2236,4273
"4131","KERICHO","61",1633,1661,3294
"4132","KERICHO","62",1261,1295,2556
"4133","KERICHO","63",1315,1367,2682
"4134","KERICHO","64",910,1051,1961
"4135","KERICHO","60-64",7156,7610,14766
"4136","KERICHO","65",1633,1705,3338
"4137","KERICHO","66",937,782,1719
"4138","KERICHO","67",1519,1490,3009
"4139","KERICHO","68",629,637,1266
"4140","KERICHO","69",1027,1013,2040
"4141","KERICHO","65-69",5745,5627,11372
"4142","KERICHO","70",1308,1555,2863
"4143","KERICHO","71",1209,899,2108
"4144","KERICHO","72",791,531,1322
"4145","KERICHO","73",618,585,1203
"4146","KERICHO","74",624,664,1288
"4147","KERICHO","70-74",4550,4234,8784
"4148","KERICHO","75",448,611,1059
"4149","KERICHO","76",347,385,732
"4150","KERICHO","77",515,480,995
"4151","KERICHO","78",246,266,512
"4152","KERICHO","79",380,683,1063
"4153","KERICHO","75-79",1936,2425,4361
"4154","KERICHO","80",390,770,1160
"4155","KERICHO","81",236,413,649
"4156","KERICHO","82",230,237,467
"4157","KERICHO","83",232,297,529
"4158","KERICHO","84",227,399,626
"4159","KERICHO","80-84",1315,2116,3431
"4160","KERICHO","85",206,291,497
"4161","KERICHO","86",146,148,294
"4162","KERICHO","87",170,199,369
"4163","KERICHO","88",103,130,233
"4164","KERICHO","89",178,486,664
"4165","KERICHO","85-89",803,1254,2057
"4166","KERICHO","90",115,223,338
"4167","KERICHO","91",53,112,165
"4168","KERICHO","92",44,69,113
"4169","KERICHO","93",47,64,111
"4170","KERICHO","94",47,116,163
"4171","KERICHO","90-94",306,584,890
"4172","KERICHO","95",91,130,221
"4173","KERICHO","96",29,49,78
"4174","KERICHO","97",34,53,87
"4175","KERICHO","98",17,42,59
"4176","KERICHO","99",34,93,127
"4177","KERICHO","95-99",205,367,572
"4178","KERICHO","100+",64,147,211
"4179","BOMET","Total",420119,427576,847695
"4180","BOMET","0",9576,9327,18903
"4181","BOMET","1",10220,10056,20276
"4182","BOMET","2",11130,10644,21774
"4183","BOMET","3",11379,11433,22812
"4184","BOMET","4",12285,11624,23909
"4185","BOMET","0 - 4",54590,53084,107674
"4186","BOMET","5",12154,11154,23308
"4187","BOMET","6",11807,11497,23304
"4188","BOMET","7",12426,12124,24550
"4189","BOMET","8",11271,10979,22250
"4190","BOMET","9",13383,13015,26398
"4191","BOMET","5-9",61041,58769,119810
"4192","BOMET","10",13057,12478,25535
"4193","BOMET","11",12391,12620,25011
"4194","BOMET","12",13486,13015,26501
"4195","BOMET","13",13043,13414,26457
"4196","BOMET","14",12718,12563,25281
"4197","BOMET","10-14",64695,64090,128785
"4198","BOMET","15",12985,12578,25563
"4199","BOMET","16",11505,11371,22876
"4200","BOMET","17",11233,10360,21593
"4201","BOMET","18",8516,8032,16548
"4202","BOMET","19",10757,10221,20978
"4203","BOMET","15-19",54996,52562,107558
"4204","BOMET","20",8028,8448,16476
"4205","BOMET","21",7856,8792,16648
"4206","BOMET","22",6969,7759,14728
"4207","BOMET","23",7202,8431,15633
"4208","BOMET","24",6345,7197,13542
"4209","BOMET","20-24",36400,40627,77027
"4210","BOMET","25",7061,7548,14609
"4211","BOMET","26",5827,6621,12448
"4212","BOMET","27",6113,7038,13151
"4213","BOMET","28",4495,5394,9889
"4214","BOMET","29",5393,6522,11915
"4215","BOMET","25-29",28889,33123,62012
"4216","BOMET","30",6147,7809,13956
"4217","BOMET","31",4939,6267,11206
"4218","BOMET","32",6064,7162,13226
"4219","BOMET","33",5371,6471,11842
"4220","BOMET","34",4743,5024,9767
"4221","BOMET","30-34",27264,32733,59997
"4222","BOMET","35",6102,5475,11577
"4223","BOMET","36",3945,3000,6945
"4224","BOMET","37",4376,3226,7602
"4225","BOMET","38",2585,1970,4555
"4226","BOMET","39",3703,2794,6497
"4227","BOMET","35-39",20711,16465,37176
"4228","BOMET","40",4187,3439,7626
"4229","BOMET","41",4859,4538,9397
"4230","BOMET","42",3461,3315,6776
"4231","BOMET","43",3088,3226,6314
"4232","BOMET","44",2285,2509,4794
"4233","BOMET","40-44",17880,17027,34907
"4234","BOMET","45",5215,4444,9659
"4235","BOMET","46",3089,3167,6256
"4236","BOMET","47",3350,3535,6885
"4237","BOMET","48",1627,1693,3320
"4238","BOMET","49",2478,2764,5242
"4239","BOMET","45-49",15759,15603,31362
"4240","BOMET","50",2561,2658,5219
"4241","BOMET","51",2432,2367,4799
"4242","BOMET","52",1529,1520,3049
"4243","BOMET","53",1127,1182,2309
"4244","BOMET","54",1471,1407,2878
"4245","BOMET","50-54",9120,9134,18254
"4246","BOMET","55",1247,1358,2605
"4247","BOMET","56",1250,1324,2574
"4248","BOMET","57",1540,1827,3367
"4249","BOMET","58",2338,3231,5569
"4250","BOMET","59",1904,1780,3684
"4251","BOMET","55-59",8279,9520,17799
"4252","BOMET","60",1872,2001,3873
"4253","BOMET","61",1587,1611,3198
"4254","BOMET","62",1179,1205,2384
"4255","BOMET","63",1232,1322,2554
"4256","BOMET","64",919,970,1889
"4257","BOMET","60-64",6789,7109,13898
"4258","BOMET","65",1415,1629,3044
"4259","BOMET","66",833,794,1627
"4260","BOMET","67",1293,1369,2662
"4261","BOMET","68",530,618,1148
"4262","BOMET","69",929,1099,2028
"4263","BOMET","65-69",5000,5509,10509
"4264","BOMET","70",1078,1414,2492
"4265","BOMET","71",1086,956,2042
"4266","BOMET","72",700,639,1339
"4267","BOMET","73",596,640,1236
"4268","BOMET","74",518,790,1308
"4269","BOMET","70-74",3978,4439,8417
"4270","BOMET","75",477,698,1175
"4271","BOMET","76",353,475,828
"4272","BOMET","77",485,565,1050
"4273","BOMET","78",230,278,508
"4274","BOMET","79",383,815,1198
"4275","BOMET","75-79",1928,2831,4759
"4276","BOMET","80",390,761,1151
"4277","BOMET","81",221,467,688
"4278","BOMET","82",212,243,455
"4279","BOMET","83",234,269,503
"4280","BOMET","84",246,445,691
"4281","BOMET","80-84",1303,2185,3488
"4282","BOMET","85",173,298,471
"4283","BOMET","86",156,171,327
"4284","BOMET","87",207,273,480
"4285","BOMET","88",102,150,252
"4286","BOMET","89",207,542,749
"4287","BOMET","85-89",845,1434,2279
"4288","BOMET","90",107,278,385
"4289","BOMET","91",74,166,240
"4290","BOMET","92",55,87,142
"4291","BOMET","93",51,93,144
"4292","BOMET","94",58,145,203
"4293","BOMET","90-94",345,769,1114
"4294","BOMET","95",102,116,218
"4295","BOMET","96",34,36,70
"4296","BOMET","97",42,40,82
"4297","BOMET","98",20,41,61
"4298","BOMET","99",34,127,161
"4299","BOMET","95-99",232,360,592
"4300","BOMET","100+",73,202,275
"4301","BOMET","Not Stated",2,1,3
"4302","KAKAMEGA","Total",806682,875526,1682208
"4303","KAKAMEGA","0",18699,18920,37619
"4304","KAKAMEGA","1",19338,19787,39125
"4305","KAKAMEGA","2",19900,20095,39995
"4306","KAKAMEGA","3",21230,21772,43002
"4307","KAKAMEGA","4",22613,22367,44980
"4308","KAKAMEGA","0 - 4",101780,102941,204721
"4309","KAKAMEGA","5",23782,23336,47118
"4310","KAKAMEGA","6",24649,24889,49538
"4311","KAKAMEGA","7",24704,24485,49189
"4312","KAKAMEGA","8",23382,24147,47529
"4313","KAKAMEGA","9",26954,26787,53741
"4314","KAKAMEGA","5-9",123471,123644,247115
"4315","KAKAMEGA","10",27500,27104,54604
"4316","KAKAMEGA","11",25196,26245,51441
"4317","KAKAMEGA","12",28508,27932,56440
"4318","KAKAMEGA","13",27375,28194,55569
"4319","KAKAMEGA","14",25627,25808,51435
"4320","KAKAMEGA","10-14",134206,135283,269489
"4321","KAKAMEGA","15",25124,25411,50535
"4322","KAKAMEGA","16",23326,23472,46798
"4323","KAKAMEGA","17",23774,22808,46582
"4324","KAKAMEGA","18",19179,17641,36820
"4325","KAKAMEGA","19",18990,18472,37462
"4326","KAKAMEGA","15-19",110393,107804,218197
"4327","KAKAMEGA","20",16021,16797,32818
"4328","KAKAMEGA","21",12946,13857,26803
"4329","KAKAMEGA","22",11407,12573,23980
"4330","KAKAMEGA","23",10828,13119,23947
"4331","KAKAMEGA","24",9168,11515,20683
"4332","KAKAMEGA","20-24",60370,67861,128231
"4333","KAKAMEGA","25",10131,12483,22614
"4334","KAKAMEGA","26",8333,11289,19622
"4335","KAKAMEGA","27",8766,11493,20259
"4336","KAKAMEGA","28",6950,9120,16070
"4337","KAKAMEGA","29",7639,10270,17909
"4338","KAKAMEGA","25-29",41819,54655,96474
"4339","KAKAMEGA","30",9605,13505,23110
"4340","KAKAMEGA","31",7946,10479,18425
"4341","KAKAMEGA","32",9681,13147,22828
"4342","KAKAMEGA","33",8293,11306,19599
"4343","KAKAMEGA","34",7623,9365,16988
"4344","KAKAMEGA","30-34",43148,57802,100950
"4345","KAKAMEGA","35",8918,10181,19099
"4346","KAKAMEGA","36",7028,7484,14512
"4347","KAKAMEGA","37",7627,7444,15071
"4348","KAKAMEGA","38",5567,5695,11262
"4349","KAKAMEGA","39",6405,6618,13023
"4350","KAKAMEGA","35-39",35545,37422,72967
"4351","KAKAMEGA","40",7276,8240,15516
"4352","KAKAMEGA","41",7000,7975,14975
"4353","KAKAMEGA","42",7151,8057,15208
"4354","KAKAMEGA","43",6532,7769,14301
"4355","KAKAMEGA","44",5438,6232,11670
"4356","KAKAMEGA","40-44",33397,38273,71670
"4357","KAKAMEGA","45",7011,8137,15148
"4358","KAKAMEGA","46",5462,6155,11617
"4359","KAKAMEGA","47",5821,6342,12163
"4360","KAKAMEGA","48",4075,4434,8509
"4361","KAKAMEGA","49",4596,5196,9792
"4362","KAKAMEGA","45-49",26965,30264,57229
"4363","KAKAMEGA","50",5456,7261,12717
"4364","KAKAMEGA","51",4897,6131,11028
"4365","KAKAMEGA","52",4050,4726,8776
"4366","KAKAMEGA","53",3558,4553,8111
"4367","KAKAMEGA","54",3852,4426,8278
"4368","KAKAMEGA","50-54",21813,27097,48910
"4369","KAKAMEGA","55",4301,4838,9139
"4370","KAKAMEGA","56",4213,5052,9265
"4371","KAKAMEGA","57",4442,6457,10899
"4372","KAKAMEGA","58",3246,3915,7161
"4373","KAKAMEGA","59",4226,5087,9313
"4374","KAKAMEGA","55-59",20428,25349,45777
"4375","KAKAMEGA","60",4372,5534,9906
"4376","KAKAMEGA","61",3868,4600,8468
"4377","KAKAMEGA","62",3307,3769,7076
"4378","KAKAMEGA","63",3516,4360,7876
"4379","KAKAMEGA","64",2809,3245,6054
"4380","KAKAMEGA","60-64",17872,21508,39380
"4381","KAKAMEGA","65",3548,4308,7856
"4382","KAKAMEGA","66",2417,2879,5296
"4383","KAKAMEGA","67",3397,4298,7695
"4384","KAKAMEGA","68",1610,1743,3353
"4385","KAKAMEGA","69",2487,2998,5485
"4386","KAKAMEGA","65-69",13459,16226,29685
"4387","KAKAMEGA","70",2932,3739,6671
"4388","KAKAMEGA","71",2046,2396,4442
"4389","KAKAMEGA","72",1814,1884,3698
"4390","KAKAMEGA","73",1646,1806,3452
"4391","KAKAMEGA","74",1440,1790,3230
"4392","KAKAMEGA","70-74",9878,11615,21493
"4393","KAKAMEGA","75",1313,1835,3148
"4394","KAKAMEGA","76",1347,2215,3562
"4395","KAKAMEGA","77",1176,1774,2950
"4396","KAKAMEGA","78",682,838,1520
"4397","KAKAMEGA","79",836,1367,2203
"4398","KAKAMEGA","75-79",5354,8029,13383
"4399","KAKAMEGA","80",995,1463,2458
"4400","KAKAMEGA","81",750,988,1738
"4401","KAKAMEGA","82",661,850,1511
"4402","KAKAMEGA","83",784,1018,1802
"4403","KAKAMEGA","84",508,691,1199
"4404","KAKAMEGA","80-84",3698,5010,8708
"4405","KAKAMEGA","85",541,701,1242
"4406","KAKAMEGA","86",397,610,1007
"4407","KAKAMEGA","87",545,871,1416
"4408","KAKAMEGA","88",220,310,530
"4409","KAKAMEGA","89",317,637,954
"4410","KAKAMEGA","85-89",2020,3129,5149
"4411","KAKAMEGA","90",215,284,499
"4412","KAKAMEGA","91",191,216,407
"4413","KAKAMEGA","92",125,163,288
"4414","KAKAMEGA","93",130,150,280
"4415","KAKAMEGA","94",60,116,176
"4416","KAKAMEGA","90-94",721,929,1650
"4417","KAKAMEGA","95",110,191,301
"4418","KAKAMEGA","96",43,82,125
"4419","KAKAMEGA","97",74,113,187
"4420","KAKAMEGA","98",31,49,80
"4421","KAKAMEGA","99",29,87,116
"4422","KAKAMEGA","95-99",287,522,809
"4423","KAKAMEGA","100+",45,150,195
"4424","KAKAMEGA","Not Stated",13,13,26
"4425","VIHIGA","Total",255727,275892,531619
"4426","VIHIGA","0",5253,5533,10786
"4427","VIHIGA","1",5446,5620,11066
"4428","VIHIGA","2",5681,5684,11365
"4429","VIHIGA","3",6155,6074,12229
"4430","VIHIGA","4",6290,6300,12590
"4431","VIHIGA","0 - 4",28825,29211,58036
"4432","VIHIGA","5",6575,6279,12854
"4433","VIHIGA","6",6802,6931,13733
"4434","VIHIGA","7",7203,7364,14567
"4435","VIHIGA","8",7023,7226,14249
"4436","VIHIGA","9",7780,7898,15678
"4437","VIHIGA","5-9",35383,35698,71081
"4438","VIHIGA","10",7967,7723,15690
"4439","VIHIGA","11",7683,7965,15648
"4440","VIHIGA","12",8494,8358,16852
"4441","VIHIGA","13",8268,8462,16730
"4442","VIHIGA","14",7752,7696,15448
"4443","VIHIGA","10-14",40164,40204,80368
"4444","VIHIGA","15",7534,7501,15035
"4445","VIHIGA","16",7386,7390,14776
"4446","VIHIGA","17",7453,7077,14530
"4447","VIHIGA","18",5996,5768,11764
"4448","VIHIGA","19",5897,5441,11338
"4449","VIHIGA","15-19",34266,33177,67443
"4450","VIHIGA","20",4832,4899,9731
"4451","VIHIGA","21",3866,3805,7671
"4452","VIHIGA","22",3555,3648,7203
"4453","VIHIGA","23",3236,3699,6935
"4454","VIHIGA","24",2819,3283,6102
"4455","VIHIGA","20-24",18308,19334,37642
"4456","VIHIGA","25",2801,3389,6190
"4457","VIHIGA","26",2437,3115,5552
"4458","VIHIGA","27",2574,3160,5734
"4459","VIHIGA","28",2262,2725,4987
"4460","VIHIGA","29",2362,2891,5253
"4461","VIHIGA","25-29",12436,15280,27716
"4462","VIHIGA","30",3028,3845,6873
"4463","VIHIGA","31",2215,2889,5104
"4464","VIHIGA","32",2860,3620,6480
"4465","VIHIGA","33",2431,2930,5361
"4466","VIHIGA","34",2371,2739,5110
"4467","VIHIGA","30-34",12905,16023,28928
"4468","VIHIGA","35",2910,3211,6121
"4469","VIHIGA","36",2225,2533,4758
"4470","VIHIGA","37",2468,2579,5047
"4471","VIHIGA","38",1949,2077,4026
"4472","VIHIGA","39",2150,2310,4460
"4473","VIHIGA","35-39",11702,12710,24412
"4474","VIHIGA","40",2476,2716,5192
"4475","VIHIGA","41",2252,2524,4776
"4476","VIHIGA","42",2332,2737,5069
"4477","VIHIGA","43",2083,2450,4533
"4478","VIHIGA","44",1747,1830,3577
"4479","VIHIGA","40-44",10890,12257,23147
"4480","VIHIGA","45",2291,2435,4726
"4481","VIHIGA","46",1935,2028,3963
"4482","VIHIGA","47",2101,2296,4397
"4483","VIHIGA","48",1540,1621,3161
"4484","VIHIGA","49",1667,1903,3570
"4485","VIHIGA","45-49",9534,10283,19817
"4486","VIHIGA","50",1964,2469,4433
"4487","VIHIGA","51",1668,2052,3720
"4488","VIHIGA","52",1541,1810,3351
"4489","VIHIGA","53",1296,1643,2939
"4490","VIHIGA","54",1500,1802,3302
"4491","VIHIGA","50-54",7969,9776,17745
"4492","VIHIGA","55",1618,1892,3510
"4493","VIHIGA","56",1538,1934,3472
"4494","VIHIGA","57",1580,2364,3944
"4495","VIHIGA","58",1245,1585,2830
"4496","VIHIGA","59",1606,1985,3591
"4497","VIHIGA","55-59",7587,9760,17347
"4498","VIHIGA","60",1720,2258,3978
"4499","VIHIGA","61",1640,1775,3415
"4500","VIHIGA","62",1485,1670,3155
"4501","VIHIGA","63",1476,1823,3299
"4502","VIHIGA","64",1313,1552,2865
"4503","VIHIGA","60-64",7634,9078,16712
"4504","VIHIGA","65",1634,1967,3601
"4505","VIHIGA","66",1169,1377,2546
"4506","VIHIGA","67",1579,1879,3458
"4507","VIHIGA","68",804,949,1753
"4508","VIHIGA","69",1244,1384,2628
"4509","VIHIGA","65-69",6430,7556,13986
"4510","VIHIGA","70",1468,1790,3258
"4511","VIHIGA","71",1119,1069,2188
"4512","VIHIGA","72",987,1072,2059
"4513","VIHIGA","73",838,927,1765
"4514","VIHIGA","74",775,910,1685
"4515","VIHIGA","70-74",5187,5768,10955
"4516","VIHIGA","75",566,848,1414
"4517","VIHIGA","76",701,1176,1877
"4518","VIHIGA","77",640,815,1455
"4519","VIHIGA","78",418,465,883
"4520","VIHIGA","79",497,718,1215
"4521","VIHIGA","75-79",2822,4022,6844
"4522","VIHIGA","80",482,860,1342
"4523","VIHIGA","81",405,587,992
"4524","VIHIGA","82",387,506,893
"4525","VIHIGA","83",367,576,943
"4526","VIHIGA","84",326,451,777
"4527","VIHIGA","80-84",1967,2980,4947
"4528","VIHIGA","85",249,450,699
"4529","VIHIGA","86",232,394,626
"4530","VIHIGA","87",266,425,691
"4531","VIHIGA","88",157,175,332
"4532","VIHIGA","89",173,337,510
"4533","VIHIGA","85-89",1077,1781,2858
"4534","VIHIGA","90",134,149,283
"4535","VIHIGA","91",114,174,288
"4536","VIHIGA","92",80,110,190
"4537","VIHIGA","93",63,79,142
"4538","VIHIGA","94",44,73,117
"4539","VIHIGA","90-94",435,585,1020
"4540","VIHIGA","95",54,113,167
"4541","VIHIGA","96",32,60,92
"4542","VIHIGA","97",39,68,107
"4543","VIHIGA","98",19,24,43
"4544","VIHIGA","99",16,53,69
"4545","VIHIGA","95-99",160,318,478
"4546","VIHIGA","100+",42,88,130
"4547","VIHIGA","Not Stated",4,3,7
"4548","BUNGOMA","Total",720235,760194,1480429
"4549","BUNGOMA","0",17590,18022,35612
"4550","BUNGOMA","1",18561,18690,37251
"4551","BUNGOMA","2",19391,19437,38828
"4552","BUNGOMA","3",20725,21206,41931
"4553","BUNGOMA","4",21276,21062,42338
"4554","BUNGOMA","0 - 4",97543,98417,195960
"4555","BUNGOMA","5",23110,22433,45543
"4556","BUNGOMA","6",22693,23131,45824
"4557","BUNGOMA","7",22807,22704,45511
"4558","BUNGOMA","8",21155,21633,42788
"4559","BUNGOMA","9",25307,24745,50052
"4560","BUNGOMA","5-9",115072,114646,229718
"4561","BUNGOMA","10",24509,24498,49007
"4562","BUNGOMA","11",23437,24067,47504
"4563","BUNGOMA","12",24925,24305,49230
"4564","BUNGOMA","13",25223,25694,50917
"4565","BUNGOMA","14",23051,22755,45806
"4566","BUNGOMA","10-14",121145,121319,242464
"4567","BUNGOMA","15",23614,22915,46529
"4568","BUNGOMA","16",20249,20290,40539
"4569","BUNGOMA","17",21386,20482,41868
"4570","BUNGOMA","18",15620,14462,30082
"4571","BUNGOMA","19",17693,16689,34382
"4572","BUNGOMA","15-19",98562,94838,193400
"4573","BUNGOMA","20",13690,14469,28159
"4574","BUNGOMA","21",12136,12850,24986
"4575","BUNGOMA","22",10584,12165,22749
"4576","BUNGOMA","23",11282,13035,24317
"4577","BUNGOMA","24",9294,11024,20318
"4578","BUNGOMA","20-24",56986,63543,120529
"4579","BUNGOMA","25",10468,12509,22977
"4580","BUNGOMA","26",8156,10058,18214
"4581","BUNGOMA","27",9036,10535,19571
"4582","BUNGOMA","28",6217,7620,13837
"4583","BUNGOMA","29",7661,8901,16562
"4584","BUNGOMA","25-29",41538,49623,91161
"4585","BUNGOMA","30",8869,11323,20192
"4586","BUNGOMA","31",7815,10278,18093
"4587","BUNGOMA","32",9083,11339,20422
"4588","BUNGOMA","33",7276,8854,16130
"4589","BUNGOMA","34",6173,6734,12907
"4590","BUNGOMA","30-34",39216,48528,87744
"4591","BUNGOMA","35",8025,8014,16039
"4592","BUNGOMA","36",6068,5939,12007
"4593","BUNGOMA","37",6372,6069,12441
"4594","BUNGOMA","38",4391,4640,9031
"4595","BUNGOMA","39",5283,5385,10668
"4596","BUNGOMA","35-39",30139,30047,60186
"4597","BUNGOMA","40",5634,6124,11758
"4598","BUNGOMA","41",6145,6945,13090
"4599","BUNGOMA","42",5962,6667,12629
"4600","BUNGOMA","43",5633,6258,11891
"4601","BUNGOMA","44",3958,4362,8320
"4602","BUNGOMA","40-44",27332,30356,57688
"4603","BUNGOMA","45",6475,6340,12815
"4604","BUNGOMA","46",4746,4856,9602
"4605","BUNGOMA","47",5093,5180,10273
"4606","BUNGOMA","48",3079,3389,6468
"4607","BUNGOMA","49",3705,3771,7476
"4608","BUNGOMA","45-49",23098,23536,46634
"4609","BUNGOMA","50",4038,4821,8859
"4610","BUNGOMA","51",3737,4325,8062
"4611","BUNGOMA","52",3160,3574,6734
"4612","BUNGOMA","53",2717,3472,6189
"4613","BUNGOMA","54",2830,3410,6240
"4614","BUNGOMA","50-54",16482,19602,36084
"4615","BUNGOMA","55",3344,3784,7128
"4616","BUNGOMA","56",3137,3738,6875
"4617","BUNGOMA","57",3427,4605,8032
"4618","BUNGOMA","58",2569,3017,5586
"4619","BUNGOMA","59",3832,4025,7857
"4620","BUNGOMA","55-59",16309,19169,35478
"4621","BUNGOMA","60",3341,3566,6907
"4622","BUNGOMA","61",2890,3301,6191
"4623","BUNGOMA","62",2232,2528,4760
"4624","BUNGOMA","63",2717,3197,5914
"4625","BUNGOMA","64",1848,2227,4075
"4626","BUNGOMA","60-64",13028,14819,27847
"4627","BUNGOMA","65",2549,3119,5668
"4628","BUNGOMA","66",1513,1929,3442
"4629","BUNGOMA","67",2042,2728,4770
"4630","BUNGOMA","68",1025,1258,2283
"4631","BUNGOMA","69",1779,2035,3814
"4632","BUNGOMA","65-69",8908,11069,19977
"4633","BUNGOMA","70",1520,1967,3487
"4634","BUNGOMA","71",1421,1906,3327
"4635","BUNGOMA","72",1101,1357,2458
"4636","BUNGOMA","73",1150,1551,2701
"4637","BUNGOMA","74",955,1195,2150
"4638","BUNGOMA","70-74",6147,7976,14123
"4639","BUNGOMA","75",944,1309,2253
"4640","BUNGOMA","76",752,1058,1810
"4641","BUNGOMA","77",910,1567,2477
"4642","BUNGOMA","78",591,672,1263
"4643","BUNGOMA","79",553,829,1382
"4644","BUNGOMA","75-79",3750,5435,9185
"4645","BUNGOMA","80",739,1034,1773
"4646","BUNGOMA","81",468,625,1093
"4647","BUNGOMA","82",477,618,1095
"4648","BUNGOMA","83",620,914,1534
"4649","BUNGOMA","84",359,450,809
"4650","BUNGOMA","80-84",2663,3641,6304
"4651","BUNGOMA","85",421,594,1015
"4652","BUNGOMA","86",231,383,614
"4653","BUNGOMA","87",414,654,1068
"4654","BUNGOMA","88",169,199,368
"4655","BUNGOMA","89",284,498,782
"4656","BUNGOMA","85-89",1519,2328,3847
"4657","BUNGOMA","90",164,197,361
"4658","BUNGOMA","91",160,226,386
"4659","BUNGOMA","92",90,145,235
"4660","BUNGOMA","93",62,143,205
"4661","BUNGOMA","94",45,77,122
"4662","BUNGOMA","90-94",521,788,1309
"4663","BUNGOMA","95",109,156,265
"4664","BUNGOMA","96",34,43,77
"4665","BUNGOMA","97",57,131,188
"4666","BUNGOMA","98",14,41,55
"4667","BUNGOMA","99",24,56,80
"4668","BUNGOMA","95-99",238,427,665
"4669","BUNGOMA","100+",34,86,120
"4670","BUSIA","Total",371289,408611,779900
"4671","BUSIA","0",8997,9276,18273
"4672","BUSIA","1",9787,9875,19662
"4673","BUSIA","2",9870,9756,19626
"4674","BUSIA","3",10226,10539,20765
"4675","BUSIA","4",10133,10219,20352
"4676","BUSIA","0 - 4",49013,49665,98678
"4677","BUSIA","5",10591,10805,21396
"4678","BUSIA","6",11299,11607,22906
"4679","BUSIA","7",11404,11574,22978
"4680","BUSIA","8",10844,11287,22131
"4681","BUSIA","9",11943,12227,24170
"4682","BUSIA","5-9",56081,57500,113581
"4683","BUSIA","10",12664,12508,25172
"4684","BUSIA","11",11549,12209,23758
"4685","BUSIA","12",13137,12968,26105
"4686","BUSIA","13",12767,13021,25788
"4687","BUSIA","14",12064,11977,24041
"4688","BUSIA","10-14",62181,62683,124864
"4689","BUSIA","15",11959,11862,23821
"4690","BUSIA","16",11071,11210,22281
"4691","BUSIA","17",11325,11007,22332
"4692","BUSIA","18",9298,8637,17935
"4693","BUSIA","19",9339,9147,18486
"4694","BUSIA","15-19",52992,51863,104855
"4695","BUSIA","20",8069,8370,16439
"4696","BUSIA","21",6272,6784,13056
"4697","BUSIA","22",5779,6841,12620
"4698","BUSIA","23",5376,6546,11922
"4699","BUSIA","24",4815,5882,10697
"4700","BUSIA","20-24",30311,34423,64734
"4701","BUSIA","25",5052,6354,11406
"4702","BUSIA","26",4205,5617,9822
"4703","BUSIA","27",4362,5497,9859
"4704","BUSIA","28",3410,4653,8063
"4705","BUSIA","29",3489,4466,7955
"4706","BUSIA","25-29",20518,26587,47105
"4707","BUSIA","30",4370,6313,10683
"4708","BUSIA","31",3467,4675,8142
"4709","BUSIA","32",4409,5953,10362
"4710","BUSIA","33",3651,4843,8494
"4711","BUSIA","34",3266,4085,7351
"4712","BUSIA","30-34",19163,25869,45032
"4713","BUSIA","35",4114,4470,8584
"4714","BUSIA","36",3184,3253,6437
"4715","BUSIA","37",3324,3334,6658
"4716","BUSIA","38",2339,2569,4908
"4717","BUSIA","39",2750,2824,5574
"4718","BUSIA","35-39",15711,16450,32161
"4719","BUSIA","40",3247,3797,7044
"4720","BUSIA","41",2952,3484,6436
"4721","BUSIA","42",3098,3577,6675
"4722","BUSIA","43",2843,3128,5971
"4723","BUSIA","44",2183,2407,4590
"4724","BUSIA","40-44",14323,16393,30716
"4725","BUSIA","45",3061,3485,6546
"4726","BUSIA","46",2152,2382,4534
"4727","BUSIA","47",2399,2780,5179
"4728","BUSIA","48",1564,1881,3445
"4729","BUSIA","49",1749,2099,3848
"4730","BUSIA","45-49",10925,12627,23552
"4731","BUSIA","50",2428,3542,5970
"4732","BUSIA","51",2062,2773,4835
"4733","BUSIA","52",1648,2142,3790
"4734","BUSIA","53",1498,1929,3427
"4735","BUSIA","54",1532,1895,3427
"4736","BUSIA","50-54",9168,12281,21449
"4737","BUSIA","55",1708,2095,3803
"4738","BUSIA","56",1733,2118,3851
"4739","BUSIA","57",1862,3057,4919
"4740","BUSIA","58",1449,1928,3377
"4741","BUSIA","59",1835,2367,4202
"4742","BUSIA","55-59",8587,11565,20152
"4743","BUSIA","60",2007,2638,4645
"4744","BUSIA","61",1615,1978,3593
"4745","BUSIA","62",1269,1637,2906
"4746","BUSIA","63",1317,1662,2979
"4747","BUSIA","64",1047,1521,2568
"4748","BUSIA","60-64",7255,9436,16691
"4749","BUSIA","65",1374,1932,3306
"4750","BUSIA","66",943,1209,2152
"4751","BUSIA","67",1366,1881,3247
"4752","BUSIA","68",627,764,1391
"4753","BUSIA","69",975,1390,2365
"4754","BUSIA","65-69",5285,7176,12461
"4755","BUSIA","70",1235,2009,3244
"4756","BUSIA","71",966,1158,2124
"4757","BUSIA","72",737,834,1571
"4758","BUSIA","73",616,751,1367
"4759","BUSIA","74",627,927,1554
"4760","BUSIA","70-74",4181,5679,9860
"4761","BUSIA","75",581,866,1447
"4762","BUSIA","76",466,560,1026
"4763","BUSIA","77",624,828,1452
"4764","BUSIA","78",303,386,689
"4765","BUSIA","79",419,800,1219
"4766","BUSIA","75-79",2393,3440,5833
"4767","BUSIA","80",474,845,1319
"4768","BUSIA","81",347,465,812
"4769","BUSIA","82",271,327,598
"4770","BUSIA","83",341,383,724
"4771","BUSIA","84",259,437,696
"4772","BUSIA","80-84",1692,2457,4149
"4773","BUSIA","85",197,355,552
"4774","BUSIA","86",249,263,512
"4775","BUSIA","87",251,400,651
"4776","BUSIA","88",126,152,278
"4777","BUSIA","89",189,436,625
"4778","BUSIA","85-89",1012,1606,2618
"4779","BUSIA","90",90,215,305
"4780","BUSIA","91",99,120,219
"4781","BUSIA","92",48,63,111
"4782","BUSIA","93",55,62,117
"4783","BUSIA","94",38,107,145
"4784","BUSIA","90-94",330,567,897
"4785","BUSIA","95",42,76,118
"4786","BUSIA","96",25,33,58
"4787","BUSIA","97",45,47,92
"4788","BUSIA","98",8,34,42
"4789","BUSIA","99",15,55,70
"4790","BUSIA","95-99",135,245,380
"4791","BUSIA","100+",29,98,127
"4792","SIAYA","Total",431450,476301,907751
"4793","SIAYA","0",10481,10607,21088
"4794","SIAYA","1",10563,10473,21036
"4795","SIAYA","2",10640,10812,21452
"4796","SIAYA","3",11745,11713,23458
"4797","SIAYA","4",11955,11671,23626
"4798","SIAYA","0 - 4",55384,55276,110660
"4799","SIAYA","5",12508,11960,24468
"4800","SIAYA","6",13084,12990,26074
"4801","SIAYA","7",12600,12823,25423
"4802","SIAYA","8",11947,12444,24391
"4803","SIAYA","9",13636,13542,27178
"4804","SIAYA","5-9",63775,63759,127534
"4805","SIAYA","10",14576,14040,28616
"4806","SIAYA","11",13314,13442,26756
"4807","SIAYA","12",15155,14702,29857
"4808","SIAYA","13",14690,14450,29140
"4809","SIAYA","14",13227,12834,26061
"4810","SIAYA","10-14",70962,69468,140430
"4811","SIAYA","15",13082,12436,25518
"4812","SIAYA","16",11581,11336,22917
"4813","SIAYA","17",11784,10933,22717
"4814","SIAYA","18",9157,8784,17941
"4815","SIAYA","19",9456,9325,18781
"4816","SIAYA","15-19",55060,52814,107874
"4817","SIAYA","20",8080,8603,16683
"4818","SIAYA","21",6762,7412,14174
"4819","SIAYA","22",6052,7227,13279
"4820","SIAYA","23",5915,7479,13394
"4821","SIAYA","24",5357,6758,12115
"4822","SIAYA","20-24",32166,37479,69645
"4823","SIAYA","25",5955,7417,13372
"4824","SIAYA","26",4984,6741,11725
"4825","SIAYA","27",5452,6774,12226
"4826","SIAYA","28",4061,5006,9067
"4827","SIAYA","29",4231,5521,9752
"4828","SIAYA","25-29",24683,31459,56142
"4829","SIAYA","30",6065,8101,14166
"4830","SIAYA","31",4344,5143,9487
"4831","SIAYA","32",5458,7058,12516
"4832","SIAYA","33",4895,6168,11063
"4833","SIAYA","34",4765,5514,10279
"4834","SIAYA","30-34",25527,31984,57511
"4835","SIAYA","35",5695,6101,11796
"4836","SIAYA","36",4213,4250,8463
"4837","SIAYA","37",4600,4264,8864
"4838","SIAYA","38",3064,2834,5898
"4839","SIAYA","39",3776,3704,7480
"4840","SIAYA","35-39",21348,21153,42501
"4841","SIAYA","40",4459,4888,9347
"4842","SIAYA","41",3864,3919,7783
"4843","SIAYA","42",3700,3643,7343
"4844","SIAYA","43",3418,3638,7056
"4845","SIAYA","44",2834,3163,5997
"4846","SIAYA","40-44",18275,19251,37526
"4847","SIAYA","45",3658,4152,7810
"4848","SIAYA","46",2665,3146,5811
"4849","SIAYA","47",2863,3235,6098
"4850","SIAYA","48",1779,2152,3931
"4851","SIAYA","49",2067,2528,4595
"4852","SIAYA","45-49",13032,15213,28245
"4853","SIAYA","50",2784,4115,6899
"4854","SIAYA","51",2360,3354,5714
"4855","SIAYA","52",1888,2531,4419
"4856","SIAYA","53",1589,2196,3785
"4857","SIAYA","54",1890,2392,4282
"4858","SIAYA","50-54",10511,14588,25099
"4859","SIAYA","55",2155,2746,4901
"4860","SIAYA","56",2055,3114,5169
"4861","SIAYA","57",2102,3762,5864
"4862","SIAYA","58",1459,2107,3566
"4863","SIAYA","59",1800,2748,4548
"4864","SIAYA","55-59",9571,14477,24048
"4865","SIAYA","60",2466,4026,6492
"4866","SIAYA","61",1821,2790,4611
"4867","SIAYA","62",1701,2372,4073
"4868","SIAYA","63",1628,2507,4135
"4869","SIAYA","64",1398,2083,3481
"4870","SIAYA","60-64",9014,13778,22792
"4871","SIAYA","65",1900,2839,4739
"4872","SIAYA","66",1512,2394,3906
"4873","SIAYA","67",2064,3348,5412
"4874","SIAYA","68",897,1242,2139
"4875","SIAYA","69",1454,2024,3478
"4876","SIAYA","65-69",7827,11847,19674
"4877","SIAYA","70",1944,3479,5423
"4878","SIAYA","71",1368,1908,3276
"4879","SIAYA","72",1230,1482,2712
"4880","SIAYA","73",972,1329,2301
"4881","SIAYA","74",936,1421,2357
"4882","SIAYA","70-74",6450,9619,16069
"4883","SIAYA","75",734,1297,2031
"4884","SIAYA","76",681,1084,1765
"4885","SIAYA","77",868,1582,2450
"4886","SIAYA","78",417,664,1081
"4887","SIAYA","79",580,1287,1867
"4888","SIAYA","75-79",3280,5914,9194
"4889","SIAYA","80",736,1482,2218
"4890","SIAYA","81",465,892,1357
"4891","SIAYA","82",488,704,1192
"4892","SIAYA","83",460,689,1149
"4893","SIAYA","84",386,623,1009
"4894","SIAYA","80-84",2535,4390,6925
"4895","SIAYA","85",321,649,970
"4896","SIAYA","86",258,401,659
"4897","SIAYA","87",377,612,989
"4898","SIAYA","88",158,291,449
"4899","SIAYA","89",253,634,887
"4900","SIAYA","85-89",1367,2587,3954
"4901","SIAYA","90",158,310,468
"4902","SIAYA","91",125,212,337
"4903","SIAYA","92",77,111,188
"4904","SIAYA","93",58,99,157
"4905","SIAYA","94",56,91,147
"4906","SIAYA","90-94",474,823,1297
"4907","SIAYA","95",62,95,157
"4908","SIAYA","96",27,50,77
"4909","SIAYA","97",27,53,80
"4910","SIAYA","98",15,44,59
"4911","SIAYA","99",25,60,85
"4912","SIAYA","95-99",156,302,458
"4913","SIAYA","100+",43,113,156
"4914","KISUMU","Total",344721,369939,714660
"4915","KISUMU","0",8082,7998,16080
"4916","KISUMU","1",8556,8281,16837
"4917","KISUMU","2",8647,8823,17470
"4918","KISUMU","3",8954,9010,17964
"4919","KISUMU","4",8888,9045,17933
"4920","KISUMU","0 - 4",43127,43157,86284
"4921","KISUMU","5",9616,9192,18808
"4922","KISUMU","6",9834,9727,19561
"4923","KISUMU","7",9575,9843,19418
"4924","KISUMU","8",9582,9421,19003
"4925","KISUMU","9",10685,10616,21301
"4926","KISUMU","5-9",49292,48799,98091
"4927","KISUMU","10",11782,11153,22935
"4928","KISUMU","11",10548,10753,21301
"4929","KISUMU","12",12321,11846,24167
"4930","KISUMU","13",11748,11611,23359
"4931","KISUMU","14",10697,10603,21300
"4932","KISUMU","10-14",57096,55966,113062
"4933","KISUMU","15",10544,10290,20834
"4934","KISUMU","16",9234,9238,18472
"4935","KISUMU","17",9583,8949,18532
"4936","KISUMU","18",7463,7046,14509
"4937","KISUMU","19",7794,7896,15690
"4938","KISUMU","15-19",44618,43419,88037
"4939","KISUMU","20",6695,7416,14111
"4940","KISUMU","21",5824,6562,12386
"4941","KISUMU","22",5082,6054,11136
"4942","KISUMU","23",5257,6349,11606
"4943","KISUMU","24",4744,5541,10285
"4944","KISUMU","20-24",27602,31922,59524
"4945","KISUMU","25",5316,6122,11438
"4946","KISUMU","26",4229,5144,9373
"4947","KISUMU","27",4625,5687,10312
"4948","KISUMU","28",3342,4006,7348
"4949","KISUMU","29",3462,4706,8168
"4950","KISUMU","25-29",20974,25665,46639
"4951","KISUMU","30",4895,6547,11442
"4952","KISUMU","31",3539,4491,8030
"4953","KISUMU","32",4499,5671,10170
"4954","KISUMU","33",3935,5115,9050
"4955","KISUMU","34",3836,4568,8404
"4956","KISUMU","30-34",20704,26392,47096
"4957","KISUMU","35",4669,4979,9648
"4958","KISUMU","36",3447,3123,6570
"4959","KISUMU","37",3751,3188,6939
"4960","KISUMU","38",2502,2148,4650
"4961","KISUMU","39",3127,2728,5855
"4962","KISUMU","35-39",17496,16166,33662
"4963","KISUMU","40",3800,3615,7415
"4964","KISUMU","41",3362,2993,6355
"4965","KISUMU","42",2975,2649,5624
"4966","KISUMU","43",2901,3222,6123
"4967","KISUMU","44",2268,2430,4698
"4968","KISUMU","40-44",15306,14909,30215
"4969","KISUMU","45",2924,3068,5992
"4970","KISUMU","46",2225,2164,4389
"4971","KISUMU","47",2336,2340,4676
"4972","KISUMU","48",1356,1452,2808
"4973","KISUMU","49",1516,1728,3244
"4974","KISUMU","45-49",10357,10752,21109
"4975","KISUMU","50",2061,2793,4854
"4976","KISUMU","51",1885,2582,4467
"4977","KISUMU","52",1399,1825,3224
"4978","KISUMU","53",1218,1550,2768
"4979","KISUMU","54",1363,1605,2968
"4980","KISUMU","50-54",7926,10355,18281
"4981","KISUMU","55",1538,1840,3378
"4982","KISUMU","56",1529,2241,3770
"4983","KISUMU","57",1729,2909,4638
"4984","KISUMU","58",1184,1556,2740
"4985","KISUMU","59",1460,2040,3500
"4986","KISUMU","55-59",7440,10586,18026
"4987","KISUMU","60",1864,2976,4840
"4988","KISUMU","61",1610,2106,3716
"4989","KISUMU","62",1235,1636,2871
"4990","KISUMU","63",1356,1790,3146
"4991","KISUMU","64",1053,1337,2390
"4992","KISUMU","60-64",7118,9845,16963
"4993","KISUMU","65",1512,2105,3617
"4994","KISUMU","66",1023,1473,2496
"4995","KISUMU","67",1577,2189,3766
"4996","KISUMU","68",597,781,1378
"4997","KISUMU","69",1119,1236,2355
"4998","KISUMU","65-69",5828,7784,13612
"4999","KISUMU","70",1473,2217,3690
"5000","KISUMU","71",1111,1162,2273
"5001","KISUMU","72",852,934,1786
"5002","KISUMU","73",689,763,1452
"5003","KISUMU","74",655,933,1588
"5004","KISUMU","70-74",4780,6009,10789
"5005","KISUMU","75",551,809,1360
"5006","KISUMU","76",476,739,1215
"5007","KISUMU","77",539,852,1391
"5008","KISUMU","78",276,383,659
"5009","KISUMU","79",366,739,1105
"5010","KISUMU","75-79",2208,3522,5730
"5011","KISUMU","80",473,897,1370
"5012","KISUMU","81",327,495,822
"5013","KISUMU","82",266,321,587
"5014","KISUMU","83",325,384,709
"5015","KISUMU","84",271,374,645
"5016","KISUMU","80-84",1662,2471,4133
"5017","KISUMU","85",200,355,555
"5018","KISUMU","86",163,192,355
"5019","KISUMU","87",212,355,567
"5020","KISUMU","88",78,151,229
"5021","KISUMU","89",121,347,468
"5022","KISUMU","85-89",774,1400,2174
"5023","KISUMU","90",75,204,279
"5024","KISUMU","91",64,123,187
"5025","KISUMU","92",57,72,129
"5026","KISUMU","93",41,61,102
"5027","KISUMU","94",29,47,76
"5028","KISUMU","90-94",266,507,773
"5029","KISUMU","95",34,63,97
"5030","KISUMU","96",17,43,60
"5031","KISUMU","97",17,32,49
"5032","KISUMU","98",15,32,47
"5033","KISUMU","99",20,52,72
"5034","KISUMU","95-99",103,222,325
"5035","KISUMU","100+",38,86,124
"5036","HOMA BAY","Total",485991,532861,1018852
"5037","HOMA BAY","0",12506,12503,25009
"5038","HOMA BAY","1",13379,12990,26369
"5039","HOMA BAY","2",13964,13881,27845
"5040","HOMA BAY","3",14997,15230,30227
"5041","HOMA BAY","4",15274,15184,30458
"5042","HOMA BAY","0 - 4",70120,69788,139908
"5043","HOMA BAY","5",15585,15201,30786
"5044","HOMA BAY","6",15319,15789,31108
"5045","HOMA BAY","7",14837,15032,29869
"5046","HOMA BAY","8",14362,14319,28681
"5047","HOMA BAY","9",16147,16197,32344
"5048","HOMA BAY","5-9",76250,76538,152788
"5049","HOMA BAY","10",17686,17151,34837
"5050","HOMA BAY","11",15595,15627,31222
"5051","HOMA BAY","12",18227,17524,35751
"5052","HOMA BAY","13",17187,17066,34253
"5053","HOMA BAY","14",15627,15261,30888
"5054","HOMA BAY","10-14",84322,82629,166951
"5055","HOMA BAY","15",15414,15125,30539
"5056","HOMA BAY","16",13609,13285,26894
"5057","HOMA BAY","17",13241,12259,25500
"5058","HOMA BAY","18",10459,9679,20138
"5059","HOMA BAY","19",10782,10917,21699
"5060","HOMA BAY","15-19",63505,61265,124770
"5061","HOMA BAY","20",9386,10683,20069
"5062","HOMA BAY","21",7931,9029,16960
"5063","HOMA BAY","22",6928,8558,15486
"5064","HOMA BAY","23",7363,8996,16359
"5065","HOMA BAY","24",6445,7584,14029
"5066","HOMA BAY","20-24",38053,44850,82903
"5067","HOMA BAY","25",7543,8765,16308
"5068","HOMA BAY","26",5622,7372,12994
"5069","HOMA BAY","27",6032,7989,14021
"5070","HOMA BAY","28",4133,5681,9814
"5071","HOMA BAY","29",4223,5961,10184
"5072","HOMA BAY","25-29",27553,35768,63321
"5073","HOMA BAY","30",6472,9640,16112
"5074","HOMA BAY","31",4565,6445,11010
"5075","HOMA BAY","32",5631,8186,13817
"5076","HOMA BAY","33",5044,7117,12161
"5077","HOMA BAY","34",4670,5785,10455
"5078","HOMA BAY","30-34",26382,37173,63555
"5079","HOMA BAY","35",6067,6756,12823
"5080","HOMA BAY","36",4425,4336,8761
"5081","HOMA BAY","37",4538,4076,8614
"5082","HOMA BAY","38",3023,2698,5721
"5083","HOMA BAY","39",3808,3547,7355
"5084","HOMA BAY","35-39",21861,21413,43274
"5085","HOMA BAY","40",4719,5032,9751
"5086","HOMA BAY","41",4116,4065,8181
"5087","HOMA BAY","42",3674,3968,7642
"5088","HOMA BAY","43",3524,4005,7529
"5089","HOMA BAY","44",2762,3287,6049
"5090","HOMA BAY","40-44",18795,20357,39152
"5091","HOMA BAY","45",3788,4747,8535
"5092","HOMA BAY","46",2695,3354,6049
"5093","HOMA BAY","47",2842,3851,6693
"5094","HOMA BAY","48",1625,2009,3634
"5095","HOMA BAY","49",1878,2389,4267
"5096","HOMA BAY","45-49",12828,16350,29178
"5097","HOMA BAY","50",2484,3672,6156
"5098","HOMA BAY","51",1951,2659,4610
"5099","HOMA BAY","52",1617,2144,3761
"5100","HOMA BAY","53",1431,1814,3245
"5101","HOMA BAY","54",1780,2052,3832
"5102","HOMA BAY","50-54",9263,12341,21604
"5103","HOMA BAY","55",2110,2465,4575
"5104","HOMA BAY","56",2110,3247,5357
"5105","HOMA BAY","57",2123,3634,5757
"5106","HOMA BAY","58",1263,1805,3068
"5107","HOMA BAY","59",1742,2488,4230
"5108","HOMA BAY","55-59",9348,13639,22987
"5109","HOMA BAY","60",2250,3597,5847
"5110","HOMA BAY","61",1994,2723,4717
"5111","HOMA BAY","62",1516,1942,3458
"5112","HOMA BAY","63",1566,2097,3663
"5113","HOMA BAY","64",1302,1739,3041
"5114","HOMA BAY","60-64",8628,12098,20726
"5115","HOMA BAY","65",1768,2550,4318
"5116","HOMA BAY","66",1202,1672,2874
"5117","HOMA BAY","67",1904,2778,4682
"5118","HOMA BAY","68",751,1011,1762
"5119","HOMA BAY","69",1252,1803,3055
"5120","HOMA BAY","65-69",6877,9814,16691
"5121","HOMA BAY","70",1790,3094,4884
"5122","HOMA BAY","71",1271,1514,2785
"5123","HOMA BAY","72",1008,1227,2235
"5124","HOMA BAY","73",803,1020,1823
"5125","HOMA BAY","74",771,1218,1989
"5126","HOMA BAY","70-74",5643,8073,13716
"5127","HOMA BAY","75",668,1087,1755
"5128","HOMA BAY","76",486,727,1213
"5129","HOMA BAY","77",757,1091,1848
"5130","HOMA BAY","78",331,523,854
"5131","HOMA BAY","79",474,1049,1523
"5132","HOMA BAY","75-79",2716,4477,7193
"5133","HOMA BAY","80",574,1223,1797
"5134","HOMA BAY","81",418,670,1088
"5135","HOMA BAY","82",343,396,739
"5136","HOMA BAY","83",413,518,931
"5137","HOMA BAY","84",305,550,855
"5138","HOMA BAY","80-84",2053,3357,5410
"5139","HOMA BAY","85",258,455,713
"5140","HOMA BAY","86",239,323,562
"5141","HOMA BAY","87",295,451,746
"5142","HOMA BAY","88",114,179,293
"5143","HOMA BAY","89",227,497,724
"5144","HOMA BAY","85-89",1133,1905,3038
"5145","HOMA BAY","90",142,273,415
"5146","HOMA BAY","91",109,129,238
"5147","HOMA BAY","92",65,74,139
"5148","HOMA BAY","93",47,79,126
"5149","HOMA BAY","94",45,65,110
"5150","HOMA BAY","90-94",408,620,1028
"5151","HOMA BAY","95",49,80,129
"5152","HOMA BAY","96",36,52,88
"5153","HOMA BAY","97",41,46,87
"5154","HOMA BAY","98",22,37,59
"5155","HOMA BAY","99",32,71,103
"5156","HOMA BAY","95-99",180,286,466
"5157","HOMA BAY","100+",71,114,185
"5158","MIGORI","Total",455887,493318,949205
"5159","MIGORI","0",12382,12636,25018
"5160","MIGORI","1",13343,13446,26789
"5161","MIGORI","2",13417,13901,27318
"5162","MIGORI","3",14681,14803,29484
"5163","MIGORI","4",14828,14804,29632
"5164","MIGORI","0 - 4",68651,69590,138241
"5165","MIGORI","5",15274,15340,30614
"5166","MIGORI","6",15367,15525,30892
"5167","MIGORI","7",14255,14185,28440
"5168","MIGORI","8",14272,14646,28918
"5169","MIGORI","9",15518,15353,30871
"5170","MIGORI","5-9",74686,75049,149735
"5171","MIGORI","10",16930,17070,34000
"5172","MIGORI","11",14626,15170,29796
"5173","MIGORI","12",16963,16310,33273
"5174","MIGORI","13",15756,15761,31517
"5175","MIGORI","14",14491,13977,28468
"5176","MIGORI","10-14",78766,78288,157054
"5177","MIGORI","15",14118,13851,27969
"5178","MIGORI","16",12231,12076,24307
"5179","MIGORI","17",11566,11185,22751
"5180","MIGORI","18",9589,9448,19037
"5181","MIGORI","19",10641,11049,21690
"5182","MIGORI","15-19",58145,57609,115754
"5183","MIGORI","20",9290,11041,20331
"5184","MIGORI","21",7429,8931,16360
"5185","MIGORI","22",6786,8545,15331
"5186","MIGORI","23",7217,8688,15905
"5187","MIGORI","24",6461,7603,14064
"5188","MIGORI","20-24",37183,44808,81991
"5189","MIGORI","25",7714,8806,16520
"5190","MIGORI","26",5820,7262,13082
"5191","MIGORI","27",6127,7452,13579
"5192","MIGORI","28",4389,5669,10058
"5193","MIGORI","29",4309,5563,9872
"5194","MIGORI","25-29",28359,34752,63111
"5195","MIGORI","30",6522,8537,15059
"5196","MIGORI","31",4605,6033,10638
"5197","MIGORI","32",5363,7000,12363
"5198","MIGORI","33",4760,6166,10926
"5199","MIGORI","34",4366,5061,9427
"5200","MIGORI","30-34",25616,32797,58413
"5201","MIGORI","35",5888,6126,12014
"5202","MIGORI","36",4048,3672,7720
"5203","MIGORI","37",3937,3534,7471
"5204","MIGORI","38",2546,2471,5017
"5205","MIGORI","39",3157,2793,5950
"5206","MIGORI","35-39",19576,18596,38172
"5207","MIGORI","40",4108,4323,8431
"5208","MIGORI","41",3534,3602,7136
"5209","MIGORI","42",3228,3585,6813
"5210","MIGORI","43",3015,3276,6291
"5211","MIGORI","44",2337,2524,4861
"5212","MIGORI","40-44",16222,17310,33532
"5213","MIGORI","45",3641,3964,7605
"5214","MIGORI","46",2602,2968,5570
"5215","MIGORI","47",2904,3511,6415
"5216","MIGORI","48",1489,1906,3395
"5217","MIGORI","49",1868,2186,4054
"5218","MIGORI","45-49",12504,14535,27039
"5219","MIGORI","50",2411,3263,5674
"5220","MIGORI","51",1799,2268,4067
"5221","MIGORI","52",1391,1808,3199
"5222","MIGORI","53",1255,1472,2727
"5223","MIGORI","54",1534,1783,3317
"5224","MIGORI","50-54",8390,10594,18984
"5225","MIGORI","55",1642,2141,3783
"5226","MIGORI","56",1742,2315,4057
"5227","MIGORI","57",1675,2789,4464
"5228","MIGORI","58",1128,1422,2550
"5229","MIGORI","59",1296,1886,3182
"5230","MIGORI","55-59",7483,10553,18036
"5231","MIGORI","60",1911,2756,4667
"5232","MIGORI","61",1518,2029,3547
"5233","MIGORI","62",1119,1354,2473
"5234","MIGORI","63",1256,1456,2712
"5235","MIGORI","64",894,1247,2141
"5236","MIGORI","60-64",6698,8842,15540
"5237","MIGORI","65",1250,1840,3090
"5238","MIGORI","66",888,1152,2040
"5239","MIGORI","67",1303,1949,3252
"5240","MIGORI","68",552,720,1272
"5241","MIGORI","69",913,1325,2238
"5242","MIGORI","65-69",4906,6986,11892
"5243","MIGORI","70",1219,1950,3169
"5244","MIGORI","71",829,1067,1896
"5245","MIGORI","72",698,783,1481
"5246","MIGORI","73",529,654,1183
"5247","MIGORI","74",544,811,1355
"5248","MIGORI","70-74",3819,5265,9084
"5249","MIGORI","75",495,745,1240
"5250","MIGORI","76",401,586,987
"5251","MIGORI","77",553,806,1359
"5252","MIGORI","78",263,352,615
"5253","MIGORI","79",359,742,1101
"5254","MIGORI","75-79",2071,3231,5302
"5255","MIGORI","80",412,840,1252
"5256","MIGORI","81",309,451,760
"5257","MIGORI","82",281,337,618
"5258","MIGORI","83",257,338,595
"5259","MIGORI","84",218,374,592
"5260","MIGORI","80-84",1477,2340,3817
"5261","MIGORI","85",201,322,523
"5262","MIGORI","86",158,186,344
"5263","MIGORI","87",243,338,581
"5264","MIGORI","88",85,153,238
"5265","MIGORI","89",153,356,509
"5266","MIGORI","85-89",840,1355,2195
"5267","MIGORI","90",107,189,296
"5268","MIGORI","91",75,104,179
"5269","MIGORI","92",47,52,99
"5270","MIGORI","93",34,53,87
"5271","MIGORI","94",29,64,93
"5272","MIGORI","90-94",292,462,754
"5273","MIGORI","95",54,94,148
"5274","MIGORI","96",28,35,63
"5275","MIGORI","97",17,36,53
"5276","MIGORI","98",11,24,35
"5277","MIGORI","99",21,48,69
"5278","MIGORI","95-99",131,237,368
"5279","MIGORI","100+",67,107,174
"5280","MIGORI","Not Stated",5,12,17
"5281","KISII","Total",531860,583560,1115420
"5282","KISII","0",11522,11642,23164
"5283","KISII","1",11809,11607,23416
"5284","KISII","2",12204,12158,24362
"5285","KISII","3",13312,13504,26816
"5286","KISII","4",14058,13984,28042
"5287","KISII","0 - 4",62905,62895,125800
"5288","KISII","5",14197,14245,28442
"5289","KISII","6",15309,15421,30730
"5290","KISII","7",15978,15594,31572
"5291","KISII","8",15188,15288,30476
"5292","KISII","9",17168,16964,34132
"5293","KISII","5-9",77840,77512,155352
"5294","KISII","10",18950,18542,37492
"5295","KISII","11",16120,16773,32893
"5296","KISII","12",19684,18450,38134
"5297","KISII","13",18283,18334,36617
"5298","KISII","14",16611,16319,32930
"5299","KISII","10-14",89648,88418,178066
"5300","KISII","15",15888,15767,31655
"5301","KISII","16",14318,14097,28415
"5302","KISII","17",14464,13907,28371
"5303","KISII","18",11605,11229,22834
"5304","KISII","19",11755,11776,23531
"5305","KISII","15-19",68030,66776,134806
"5306","KISII","20",9458,10778,20236
"5307","KISII","21",7444,9047,16491
"5308","KISII","22",7172,8773,15945
"5309","KISII","23",6993,9293,16286
"5310","KISII","24",6310,8480,14790
"5311","KISII","20-24",37377,46371,83748
"5312","KISII","25",7664,10396,18060
"5313","KISII","26",6137,8391,14528
"5314","KISII","27",6563,8661,15224
"5315","KISII","28",5160,6969,12129
"5316","KISII","29",5470,7730,13200
"5317","KISII","25-29",30994,42147,73141
"5318","KISII","30",7553,11217,18770
"5319","KISII","31",6122,8713,14835
"5320","KISII","32",7136,10233,17369
"5321","KISII","33",5989,9166,15155
"5322","KISII","34",5228,7548,12776
"5323","KISII","30-34",32028,46877,78905
"5324","KISII","35",7082,8301,15383
"5325","KISII","36",4746,4647,9393
"5326","KISII","37",5078,4826,9904
"5327","KISII","38",3589,3595,7184
"5328","KISII","39",4529,4760,9289
"5329","KISII","35-39",25024,26129,51153
"5330","KISII","40",5444,5647,11091
"5331","KISII","41",5936,5560,11496
"5332","KISII","42",4394,4365,8759
"5333","KISII","43",4208,4489,8697
"5334","KISII","44",3025,3604,6629
"5335","KISII","40-44",23007,23665,46672
"5336","KISII","45",5661,6706,12367
"5337","KISII","46",3757,5023,8780
"5338","KISII","47",4132,5617,9749
"5339","KISII","48",2371,2881,5252
"5340","KISII","49",2836,3899,6735
"5341","KISII","45-49",18757,24126,42883
"5342","KISII","50",3681,4407,8088
"5343","KISII","51",3159,3161,6320
"5344","KISII","52",2249,2062,4311
"5345","KISII","53",1784,1599,3383
"5346","KISII","54",2270,1947,4217
"5347","KISII","50-54",13143,13176,26319
"5348","KISII","55",3017,2751,5768
"5349","KISII","56",3438,3575,7013
"5350","KISII","57",3775,5120,8895
"5351","KISII","58",2559,3045,5604
"5352","KISII","59",3621,4571,8192
"5353","KISII","55-59",16410,19062,35472
"5354","KISII","60",3598,4910,8508
"5355","KISII","61",3195,3618,6813
"5356","KISII","62",2234,2508,4742
"5357","KISII","63",2383,2658,5041
"5358","KISII","64",1701,1950,3651
"5359","KISII","60-64",13111,15644,28755
"5360","KISII","65",2519,3307,5826
"5361","KISII","66",1458,1525,2983
"5362","KISII","67",2289,2590,4879
"5363","KISII","68",984,1307,2291
"5364","KISII","69",1834,2418,4252
"5365","KISII","65-69",9084,11147,20231
"5366","KISII","70",1911,3214,5125
"5367","KISII","71",1594,1617,3211
"5368","KISII","72",1179,1099,2278
"5369","KISII","73",939,915,1854
"5370","KISII","74",975,1298,2273
"5371","KISII","70-74",6598,8143,14741
"5372","KISII","75",811,1130,1941
"5373","KISII","76",530,594,1124
"5374","KISII","77",824,853,1677
"5375","KISII","78",450,451,901
"5376","KISII","79",639,1208,1847
"5377","KISII","75-79",3254,4236,7490
"5378","KISII","80",709,1332,2041
"5379","KISII","81",467,680,1147
"5380","KISII","82",374,399,773
"5381","KISII","83",412,457,869
"5382","KISII","84",391,636,1027
"5383","KISII","80-84",2353,3504,5857
"5384","KISII","85",321,529,850
"5385","KISII","86",246,260,506
"5386","KISII","87",351,395,746
"5387","KISII","88",180,214,394
"5388","KISII","89",318,698,1016
"5389","KISII","85-89",1416,2096,3512
"5390","KISII","90",159,373,532
"5391","KISII","91",111,169,280
"5392","KISII","92",112,119,231
"5393","KISII","93",47,97,144
"5394","KISII","94",85,141,226
"5395","KISII","90-94",514,899,1413
"5396","KISII","95",89,143,232
"5397","KISII","96",41,61,102
"5398","KISII","97",57,81,138
"5399","KISII","98",27,61,88
"5400","KISII","99",49,112,161
"5401","KISII","95-99",263,458,721
"5402","KISII","100+",89,274,363
"5403","KISII","Not Stated",15,5,20
"5404","NYAMIRA","Total",268241,290286,558527
"5405","NYAMIRA","0",5200,5365,10565
"5406","NYAMIRA","1",5549,5568,11117
"5407","NYAMIRA","2",5848,5804,11652
"5408","NYAMIRA","3",6283,6340,12623
"5409","NYAMIRA","4",6727,6539,13266
"5410","NYAMIRA","0-4",29607,29616,59223
"5411","NYAMIRA","5",6800,6744,13544
"5412","NYAMIRA","6",7160,7203,14363
"5413","NYAMIRA","7",7477,7250,14727
"5414","NYAMIRA","8",7181,7106,14287
"5415","NYAMIRA","9",8291,8149,16440
"5416","NYAMIRA","5-9",36909,36452,73361
"5417","NYAMIRA","10",9234,8964,18198
"5418","NYAMIRA","11",7857,8127,15984
"5419","NYAMIRA","12",9841,9253,19094
"5420","NYAMIRA","13",8948,8941,17889
"5421","NYAMIRA","14",8340,7916,16256
"5422","NYAMIRA","10-14",44220,43201,87421
"5423","NYAMIRA","15",7877,7734,15611
"5424","NYAMIRA","16",7164,6990,14154
"5425","NYAMIRA","17",6852,6924,13776
"5426","NYAMIRA","18",5400,5233,10633
"5427","NYAMIRA","19",5588,5414,11002
"5428","NYAMIRA","15-19",32881,32295,65176
"5429","NYAMIRA","20",4470,4912,9382
"5430","NYAMIRA","21",3586,4230,7816
"5431","NYAMIRA","22",3396,4135,7531
"5432","NYAMIRA","23",3343,4359,7702
"5433","NYAMIRA","24",3186,4168,7354
"5434","NYAMIRA","20-24",17981,21804,39785
"5435","NYAMIRA","25",4039,5151,9190
"5436","NYAMIRA","26",2875,4172,7047
"5437","NYAMIRA","27",3255,4506,7761
"5438","NYAMIRA","28",2672,3629,6301
"5439","NYAMIRA","29",2764,4092,6856
"5440","NYAMIRA","25-29",15605,21550,37155
"5441","NYAMIRA","30",4129,6196,10325
"5442","NYAMIRA","31",3032,4823,7855
"5443","NYAMIRA","32",3534,5397,8931
"5444","NYAMIRA","33",3024,4441,7465
"5445","NYAMIRA","34",2818,3909,6727
"5446","NYAMIRA","30-34",16537,24766,41303
"5447","NYAMIRA","35",4027,4618,8645
"5448","NYAMIRA","36",2573,2519,5092
"5449","NYAMIRA","37",2648,2542,5190
"5450","NYAMIRA","38",2039,2066,4105
"5451","NYAMIRA","39",2465,2391,4856
"5452","NYAMIRA","35-39",13752,14136,27888
"5453","NYAMIRA","40",3088,3355,6443
"5454","NYAMIRA","41",3337,3195,6532
"5455","NYAMIRA","42",2369,2530,4899
"5456","NYAMIRA","43",2311,2551,4862
"5457","NYAMIRA","44",1779,2003,3782
"5458","NYAMIRA","40-44",12884,13634,26518
"5459","NYAMIRA","45",3219,3527,6746
"5460","NYAMIRA","46",2047,2493,4540
"5461","NYAMIRA","47",2249,2607,4856
"5462","NYAMIRA","48",1410,1532,2942
"5463","NYAMIRA","49",1669,2047,3716
"5464","NYAMIRA","45-49",10594,12206,22800
"5465","NYAMIRA","50",2176,2469,4645
"5466","NYAMIRA","51",1734,1655,3389
"5467","NYAMIRA","52",1253,1152,2405
"5468","NYAMIRA","53",1118,903,2021
"5469","NYAMIRA","54",1318,1089,2407
"5470","NYAMIRA","50-54",7599,7268,14867
"5471","NYAMIRA","55",1642,1449,3091
"5472","NYAMIRA","56",1894,1945,3839
"5473","NYAMIRA","57",2169,2545,4714
"5474","NYAMIRA","58",1398,1536,2934
"5475","NYAMIRA","59",2101,2179,4280
"5476","NYAMIRA","55-59",9204,9654,18858
"5477","NYAMIRA","60",2282,2508,4790
"5478","NYAMIRA","61",1774,1807,3581
"5479","NYAMIRA","62",1195,1138,2333
"5480","NYAMIRA","63",1286,1377,2663
"5481","NYAMIRA","64",842,934,1776
"5482","NYAMIRA","60-64",7379,7764,15143
"5483","NYAMIRA","65",1366,1674,3040
"5484","NYAMIRA","66",691,710,1401
"5485","NYAMIRA","67",1238,1228,2466
"5486","NYAMIRA","68",564,631,1195
"5487","NYAMIRA","69",978,1279,2257
"5488","NYAMIRA","65-69",4837,5522,10359
"5489","NYAMIRA","70",1214,1766,2980
"5490","NYAMIRA","71",948,956,1904
"5491","NYAMIRA","72",600,577,1177
"5492","NYAMIRA","73",536,471,1007
"5493","NYAMIRA","74",529,653,1182
"5494","NYAMIRA","70-74",3827,4423,8250
"5495","NYAMIRA","75",478,617,1095
"5496","NYAMIRA","76",283,285,568
"5497","NYAMIRA","77",441,452,893
"5498","NYAMIRA","78",266,248,514
"5499","NYAMIRA","79",375,653,1028
"5500","NYAMIRA","75-79",1843,2255,4098
"5501","NYAMIRA","80",398,762,1160
"5502","NYAMIRA","81",277,355,632
"5503","NYAMIRA","82",194,164,358
"5504","NYAMIRA","83",237,228,465
"5505","NYAMIRA","84",226,328,554
"5506","NYAMIRA","80-84",1332,1837,3169
"5507","NYAMIRA","85",189,299,488
"5508","NYAMIRA","86",124,140,264
"5509","NYAMIRA","87",175,198,373
"5510","NYAMIRA","88",109,67,176
"5511","NYAMIRA","89",152,377,529
"5512","NYAMIRA","85-89",749,1081,1830
"5513","NYAMIRA","90",98,224,322
"5514","NYAMIRA","91",67,88,155
"5515","NYAMIRA","92",47,51,98
"5516","NYAMIRA","93",34,43,77
"5517","NYAMIRA","94",42,58,100
"5518","NYAMIRA","90-94",288,464,752
"5519","NYAMIRA","95",66,86,152
"5520","NYAMIRA","96",13,29,42
"5521","NYAMIRA","97",28,22,50
"5522","NYAMIRA","98",24,26,50
"5523","NYAMIRA","99",29,72,101
"5524","NYAMIRA","95-99",160,235,395
"5525","NYAMIRA","100+",52,121,173
"5526","NYAMIRA","Not Stated",1,2,3
