"","County","SubCounty","Age","Male","Female","Total"
"1","BARINGO","ALL","Total",336322,330428,666750
"2","BARINGO","ALL","0",8303,7982,16285
"3","BARINGO","ALL","1",8669,8417,17086
"4","BARINGO","ALL","2",10226,9762,19988
"5","BARINGO","ALL","3",10265,10086,20351
"6","BARINGO","ALL","4",11045,10276,21321
"7","BARINGO","ALL","0 - 4",48508,46523,95031
"8","BARINGO","ALL","5",10701,10047,20748
"9","BARINGO","ALL","6",10949,10422,21371
"10","BARINGO","ALL","7",9595,9082,18677
"11","BARINGO","ALL","8",10276,10027,20303
"12","BARINGO","ALL","9",9355,9101,18456
"13","BARINGO","ALL","5-9",50876,48679,99555
"14","BARINGO","ALL","10",12772,11975,24747
"15","BARINGO","ALL","11",8102,8365,16467
"16","BARINGO","ALL","12",11844,10549,22393
"17","BARINGO","ALL","13",9747,9167,18914
"18","BARINGO","ALL","14",9920,9151,19071
"19","BARINGO","ALL","10 -14",52385,49207,101592
"20","BARINGO","ALL","15",10511,9330,19841
"21","BARINGO","ALL","16",8720,8131,16851
"22","BARINGO","ALL","17",8494,7641,16135
"23","BARINGO","ALL","18",7287,6686,13973
"24","BARINGO","ALL","19",7312,6836,14148
"25","BARINGO","ALL","15-19",42324,38624,80948
"26","BARINGO","ALL","20",7833,7737,15570
"27","BARINGO","ALL","21",5933,6111,12044
"28","BARINGO","ALL","22",5679,5987,11666
"29","BARINGO","ALL","23",5840,6017,11857
"30","BARINGO","ALL","24",5303,5405,10708
"31","BARINGO","ALL","20-24",30588,31257,61845
"32","BARINGO","ALL","25",6470,6583,13053
"33","BARINGO","ALL","26",4296,4652,8948
"34","BARINGO","ALL","27",4417,4584,9001
"35","BARINGO","ALL","28",3754,4292,8046
"36","BARINGO","ALL","29",3956,4254,8210
"37","BARINGO","ALL","25-29",22893,24365,47258
"38","BARINGO","ALL","30",6117,6540,12657
"39","BARINGO","ALL","31",3290,3428,6718
"40","BARINGO","ALL","32",3900,4109,8009
"41","BARINGO","ALL","33",3299,3485,6784
"42","BARINGO","ALL","34",2773,2899,5672
"43","BARINGO","ALL","30-34",19379,20461,39840
"44","BARINGO","ALL","35",5022,5023,10045
"45","BARINGO","ALL","36",2612,2449,5061
"46","BARINGO","ALL","37",2697,2318,5015
"47","BARINGO","ALL","38",1984,2084,4068
"48","BARINGO","ALL","39",2335,2201,4536
"49","BARINGO","ALL","35-39",14650,14075,28725
"50","BARINGO","ALL","40",3863,3488,7351
"51","BARINGO","ALL","41",2944,2634,5578
"52","BARINGO","ALL","42",2351,2237,4588
"53","BARINGO","ALL","43",1895,2086,3981
"54","BARINGO","ALL","44",1440,1583,3023
"55","BARINGO","ALL","40-44",12493,12028,24521
"56","BARINGO","ALL","45",3764,3602,7366
"57","BARINGO","ALL","46",1954,2078,4032
"58","BARINGO","ALL","47",2040,2073,4113
"59","BARINGO","ALL","48",1278,1289,2567
"60","BARINGO","ALL","49",1627,1785,3412
"61","BARINGO","ALL","45-49",10663,10827,21490
"62","BARINGO","ALL","50",2502,2745,5247
"63","BARINGO","ALL","51",1471,1457,2928
"64","BARINGO","ALL","52",1259,1371,2630
"65","BARINGO","ALL","53",1004,1067,2071
"66","BARINGO","ALL","54",1432,1517,2949
"67","BARINGO","ALL","50-54",7668,8157,15825
"68","BARINGO","ALL","55",1305,1107,2412
"69","BARINGO","ALL","56",1163,1176,2339
"70","BARINGO","ALL","57",1170,1492,2662
"71","BARINGO","ALL","58",1395,1537,2932
"72","BARINGO","ALL","59",1406,1390,2796
"73","BARINGO","ALL","55-59",6439,6702,13141
"74","BARINGO","ALL","60",1946,2061,4007
"75","BARINGO","ALL","61",1213,1064,2277
"76","BARINGO","ALL","62",868,875,1743
"77","BARINGO","ALL","63",944,948,1892
"78","BARINGO","ALL","64",642,670,1312
"79","BARINGO","ALL","60-64",5613,5618,11231
"80","BARINGO","ALL","65",1223,1405,2628
"81","BARINGO","ALL","66",560,557,1117
"82","BARINGO","ALL","67",1069,976,2045
"83","BARINGO","ALL","68",574,565,1139
"84","BARINGO","ALL","69",943,1026,1969
"85","BARINGO","ALL","65-69",4369,4529,8898
"86","BARINGO","ALL","70",1267,1525,2792
"87","BARINGO","ALL","71",874,776,1650
"88","BARINGO","ALL","72",593,566,1159
"89","BARINGO","ALL","73",409,486,895
"90","BARINGO","ALL","74",477,529,1006
"91","BARINGO","ALL","70-74",3620,3882,7502
"92","BARINGO","ALL","75",493,543,1036
"93","BARINGO","ALL","76",306,310,616
"94","BARINGO","ALL","77",318,354,672
"95","BARINGO","ALL","78",212,224,436
"96","BARINGO","ALL","79",350,591,941
"97","BARINGO","ALL","75-79",1679,2022,3701
"98","BARINGO","ALL","80",458,681,1139
"99","BARINGO","ALL","81",167,345,512
"100","BARINGO","ALL","82",137,167,304
"101","BARINGO","ALL","83",169,258,427
"102","BARINGO","ALL","84",185,277,462
"103","BARINGO","ALL","80-84",1116,1728,2844
"104","BARINGO","ALL","85",137,239,376
"105","BARINGO","ALL","86",102,134,236
"106","BARINGO","ALL","87",123,137,260
"107","BARINGO","ALL","88",51,71,122
"108","BARINGO","ALL","89",185,318,503
"109","BARINGO","ALL","85-89",598,899,1497
"110","BARINGO","ALL","90",85,186,271
"111","BARINGO","ALL","91",58,80,138
"112","BARINGO","ALL","92",39,57,96
"113","BARINGO","ALL","93",38,55,93
"114","BARINGO","ALL","94",33,62,95
"115","BARINGO","ALL","90-94",253,440,693
"116","BARINGO","ALL","95",55,116,171
"117","BARINGO","ALL","96",22,31,53
"118","BARINGO","ALL","97",27,34,61
"119","BARINGO","ALL","98",8,29,37
"120","BARINGO","ALL","99",29,68,97
"121","BARINGO","ALL","95-99",141,278,419
"122","BARINGO","ALL","100+",66,126,192
"123","BARINGO","ALL","Not Stated",1,1,2
"124","BARINGO","BARINGO CENTRAL","Total",48120,48829,96949
"125","BARINGO","BARINGO CENTRAL","0",1110,1071,2181
"126","BARINGO","BARINGO CENTRAL","1",1189,1160,2349
"127","BARINGO","BARINGO CENTRAL","2",1293,1222,2515
"128","BARINGO","BARINGO CENTRAL","3",1367,1353,2720
"129","BARINGO","BARINGO CENTRAL","4",1344,1247,2591
"130","BARINGO","BARINGO CENTRAL","0 - 4",6303,6053,12356
"131","BARINGO","BARINGO CENTRAL","5",1297,1235,2532
"132","BARINGO","BARINGO CENTRAL","6",1250,1282,2532
"133","BARINGO","BARINGO CENTRAL","7",1232,1251,2483
"134","BARINGO","BARINGO CENTRAL","8",1098,1193,2291
"135","BARINGO","BARINGO CENTRAL","9",1266,1297,2563
"136","BARINGO","BARINGO CENTRAL","5-9",6143,6258,12401
"137","BARINGO","BARINGO CENTRAL","10",1450,1378,2828
"138","BARINGO","BARINGO CENTRAL","11",1149,1259,2408
"139","BARINGO","BARINGO CENTRAL","12",1387,1357,2744
"140","BARINGO","BARINGO CENTRAL","13",1429,1368,2797
"141","BARINGO","BARINGO CENTRAL","14",1300,1382,2682
"142","BARINGO","BARINGO CENTRAL","10 -14",6715,6744,13459
"143","BARINGO","BARINGO CENTRAL","15",1424,1377,2801
"144","BARINGO","BARINGO CENTRAL","16",1181,1195,2376
"145","BARINGO","BARINGO CENTRAL","17",1255,1275,2530
"146","BARINGO","BARINGO CENTRAL","18",949,905,1854
"147","BARINGO","BARINGO CENTRAL","19",1133,1097,2230
"148","BARINGO","BARINGO CENTRAL","15-19",5942,5849,11791
"149","BARINGO","BARINGO CENTRAL","20",974,994,1968
"150","BARINGO","BARINGO CENTRAL","21",927,970,1897
"151","BARINGO","BARINGO CENTRAL","22",827,871,1698
"152","BARINGO","BARINGO CENTRAL","23",947,986,1933
"153","BARINGO","BARINGO CENTRAL","24",858,879,1737
"154","BARINGO","BARINGO CENTRAL","20-24",4533,4700,9233
"155","BARINGO","BARINGO CENTRAL","25",956,928,1884
"156","BARINGO","BARINGO CENTRAL","26",708,736,1444
"157","BARINGO","BARINGO CENTRAL","27",755,733,1488
"158","BARINGO","BARINGO CENTRAL","28",596,689,1285
"159","BARINGO","BARINGO CENTRAL","29",651,664,1315
"160","BARINGO","BARINGO CENTRAL","25-29",3666,3750,7416
"161","BARINGO","BARINGO CENTRAL","30",829,852,1681
"162","BARINGO","BARINGO CENTRAL","31",572,513,1085
"163","BARINGO","BARINGO CENTRAL","32",655,712,1367
"164","BARINGO","BARINGO CENTRAL","33",566,581,1147
"165","BARINGO","BARINGO CENTRAL","34",468,537,1005
"166","BARINGO","BARINGO CENTRAL","30-34",3090,3195,6285
"167","BARINGO","BARINGO CENTRAL","35",767,701,1468
"168","BARINGO","BARINGO CENTRAL","36",445,401,846
"169","BARINGO","BARINGO CENTRAL","37",465,435,900
"170","BARINGO","BARINGO CENTRAL","38",345,330,675
"171","BARINGO","BARINGO CENTRAL","39",377,393,770
"172","BARINGO","BARINGO CENTRAL","35-39",2399,2260,4659
"173","BARINGO","BARINGO CENTRAL","40",533,470,1003
"174","BARINGO","BARINGO CENTRAL","41",508,475,983
"175","BARINGO","BARINGO CENTRAL","42",352,372,724
"176","BARINGO","BARINGO CENTRAL","43",329,393,722
"177","BARINGO","BARINGO CENTRAL","44",278,323,601
"178","BARINGO","BARINGO CENTRAL","40-44",2000,2033,4033
"179","BARINGO","BARINGO CENTRAL","45",583,596,1179
"180","BARINGO","BARINGO CENTRAL","46",325,334,659
"181","BARINGO","BARINGO CENTRAL","47",344,383,727
"182","BARINGO","BARINGO CENTRAL","48",197,208,405
"183","BARINGO","BARINGO CENTRAL","49",292,307,599
"184","BARINGO","BARINGO CENTRAL","45-49",1741,1828,3569
"185","BARINGO","BARINGO CENTRAL","50",295,381,676
"186","BARINGO","BARINGO CENTRAL","51",250,255,505
"187","BARINGO","BARINGO CENTRAL","52",219,218,437
"188","BARINGO","BARINGO CENTRAL","53",177,215,392
"189","BARINGO","BARINGO CENTRAL","54",259,308,567
"190","BARINGO","BARINGO CENTRAL","50-54",1200,1377,2577
"191","BARINGO","BARINGO CENTRAL","55",201,190,391
"192","BARINGO","BARINGO CENTRAL","56",174,192,366
"193","BARINGO","BARINGO CENTRAL","57",239,335,574
"194","BARINGO","BARINGO CENTRAL","58",267,322,589
"195","BARINGO","BARINGO CENTRAL","59",269,241,510
"196","BARINGO","BARINGO CENTRAL","55-59",1150,1280,2430
"197","BARINGO","BARINGO CENTRAL","60",306,299,605
"198","BARINGO","BARINGO CENTRAL","61",270,217,487
"199","BARINGO","BARINGO CENTRAL","62",187,175,362
"200","BARINGO","BARINGO CENTRAL","63",211,187,398
"201","BARINGO","BARINGO CENTRAL","64",156,114,270
"202","BARINGO","BARINGO CENTRAL","60-64",1130,992,2122
"203","BARINGO","BARINGO CENTRAL","65",217,250,467
"204","BARINGO","BARINGO CENTRAL","66",103,129,232
"205","BARINGO","BARINGO CENTRAL","67",175,187,362
"206","BARINGO","BARINGO CENTRAL","68",97,93,190
"207","BARINGO","BARINGO CENTRAL","69",169,175,344
"208","BARINGO","BARINGO CENTRAL","65-69",761,834,1595
"209","BARINGO","BARINGO CENTRAL","70",209,220,429
"210","BARINGO","BARINGO CENTRAL","71",184,149,333
"211","BARINGO","BARINGO CENTRAL","72",125,87,212
"212","BARINGO","BARINGO CENTRAL","73",94,91,185
"213","BARINGO","BARINGO CENTRAL","74",75,85,160
"214","BARINGO","BARINGO CENTRAL","70-74",687,632,1319
"215","BARINGO","BARINGO CENTRAL","75",90,104,194
"216","BARINGO","BARINGO CENTRAL","76",51,63,114
"217","BARINGO","BARINGO CENTRAL","77",54,61,115
"218","BARINGO","BARINGO CENTRAL","78",30,30,60
"219","BARINGO","BARINGO CENTRAL","79",50,90,140
"220","BARINGO","BARINGO CENTRAL","75-79",275,348,623
"221","BARINGO","BARINGO CENTRAL","80",66,106,172
"222","BARINGO","BARINGO CENTRAL","81",34,81,115
"223","BARINGO","BARINGO CENTRAL","82",20,32,52
"224","BARINGO","BARINGO CENTRAL","83",31,68,99
"225","BARINGO","BARINGO CENTRAL","84",24,56,80
"226","BARINGO","BARINGO CENTRAL","80-84",175,343,518
"227","BARINGO","BARINGO CENTRAL","85",26,57,83
"228","BARINGO","BARINGO CENTRAL","86",17,22,39
"229","BARINGO","BARINGO CENTRAL","87",20,26,46
"230","BARINGO","BARINGO CENTRAL","88",11,12,23
"231","BARINGO","BARINGO CENTRAL","89",37,52,89
"232","BARINGO","BARINGO CENTRAL","85-89",111,169,280
"233","BARINGO","BARINGO CENTRAL","90",20,32,52
"234","BARINGO","BARINGO CENTRAL","91",13,21,34
"235","BARINGO","BARINGO CENTRAL","92",9,15,24
"236","BARINGO","BARINGO CENTRAL","93",9,12,21
"237","BARINGO","BARINGO CENTRAL","94",5,13,18
"238","BARINGO","BARINGO CENTRAL","90-94",56,93,149
"239","BARINGO","BARINGO CENTRAL","95",14,34,48
"240","BARINGO","BARINGO CENTRAL","96",4,8,12
"241","BARINGO","BARINGO CENTRAL","97",6,6,12
"242","BARINGO","BARINGO CENTRAL","98",NA,5,5
"243","BARINGO","BARINGO CENTRAL","99",10,14,24
"244","BARINGO","BARINGO CENTRAL","95-99",34,67,101
"245","BARINGO","BARINGO CENTRAL","100+",9,23,32
"246","BARINGO","BARINGO CENTRAL","Not Stated",NA,1,1
"247","BARINGO","BARINGO NORTH","Total",52369,52500,104869
"248","BARINGO","BARINGO NORTH","0",1207,1243,2450
"249","BARINGO","BARINGO NORTH","1",1354,1296,2650
"250","BARINGO","BARINGO NORTH","2",1486,1408,2894
"251","BARINGO","BARINGO NORTH","3",1609,1568,3177
"252","BARINGO","BARINGO NORTH","4",1700,1555,3255
"253","BARINGO","BARINGO NORTH","0 - 4",7356,7070,14426
"254","BARINGO","BARINGO NORTH","5",1651,1543,3194
"255","BARINGO","BARINGO NORTH","6",1701,1554,3255
"256","BARINGO","BARINGO NORTH","7",1572,1435,3007
"257","BARINGO","BARINGO NORTH","8",1498,1372,2870
"258","BARINGO","BARINGO NORTH","9",1532,1488,3020
"259","BARINGO","BARINGO NORTH","5-9",7954,7392,15346
"260","BARINGO","BARINGO NORTH","10",1902,1732,3634
"261","BARINGO","BARINGO NORTH","11",1343,1426,2769
"262","BARINGO","BARINGO NORTH","12",1837,1676,3513
"263","BARINGO","BARINGO NORTH","13",1678,1631,3309
"264","BARINGO","BARINGO NORTH","14",1676,1544,3220
"265","BARINGO","BARINGO NORTH","10 -14",8436,8009,16445
"266","BARINGO","BARINGO NORTH","15",1577,1522,3099
"267","BARINGO","BARINGO NORTH","16",1333,1300,2633
"268","BARINGO","BARINGO NORTH","17",1300,1198,2498
"269","BARINGO","BARINGO NORTH","18",1081,1031,2112
"270","BARINGO","BARINGO NORTH","19",1084,970,2054
"271","BARINGO","BARINGO NORTH","15-19",6375,6021,12396
"272","BARINGO","BARINGO NORTH","20",1037,975,2012
"273","BARINGO","BARINGO NORTH","21",814,832,1646
"274","BARINGO","BARINGO NORTH","22",734,840,1574
"275","BARINGO","BARINGO NORTH","23",804,914,1718
"276","BARINGO","BARINGO NORTH","24",737,736,1473
"277","BARINGO","BARINGO NORTH","20-24",4126,4297,8423
"278","BARINGO","BARINGO NORTH","25",858,893,1751
"279","BARINGO","BARINGO NORTH","26",570,639,1209
"280","BARINGO","BARINGO NORTH","27",609,629,1238
"281","BARINGO","BARINGO NORTH","28",477,616,1093
"282","BARINGO","BARINGO NORTH","29",537,600,1137
"283","BARINGO","BARINGO NORTH","25-29",3051,3377,6428
"284","BARINGO","BARINGO NORTH","30",799,904,1703
"285","BARINGO","BARINGO NORTH","31",486,521,1007
"286","BARINGO","BARINGO NORTH","32",549,595,1144
"287","BARINGO","BARINGO NORTH","33",516,564,1080
"288","BARINGO","BARINGO NORTH","34",397,407,804
"289","BARINGO","BARINGO NORTH","30-34",2747,2991,5738
"290","BARINGO","BARINGO NORTH","35",753,763,1516
"291","BARINGO","BARINGO NORTH","36",401,338,739
"292","BARINGO","BARINGO NORTH","37",377,290,667
"293","BARINGO","BARINGO NORTH","38",296,308,604
"294","BARINGO","BARINGO NORTH","39",339,280,619
"295","BARINGO","BARINGO NORTH","35-39",2166,1979,4145
"296","BARINGO","BARINGO NORTH","40",505,472,977
"297","BARINGO","BARINGO NORTH","41",398,397,795
"298","BARINGO","BARINGO NORTH","42",318,333,651
"299","BARINGO","BARINGO NORTH","43",282,355,637
"300","BARINGO","BARINGO NORTH","44",197,234,431
"301","BARINGO","BARINGO NORTH","40-44",1700,1791,3491
"302","BARINGO","BARINGO NORTH","45",613,662,1275
"303","BARINGO","BARINGO NORTH","46",334,339,673
"304","BARINGO","BARINGO NORTH","47",397,359,756
"305","BARINGO","BARINGO NORTH","48",181,216,397
"306","BARINGO","BARINGO NORTH","49",260,357,617
"307","BARINGO","BARINGO NORTH","45-49",1785,1933,3718
"308","BARINGO","BARINGO NORTH","50",422,505,927
"309","BARINGO","BARINGO NORTH","51",239,253,492
"310","BARINGO","BARINGO NORTH","52",200,254,454
"311","BARINGO","BARINGO NORTH","53",146,164,310
"312","BARINGO","BARINGO NORTH","54",266,302,568
"313","BARINGO","BARINGO NORTH","50-54",1273,1478,2751
"314","BARINGO","BARINGO NORTH","55",211,230,441
"315","BARINGO","BARINGO NORTH","56",191,203,394
"316","BARINGO","BARINGO NORTH","57",197,316,513
"317","BARINGO","BARINGO NORTH","58",260,310,570
"318","BARINGO","BARINGO NORTH","59",302,281,583
"319","BARINGO","BARINGO NORTH","55-59",1161,1340,2501
"320","BARINGO","BARINGO NORTH","60",402,475,877
"321","BARINGO","BARINGO NORTH","61",236,222,458
"322","BARINGO","BARINGO NORTH","62",177,211,388
"323","BARINGO","BARINGO NORTH","63",209,235,444
"324","BARINGO","BARINGO NORTH","64",158,173,331
"325","BARINGO","BARINGO NORTH","60-64",1182,1316,2498
"326","BARINGO","BARINGO NORTH","65",267,348,615
"327","BARINGO","BARINGO NORTH","66",121,128,249
"328","BARINGO","BARINGO NORTH","67",269,237,506
"329","BARINGO","BARINGO NORTH","68",161,156,317
"330","BARINGO","BARINGO NORTH","69",253,241,494
"331","BARINGO","BARINGO NORTH","65-69",1071,1110,2181
"332","BARINGO","BARINGO NORTH","70",362,400,762
"333","BARINGO","BARINGO NORTH","71",268,208,476
"334","BARINGO","BARINGO NORTH","72",178,141,319
"335","BARINGO","BARINGO NORTH","73",95,127,222
"336","BARINGO","BARINGO NORTH","74",126,147,273
"337","BARINGO","BARINGO NORTH","70-74",1029,1023,2052
"338","BARINGO","BARINGO NORTH","75",107,124,231
"339","BARINGO","BARINGO NORTH","76",69,50,119
"340","BARINGO","BARINGO NORTH","77",82,94,176
"341","BARINGO","BARINGO NORTH","78",57,51,108
"342","BARINGO","BARINGO NORTH","79",76,153,229
"343","BARINGO","BARINGO NORTH","75-79",391,472,863
"344","BARINGO","BARINGO NORTH","80",121,169,290
"345","BARINGO","BARINGO NORTH","81",40,106,146
"346","BARINGO","BARINGO NORTH","82",44,41,85
"347","BARINGO","BARINGO NORTH","83",48,70,118
"348","BARINGO","BARINGO NORTH","84",51,80,131
"349","BARINGO","BARINGO NORTH","80-84",304,466,770
"350","BARINGO","BARINGO NORTH","85",34,57,91
"351","BARINGO","BARINGO NORTH","86",23,38,61
"352","BARINGO","BARINGO NORTH","87",29,31,60
"353","BARINGO","BARINGO NORTH","88",12,12,24
"354","BARINGO","BARINGO NORTH","89",47,79,126
"355","BARINGO","BARINGO NORTH","85-89",145,217,362
"356","BARINGO","BARINGO NORTH","90",23,58,81
"357","BARINGO","BARINGO NORTH","91",17,23,40
"358","BARINGO","BARINGO NORTH","92",12,12,24
"359","BARINGO","BARINGO NORTH","93",11,15,26
"360","BARINGO","BARINGO NORTH","94",6,11,17
"361","BARINGO","BARINGO NORTH","90-94",69,119,188
"362","BARINGO","BARINGO NORTH","95",14,22,36
"363","BARINGO","BARINGO NORTH","96",8,6,14
"364","BARINGO","BARINGO NORTH","97",9,8,17
"365","BARINGO","BARINGO NORTH","98",5,7,12
"366","BARINGO","BARINGO NORTH","99",3,20,23
"367","BARINGO","BARINGO NORTH","95-99",39,63,102
"368","BARINGO","BARINGO NORTH","100+",9,36,45
"369","BARINGO","BARINGO NORTH","Not Stated",NA,NA,NA
"370","BARINGO","EAST POKOT","Total",40462,39459,79921
"371","BARINGO","EAST POKOT","0",872,789,1661
"372","BARINGO","EAST POKOT","1",987,949,1936
"373","BARINGO","EAST POKOT","2",1552,1489,3041
"374","BARINGO","EAST POKOT","3",1332,1276,2608
"375","BARINGO","EAST POKOT","4",1723,1614,3337
"376","BARINGO","EAST POKOT","0 - 4",6466,6117,12583
"377","BARINGO","EAST POKOT","5",1548,1423,2971
"378","BARINGO","EAST POKOT","6",1815,1708,3523
"379","BARINGO","EAST POKOT","7",1189,1065,2254
"380","BARINGO","EAST POKOT","8",1932,1915,3847
"381","BARINGO","EAST POKOT","9",1144,1115,2259
"382","BARINGO","EAST POKOT","5-9",7628,7226,14854
"383","BARINGO","EAST POKOT","10",2371,2321,4692
"384","BARINGO","EAST POKOT","11",749,860,1609
"385","BARINGO","EAST POKOT","12",1889,1536,3425
"386","BARINGO","EAST POKOT","13",966,852,1818
"387","BARINGO","EAST POKOT","14",1296,1012,2308
"388","BARINGO","EAST POKOT","10 -14",7271,6581,13852
"389","BARINGO","EAST POKOT","15",1502,1074,2576
"390","BARINGO","EAST POKOT","16",1230,950,2180
"391","BARINGO","EAST POKOT","17",841,687,1528
"392","BARINGO","EAST POKOT","18",1205,1003,2208
"393","BARINGO","EAST POKOT","19",743,615,1358
"394","BARINGO","EAST POKOT","15-19",5521,4329,9850
"395","BARINGO","EAST POKOT","20",1382,1434,2816
"396","BARINGO","EAST POKOT","21",554,633,1187
"397","BARINGO","EAST POKOT","22",639,738,1377
"398","BARINGO","EAST POKOT","23",578,612,1190
"399","BARINGO","EAST POKOT","24",552,612,1164
"400","BARINGO","EAST POKOT","20-24",3705,4029,7734
"401","BARINGO","EAST POKOT","25",891,1033,1924
"402","BARINGO","EAST POKOT","26",491,603,1094
"403","BARINGO","EAST POKOT","27",401,483,884
"404","BARINGO","EAST POKOT","28",498,632,1130
"405","BARINGO","EAST POKOT","29",433,519,952
"406","BARINGO","EAST POKOT","25-29",2714,3270,5984
"407","BARINGO","EAST POKOT","30",1123,1144,2267
"408","BARINGO","EAST POKOT","31",278,326,604
"409","BARINGO","EAST POKOT","32",342,330,672
"410","BARINGO","EAST POKOT","33",197,190,387
"411","BARINGO","EAST POKOT","34",167,209,376
"412","BARINGO","EAST POKOT","30-34",2107,2199,4306
"413","BARINGO","EAST POKOT","35",514,563,1077
"414","BARINGO","EAST POKOT","36",139,169,308
"415","BARINGO","EAST POKOT","37",136,135,271
"416","BARINGO","EAST POKOT","38",161,232,393
"417","BARINGO","EAST POKOT","39",122,169,291
"418","BARINGO","EAST POKOT","35-39",1072,1268,2340
"419","BARINGO","EAST POKOT","40",569,666,1235
"420","BARINGO","EAST POKOT","41",211,192,403
"421","BARINGO","EAST POKOT","42",180,172,352
"422","BARINGO","EAST POKOT","43",87,127,214
"423","BARINGO","EAST POKOT","44",93,125,218
"424","BARINGO","EAST POKOT","40-44",1140,1282,2422
"425","BARINGO","EAST POKOT","45",349,363,712
"426","BARINGO","EAST POKOT","46",142,140,282
"427","BARINGO","EAST POKOT","47",95,133,228
"428","BARINGO","EAST POKOT","48",98,113,211
"429","BARINGO","EAST POKOT","49",127,153,280
"430","BARINGO","EAST POKOT","45-49",811,902,1713
"431","BARINGO","EAST POKOT","50",445,446,891
"432","BARINGO","EAST POKOT","51",62,77,139
"433","BARINGO","EAST POKOT","52",87,80,167
"434","BARINGO","EAST POKOT","53",63,56,119
"435","BARINGO","EAST POKOT","54",69,99,168
"436","BARINGO","EAST POKOT","50-54",726,758,1484
"437","BARINGO","EAST POKOT","55",123,78,201
"438","BARINGO","EAST POKOT","56",73,72,145
"439","BARINGO","EAST POKOT","57",45,54,99
"440","BARINGO","EAST POKOT","58",61,68,129
"441","BARINGO","EAST POKOT","59",73,92,165
"442","BARINGO","EAST POKOT","55-59",375,364,739
"443","BARINGO","EAST POKOT","60",226,226,452
"444","BARINGO","EAST POKOT","61",45,58,103
"445","BARINGO","EAST POKOT","62",32,45,77
"446","BARINGO","EAST POKOT","63",43,43,86
"447","BARINGO","EAST POKOT","64",19,34,53
"448","BARINGO","EAST POKOT","60-64",365,406,771
"449","BARINGO","EAST POKOT","65",82,108,190
"450","BARINGO","EAST POKOT","66",21,22,43
"451","BARINGO","EAST POKOT","67",25,29,54
"452","BARINGO","EAST POKOT","68",29,30,59
"453","BARINGO","EAST POKOT","69",68,98,166
"454","BARINGO","EAST POKOT","65-69",225,287,512
"455","BARINGO","EAST POKOT","70",90,115,205
"456","BARINGO","EAST POKOT","71",28,29,57
"457","BARINGO","EAST POKOT","72",24,33,57
"458","BARINGO","EAST POKOT","73",14,15,29
"459","BARINGO","EAST POKOT","74",17,20,37
"460","BARINGO","EAST POKOT","70-74",173,212,385
"461","BARINGO","EAST POKOT","75",30,30,60
"462","BARINGO","EAST POKOT","76",10,9,19
"463","BARINGO","EAST POKOT","77",6,9,15
"464","BARINGO","EAST POKOT","78",8,8,16
"465","BARINGO","EAST POKOT","79",25,41,66
"466","BARINGO","EAST POKOT","75-79",79,97,176
"467","BARINGO","EAST POKOT","80",31,45,76
"468","BARINGO","EAST POKOT","81",2,5,7
"469","BARINGO","EAST POKOT","82",6,2,8
"470","BARINGO","EAST POKOT","83",5,4,9
"471","BARINGO","EAST POKOT","84",4,10,14
"472","BARINGO","EAST POKOT","80-84",48,66,114
"473","BARINGO","EAST POKOT","85",4,8,12
"474","BARINGO","EAST POKOT","86",NA,5,5
"475","BARINGO","EAST POKOT","87",4,5,9
"476","BARINGO","EAST POKOT","88",NA,1,1
"477","BARINGO","EAST POKOT","89",14,16,30
"478","BARINGO","EAST POKOT","85-89",22,35,57
"479","BARINGO","EAST POKOT","90",3,9,12
"480","BARINGO","EAST POKOT","91",1,3,4
"481","BARINGO","EAST POKOT","92",NA,4,4
"482","BARINGO","EAST POKOT","93",1,2,3
"483","BARINGO","EAST POKOT","94",1,1,2
"484","BARINGO","EAST POKOT","90-94",6,19,25
"485","BARINGO","EAST POKOT","95",NA,5,5
"486","BARINGO","EAST POKOT","96",NA,NA,NA
"487","BARINGO","EAST POKOT","97",1,NA,1
"488","BARINGO","EAST POKOT","98",NA,NA,NA
"489","BARINGO","EAST POKOT","99",2,1,3
"490","BARINGO","EAST POKOT","95-99",3,6,9
"491","BARINGO","EAST POKOT","100+",5,6,11
"492","BARINGO","EAST POKOT","Not Stated",NA,NA,NA
"493","BARINGO","KOIBATEK","Total",65295,64238,129533
"494","BARINGO","KOIBATEK","0",1604,1510,3114
"495","BARINGO","KOIBATEK","1",1634,1534,3168
"496","BARINGO","KOIBATEK","2",1620,1514,3134
"497","BARINGO","KOIBATEK","3",1708,1652,3360
"498","BARINGO","KOIBATEK","4",1766,1679,3445
"499","BARINGO","KOIBATEK","0 - 4",8332,7889,16221
"500","BARINGO","KOIBATEK","5",1718,1635,3353
"501","BARINGO","KOIBATEK","6",1685,1660,3345
"502","BARINGO","KOIBATEK","7",1706,1662,3368
"503","BARINGO","KOIBATEK","8",1450,1510,2960
"504","BARINGO","KOIBATEK","9",1713,1728,3441
"505","BARINGO","KOIBATEK","5-9",8272,8195,16467
"506","BARINGO","KOIBATEK","10",1678,1704,3382
"507","BARINGO","KOIBATEK","11",1704,1649,3353
"508","BARINGO","KOIBATEK","12",1891,1722,3613
"509","BARINGO","KOIBATEK","13",1808,1820,3628
"510","BARINGO","KOIBATEK","14",1859,1752,3611
"511","BARINGO","KOIBATEK","10 -14",8940,8647,17587
"512","BARINGO","KOIBATEK","15",1776,1714,3490
"513","BARINGO","KOIBATEK","16",1615,1641,3256
"514","BARINGO","KOIBATEK","17",1700,1676,3376
"515","BARINGO","KOIBATEK","18",1311,1277,2588
"516","BARINGO","KOIBATEK","19",1580,1510,3090
"517","BARINGO","KOIBATEK","15-19",7982,7818,15800
"518","BARINGO","KOIBATEK","20",1290,1288,2578
"519","BARINGO","KOIBATEK","21",1287,1356,2643
"520","BARINGO","KOIBATEK","22",1250,1219,2469
"521","BARINGO","KOIBATEK","23",1302,1233,2535
"522","BARINGO","KOIBATEK","24",1173,1207,2380
"523","BARINGO","KOIBATEK","20-24",6302,6303,12605
"524","BARINGO","KOIBATEK","25",1225,1207,2432
"525","BARINGO","KOIBATEK","26",907,998,1905
"526","BARINGO","KOIBATEK","27",997,984,1981
"527","BARINGO","KOIBATEK","28",777,758,1535
"528","BARINGO","KOIBATEK","29",854,914,1768
"529","BARINGO","KOIBATEK","25-29",4760,4861,9621
"530","BARINGO","KOIBATEK","30",1099,1104,2203
"531","BARINGO","KOIBATEK","31",769,737,1506
"532","BARINGO","KOIBATEK","32",925,978,1903
"533","BARINGO","KOIBATEK","33",869,891,1760
"534","BARINGO","KOIBATEK","34",758,781,1539
"535","BARINGO","KOIBATEK","30-34",4420,4491,8911
"536","BARINGO","KOIBATEK","35",1066,1025,2091
"537","BARINGO","KOIBATEK","36",704,661,1365
"538","BARINGO","KOIBATEK","37",802,646,1448
"539","BARINGO","KOIBATEK","38",517,504,1021
"540","BARINGO","KOIBATEK","39",640,615,1255
"541","BARINGO","KOIBATEK","35-39",3729,3451,7180
"542","BARINGO","KOIBATEK","40",719,688,1407
"543","BARINGO","KOIBATEK","41",742,659,1401
"544","BARINGO","KOIBATEK","42",604,619,1223
"545","BARINGO","KOIBATEK","43",563,565,1128
"546","BARINGO","KOIBATEK","44",392,408,800
"547","BARINGO","KOIBATEK","40-44",3020,2939,5959
"548","BARINGO","KOIBATEK","45",861,777,1638
"549","BARINGO","KOIBATEK","46",497,482,979
"550","BARINGO","KOIBATEK","47",530,522,1052
"551","BARINGO","KOIBATEK","48",353,335,688
"552","BARINGO","KOIBATEK","49",414,434,848
"553","BARINGO","KOIBATEK","45-49",2655,2550,5205
"554","BARINGO","KOIBATEK","50",496,511,1007
"555","BARINGO","KOIBATEK","51",406,373,779
"556","BARINGO","KOIBATEK","52",329,352,681
"557","BARINGO","KOIBATEK","53",296,274,570
"558","BARINGO","KOIBATEK","54",344,299,643
"559","BARINGO","KOIBATEK","50-54",1871,1809,3680
"560","BARINGO","KOIBATEK","55",320,244,564
"561","BARINGO","KOIBATEK","56",322,298,620
"562","BARINGO","KOIBATEK","57",308,358,666
"563","BARINGO","KOIBATEK","58",313,359,672
"564","BARINGO","KOIBATEK","59",328,279,607
"565","BARINGO","KOIBATEK","55-59",1591,1538,3129
"566","BARINGO","KOIBATEK","60",348,353,701
"567","BARINGO","KOIBATEK","61",297,243,540
"568","BARINGO","KOIBATEK","62",180,168,348
"569","BARINGO","KOIBATEK","63",198,176,374
"570","BARINGO","KOIBATEK","64",124,147,271
"571","BARINGO","KOIBATEK","60-64",1147,1087,2234
"572","BARINGO","KOIBATEK","65",217,217,434
"573","BARINGO","KOIBATEK","66",114,129,243
"574","BARINGO","KOIBATEK","67",228,228,456
"575","BARINGO","KOIBATEK","68",95,107,202
"576","BARINGO","KOIBATEK","69",163,181,344
"577","BARINGO","KOIBATEK","65-69",817,862,1679
"578","BARINGO","KOIBATEK","70",205,223,428
"579","BARINGO","KOIBATEK","71",160,152,312
"580","BARINGO","KOIBATEK","72",102,115,217
"581","BARINGO","KOIBATEK","73",73,106,179
"582","BARINGO","KOIBATEK","74",95,103,198
"583","BARINGO","KOIBATEK","70-74",635,699,1334
"584","BARINGO","KOIBATEK","75",85,101,186
"585","BARINGO","KOIBATEK","76",79,82,161
"586","BARINGO","KOIBATEK","77",69,88,157
"587","BARINGO","KOIBATEK","78",50,53,103
"588","BARINGO","KOIBATEK","79",71,116,187
"589","BARINGO","KOIBATEK","75-79",354,440,794
"590","BARINGO","KOIBATEK","80",78,123,201
"591","BARINGO","KOIBATEK","81",44,51,95
"592","BARINGO","KOIBATEK","82",32,41,73
"593","BARINGO","KOIBATEK","83",44,60,104
"594","BARINGO","KOIBATEK","84",46,51,97
"595","BARINGO","KOIBATEK","80-84",244,326,570
"596","BARINGO","KOIBATEK","85",29,44,73
"597","BARINGO","KOIBATEK","86",31,26,57
"598","BARINGO","KOIBATEK","87",28,29,57
"599","BARINGO","KOIBATEK","88",8,18,26
"600","BARINGO","KOIBATEK","89",27,56,83
"601","BARINGO","KOIBATEK","85-89",123,173,296
"602","BARINGO","KOIBATEK","90",17,37,54
"603","BARINGO","KOIBATEK","91",13,11,24
"604","BARINGO","KOIBATEK","92",11,14,25
"605","BARINGO","KOIBATEK","93",7,10,17
"606","BARINGO","KOIBATEK","94",8,13,21
"607","BARINGO","KOIBATEK","90-94",56,85,141
"608","BARINGO","KOIBATEK","95",13,27,40
"609","BARINGO","KOIBATEK","96",4,3,7
"610","BARINGO","KOIBATEK","97",5,8,13
"611","BARINGO","KOIBATEK","98",2,8,10
"612","BARINGO","KOIBATEK","99",4,14,18
"613","BARINGO","KOIBATEK","95-99",28,60,88
"614","BARINGO","KOIBATEK","100+",17,15,32
"615","BARINGO","KOIBATEK","Not Stated",NA,NA,NA
"616","BARINGO","MARIGAT","Total",45706,45246,90952
"617","BARINGO","MARIGAT","0",1315,1243,2558
"618","BARINGO","MARIGAT","1",1360,1373,2733
"619","BARINGO","MARIGAT","2",1557,1459,3016
"620","BARINGO","MARIGAT","3",1597,1626,3223
"621","BARINGO","MARIGAT","4",1672,1565,3237
"622","BARINGO","MARIGAT","0 - 4",7501,7266,14767
"623","BARINGO","MARIGAT","5",1641,1553,3194
"624","BARINGO","MARIGAT","6",1548,1482,3030
"625","BARINGO","MARIGAT","7",1421,1442,2863
"626","BARINGO","MARIGAT","8",1392,1360,2752
"627","BARINGO","MARIGAT","9",1328,1267,2595
"628","BARINGO","MARIGAT","5-9",7330,7104,14434
"629","BARINGO","MARIGAT","10",1725,1531,3256
"630","BARINGO","MARIGAT","11",1145,1136,2281
"631","BARINGO","MARIGAT","12",1652,1547,3199
"632","BARINGO","MARIGAT","13",1394,1329,2723
"633","BARINGO","MARIGAT","14",1355,1298,2653
"634","BARINGO","MARIGAT","10 -14",7271,6841,14112
"635","BARINGO","MARIGAT","15",1342,1213,2555
"636","BARINGO","MARIGAT","16",1163,1049,2212
"637","BARINGO","MARIGAT","17",1155,983,2138
"638","BARINGO","MARIGAT","18",840,802,1642
"639","BARINGO","MARIGAT","19",855,901,1756
"640","BARINGO","MARIGAT","15-19",5355,4948,10303
"641","BARINGO","MARIGAT","20",884,984,1868
"642","BARINGO","MARIGAT","21",806,891,1697
"643","BARINGO","MARIGAT","22",748,866,1614
"644","BARINGO","MARIGAT","23",812,814,1626
"645","BARINGO","MARIGAT","24",704,712,1416
"646","BARINGO","MARIGAT","20-24",3954,4267,8221
"647","BARINGO","MARIGAT","25",890,897,1787
"648","BARINGO","MARIGAT","26",561,643,1204
"649","BARINGO","MARIGAT","27",606,663,1269
"650","BARINGO","MARIGAT","28",528,613,1141
"651","BARINGO","MARIGAT","29",504,543,1047
"652","BARINGO","MARIGAT","25-29",3089,3359,6448
"653","BARINGO","MARIGAT","30",747,878,1625
"654","BARINGO","MARIGAT","31",475,544,1019
"655","BARINGO","MARIGAT","32",559,577,1136
"656","BARINGO","MARIGAT","33",440,454,894
"657","BARINGO","MARIGAT","34",378,363,741
"658","BARINGO","MARIGAT","30-34",2599,2816,5415
"659","BARINGO","MARIGAT","35",645,655,1300
"660","BARINGO","MARIGAT","36",356,297,653
"661","BARINGO","MARIGAT","37",333,293,626
"662","BARINGO","MARIGAT","38",241,218,459
"663","BARINGO","MARIGAT","39",291,249,540
"664","BARINGO","MARIGAT","35-39",1866,1712,3578
"665","BARINGO","MARIGAT","40",437,363,800
"666","BARINGO","MARIGAT","41",441,367,808
"667","BARINGO","MARIGAT","42",353,263,616
"668","BARINGO","MARIGAT","43",213,229,442
"669","BARINGO","MARIGAT","44",157,171,328
"670","BARINGO","MARIGAT","40-44",1601,1393,2994
"671","BARINGO","MARIGAT","45",472,489,961
"672","BARINGO","MARIGAT","46",204,271,475
"673","BARINGO","MARIGAT","47",266,256,522
"674","BARINGO","MARIGAT","48",131,133,264
"675","BARINGO","MARIGAT","49",193,161,354
"676","BARINGO","MARIGAT","45-49",1266,1310,2576
"677","BARINGO","MARIGAT","50",278,329,607
"678","BARINGO","MARIGAT","51",187,176,363
"679","BARINGO","MARIGAT","52",141,179,320
"680","BARINGO","MARIGAT","53",132,150,282
"681","BARINGO","MARIGAT","54",198,209,407
"682","BARINGO","MARIGAT","50-54",936,1043,1979
"683","BARINGO","MARIGAT","55",169,148,317
"684","BARINGO","MARIGAT","56",134,155,289
"685","BARINGO","MARIGAT","57",165,175,340
"686","BARINGO","MARIGAT","58",189,178,367
"687","BARINGO","MARIGAT","59",167,224,391
"688","BARINGO","MARIGAT","55-59",824,880,1704
"689","BARINGO","MARIGAT","60",260,290,550
"690","BARINGO","MARIGAT","61",160,137,297
"691","BARINGO","MARIGAT","62",117,100,217
"692","BARINGO","MARIGAT","63",115,145,260
"693","BARINGO","MARIGAT","64",74,74,148
"694","BARINGO","MARIGAT","60-64",726,746,1472
"695","BARINGO","MARIGAT","65",173,167,340
"696","BARINGO","MARIGAT","66",74,57,131
"697","BARINGO","MARIGAT","67",126,96,222
"698","BARINGO","MARIGAT","68",74,62,136
"699","BARINGO","MARIGAT","69",103,115,218
"700","BARINGO","MARIGAT","65-69",550,497,1047
"701","BARINGO","MARIGAT","70",141,195,336
"702","BARINGO","MARIGAT","71",86,97,183
"703","BARINGO","MARIGAT","72",69,60,129
"704","BARINGO","MARIGAT","73",53,48,101
"705","BARINGO","MARIGAT","74",62,49,111
"706","BARINGO","MARIGAT","70-74",411,449,860
"707","BARINGO","MARIGAT","75",65,67,132
"708","BARINGO","MARIGAT","76",43,31,74
"709","BARINGO","MARIGAT","77",44,35,79
"710","BARINGO","MARIGAT","78",24,25,49
"711","BARINGO","MARIGAT","79",49,80,129
"712","BARINGO","MARIGAT","75-79",225,238,463
"713","BARINGO","MARIGAT","80",51,65,116
"714","BARINGO","MARIGAT","81",18,46,64
"715","BARINGO","MARIGAT","82",11,16,27
"716","BARINGO","MARIGAT","83",11,21,32
"717","BARINGO","MARIGAT","84",21,29,50
"718","BARINGO","MARIGAT","80-84",112,177,289
"719","BARINGO","MARIGAT","85",8,29,37
"720","BARINGO","MARIGAT","86",9,14,23
"721","BARINGO","MARIGAT","87",15,17,32
"722","BARINGO","MARIGAT","88",4,10,14
"723","BARINGO","MARIGAT","89",16,47,63
"724","BARINGO","MARIGAT","85-89",52,117,169
"725","BARINGO","MARIGAT","90",5,17,22
"726","BARINGO","MARIGAT","91",5,8,13
"727","BARINGO","MARIGAT","92",2,5,7
"728","BARINGO","MARIGAT","93",2,6,8
"729","BARINGO","MARIGAT","94",5,6,11
"730","BARINGO","MARIGAT","90-94",19,42,61
"731","BARINGO","MARIGAT","95",2,11,13
"732","BARINGO","MARIGAT","96",1,4,5
"733","BARINGO","MARIGAT","97",2,4,6
"734","BARINGO","MARIGAT","98",NA,7,7
"735","BARINGO","MARIGAT","99",4,3,7
"736","BARINGO","MARIGAT","95-99",9,29,38
"737","BARINGO","MARIGAT","100+",9,12,21
"738","BARINGO","MARIGAT","Not Stated",1,NA,1
"739","BARINGO","MOGOTIO","Total",46014,45088,91102
"740","BARINGO","MOGOTIO","0",1192,1082,2274
"741","BARINGO","MOGOTIO","1",1192,1150,2342
"742","BARINGO","MOGOTIO","2",1285,1297,2582
"743","BARINGO","MOGOTIO","3",1415,1416,2831
"744","BARINGO","MOGOTIO","4",1418,1320,2738
"745","BARINGO","MOGOTIO","0 - 4",6502,6265,12767
"746","BARINGO","MOGOTIO","5",1425,1306,2731
"747","BARINGO","MOGOTIO","6",1357,1328,2685
"748","BARINGO","MOGOTIO","7",1345,1271,2616
"749","BARINGO","MOGOTIO","8",1223,1137,2360
"750","BARINGO","MOGOTIO","9",1259,1243,2502
"751","BARINGO","MOGOTIO","5-9",6609,6285,12894
"752","BARINGO","MOGOTIO","10",1372,1357,2729
"753","BARINGO","MOGOTIO","11",1206,1224,2430
"754","BARINGO","MOGOTIO","12",1399,1342,2741
"755","BARINGO","MOGOTIO","13",1362,1327,2689
"756","BARINGO","MOGOTIO","14",1302,1210,2512
"757","BARINGO","MOGOTIO","10 -14",6641,6460,13101
"758","BARINGO","MOGOTIO","15",1372,1306,2678
"759","BARINGO","MOGOTIO","16",1128,1159,2287
"760","BARINGO","MOGOTIO","17",1272,1118,2390
"761","BARINGO","MOGOTIO","18",847,894,1741
"762","BARINGO","MOGOTIO","19",1125,1053,2178
"763","BARINGO","MOGOTIO","15-19",5744,5530,11274
"764","BARINGO","MOGOTIO","20",984,932,1916
"765","BARINGO","MOGOTIO","21",991,940,1931
"766","BARINGO","MOGOTIO","22",901,875,1776
"767","BARINGO","MOGOTIO","23",862,958,1820
"768","BARINGO","MOGOTIO","24",797,790,1587
"769","BARINGO","MOGOTIO","20-24",4535,4495,9030
"770","BARINGO","MOGOTIO","25",864,837,1701
"771","BARINGO","MOGOTIO","26",657,634,1291
"772","BARINGO","MOGOTIO","27",621,659,1280
"773","BARINGO","MOGOTIO","28",443,496,939
"774","BARINGO","MOGOTIO","29",608,629,1237
"775","BARINGO","MOGOTIO","25-29",3193,3255,6448
"776","BARINGO","MOGOTIO","30",662,707,1369
"777","BARINGO","MOGOTIO","31",486,490,976
"778","BARINGO","MOGOTIO","32",553,575,1128
"779","BARINGO","MOGOTIO","33",524,583,1107
"780","BARINGO","MOGOTIO","34",433,453,886
"781","BARINGO","MOGOTIO","30-34",2658,2808,5466
"782","BARINGO","MOGOTIO","35",670,621,1291
"783","BARINGO","MOGOTIO","36",402,386,788
"784","BARINGO","MOGOTIO","37",444,366,810
"785","BARINGO","MOGOTIO","38",271,273,544
"786","BARINGO","MOGOTIO","39",419,332,751
"787","BARINGO","MOGOTIO","35-39",2206,1978,4184
"788","BARINGO","MOGOTIO","40",483,356,839
"789","BARINGO","MOGOTIO","41",456,362,818
"790","BARINGO","MOGOTIO","42",336,314,650
"791","BARINGO","MOGOTIO","43",311,294,605
"792","BARINGO","MOGOTIO","44",230,226,456
"793","BARINGO","MOGOTIO","40-44",1816,1552,3368
"794","BARINGO","MOGOTIO","45",484,470,954
"795","BARINGO","MOGOTIO","46",321,342,663
"796","BARINGO","MOGOTIO","47",318,323,641
"797","BARINGO","MOGOTIO","48",206,175,381
"798","BARINGO","MOGOTIO","49",241,250,491
"799","BARINGO","MOGOTIO","45-49",1570,1560,3130
"800","BARINGO","MOGOTIO","50",274,284,558
"801","BARINGO","MOGOTIO","51",253,245,498
"802","BARINGO","MOGOTIO","52",211,206,417
"803","BARINGO","MOGOTIO","53",143,161,304
"804","BARINGO","MOGOTIO","54",197,231,428
"805","BARINGO","MOGOTIO","50-54",1078,1127,2205
"806","BARINGO","MOGOTIO","55",166,124,290
"807","BARINGO","MOGOTIO","56",176,175,351
"808","BARINGO","MOGOTIO","57",170,212,382
"809","BARINGO","MOGOTIO","58",242,257,499
"810","BARINGO","MOGOTIO","59",202,187,389
"811","BARINGO","MOGOTIO","55-59",956,955,1911
"812","BARINGO","MOGOTIO","60",214,209,423
"813","BARINGO","MOGOTIO","61",169,157,326
"814","BARINGO","MOGOTIO","62",142,131,273
"815","BARINGO","MOGOTIO","63",131,122,253
"816","BARINGO","MOGOTIO","64",90,101,191
"817","BARINGO","MOGOTIO","60-64",746,720,1466
"818","BARINGO","MOGOTIO","65",171,197,368
"819","BARINGO","MOGOTIO","66",101,71,172
"820","BARINGO","MOGOTIO","67",199,153,352
"821","BARINGO","MOGOTIO","68",85,81,166
"822","BARINGO","MOGOTIO","69",124,131,255
"823","BARINGO","MOGOTIO","65-69",680,633,1313
"824","BARINGO","MOGOTIO","70",148,235,383
"825","BARINGO","MOGOTIO","71",118,117,235
"826","BARINGO","MOGOTIO","72",64,94,158
"827","BARINGO","MOGOTIO","73",60,78,138
"828","BARINGO","MOGOTIO","74",74,93,167
"829","BARINGO","MOGOTIO","70-74",464,617,1081
"830","BARINGO","MOGOTIO","75",77,75,152
"831","BARINGO","MOGOTIO","76",48,59,107
"832","BARINGO","MOGOTIO","77",52,55,107
"833","BARINGO","MOGOTIO","78",27,38,65
"834","BARINGO","MOGOTIO","79",48,81,129
"835","BARINGO","MOGOTIO","75-79",252,308,560
"836","BARINGO","MOGOTIO","80",68,108,176
"837","BARINGO","MOGOTIO","81",23,48,71
"838","BARINGO","MOGOTIO","82",20,24,44
"839","BARINGO","MOGOTIO","83",28,29,57
"840","BARINGO","MOGOTIO","84",35,46,81
"841","BARINGO","MOGOTIO","80-84",174,255,429
"842","BARINGO","MOGOTIO","85",31,28,59
"843","BARINGO","MOGOTIO","86",19,26,45
"844","BARINGO","MOGOTIO","87",20,26,46
"845","BARINGO","MOGOTIO","88",15,15,30
"846","BARINGO","MOGOTIO","89",36,55,91
"847","BARINGO","MOGOTIO","85-89",121,150,271
"848","BARINGO","MOGOTIO","90",13,26,39
"849","BARINGO","MOGOTIO","91",5,12,17
"850","BARINGO","MOGOTIO","92",5,7,12
"851","BARINGO","MOGOTIO","93",6,5,11
"852","BARINGO","MOGOTIO","94",5,15,20
"853","BARINGO","MOGOTIO","90-94",34,65,99
"854","BARINGO","MOGOTIO","95",10,13,23
"855","BARINGO","MOGOTIO","96",4,8,12
"856","BARINGO","MOGOTIO","97",2,6,8
"857","BARINGO","MOGOTIO","98",1,1,2
"858","BARINGO","MOGOTIO","99",4,15,19
"859","BARINGO","MOGOTIO","95-99",21,43,64
"860","BARINGO","MOGOTIO","100+",14,27,41
"861","BARINGO","MOGOTIO","Not Stated",NA,NA,NA
"862","BARINGO","TIATY EAST","Total",38356,35068,73424
"863","BARINGO","TIATY EAST","0",1003,1044,2047
"864","BARINGO","TIATY EAST","1",953,955,1908
"865","BARINGO","TIATY EAST","2",1433,1373,2806
"866","BARINGO","TIATY EAST","3",1237,1195,2432
"867","BARINGO","TIATY EAST","4",1422,1296,2718
"868","BARINGO","TIATY EAST","0 - 4",6048,5863,11911
"869","BARINGO","TIATY EAST","5",1421,1352,2773
"870","BARINGO","TIATY EAST","6",1593,1408,3001
"871","BARINGO","TIATY EAST","7",1130,956,2086
"872","BARINGO","TIATY EAST","8",1683,1540,3223
"873","BARINGO","TIATY EAST","9",1113,963,2076
"874","BARINGO","TIATY EAST","5-9",6940,6219,13159
"875","BARINGO","TIATY EAST","10",2274,1952,4226
"876","BARINGO","TIATY EAST","11",806,811,1617
"877","BARINGO","TIATY EAST","12",1789,1369,3158
"878","BARINGO","TIATY EAST","13",1110,840,1950
"879","BARINGO","TIATY EAST","14",1132,953,2085
"880","BARINGO","TIATY EAST","10 -14",7111,5925,13036
"881","BARINGO","TIATY EAST","15",1518,1124,2642
"882","BARINGO","TIATY EAST","16",1070,837,1907
"883","BARINGO","TIATY EAST","17",971,704,1675
"884","BARINGO","TIATY EAST","18",1054,774,1828
"885","BARINGO","TIATY EAST","19",792,690,1482
"886","BARINGO","TIATY EAST","15-19",5405,4129,9534
"887","BARINGO","TIATY EAST","20",1282,1130,2412
"888","BARINGO","TIATY EAST","21",554,489,1043
"889","BARINGO","TIATY EAST","22",580,578,1158
"890","BARINGO","TIATY EAST","23",535,500,1035
"891","BARINGO","TIATY EAST","24",482,469,951
"892","BARINGO","TIATY EAST","20-24",3433,3166,6599
"893","BARINGO","TIATY EAST","25",786,788,1574
"894","BARINGO","TIATY EAST","26",402,399,801
"895","BARINGO","TIATY EAST","27",428,433,861
"896","BARINGO","TIATY EAST","28",435,488,923
"897","BARINGO","TIATY EAST","29",369,385,754
"898","BARINGO","TIATY EAST","25-29",2420,2493,4913
"899","BARINGO","TIATY EAST","30",858,951,1809
"900","BARINGO","TIATY EAST","31",224,297,521
"901","BARINGO","TIATY EAST","32",317,342,659
"902","BARINGO","TIATY EAST","33",187,222,409
"903","BARINGO","TIATY EAST","34",172,149,321
"904","BARINGO","TIATY EAST","30-34",1758,1961,3719
"905","BARINGO","TIATY EAST","35",607,695,1302
"906","BARINGO","TIATY EAST","36",165,197,362
"907","BARINGO","TIATY EAST","37",140,153,293
"908","BARINGO","TIATY EAST","38",153,219,372
"909","BARINGO","TIATY EAST","39",147,163,310
"910","BARINGO","TIATY EAST","35-39",1212,1427,2639
"911","BARINGO","TIATY EAST","40",617,473,1090
"912","BARINGO","TIATY EAST","41",188,182,370
"913","BARINGO","TIATY EAST","42",208,164,372
"914","BARINGO","TIATY EAST","43",110,123,233
"915","BARINGO","TIATY EAST","44",93,96,189
"916","BARINGO","TIATY EAST","40-44",1216,1038,2254
"917","BARINGO","TIATY EAST","45",402,245,647
"918","BARINGO","TIATY EAST","46",131,170,301
"919","BARINGO","TIATY EAST","47",90,97,187
"920","BARINGO","TIATY EAST","48",112,109,221
"921","BARINGO","TIATY EAST","49",100,123,223
"922","BARINGO","TIATY EAST","45-49",835,744,1579
"923","BARINGO","TIATY EAST","50",292,289,581
"924","BARINGO","TIATY EAST","51",74,78,152
"925","BARINGO","TIATY EAST","52",72,82,154
"926","BARINGO","TIATY EAST","53",47,47,94
"927","BARINGO","TIATY EAST","54",99,69,168
"928","BARINGO","TIATY EAST","50-54",584,565,1149
"929","BARINGO","TIATY EAST","55",115,93,208
"930","BARINGO","TIATY EAST","56",93,81,174
"931","BARINGO","TIATY EAST","57",46,42,88
"932","BARINGO","TIATY EAST","58",63,43,106
"933","BARINGO","TIATY EAST","59",65,86,151
"934","BARINGO","TIATY EAST","55-59",382,345,727
"935","BARINGO","TIATY EAST","60",190,209,399
"936","BARINGO","TIATY EAST","61",36,30,66
"937","BARINGO","TIATY EAST","62",33,45,78
"938","BARINGO","TIATY EAST","63",37,40,77
"939","BARINGO","TIATY EAST","64",21,27,48
"940","BARINGO","TIATY EAST","60-64",317,351,668
"941","BARINGO","TIATY EAST","65",96,118,214
"942","BARINGO","TIATY EAST","66",26,21,47
"943","BARINGO","TIATY EAST","67",47,46,93
"944","BARINGO","TIATY EAST","68",33,36,69
"945","BARINGO","TIATY EAST","69",63,85,148
"946","BARINGO","TIATY EAST","65-69",265,306,571
"947","BARINGO","TIATY EAST","70",112,137,249
"948","BARINGO","TIATY EAST","71",30,24,54
"949","BARINGO","TIATY EAST","72",31,36,67
"950","BARINGO","TIATY EAST","73",20,21,41
"951","BARINGO","TIATY EAST","74",28,32,60
"952","BARINGO","TIATY EAST","70-74",221,250,471
"953","BARINGO","TIATY EAST","75",39,42,81
"954","BARINGO","TIATY EAST","76",6,16,22
"955","BARINGO","TIATY EAST","77",11,12,23
"956","BARINGO","TIATY EAST","78",16,19,35
"957","BARINGO","TIATY EAST","79",31,30,61
"958","BARINGO","TIATY EAST","75-79",103,119,222
"959","BARINGO","TIATY EAST","80",43,65,108
"960","BARINGO","TIATY EAST","81",6,8,14
"961","BARINGO","TIATY EAST","82",4,11,15
"962","BARINGO","TIATY EAST","83",2,6,8
"963","BARINGO","TIATY EAST","84",4,5,9
"964","BARINGO","TIATY EAST","80-84",59,95,154
"965","BARINGO","TIATY EAST","85",5,16,21
"966","BARINGO","TIATY EAST","86",3,3,6
"967","BARINGO","TIATY EAST","87",7,3,10
"968","BARINGO","TIATY EAST","88",1,3,4
"969","BARINGO","TIATY EAST","89",8,13,21
"970","BARINGO","TIATY EAST","85-89",24,38,62
"971","BARINGO","TIATY EAST","90",4,7,11
"972","BARINGO","TIATY EAST","91",4,2,6
"973","BARINGO","TIATY EAST","92",NA,NA,NA
"974","BARINGO","TIATY EAST","93",2,5,7
"975","BARINGO","TIATY EAST","94",3,3,6
"976","BARINGO","TIATY EAST","90-94",13,17,30
"977","BARINGO","TIATY EAST","95",2,4,6
"978","BARINGO","TIATY EAST","96",1,2,3
"979","BARINGO","TIATY EAST","97",2,2,4
"980","BARINGO","TIATY EAST","98",NA,1,1
"981","BARINGO","TIATY EAST","99",2,1,3
"982","BARINGO","TIATY EAST","95-99",7,10,17
"983","BARINGO","TIATY EAST","100+",3,7,10
"984","BARINGO","TIATY EAST","Not Stated",NA,NA,NA
"985","BOMET","ALL","Total",434287,441379,875666
"986","BOMET","ALL","0",10015,9753,19768
"987","BOMET","ALL","1",10566,10389,20955
"988","BOMET","ALL","2",11425,10948,22373
"989","BOMET","ALL","3",11684,11715,23399
"990","BOMET","ALL","4",12577,11904,24481
"991","BOMET","ALL","0 - 4",56267,54709,110976
"992","BOMET","ALL","5",12433,11415,23848
"993","BOMET","ALL","6",12065,11755,23820
"994","BOMET","ALL","7",12707,12397,25104
"995","BOMET","ALL","8",11516,11202,22718
"996","BOMET","ALL","9",13689,13281,26970
"997","BOMET","ALL","5-9",62410,60050,122460
"998","BOMET","ALL","10",13311,12742,26053
"999","BOMET","ALL","11",12635,12880,25515
"1000","BOMET","ALL","12",13747,13278,27025
"1001","BOMET","ALL","13",13317,13689,27006
"1002","BOMET","ALL","14",12936,12813,25749
"1003","BOMET","ALL","10 -14",65946,65402,131348
"1004","BOMET","ALL","15",13204,12799,26003
"1005","BOMET","ALL","16",11709,11619,23328
"1006","BOMET","ALL","17",11456,10622,22078
"1007","BOMET","ALL","18",8701,8300,17001
"1008","BOMET","ALL","19",11030,10569,21599
"1009","BOMET","ALL","15-19",56100,53909,110009
"1010","BOMET","ALL","20",8280,8864,17144
"1011","BOMET","ALL","21",8221,9254,17475
"1012","BOMET","ALL","22",7331,8195,15526
"1013","BOMET","ALL","23",7645,8978,16623
"1014","BOMET","ALL","24",6758,7666,14424
"1015","BOMET","ALL","20-24",38235,42957,81192
"1016","BOMET","ALL","25",7516,8033,15549
"1017","BOMET","ALL","26",6224,7034,13258
"1018","BOMET","ALL","27",6532,7467,13999
"1019","BOMET","ALL","28",4824,5714,10538
"1020","BOMET","ALL","29",5738,6904,12642
"1021","BOMET","ALL","25-29",30834,35152,65986
"1022","BOMET","ALL","30",6590,8239,14829
"1023","BOMET","ALL","31",5220,6516,11736
"1024","BOMET","ALL","32",6442,7470,13912
"1025","BOMET","ALL","33",5659,6738,12397
"1026","BOMET","ALL","34",4978,5235,10213
"1027","BOMET","ALL","30-34",28889,34198,63087
"1028","BOMET","ALL","35",6455,5719,12174
"1029","BOMET","ALL","36",4151,3159,7310
"1030","BOMET","ALL","37",4586,3374,7960
"1031","BOMET","ALL","38",2716,2095,4811
"1032","BOMET","ALL","39",3869,2912,6781
"1033","BOMET","ALL","35-39",21777,17259,39036
"1034","BOMET","ALL","40",4381,3618,7999
"1035","BOMET","ALL","41",5024,4674,9698
"1036","BOMET","ALL","42",3617,3413,7030
"1037","BOMET","ALL","43",3222,3308,6530
"1038","BOMET","ALL","44",2381,2573,4954
"1039","BOMET","ALL","40-44",18625,17586,36211
"1040","BOMET","ALL","45",5403,4588,9991
"1041","BOMET","ALL","46",3198,3248,6446
"1042","BOMET","ALL","47",3478,3611,7089
"1043","BOMET","ALL","48",1694,1739,3433
"1044","BOMET","ALL","49",2559,2823,5382
"1045","BOMET","ALL","45-49",16332,16009,32341
"1046","BOMET","ALL","50",2657,2723,5380
"1047","BOMET","ALL","51",2512,2412,4924
"1048","BOMET","ALL","52",1593,1564,3157
"1049","BOMET","ALL","53",1182,1215,2397
"1050","BOMET","ALL","54",1514,1446,2960
"1051","BOMET","ALL","50-54",9458,9360,18818
"1052","BOMET","ALL","55",1300,1385,2685
"1053","BOMET","ALL","56",1311,1360,2671
"1054","BOMET","ALL","57",1591,1871,3462
"1055","BOMET","ALL","58",2391,3272,5663
"1056","BOMET","ALL","59",1962,1808,3770
"1057","BOMET","ALL","55-59",8555,9696,18251
"1058","BOMET","ALL","60",1918,2029,3947
"1059","BOMET","ALL","61",1621,1627,3248
"1060","BOMET","ALL","62",1196,1224,2420
"1061","BOMET","ALL","63",1264,1332,2596
"1062","BOMET","ALL","64",936,979,1915
"1063","BOMET","ALL","60-64",6935,7191,14126
"1064","BOMET","ALL","65",1447,1655,3102
"1065","BOMET","ALL","66",845,803,1648
"1066","BOMET","ALL","67",1320,1385,2705
"1067","BOMET","ALL","68",539,628,1167
"1068","BOMET","ALL","69",938,1107,2045
"1069","BOMET","ALL","65-69",5089,5578,10667
"1070","BOMET","ALL","70",1099,1428,2527
"1071","BOMET","ALL","71",1099,961,2060
"1072","BOMET","ALL","72",708,645,1353
"1073","BOMET","ALL","73",606,641,1247
"1074","BOMET","ALL","74",523,795,1318
"1075","BOMET","ALL","70-74",4035,4470,8505
"1076","BOMET","ALL","75",489,711,1200
"1077","BOMET","ALL","76",358,478,836
"1078","BOMET","ALL","77",490,569,1059
"1079","BOMET","ALL","78",235,281,516
"1080","BOMET","ALL","79",384,821,1205
"1081","BOMET","ALL","75-79",1956,2860,4816
"1082","BOMET","ALL","80",392,769,1161
"1083","BOMET","ALL","81",225,474,699
"1084","BOMET","ALL","82",218,245,463
"1085","BOMET","ALL","83",236,274,510
"1086","BOMET","ALL","84",248,446,694
"1087","BOMET","ALL","80-84",1319,2208,3527
"1088","BOMET","ALL","85",176,300,476
"1089","BOMET","ALL","86",160,173,333
"1090","BOMET","ALL","87",209,274,483
"1091","BOMET","ALL","88",104,150,254
"1092","BOMET","ALL","89",209,543,752
"1093","BOMET","ALL","85-89",858,1440,2298
"1094","BOMET","ALL","90",109,278,387
"1095","BOMET","ALL","91",74,166,240
"1096","BOMET","ALL","92",55,88,143
"1097","BOMET","ALL","93",51,94,145
"1098","BOMET","ALL","94",59,146,205
"1099","BOMET","ALL","90-94",348,772,1120
"1100","BOMET","ALL","95",102,117,219
"1101","BOMET","ALL","96",34,37,71
"1102","BOMET","ALL","97",45,40,85
"1103","BOMET","ALL","98",20,41,61
"1104","BOMET","ALL","99",42,129,171
"1105","BOMET","ALL","95-99",243,364,607
"1106","BOMET","ALL","100+",73,207,280
"1107","BOMET","ALL","Not Stated",3,2,5
"1108","BOMET","BOMET EAST","Total",71095,73172,144267
"1109","BOMET","BOMET EAST","0",1837,1679,3516
"1110","BOMET","BOMET EAST","1",1788,1853,3641
"1111","BOMET","BOMET EAST","2",2087,1898,3985
"1112","BOMET","BOMET EAST","3",2063,2025,4088
"1113","BOMET","BOMET EAST","4",2240,2009,4249
"1114","BOMET","BOMET EAST","0 - 4",10015,9464,19479
"1115","BOMET","BOMET EAST","5",2197,1913,4110
"1116","BOMET","BOMET EAST","6",2156,1935,4091
"1117","BOMET","BOMET EAST","7",2274,2081,4355
"1118","BOMET","BOMET EAST","8",1964,1850,3814
"1119","BOMET","BOMET EAST","9",2289,2240,4529
"1120","BOMET","BOMET EAST","5-9",10880,10019,20899
"1121","BOMET","BOMET EAST","10",2304,2180,4484
"1122","BOMET","BOMET EAST","11",2125,2088,4213
"1123","BOMET","BOMET EAST","12",2254,2293,4547
"1124","BOMET","BOMET EAST","13",2237,2199,4436
"1125","BOMET","BOMET EAST","14",2156,2067,4223
"1126","BOMET","BOMET EAST","10 -14",11076,10827,21903
"1127","BOMET","BOMET EAST","15",2125,2132,4257
"1128","BOMET","BOMET EAST","16",1955,1842,3797
"1129","BOMET","BOMET EAST","17",1857,1749,3606
"1130","BOMET","BOMET EAST","18",1469,1339,2808
"1131","BOMET","BOMET EAST","19",1931,1761,3692
"1132","BOMET","BOMET EAST","15-19",9337,8823,18160
"1133","BOMET","BOMET EAST","20",1380,1500,2880
"1134","BOMET","BOMET EAST","21",1372,1556,2928
"1135","BOMET","BOMET EAST","22",1108,1367,2475
"1136","BOMET","BOMET EAST","23",1194,1430,2624
"1137","BOMET","BOMET EAST","24",1052,1316,2368
"1138","BOMET","BOMET EAST","20-24",6106,7169,13275
"1139","BOMET","BOMET EAST","25",1092,1235,2327
"1140","BOMET","BOMET EAST","26",922,1062,1984
"1141","BOMET","BOMET EAST","27",1051,1156,2207
"1142","BOMET","BOMET EAST","28",733,870,1603
"1143","BOMET","BOMET EAST","29",919,1112,2031
"1144","BOMET","BOMET EAST","25-29",4717,5435,10152
"1145","BOMET","BOMET EAST","30",1042,1333,2375
"1146","BOMET","BOMET EAST","31",764,1085,1849
"1147","BOMET","BOMET EAST","32",937,1093,2030
"1148","BOMET","BOMET EAST","33",886,1075,1961
"1149","BOMET","BOMET EAST","34",796,926,1722
"1150","BOMET","BOMET EAST","30-34",4425,5512,9937
"1151","BOMET","BOMET EAST","35",936,907,1843
"1152","BOMET","BOMET EAST","36",575,461,1036
"1153","BOMET","BOMET EAST","37",668,562,1230
"1154","BOMET","BOMET EAST","38",366,300,666
"1155","BOMET","BOMET EAST","39",522,429,951
"1156","BOMET","BOMET EAST","35-39",3067,2659,5726
"1157","BOMET","BOMET EAST","40",603,577,1180
"1158","BOMET","BOMET EAST","41",739,818,1557
"1159","BOMET","BOMET EAST","42",548,610,1158
"1160","BOMET","BOMET EAST","43",516,574,1090
"1161","BOMET","BOMET EAST","44",370,462,832
"1162","BOMET","BOMET EAST","40-44",2776,3041,5817
"1163","BOMET","BOMET EAST","45",758,725,1483
"1164","BOMET","BOMET EAST","46",487,528,1015
"1165","BOMET","BOMET EAST","47",520,561,1081
"1166","BOMET","BOMET EAST","48",231,257,488
"1167","BOMET","BOMET EAST","49",381,556,937
"1168","BOMET","BOMET EAST","45-49",2377,2627,5004
"1169","BOMET","BOMET EAST","50",407,426,833
"1170","BOMET","BOMET EAST","51",455,424,879
"1171","BOMET","BOMET EAST","52",244,232,476
"1172","BOMET","BOMET EAST","53",169,174,343
"1173","BOMET","BOMET EAST","54",228,238,466
"1174","BOMET","BOMET EAST","50-54",1503,1494,2997
"1175","BOMET","BOMET EAST","55",190,243,433
"1176","BOMET","BOMET EAST","56",182,210,392
"1177","BOMET","BOMET EAST","57",264,291,555
"1178","BOMET","BOMET EAST","58",379,572,951
"1179","BOMET","BOMET EAST","59",285,289,574
"1180","BOMET","BOMET EAST","55-59",1300,1605,2905
"1181","BOMET","BOMET EAST","60",296,370,666
"1182","BOMET","BOMET EAST","61",280,273,553
"1183","BOMET","BOMET EAST","62",195,210,405
"1184","BOMET","BOMET EAST","63",202,237,439
"1185","BOMET","BOMET EAST","64",188,191,379
"1186","BOMET","BOMET EAST","60-64",1161,1281,2442
"1187","BOMET","BOMET EAST","65",249,282,531
"1188","BOMET","BOMET EAST","66",139,127,266
"1189","BOMET","BOMET EAST","67",217,258,475
"1190","BOMET","BOMET EAST","68",85,122,207
"1191","BOMET","BOMET EAST","69",172,202,374
"1192","BOMET","BOMET EAST","65-69",862,991,1853
"1193","BOMET","BOMET EAST","70",184,245,429
"1194","BOMET","BOMET EAST","71",174,168,342
"1195","BOMET","BOMET EAST","72",115,119,234
"1196","BOMET","BOMET EAST","73",86,108,194
"1197","BOMET","BOMET EAST","74",80,158,238
"1198","BOMET","BOMET EAST","70-74",639,798,1437
"1199","BOMET","BOMET EAST","75",87,136,223
"1200","BOMET","BOMET EAST","76",82,104,186
"1201","BOMET","BOMET EAST","77",89,102,191
"1202","BOMET","BOMET EAST","78",41,58,99
"1203","BOMET","BOMET EAST","79",71,158,229
"1204","BOMET","BOMET EAST","75-79",370,558,928
"1205","BOMET","BOMET EAST","80",80,139,219
"1206","BOMET","BOMET EAST","81",40,77,117
"1207","BOMET","BOMET EAST","82",39,35,74
"1208","BOMET","BOMET EAST","83",34,52,86
"1209","BOMET","BOMET EAST","84",40,80,120
"1210","BOMET","BOMET EAST","80-84",233,383,616
"1211","BOMET","BOMET EAST","85",33,60,93
"1212","BOMET","BOMET EAST","86",25,32,57
"1213","BOMET","BOMET EAST","87",27,58,85
"1214","BOMET","BOMET EAST","88",17,29,46
"1215","BOMET","BOMET EAST","89",33,102,135
"1216","BOMET","BOMET EAST","85-89",135,281,416
"1217","BOMET","BOMET EAST","90",26,45,71
"1218","BOMET","BOMET EAST","91",11,25,36
"1219","BOMET","BOMET EAST","92",10,11,21
"1220","BOMET","BOMET EAST","93",8,16,24
"1221","BOMET","BOMET EAST","94",13,24,37
"1222","BOMET","BOMET EAST","90-94",68,121,189
"1223","BOMET","BOMET EAST","95",20,18,38
"1224","BOMET","BOMET EAST","96",4,10,14
"1225","BOMET","BOMET EAST","97",8,7,15
"1226","BOMET","BOMET EAST","98",2,11,13
"1227","BOMET","BOMET EAST","99",4,10,14
"1228","BOMET","BOMET EAST","95-99",38,56,94
"1229","BOMET","BOMET EAST","100+",10,28,38
"1230","BOMET","BOMET EAST","Not Stated",NA,NA,NA
"1231","BOMET","CHEPALUNGU","Total",79921,84912,164833
"1232","BOMET","CHEPALUNGU","0",1896,1931,3827
"1233","BOMET","CHEPALUNGU","1",1955,1994,3949
"1234","BOMET","CHEPALUNGU","2",2338,2191,4529
"1235","BOMET","CHEPALUNGU","3",2351,2262,4613
"1236","BOMET","CHEPALUNGU","4",2442,2380,4822
"1237","BOMET","CHEPALUNGU","0 - 4",10982,10758,21740
"1238","BOMET","CHEPALUNGU","5",2512,2330,4842
"1239","BOMET","CHEPALUNGU","6",2331,2258,4589
"1240","BOMET","CHEPALUNGU","7",2618,2532,5150
"1241","BOMET","CHEPALUNGU","8",2327,2283,4610
"1242","BOMET","CHEPALUNGU","9",2806,2739,5545
"1243","BOMET","CHEPALUNGU","5-9",12594,12142,24736
"1244","BOMET","CHEPALUNGU","10",2671,2604,5275
"1245","BOMET","CHEPALUNGU","11",2498,2612,5110
"1246","BOMET","CHEPALUNGU","12",2748,2666,5414
"1247","BOMET","CHEPALUNGU","13",2739,2780,5519
"1248","BOMET","CHEPALUNGU","14",2595,2528,5123
"1249","BOMET","CHEPALUNGU","10 -14",13251,13190,26441
"1250","BOMET","CHEPALUNGU","15",2662,2567,5229
"1251","BOMET","CHEPALUNGU","16",2279,2373,4652
"1252","BOMET","CHEPALUNGU","17",2272,2147,4419
"1253","BOMET","CHEPALUNGU","18",1557,1520,3077
"1254","BOMET","CHEPALUNGU","19",2109,2077,4186
"1255","BOMET","CHEPALUNGU","15-19",10879,10684,21563
"1256","BOMET","CHEPALUNGU","20",1491,1687,3178
"1257","BOMET","CHEPALUNGU","21",1387,1693,3080
"1258","BOMET","CHEPALUNGU","22",1247,1489,2736
"1259","BOMET","CHEPALUNGU","23",1331,1586,2917
"1260","BOMET","CHEPALUNGU","24",1095,1298,2393
"1261","BOMET","CHEPALUNGU","20-24",6551,7753,14304
"1262","BOMET","CHEPALUNGU","25",1208,1374,2582
"1263","BOMET","CHEPALUNGU","26",964,1207,2171
"1264","BOMET","CHEPALUNGU","27",922,1326,2248
"1265","BOMET","CHEPALUNGU","28",713,977,1690
"1266","BOMET","CHEPALUNGU","29",884,1161,2045
"1267","BOMET","CHEPALUNGU","25-29",4691,6045,10736
"1268","BOMET","CHEPALUNGU","30",1027,1373,2400
"1269","BOMET","CHEPALUNGU","31",789,1221,2010
"1270","BOMET","CHEPALUNGU","32",1035,1336,2371
"1271","BOMET","CHEPALUNGU","33",866,1180,2046
"1272","BOMET","CHEPALUNGU","34",739,826,1565
"1273","BOMET","CHEPALUNGU","30-34",4456,5936,10392
"1274","BOMET","CHEPALUNGU","35",989,921,1910
"1275","BOMET","CHEPALUNGU","36",565,496,1061
"1276","BOMET","CHEPALUNGU","37",663,574,1237
"1277","BOMET","CHEPALUNGU","38",419,367,786
"1278","BOMET","CHEPALUNGU","39",611,446,1057
"1279","BOMET","CHEPALUNGU","35-39",3247,2804,6051
"1280","BOMET","CHEPALUNGU","40",713,609,1322
"1281","BOMET","CHEPALUNGU","41",903,983,1886
"1282","BOMET","CHEPALUNGU","42",616,627,1243
"1283","BOMET","CHEPALUNGU","43",539,627,1166
"1284","BOMET","CHEPALUNGU","44",443,508,951
"1285","BOMET","CHEPALUNGU","40-44",3214,3354,6568
"1286","BOMET","CHEPALUNGU","45",868,810,1678
"1287","BOMET","CHEPALUNGU","46",529,610,1139
"1288","BOMET","CHEPALUNGU","47",653,749,1402
"1289","BOMET","CHEPALUNGU","48",285,366,651
"1290","BOMET","CHEPALUNGU","49",441,538,979
"1291","BOMET","CHEPALUNGU","45-49",2776,3073,5849
"1292","BOMET","CHEPALUNGU","50",433,496,929
"1293","BOMET","CHEPALUNGU","51",414,466,880
"1294","BOMET","CHEPALUNGU","52",253,300,553
"1295","BOMET","CHEPALUNGU","53",219,222,441
"1296","BOMET","CHEPALUNGU","54",265,277,542
"1297","BOMET","CHEPALUNGU","50-54",1584,1761,3345
"1298","BOMET","CHEPALUNGU","55",204,276,480
"1299","BOMET","CHEPALUNGU","56",257,259,516
"1300","BOMET","CHEPALUNGU","57",297,335,632
"1301","BOMET","CHEPALUNGU","58",440,681,1121
"1302","BOMET","CHEPALUNGU","59",349,394,743
"1303","BOMET","CHEPALUNGU","55-59",1547,1945,3492
"1304","BOMET","CHEPALUNGU","60",338,445,783
"1305","BOMET","CHEPALUNGU","61",290,334,624
"1306","BOMET","CHEPALUNGU","62",216,246,462
"1307","BOMET","CHEPALUNGU","63",243,271,514
"1308","BOMET","CHEPALUNGU","64",172,205,377
"1309","BOMET","CHEPALUNGU","60-64",1259,1501,2760
"1310","BOMET","CHEPALUNGU","65",269,319,588
"1311","BOMET","CHEPALUNGU","66",182,150,332
"1312","BOMET","CHEPALUNGU","67",236,297,533
"1313","BOMET","CHEPALUNGU","68",105,117,222
"1314","BOMET","CHEPALUNGU","69",206,266,472
"1315","BOMET","CHEPALUNGU","65-69",998,1149,2147
"1316","BOMET","CHEPALUNGU","70",231,313,544
"1317","BOMET","CHEPALUNGU","71",238,219,457
"1318","BOMET","CHEPALUNGU","72",127,162,289
"1319","BOMET","CHEPALUNGU","73",132,156,288
"1320","BOMET","CHEPALUNGU","74",115,176,291
"1321","BOMET","CHEPALUNGU","70-74",843,1026,1869
"1322","BOMET","CHEPALUNGU","75",102,152,254
"1323","BOMET","CHEPALUNGU","76",75,98,173
"1324","BOMET","CHEPALUNGU","77",105,98,203
"1325","BOMET","CHEPALUNGU","78",46,64,110
"1326","BOMET","CHEPALUNGU","79",80,204,284
"1327","BOMET","CHEPALUNGU","75-79",408,616,1024
"1328","BOMET","CHEPALUNGU","80",79,168,247
"1329","BOMET","CHEPALUNGU","81",58,124,182
"1330","BOMET","CHEPALUNGU","82",34,65,99
"1331","BOMET","CHEPALUNGU","83",47,51,98
"1332","BOMET","CHEPALUNGU","84",56,124,180
"1333","BOMET","CHEPALUNGU","80-84",274,532,806
"1334","BOMET","CHEPALUNGU","85",47,67,114
"1335","BOMET","CHEPALUNGU","86",31,31,62
"1336","BOMET","CHEPALUNGU","87",45,55,100
"1337","BOMET","CHEPALUNGU","88",29,28,57
"1338","BOMET","CHEPALUNGU","89",50,142,192
"1339","BOMET","CHEPALUNGU","85-89",202,323,525
"1340","BOMET","CHEPALUNGU","90",26,65,91
"1341","BOMET","CHEPALUNGU","91",22,37,59
"1342","BOMET","CHEPALUNGU","92",10,19,29
"1343","BOMET","CHEPALUNGU","93",11,34,45
"1344","BOMET","CHEPALUNGU","94",19,38,57
"1345","BOMET","CHEPALUNGU","90-94",88,193,281
"1346","BOMET","CHEPALUNGU","95",21,28,49
"1347","BOMET","CHEPALUNGU","96",12,7,19
"1348","BOMET","CHEPALUNGU","97",10,9,19
"1349","BOMET","CHEPALUNGU","98",4,11,15
"1350","BOMET","CHEPALUNGU","99",10,28,38
"1351","BOMET","CHEPALUNGU","95-99",57,83,140
"1352","BOMET","CHEPALUNGU","100+",20,44,64
"1353","BOMET","CHEPALUNGU","Not Stated",NA,NA,NA
"1354","BOMET","KONOIN","Total",83120,80384,163504
"1355","BOMET","KONOIN","0",1659,1620,3279
"1356","BOMET","KONOIN","1",1947,1985,3932
"1357","BOMET","KONOIN","2",2034,1987,4021
"1358","BOMET","KONOIN","3",2057,2080,4137
"1359","BOMET","KONOIN","4",2273,2136,4409
"1360","BOMET","KONOIN","0 - 4",9970,9808,19778
"1361","BOMET","KONOIN","5",2191,2034,4225
"1362","BOMET","KONOIN","6",2272,2143,4415
"1363","BOMET","KONOIN","7",2223,2271,4494
"1364","BOMET","KONOIN","8",2067,2089,4156
"1365","BOMET","KONOIN","9",2464,2390,4854
"1366","BOMET","KONOIN","5-9",11217,10927,22144
"1367","BOMET","KONOIN","10",2397,2239,4636
"1368","BOMET","KONOIN","11",2257,2286,4543
"1369","BOMET","KONOIN","12",2493,2373,4866
"1370","BOMET","KONOIN","13",2347,2433,4780
"1371","BOMET","KONOIN","14",2299,2342,4641
"1372","BOMET","KONOIN","10 -14",11793,11673,23466
"1373","BOMET","KONOIN","15",2428,2263,4691
"1374","BOMET","KONOIN","16",2143,2117,4260
"1375","BOMET","KONOIN","17",2001,1890,3891
"1376","BOMET","KONOIN","18",1680,1542,3222
"1377","BOMET","KONOIN","19",1921,1915,3836
"1378","BOMET","KONOIN","15-19",10173,9727,19900
"1379","BOMET","KONOIN","20",1532,1618,3150
"1380","BOMET","KONOIN","21",1580,1666,3246
"1381","BOMET","KONOIN","22",1469,1521,2990
"1382","BOMET","KONOIN","23",1476,1719,3195
"1383","BOMET","KONOIN","24",1390,1430,2820
"1384","BOMET","KONOIN","20-24",7447,7954,15401
"1385","BOMET","KONOIN","25",1580,1701,3281
"1386","BOMET","KONOIN","26",1343,1395,2738
"1387","BOMET","KONOIN","27",1434,1498,2932
"1388","BOMET","KONOIN","28",1086,1239,2325
"1389","BOMET","KONOIN","29",1197,1412,2609
"1390","BOMET","KONOIN","25-29",6640,7245,13885
"1391","BOMET","KONOIN","30",1386,1557,2943
"1392","BOMET","KONOIN","31",1154,1208,2362
"1393","BOMET","KONOIN","32",1426,1527,2953
"1394","BOMET","KONOIN","33",1188,1285,2473
"1395","BOMET","KONOIN","34",1034,954,1988
"1396","BOMET","KONOIN","30-34",6188,6531,12719
"1397","BOMET","KONOIN","35",1390,1042,2432
"1398","BOMET","KONOIN","36",952,667,1619
"1399","BOMET","KONOIN","37",1019,679,1698
"1400","BOMET","KONOIN","38",649,410,1059
"1401","BOMET","KONOIN","39",899,615,1514
"1402","BOMET","KONOIN","35-39",4909,3413,8322
"1403","BOMET","KONOIN","40",1015,758,1773
"1404","BOMET","KONOIN","41",1142,856,1998
"1405","BOMET","KONOIN","42",837,632,1469
"1406","BOMET","KONOIN","43",666,658,1324
"1407","BOMET","KONOIN","44",523,443,966
"1408","BOMET","KONOIN","40-44",4183,3347,7530
"1409","BOMET","KONOIN","45",1187,893,2080
"1410","BOMET","KONOIN","46",722,589,1311
"1411","BOMET","KONOIN","47",718,637,1355
"1412","BOMET","KONOIN","48",399,311,710
"1413","BOMET","KONOIN","49",529,490,1019
"1414","BOMET","KONOIN","45-49",3555,2920,6475
"1415","BOMET","KONOIN","50",558,529,1087
"1416","BOMET","KONOIN","51",521,418,939
"1417","BOMET","KONOIN","52",337,283,620
"1418","BOMET","KONOIN","53",229,176,405
"1419","BOMET","KONOIN","54",290,203,493
"1420","BOMET","KONOIN","50-54",1935,1609,3544
"1421","BOMET","KONOIN","55",232,184,416
"1422","BOMET","KONOIN","56",216,194,410
"1423","BOMET","KONOIN","57",286,343,629
"1424","BOMET","KONOIN","58",500,543,1043
"1425","BOMET","KONOIN","59",354,271,625
"1426","BOMET","KONOIN","55-59",1588,1535,3123
"1427","BOMET","KONOIN","60",338,291,629
"1428","BOMET","KONOIN","61",275,276,551
"1429","BOMET","KONOIN","62",229,197,426
"1430","BOMET","KONOIN","63",207,200,407
"1431","BOMET","KONOIN","64",150,139,289
"1432","BOMET","KONOIN","60-64",1199,1103,2302
"1433","BOMET","KONOIN","65",255,255,510
"1434","BOMET","KONOIN","66",158,129,287
"1435","BOMET","KONOIN","67",220,204,424
"1436","BOMET","KONOIN","68",104,111,215
"1437","BOMET","KONOIN","69",143,155,298
"1438","BOMET","KONOIN","65-69",880,854,1734
"1439","BOMET","KONOIN","70",192,199,391
"1440","BOMET","KONOIN","71",188,139,327
"1441","BOMET","KONOIN","72",123,78,201
"1442","BOMET","KONOIN","73",110,101,211
"1443","BOMET","KONOIN","74",96,109,205
"1444","BOMET","KONOIN","70-74",709,626,1335
"1445","BOMET","KONOIN","75",70,94,164
"1446","BOMET","KONOIN","76",54,70,124
"1447","BOMET","KONOIN","77",83,92,175
"1448","BOMET","KONOIN","78",29,39,68
"1449","BOMET","KONOIN","79",59,111,170
"1450","BOMET","KONOIN","75-79",295,406,701
"1451","BOMET","KONOIN","80",66,132,198
"1452","BOMET","KONOIN","81",39,56,95
"1453","BOMET","KONOIN","82",30,19,49
"1454","BOMET","KONOIN","83",40,33,73
"1455","BOMET","KONOIN","84",42,70,112
"1456","BOMET","KONOIN","80-84",217,310,527
"1457","BOMET","KONOIN","85",25,34,59
"1458","BOMET","KONOIN","86",27,33,60
"1459","BOMET","KONOIN","87",33,49,82
"1460","BOMET","KONOIN","88",15,25,40
"1461","BOMET","KONOIN","89",33,79,112
"1462","BOMET","KONOIN","85-89",133,220,353
"1463","BOMET","KONOIN","90",16,36,52
"1464","BOMET","KONOIN","91",11,20,31
"1465","BOMET","KONOIN","92",12,10,22
"1466","BOMET","KONOIN","93",7,8,15
"1467","BOMET","KONOIN","94",5,18,23
"1468","BOMET","KONOIN","90-94",51,92,143
"1469","BOMET","KONOIN","95",13,18,31
"1470","BOMET","KONOIN","96",5,4,9
"1471","BOMET","KONOIN","97",10,3,13
"1472","BOMET","KONOIN","98",2,7,9
"1473","BOMET","KONOIN","99",5,25,30
"1474","BOMET","KONOIN","95-99",35,57,92
"1475","BOMET","KONOIN","100+",3,27,30
"1476","BOMET","KONOIN","Not Stated",NA,NA,NA
"1477","BOMET","SOTIK","Total",112369,115482,227851
"1478","BOMET","SOTIK","0",2556,2560,5116
"1479","BOMET","SOTIK","1",2786,2634,5420
"1480","BOMET","SOTIK","2",2789,2757,5546
"1481","BOMET","SOTIK","3",2978,3018,5996
"1482","BOMET","SOTIK","4",3207,3081,6288
"1483","BOMET","SOTIK","0 - 4",14316,14050,28366
"1484","BOMET","SOTIK","5",3197,2959,6156
"1485","BOMET","SOTIK","6",3037,3092,6129
"1486","BOMET","SOTIK","7",3245,3202,6447
"1487","BOMET","SOTIK","8",2983,2881,5864
"1488","BOMET","SOTIK","9",3586,3559,7145
"1489","BOMET","SOTIK","5-9",16048,15693,31741
"1490","BOMET","SOTIK","10",3520,3410,6930
"1491","BOMET","SOTIK","11",3353,3545,6898
"1492","BOMET","SOTIK","12",3682,3509,7191
"1493","BOMET","SOTIK","13",3535,3653,7188
"1494","BOMET","SOTIK","14",3463,3430,6893
"1495","BOMET","SOTIK","10 -14",17553,17547,35100
"1496","BOMET","SOTIK","15",3528,3461,6989
"1497","BOMET","SOTIK","16",3102,3076,6178
"1498","BOMET","SOTIK","17",3121,2731,5852
"1499","BOMET","SOTIK","18",2267,2257,4524
"1500","BOMET","SOTIK","19",2917,2700,5617
"1501","BOMET","SOTIK","15-19",14935,14225,29160
"1502","BOMET","SOTIK","20",2142,2197,4339
"1503","BOMET","SOTIK","21",2019,2309,4328
"1504","BOMET","SOTIK","22",1848,2029,3877
"1505","BOMET","SOTIK","23",1875,2277,4152
"1506","BOMET","SOTIK","24",1680,1925,3605
"1507","BOMET","SOTIK","20-24",9564,10737,20301
"1508","BOMET","SOTIK","25",1890,1975,3865
"1509","BOMET","SOTIK","26",1560,1805,3365
"1510","BOMET","SOTIK","27",1603,1883,3486
"1511","BOMET","SOTIK","28",1164,1406,2570
"1512","BOMET","SOTIK","29",1411,1768,3179
"1513","BOMET","SOTIK","25-29",7628,8837,16465
"1514","BOMET","SOTIK","30",1653,2164,3817
"1515","BOMET","SOTIK","31",1265,1656,2921
"1516","BOMET","SOTIK","32",1624,2019,3643
"1517","BOMET","SOTIK","33",1409,1654,3063
"1518","BOMET","SOTIK","34",1270,1390,2660
"1519","BOMET","SOTIK","30-34",7221,8883,16104
"1520","BOMET","SOTIK","35",1633,1567,3200
"1521","BOMET","SOTIK","36",1095,822,1917
"1522","BOMET","SOTIK","37",1228,873,2101
"1523","BOMET","SOTIK","38",720,563,1283
"1524","BOMET","SOTIK","39",988,772,1760
"1525","BOMET","SOTIK","35-39",5664,4597,10261
"1526","BOMET","SOTIK","40",1176,991,2167
"1527","BOMET","SOTIK","41",1239,1201,2440
"1528","BOMET","SOTIK","42",941,880,1821
"1529","BOMET","SOTIK","43",787,800,1587
"1530","BOMET","SOTIK","44",593,643,1236
"1531","BOMET","SOTIK","40-44",4736,4515,9251
"1532","BOMET","SOTIK","45",1423,1200,2623
"1533","BOMET","SOTIK","46",800,887,1687
"1534","BOMET","SOTIK","47",881,964,1845
"1535","BOMET","SOTIK","48",428,458,886
"1536","BOMET","SOTIK","49",722,728,1450
"1537","BOMET","SOTIK","45-49",4254,4237,8491
"1538","BOMET","SOTIK","50",701,720,1421
"1539","BOMET","SOTIK","51",652,610,1262
"1540","BOMET","SOTIK","52",459,446,905
"1541","BOMET","SOTIK","53",360,433,793
"1542","BOMET","SOTIK","54",420,442,862
"1543","BOMET","SOTIK","50-54",2592,2651,5243
"1544","BOMET","SOTIK","55",401,403,804
"1545","BOMET","SOTIK","56",378,413,791
"1546","BOMET","SOTIK","57",408,518,926
"1547","BOMET","SOTIK","58",621,900,1521
"1548","BOMET","SOTIK","59",554,531,1085
"1549","BOMET","SOTIK","55-59",2362,2765,5127
"1550","BOMET","SOTIK","60",537,544,1081
"1551","BOMET","SOTIK","61",433,432,865
"1552","BOMET","SOTIK","62",324,345,669
"1553","BOMET","SOTIK","63",339,368,707
"1554","BOMET","SOTIK","64",255,249,504
"1555","BOMET","SOTIK","60-64",1888,1938,3826
"1556","BOMET","SOTIK","65",369,471,840
"1557","BOMET","SOTIK","66",202,246,448
"1558","BOMET","SOTIK","67",358,348,706
"1559","BOMET","SOTIK","68",143,184,327
"1560","BOMET","SOTIK","69",235,308,543
"1561","BOMET","SOTIK","65-69",1307,1557,2864
"1562","BOMET","SOTIK","70",299,421,720
"1563","BOMET","SOTIK","71",260,251,511
"1564","BOMET","SOTIK","72",177,162,339
"1565","BOMET","SOTIK","73",161,161,322
"1566","BOMET","SOTIK","74",128,203,331
"1567","BOMET","SOTIK","70-74",1025,1198,2223
"1568","BOMET","SOTIK","75",141,197,338
"1569","BOMET","SOTIK","76",72,119,191
"1570","BOMET","SOTIK","77",128,164,292
"1571","BOMET","SOTIK","78",65,69,134
"1572","BOMET","SOTIK","79",101,207,308
"1573","BOMET","SOTIK","75-79",507,756,1263
"1574","BOMET","SOTIK","80",103,223,326
"1575","BOMET","SOTIK","81",62,123,185
"1576","BOMET","SOTIK","82",63,72,135
"1577","BOMET","SOTIK","83",68,81,149
"1578","BOMET","SOTIK","84",67,93,160
"1579","BOMET","SOTIK","80-84",363,592,955
"1580","BOMET","SOTIK","85",45,68,113
"1581","BOMET","SOTIK","86",43,40,83
"1582","BOMET","SOTIK","87",63,61,124
"1583","BOMET","SOTIK","88",28,43,71
"1584","BOMET","SOTIK","89",49,121,170
"1585","BOMET","SOTIK","85-89",228,333,561
"1586","BOMET","SOTIK","90",27,75,102
"1587","BOMET","SOTIK","91",18,42,60
"1588","BOMET","SOTIK","92",15,32,47
"1589","BOMET","SOTIK","93",15,18,33
"1590","BOMET","SOTIK","94",12,33,45
"1591","BOMET","SOTIK","90-94",87,200,287
"1592","BOMET","SOTIK","95",30,24,54
"1593","BOMET","SOTIK","96",10,6,16
"1594","BOMET","SOTIK","97",10,14,24
"1595","BOMET","SOTIK","98",8,5,13
"1596","BOMET","SOTIK","99",7,46,53
"1597","BOMET","SOTIK","95-99",65,95,160
"1598","BOMET","SOTIK","100+",26,75,101
"1599","BOMET","SOTIK","Not Stated",NA,1,1
"1600","BOMET","BOMET CENTRAL","Total",87782,87429,175211
"1601","BOMET","BOMET CENTRAL","0",2067,1963,4030
"1602","BOMET","BOMET CENTRAL","1",2090,1923,4013
"1603","BOMET","BOMET CENTRAL","2",2177,2115,4292
"1604","BOMET","BOMET CENTRAL","3",2235,2330,4565
"1605","BOMET","BOMET CENTRAL","4",2415,2298,4713
"1606","BOMET","BOMET CENTRAL","0 - 4",10984,10629,21613
"1607","BOMET","BOMET CENTRAL","5",2336,2179,4515
"1608","BOMET","BOMET CENTRAL","6",2269,2327,4596
"1609","BOMET","BOMET CENTRAL","7",2347,2311,4658
"1610","BOMET","BOMET CENTRAL","8",2175,2099,4274
"1611","BOMET","BOMET CENTRAL","9",2544,2353,4897
"1612","BOMET","BOMET CENTRAL","5-9",11671,11269,22940
"1613","BOMET","BOMET CENTRAL","10",2419,2309,4728
"1614","BOMET","BOMET CENTRAL","11",2402,2349,4751
"1615","BOMET","BOMET CENTRAL","12",2570,2437,5007
"1616","BOMET","BOMET CENTRAL","13",2459,2624,5083
"1617","BOMET","BOMET CENTRAL","14",2423,2446,4869
"1618","BOMET","BOMET CENTRAL","10 -14",12273,12165,24438
"1619","BOMET","BOMET CENTRAL","15",2461,2376,4837
"1620","BOMET","BOMET CENTRAL","16",2230,2211,4441
"1621","BOMET","BOMET CENTRAL","17",2205,2105,4310
"1622","BOMET","BOMET CENTRAL","18",1728,1642,3370
"1623","BOMET","BOMET CENTRAL","19",2152,2116,4268
"1624","BOMET","BOMET CENTRAL","15-19",10776,10450,21226
"1625","BOMET","BOMET CENTRAL","20",1735,1862,3597
"1626","BOMET","BOMET CENTRAL","21",1863,2030,3893
"1627","BOMET","BOMET CENTRAL","22",1659,1789,3448
"1628","BOMET","BOMET CENTRAL","23",1769,1966,3735
"1629","BOMET","BOMET CENTRAL","24",1541,1697,3238
"1630","BOMET","BOMET CENTRAL","20-24",8567,9344,17911
"1631","BOMET","BOMET CENTRAL","25",1746,1748,3494
"1632","BOMET","BOMET CENTRAL","26",1435,1565,3000
"1633","BOMET","BOMET CENTRAL","27",1522,1604,3126
"1634","BOMET","BOMET CENTRAL","28",1128,1222,2350
"1635","BOMET","BOMET CENTRAL","29",1327,1451,2778
"1636","BOMET","BOMET CENTRAL","25-29",7158,7590,14748
"1637","BOMET","BOMET CENTRAL","30",1482,1812,3294
"1638","BOMET","BOMET CENTRAL","31",1248,1346,2594
"1639","BOMET","BOMET CENTRAL","32",1420,1495,2915
"1640","BOMET","BOMET CENTRAL","33",1310,1544,2854
"1641","BOMET","BOMET CENTRAL","34",1139,1139,2278
"1642","BOMET","BOMET CENTRAL","30-34",6599,7336,13935
"1643","BOMET","BOMET CENTRAL","35",1507,1282,2789
"1644","BOMET","BOMET CENTRAL","36",964,713,1677
"1645","BOMET","BOMET CENTRAL","37",1008,686,1694
"1646","BOMET","BOMET CENTRAL","38",562,455,1017
"1647","BOMET","BOMET CENTRAL","39",849,650,1499
"1648","BOMET","BOMET CENTRAL","35-39",4890,3786,8676
"1649","BOMET","BOMET CENTRAL","40",874,683,1557
"1650","BOMET","BOMET CENTRAL","41",1001,816,1817
"1651","BOMET","BOMET CENTRAL","42",675,664,1339
"1652","BOMET","BOMET CENTRAL","43",714,649,1363
"1653","BOMET","BOMET CENTRAL","44",452,517,969
"1654","BOMET","BOMET CENTRAL","40-44",3716,3329,7045
"1655","BOMET","BOMET CENTRAL","45",1167,960,2127
"1656","BOMET","BOMET CENTRAL","46",660,634,1294
"1657","BOMET","BOMET CENTRAL","47",706,700,1406
"1658","BOMET","BOMET CENTRAL","48",351,347,698
"1659","BOMET","BOMET CENTRAL","49",486,511,997
"1660","BOMET","BOMET CENTRAL","45-49",3370,3152,6522
"1661","BOMET","BOMET CENTRAL","50",558,552,1110
"1662","BOMET","BOMET CENTRAL","51",470,494,964
"1663","BOMET","BOMET CENTRAL","52",300,303,603
"1664","BOMET","BOMET CENTRAL","53",205,210,415
"1665","BOMET","BOMET CENTRAL","54",311,286,597
"1666","BOMET","BOMET CENTRAL","50-54",1844,1845,3689
"1667","BOMET","BOMET CENTRAL","55",273,279,552
"1668","BOMET","BOMET CENTRAL","56",278,284,562
"1669","BOMET","BOMET CENTRAL","57",336,384,720
"1670","BOMET","BOMET CENTRAL","58",451,576,1027
"1671","BOMET","BOMET CENTRAL","59",420,323,743
"1672","BOMET","BOMET CENTRAL","55-59",1758,1846,3604
"1673","BOMET","BOMET CENTRAL","60",409,379,788
"1674","BOMET","BOMET CENTRAL","61",343,312,655
"1675","BOMET","BOMET CENTRAL","62",232,226,458
"1676","BOMET","BOMET CENTRAL","63",273,256,529
"1677","BOMET","BOMET CENTRAL","64",171,195,366
"1678","BOMET","BOMET CENTRAL","60-64",1428,1368,2796
"1679","BOMET","BOMET CENTRAL","65",305,328,633
"1680","BOMET","BOMET CENTRAL","66",164,151,315
"1681","BOMET","BOMET CENTRAL","67",289,278,567
"1682","BOMET","BOMET CENTRAL","68",102,94,196
"1683","BOMET","BOMET CENTRAL","69",182,176,358
"1684","BOMET","BOMET CENTRAL","65-69",1042,1027,2069
"1685","BOMET","BOMET CENTRAL","70",193,250,443
"1686","BOMET","BOMET CENTRAL","71",239,184,423
"1687","BOMET","BOMET CENTRAL","72",166,124,290
"1688","BOMET","BOMET CENTRAL","73",117,115,232
"1689","BOMET","BOMET CENTRAL","74",104,149,253
"1690","BOMET","BOMET CENTRAL","70-74",819,822,1641
"1691","BOMET","BOMET CENTRAL","75",89,132,221
"1692","BOMET","BOMET CENTRAL","76",75,87,162
"1693","BOMET","BOMET CENTRAL","77",85,113,198
"1694","BOMET","BOMET CENTRAL","78",54,51,105
"1695","BOMET","BOMET CENTRAL","79",73,141,214
"1696","BOMET","BOMET CENTRAL","75-79",376,524,900
"1697","BOMET","BOMET CENTRAL","80",64,107,171
"1698","BOMET","BOMET CENTRAL","81",26,94,120
"1699","BOMET","BOMET CENTRAL","82",52,54,106
"1700","BOMET","BOMET CENTRAL","83",47,57,104
"1701","BOMET","BOMET CENTRAL","84",43,79,122
"1702","BOMET","BOMET CENTRAL","80-84",232,391,623
"1703","BOMET","BOMET CENTRAL","85",26,71,97
"1704","BOMET","BOMET CENTRAL","86",34,37,71
"1705","BOMET","BOMET CENTRAL","87",41,51,92
"1706","BOMET","BOMET CENTRAL","88",15,25,40
"1707","BOMET","BOMET CENTRAL","89",44,99,143
"1708","BOMET","BOMET CENTRAL","85-89",160,283,443
"1709","BOMET","BOMET CENTRAL","90",14,57,71
"1710","BOMET","BOMET CENTRAL","91",12,42,54
"1711","BOMET","BOMET CENTRAL","92",8,16,24
"1712","BOMET","BOMET CENTRAL","93",10,18,28
"1713","BOMET","BOMET CENTRAL","94",10,33,43
"1714","BOMET","BOMET CENTRAL","90-94",54,166,220
"1715","BOMET","BOMET CENTRAL","95",18,29,47
"1716","BOMET","BOMET CENTRAL","96",3,10,13
"1717","BOMET","BOMET CENTRAL","97",7,7,14
"1718","BOMET","BOMET CENTRAL","98",4,7,11
"1719","BOMET","BOMET CENTRAL","99",16,20,36
"1720","BOMET","BOMET CENTRAL","95-99",48,73,121
"1721","BOMET","BOMET CENTRAL","100+",14,33,47
"1722","BOMET","BOMET CENTRAL","Not Stated",3,1,4
"1723","BUNGOMA","ALL","Total",812146,858389,1670535
"1724","BUNGOMA","ALL","0",19903,20290,40193
"1725","BUNGOMA","ALL","1",20926,21076,42002
"1726","BUNGOMA","ALL","2",21576,21681,43257
"1727","BUNGOMA","ALL","3",23106,23590,46696
"1728","BUNGOMA","ALL","4",23594,23432,47026
"1729","BUNGOMA","ALL","0 - 4",109105,110069,219174
"1730","BUNGOMA","ALL","5",25439,24790,50229
"1731","BUNGOMA","ALL","6",25041,25479,50520
"1732","BUNGOMA","ALL","7",25199,25081,50280
"1733","BUNGOMA","ALL","8",23313,23875,47188
"1734","BUNGOMA","ALL","9",27830,27261,55091
"1735","BUNGOMA","ALL","5-9",126822,126486,253308
"1736","BUNGOMA","ALL","10",27036,27013,54049
"1737","BUNGOMA","ALL","11",25654,26436,52090
"1738","BUNGOMA","ALL","12",27412,26868,54280
"1739","BUNGOMA","ALL","13",27634,28358,55992
"1740","BUNGOMA","ALL","14",25297,25246,50543
"1741","BUNGOMA","ALL","10 -14",133033,133921,266954
"1742","BUNGOMA","ALL","15",25840,25347,51187
"1743","BUNGOMA","ALL","16",22352,22670,45022
"1744","BUNGOMA","ALL","17",23783,23071,46854
"1745","BUNGOMA","ALL","18",17525,16457,33982
"1746","BUNGOMA","ALL","19",19837,18940,38777
"1747","BUNGOMA","ALL","15-19",109337,106485,215822
"1748","BUNGOMA","ALL","20",15497,16646,32143
"1749","BUNGOMA","ALL","21",13828,14901,28729
"1750","BUNGOMA","ALL","22",12263,14158,26421
"1751","BUNGOMA","ALL","23",13097,15338,28435
"1752","BUNGOMA","ALL","24",10930,13119,24049
"1753","BUNGOMA","ALL","20-24",65615,74162,139777
"1754","BUNGOMA","ALL","25",12374,14866,27240
"1755","BUNGOMA","ALL","26",9712,11968,21680
"1756","BUNGOMA","ALL","27",10713,12502,23215
"1757","BUNGOMA","ALL","28",7514,9228,16742
"1758","BUNGOMA","ALL","29",9144,10568,19712
"1759","BUNGOMA","ALL","25-29",49457,59132,108589
"1760","BUNGOMA","ALL","30",10799,13518,24317
"1761","BUNGOMA","ALL","31",9101,11776,20877
"1762","BUNGOMA","ALL","32",10807,13350,24157
"1763","BUNGOMA","ALL","33",8598,10288,18886
"1764","BUNGOMA","ALL","34",7310,8068,15378
"1765","BUNGOMA","ALL","30-34",46615,57000,103615
"1766","BUNGOMA","ALL","35",9550,9492,19042
"1767","BUNGOMA","ALL","36",7206,7007,14213
"1768","BUNGOMA","ALL","37",7463,7112,14575
"1769","BUNGOMA","ALL","38",5287,5551,10838
"1770","BUNGOMA","ALL","39",6256,6324,12580
"1771","BUNGOMA","ALL","35-39",35762,35486,71248
"1772","BUNGOMA","ALL","40",6845,7255,14100
"1773","BUNGOMA","ALL","41",7080,7959,15039
"1774","BUNGOMA","ALL","42",6950,7614,14564
"1775","BUNGOMA","ALL","43",6552,7071,13623
"1776","BUNGOMA","ALL","44",4608,4967,9575
"1777","BUNGOMA","ALL","40-44",32035,34866,66901
"1778","BUNGOMA","ALL","45",7471,7277,14748
"1779","BUNGOMA","ALL","46",5428,5512,10940
"1780","BUNGOMA","ALL","47",5819,5843,11662
"1781","BUNGOMA","ALL","48",3580,3895,7475
"1782","BUNGOMA","ALL","49",4286,4314,8600
"1783","BUNGOMA","ALL","45-49",26584,26841,53425
"1784","BUNGOMA","ALL","50",4737,5538,10275
"1785","BUNGOMA","ALL","51",4259,4809,9068
"1786","BUNGOMA","ALL","52",3660,4022,7682
"1787","BUNGOMA","ALL","53",3107,3895,7002
"1788","BUNGOMA","ALL","54",3262,3837,7099
"1789","BUNGOMA","ALL","50-54",19025,22101,41126
"1790","BUNGOMA","ALL","55",3791,4223,8014
"1791","BUNGOMA","ALL","56",3590,4181,7771
"1792","BUNGOMA","ALL","57",3867,5052,8919
"1793","BUNGOMA","ALL","58",2903,3384,6287
"1794","BUNGOMA","ALL","59",4277,4426,8703
"1795","BUNGOMA","ALL","55-59",18428,21266,39694
"1796","BUNGOMA","ALL","60",3765,3967,7732
"1797","BUNGOMA","ALL","61",3196,3624,6820
"1798","BUNGOMA","ALL","62",2490,2780,5270
"1799","BUNGOMA","ALL","63",2968,3480,6448
"1800","BUNGOMA","ALL","64",2059,2438,4497
"1801","BUNGOMA","ALL","60-64",14478,16289,30767
"1802","BUNGOMA","ALL","65",2782,3366,6148
"1803","BUNGOMA","ALL","66",1668,2099,3767
"1804","BUNGOMA","ALL","67",2225,2935,5160
"1805","BUNGOMA","ALL","68",1128,1364,2492
"1806","BUNGOMA","ALL","69",1943,2213,4156
"1807","BUNGOMA","ALL","65-69",9746,11977,21723
"1808","BUNGOMA","ALL","70",1699,2176,3875
"1809","BUNGOMA","ALL","71",1550,2034,3584
"1810","BUNGOMA","ALL","72",1214,1509,2723
"1811","BUNGOMA","ALL","73",1252,1646,2898
"1812","BUNGOMA","ALL","74",1035,1290,2325
"1813","BUNGOMA","ALL","70-74",6750,8655,15405
"1814","BUNGOMA","ALL","75",1001,1424,2425
"1815","BUNGOMA","ALL","76",808,1144,1952
"1816","BUNGOMA","ALL","77",977,1673,2650
"1817","BUNGOMA","ALL","78",634,713,1347
"1818","BUNGOMA","ALL","79",608,886,1494
"1819","BUNGOMA","ALL","75-79",4028,5840,9868
"1820","BUNGOMA","ALL","80",795,1111,1906
"1821","BUNGOMA","ALL","81",500,664,1164
"1822","BUNGOMA","ALL","82",509,660,1169
"1823","BUNGOMA","ALL","83",659,982,1641
"1824","BUNGOMA","ALL","84",378,479,857
"1825","BUNGOMA","ALL","80-84",2841,3896,6737
"1826","BUNGOMA","ALL","85",448,644,1092
"1827","BUNGOMA","ALL","86",255,412,667
"1828","BUNGOMA","ALL","87",451,708,1159
"1829","BUNGOMA","ALL","88",178,214,392
"1830","BUNGOMA","ALL","89",297,525,822
"1831","BUNGOMA","ALL","85-89",1629,2503,4132
"1832","BUNGOMA","ALL","90",177,217,394
"1833","BUNGOMA","ALL","91",166,239,405
"1834","BUNGOMA","ALL","92",96,156,252
"1835","BUNGOMA","ALL","93",68,155,223
"1836","BUNGOMA","ALL","94",48,81,129
"1837","BUNGOMA","ALL","90-94",555,848,1403
"1838","BUNGOMA","ALL","95",117,173,290
"1839","BUNGOMA","ALL","96",36,51,87
"1840","BUNGOMA","ALL","97",61,137,198
"1841","BUNGOMA","ALL","98",14,46,60
"1842","BUNGOMA","ALL","99",25,58,83
"1843","BUNGOMA","ALL","95-99",253,465,718
"1844","BUNGOMA","ALL","100+",41,100,141
"1845","BUNGOMA","ALL","Not Stated",7,1,8
"1846","BUNGOMA","BUMULA","Total",103368,112523,215891
"1847","BUNGOMA","BUMULA","0",2567,2674,5241
"1848","BUNGOMA","BUMULA","1",2619,2701,5320
"1849","BUNGOMA","BUMULA","2",2707,2797,5504
"1850","BUNGOMA","BUMULA","3",2990,3057,6047
"1851","BUNGOMA","BUMULA","4",3090,3093,6183
"1852","BUNGOMA","BUMULA","0 - 4",13973,14322,28295
"1853","BUNGOMA","BUMULA","5",3392,3443,6835
"1854","BUNGOMA","BUMULA","6",3354,3460,6814
"1855","BUNGOMA","BUMULA","7",3440,3357,6797
"1856","BUNGOMA","BUMULA","8",3185,3178,6363
"1857","BUNGOMA","BUMULA","9",3666,3690,7356
"1858","BUNGOMA","BUMULA","5-9",17037,17128,34165
"1859","BUNGOMA","BUMULA","10",3636,3637,7273
"1860","BUNGOMA","BUMULA","11",3537,3580,7117
"1861","BUNGOMA","BUMULA","12",3637,3609,7246
"1862","BUNGOMA","BUMULA","13",3644,3855,7499
"1863","BUNGOMA","BUMULA","14",3401,3437,6838
"1864","BUNGOMA","BUMULA","10 -14",17855,18118,35973
"1865","BUNGOMA","BUMULA","15",3591,3444,7035
"1866","BUNGOMA","BUMULA","16",2942,3071,6013
"1867","BUNGOMA","BUMULA","17",3133,3136,6269
"1868","BUNGOMA","BUMULA","18",2168,2120,4288
"1869","BUNGOMA","BUMULA","19",2542,2445,4987
"1870","BUNGOMA","BUMULA","15-19",14376,14216,28592
"1871","BUNGOMA","BUMULA","20",1922,2147,4069
"1872","BUNGOMA","BUMULA","21",1787,1919,3706
"1873","BUNGOMA","BUMULA","22",1397,1715,3112
"1874","BUNGOMA","BUMULA","23",1478,1806,3284
"1875","BUNGOMA","BUMULA","24",1265,1680,2945
"1876","BUNGOMA","BUMULA","20-24",7849,9267,17116
"1877","BUNGOMA","BUMULA","25",1414,1887,3301
"1878","BUNGOMA","BUMULA","26",1114,1580,2694
"1879","BUNGOMA","BUMULA","27",1276,1604,2880
"1880","BUNGOMA","BUMULA","28",875,1200,2075
"1881","BUNGOMA","BUMULA","29",1040,1348,2388
"1882","BUNGOMA","BUMULA","25-29",5719,7619,13338
"1883","BUNGOMA","BUMULA","30",1183,1695,2878
"1884","BUNGOMA","BUMULA","31",1122,1592,2714
"1885","BUNGOMA","BUMULA","32",1237,1727,2964
"1886","BUNGOMA","BUMULA","33",950,1300,2250
"1887","BUNGOMA","BUMULA","34",822,940,1762
"1888","BUNGOMA","BUMULA","30-34",5314,7254,12568
"1889","BUNGOMA","BUMULA","35",1077,1106,2183
"1890","BUNGOMA","BUMULA","36",804,800,1604
"1891","BUNGOMA","BUMULA","37",937,851,1788
"1892","BUNGOMA","BUMULA","38",583,682,1265
"1893","BUNGOMA","BUMULA","39",802,725,1527
"1894","BUNGOMA","BUMULA","35-39",4203,4164,8367
"1895","BUNGOMA","BUMULA","40",742,841,1583
"1896","BUNGOMA","BUMULA","41",873,1003,1876
"1897","BUNGOMA","BUMULA","42",828,886,1714
"1898","BUNGOMA","BUMULA","43",848,951,1799
"1899","BUNGOMA","BUMULA","44",611,604,1215
"1900","BUNGOMA","BUMULA","40-44",3902,4285,8187
"1901","BUNGOMA","BUMULA","45",898,919,1817
"1902","BUNGOMA","BUMULA","46",595,643,1238
"1903","BUNGOMA","BUMULA","47",743,720,1463
"1904","BUNGOMA","BUMULA","48",403,442,845
"1905","BUNGOMA","BUMULA","49",474,502,976
"1906","BUNGOMA","BUMULA","45-49",3113,3226,6339
"1907","BUNGOMA","BUMULA","50",539,730,1269
"1908","BUNGOMA","BUMULA","51",558,692,1250
"1909","BUNGOMA","BUMULA","52",431,560,991
"1910","BUNGOMA","BUMULA","53",398,556,954
"1911","BUNGOMA","BUMULA","54",361,483,844
"1912","BUNGOMA","BUMULA","50-54",2287,3021,5308
"1913","BUNGOMA","BUMULA","55",523,535,1058
"1914","BUNGOMA","BUMULA","56",447,510,957
"1915","BUNGOMA","BUMULA","57",464,687,1151
"1916","BUNGOMA","BUMULA","58",340,386,726
"1917","BUNGOMA","BUMULA","59",554,586,1140
"1918","BUNGOMA","BUMULA","55-59",2328,2704,5032
"1919","BUNGOMA","BUMULA","60",442,544,986
"1920","BUNGOMA","BUMULA","61",400,494,894
"1921","BUNGOMA","BUMULA","62",319,332,651
"1922","BUNGOMA","BUMULA","63",366,538,904
"1923","BUNGOMA","BUMULA","64",255,332,587
"1924","BUNGOMA","BUMULA","60-64",1782,2240,4022
"1925","BUNGOMA","BUMULA","65",383,567,950
"1926","BUNGOMA","BUMULA","66",178,289,467
"1927","BUNGOMA","BUMULA","67",329,487,816
"1928","BUNGOMA","BUMULA","68",137,170,307
"1929","BUNGOMA","BUMULA","69",297,292,589
"1930","BUNGOMA","BUMULA","65-69",1324,1805,3129
"1931","BUNGOMA","BUMULA","70",227,294,521
"1932","BUNGOMA","BUMULA","71",208,339,547
"1933","BUNGOMA","BUMULA","72",159,196,355
"1934","BUNGOMA","BUMULA","73",174,254,428
"1935","BUNGOMA","BUMULA","74",149,198,347
"1936","BUNGOMA","BUMULA","70-74",917,1281,2198
"1937","BUNGOMA","BUMULA","75",159,229,388
"1938","BUNGOMA","BUMULA","76",133,137,270
"1939","BUNGOMA","BUMULA","77",159,244,403
"1940","BUNGOMA","BUMULA","78",110,114,224
"1941","BUNGOMA","BUMULA","79",89,118,207
"1942","BUNGOMA","BUMULA","75-79",650,842,1492
"1943","BUNGOMA","BUMULA","80",116,150,266
"1944","BUNGOMA","BUMULA","81",65,84,149
"1945","BUNGOMA","BUMULA","82",70,104,174
"1946","BUNGOMA","BUMULA","83",95,129,224
"1947","BUNGOMA","BUMULA","84",63,58,121
"1948","BUNGOMA","BUMULA","80-84",409,525,934
"1949","BUNGOMA","BUMULA","85",66,75,141
"1950","BUNGOMA","BUMULA","86",30,47,77
"1951","BUNGOMA","BUMULA","87",64,111,175
"1952","BUNGOMA","BUMULA","88",33,29,62
"1953","BUNGOMA","BUMULA","89",38,76,114
"1954","BUNGOMA","BUMULA","85-89",231,338,569
"1955","BUNGOMA","BUMULA","90",21,25,46
"1956","BUNGOMA","BUMULA","91",22,31,53
"1957","BUNGOMA","BUMULA","92",9,23,32
"1958","BUNGOMA","BUMULA","93",5,13,18
"1959","BUNGOMA","BUMULA","94",6,16,22
"1960","BUNGOMA","BUMULA","90-94",63,108,171
"1961","BUNGOMA","BUMULA","95",12,14,26
"1962","BUNGOMA","BUMULA","96",6,2,8
"1963","BUNGOMA","BUMULA","97",9,16,25
"1964","BUNGOMA","BUMULA","98",3,9,12
"1965","BUNGOMA","BUMULA","99",3,7,10
"1966","BUNGOMA","BUMULA","95-99",33,48,81
"1967","BUNGOMA","BUMULA","100+",3,12,15
"1968","BUNGOMA","BUMULA","Not Stated",NA,NA,NA
"1969","BUNGOMA","BUNGOMA CENTRAL","Total",86302,91438,177740
"1970","BUNGOMA","BUNGOMA CENTRAL","0",2201,2160,4361
"1971","BUNGOMA","BUNGOMA CENTRAL","1",2220,2271,4491
"1972","BUNGOMA","BUNGOMA CENTRAL","2",2236,2299,4535
"1973","BUNGOMA","BUNGOMA CENTRAL","3",2413,2398,4811
"1974","BUNGOMA","BUNGOMA CENTRAL","4",2523,2438,4961
"1975","BUNGOMA","BUNGOMA CENTRAL","0 - 4",11593,11566,23159
"1976","BUNGOMA","BUNGOMA CENTRAL","5",2686,2578,5264
"1977","BUNGOMA","BUNGOMA CENTRAL","6",2577,2727,5304
"1978","BUNGOMA","BUNGOMA CENTRAL","7",2548,2632,5180
"1979","BUNGOMA","BUNGOMA CENTRAL","8",2435,2610,5045
"1980","BUNGOMA","BUNGOMA CENTRAL","9",2972,2893,5865
"1981","BUNGOMA","BUNGOMA CENTRAL","5-9",13218,13440,26658
"1982","BUNGOMA","BUNGOMA CENTRAL","10",2866,2933,5799
"1983","BUNGOMA","BUNGOMA CENTRAL","11",2610,2774,5384
"1984","BUNGOMA","BUNGOMA CENTRAL","12",2868,2903,5771
"1985","BUNGOMA","BUNGOMA CENTRAL","13",2848,3000,5848
"1986","BUNGOMA","BUNGOMA CENTRAL","14",2665,2814,5479
"1987","BUNGOMA","BUNGOMA CENTRAL","10 -14",13857,14424,28281
"1988","BUNGOMA","BUNGOMA CENTRAL","15",2802,2738,5540
"1989","BUNGOMA","BUNGOMA CENTRAL","16",2411,2469,4880
"1990","BUNGOMA","BUNGOMA CENTRAL","17",2556,2435,4991
"1991","BUNGOMA","BUNGOMA CENTRAL","18",1902,1762,3664
"1992","BUNGOMA","BUNGOMA CENTRAL","19",2164,2007,4171
"1993","BUNGOMA","BUNGOMA CENTRAL","15-19",11835,11411,23246
"1994","BUNGOMA","BUNGOMA CENTRAL","20",1670,1742,3412
"1995","BUNGOMA","BUNGOMA CENTRAL","21",1431,1551,2982
"1996","BUNGOMA","BUNGOMA CENTRAL","22",1241,1451,2692
"1997","BUNGOMA","BUNGOMA CENTRAL","23",1421,1573,2994
"1998","BUNGOMA","BUNGOMA CENTRAL","24",1145,1337,2482
"1999","BUNGOMA","BUNGOMA CENTRAL","20-24",6908,7654,14562
"2000","BUNGOMA","BUNGOMA CENTRAL","25",1333,1592,2925
"2001","BUNGOMA","BUNGOMA CENTRAL","26",1064,1246,2310
"2002","BUNGOMA","BUNGOMA CENTRAL","27",1157,1329,2486
"2003","BUNGOMA","BUNGOMA CENTRAL","28",807,953,1760
"2004","BUNGOMA","BUNGOMA CENTRAL","29",980,1170,2150
"2005","BUNGOMA","BUNGOMA CENTRAL","25-29",5341,6290,11631
"2006","BUNGOMA","BUNGOMA CENTRAL","30",1095,1423,2518
"2007","BUNGOMA","BUNGOMA CENTRAL","31",937,1271,2208
"2008","BUNGOMA","BUNGOMA CENTRAL","32",1177,1383,2560
"2009","BUNGOMA","BUNGOMA CENTRAL","33",952,1098,2050
"2010","BUNGOMA","BUNGOMA CENTRAL","34",743,854,1597
"2011","BUNGOMA","BUNGOMA CENTRAL","30-34",4904,6029,10933
"2012","BUNGOMA","BUNGOMA CENTRAL","35",1036,1064,2100
"2013","BUNGOMA","BUNGOMA CENTRAL","36",733,708,1441
"2014","BUNGOMA","BUNGOMA CENTRAL","37",815,771,1586
"2015","BUNGOMA","BUNGOMA CENTRAL","38",609,631,1240
"2016","BUNGOMA","BUNGOMA CENTRAL","39",676,711,1387
"2017","BUNGOMA","BUNGOMA CENTRAL","35-39",3869,3885,7754
"2018","BUNGOMA","BUNGOMA CENTRAL","40",732,825,1557
"2019","BUNGOMA","BUNGOMA CENTRAL","41",783,878,1661
"2020","BUNGOMA","BUNGOMA CENTRAL","42",796,781,1577
"2021","BUNGOMA","BUNGOMA CENTRAL","43",678,777,1455
"2022","BUNGOMA","BUNGOMA CENTRAL","44",510,551,1061
"2023","BUNGOMA","BUNGOMA CENTRAL","40-44",3499,3812,7311
"2024","BUNGOMA","BUNGOMA CENTRAL","45",807,755,1562
"2025","BUNGOMA","BUNGOMA CENTRAL","46",545,592,1137
"2026","BUNGOMA","BUNGOMA CENTRAL","47",633,638,1271
"2027","BUNGOMA","BUNGOMA CENTRAL","48",374,392,766
"2028","BUNGOMA","BUNGOMA CENTRAL","49",466,448,914
"2029","BUNGOMA","BUNGOMA CENTRAL","45-49",2825,2825,5650
"2030","BUNGOMA","BUNGOMA CENTRAL","50",527,599,1126
"2031","BUNGOMA","BUNGOMA CENTRAL","51",474,480,954
"2032","BUNGOMA","BUNGOMA CENTRAL","52",404,423,827
"2033","BUNGOMA","BUNGOMA CENTRAL","53",305,419,724
"2034","BUNGOMA","BUNGOMA CENTRAL","54",358,390,748
"2035","BUNGOMA","BUNGOMA CENTRAL","50-54",2068,2311,4379
"2036","BUNGOMA","BUNGOMA CENTRAL","55",407,405,812
"2037","BUNGOMA","BUNGOMA CENTRAL","56",369,421,790
"2038","BUNGOMA","BUNGOMA CENTRAL","57",421,583,1004
"2039","BUNGOMA","BUNGOMA CENTRAL","58",314,372,686
"2040","BUNGOMA","BUNGOMA CENTRAL","59",461,457,918
"2041","BUNGOMA","BUNGOMA CENTRAL","55-59",1972,2238,4210
"2042","BUNGOMA","BUNGOMA CENTRAL","60",435,414,849
"2043","BUNGOMA","BUNGOMA CENTRAL","61",328,385,713
"2044","BUNGOMA","BUNGOMA CENTRAL","62",241,293,534
"2045","BUNGOMA","BUNGOMA CENTRAL","63",295,357,652
"2046","BUNGOMA","BUNGOMA CENTRAL","64",215,247,462
"2047","BUNGOMA","BUNGOMA CENTRAL","60-64",1514,1696,3210
"2048","BUNGOMA","BUNGOMA CENTRAL","65",312,380,692
"2049","BUNGOMA","BUNGOMA CENTRAL","66",186,224,410
"2050","BUNGOMA","BUNGOMA CENTRAL","67",218,306,524
"2051","BUNGOMA","BUNGOMA CENTRAL","68",124,155,279
"2052","BUNGOMA","BUNGOMA CENTRAL","69",202,274,476
"2053","BUNGOMA","BUNGOMA CENTRAL","65-69",1042,1339,2381
"2054","BUNGOMA","BUNGOMA CENTRAL","70",198,257,455
"2055","BUNGOMA","BUNGOMA CENTRAL","71",160,214,374
"2056","BUNGOMA","BUNGOMA CENTRAL","72",132,155,287
"2057","BUNGOMA","BUNGOMA CENTRAL","73",166,167,333
"2058","BUNGOMA","BUNGOMA CENTRAL","74",119,142,261
"2059","BUNGOMA","BUNGOMA CENTRAL","70-74",775,935,1710
"2060","BUNGOMA","BUNGOMA CENTRAL","75",130,150,280
"2061","BUNGOMA","BUNGOMA CENTRAL","76",103,124,227
"2062","BUNGOMA","BUNGOMA CENTRAL","77",100,206,306
"2063","BUNGOMA","BUNGOMA CENTRAL","78",76,94,170
"2064","BUNGOMA","BUNGOMA CENTRAL","79",63,98,161
"2065","BUNGOMA","BUNGOMA CENTRAL","75-79",472,672,1144
"2066","BUNGOMA","BUNGOMA CENTRAL","80",80,144,224
"2067","BUNGOMA","BUNGOMA CENTRAL","81",55,69,124
"2068","BUNGOMA","BUNGOMA CENTRAL","82",62,70,132
"2069","BUNGOMA","BUNGOMA CENTRAL","83",68,121,189
"2070","BUNGOMA","BUNGOMA CENTRAL","84",38,64,102
"2071","BUNGOMA","BUNGOMA CENTRAL","80-84",303,468,771
"2072","BUNGOMA","BUNGOMA CENTRAL","85",60,84,144
"2073","BUNGOMA","BUNGOMA CENTRAL","86",39,57,96
"2074","BUNGOMA","BUNGOMA CENTRAL","87",54,70,124
"2075","BUNGOMA","BUNGOMA CENTRAL","88",19,29,48
"2076","BUNGOMA","BUNGOMA CENTRAL","89",39,69,108
"2077","BUNGOMA","BUNGOMA CENTRAL","85-89",211,309,520
"2078","BUNGOMA","BUNGOMA CENTRAL","90",21,17,38
"2079","BUNGOMA","BUNGOMA CENTRAL","91",16,24,40
"2080","BUNGOMA","BUNGOMA CENTRAL","92",11,20,31
"2081","BUNGOMA","BUNGOMA CENTRAL","93",13,16,29
"2082","BUNGOMA","BUNGOMA CENTRAL","94",6,7,13
"2083","BUNGOMA","BUNGOMA CENTRAL","90-94",67,84,151
"2084","BUNGOMA","BUNGOMA CENTRAL","95",9,13,22
"2085","BUNGOMA","BUNGOMA CENTRAL","96",3,4,7
"2086","BUNGOMA","BUNGOMA CENTRAL","97",6,11,17
"2087","BUNGOMA","BUNGOMA CENTRAL","98",2,5,7
"2088","BUNGOMA","BUNGOMA CENTRAL","99",3,4,7
"2089","BUNGOMA","BUNGOMA CENTRAL","95-99",23,37,60
"2090","BUNGOMA","BUNGOMA CENTRAL","100+",6,13,19
"2091","BUNGOMA","BUNGOMA CENTRAL","Not Stated",NA,NA,NA
"2092","BUNGOMA","BUNGOMA EAST","Total",55775,58771,114546
"2093","BUNGOMA","BUNGOMA EAST","0",1347,1321,2668
"2094","BUNGOMA","BUNGOMA EAST","1",1348,1307,2655
"2095","BUNGOMA","BUNGOMA EAST","2",1390,1412,2802
"2096","BUNGOMA","BUNGOMA EAST","3",1566,1573,3139
"2097","BUNGOMA","BUNGOMA EAST","4",1440,1523,2963
"2098","BUNGOMA","BUNGOMA EAST","0 - 4",7091,7136,14227
"2099","BUNGOMA","BUNGOMA EAST","5",1601,1581,3182
"2100","BUNGOMA","BUNGOMA EAST","6",1607,1640,3247
"2101","BUNGOMA","BUNGOMA EAST","7",1784,1730,3514
"2102","BUNGOMA","BUNGOMA EAST","8",1568,1561,3129
"2103","BUNGOMA","BUNGOMA EAST","9",1920,1883,3803
"2104","BUNGOMA","BUNGOMA EAST","5-9",8480,8395,16875
"2105","BUNGOMA","BUNGOMA EAST","10",1795,1868,3663
"2106","BUNGOMA","BUNGOMA EAST","11",1809,1841,3650
"2107","BUNGOMA","BUNGOMA EAST","12",1951,1827,3778
"2108","BUNGOMA","BUNGOMA EAST","13",1927,2010,3937
"2109","BUNGOMA","BUNGOMA EAST","14",1736,1730,3466
"2110","BUNGOMA","BUNGOMA EAST","10 -14",9218,9276,18494
"2111","BUNGOMA","BUNGOMA EAST","15",1804,1796,3600
"2112","BUNGOMA","BUNGOMA EAST","16",1565,1618,3183
"2113","BUNGOMA","BUNGOMA EAST","17",1721,1607,3328
"2114","BUNGOMA","BUNGOMA EAST","18",1283,1153,2436
"2115","BUNGOMA","BUNGOMA EAST","19",1486,1249,2735
"2116","BUNGOMA","BUNGOMA EAST","15-19",7859,7423,15282
"2117","BUNGOMA","BUNGOMA EAST","20",1044,1113,2157
"2118","BUNGOMA","BUNGOMA EAST","21",993,942,1935
"2119","BUNGOMA","BUNGOMA EAST","22",826,938,1764
"2120","BUNGOMA","BUNGOMA EAST","23",801,1034,1835
"2121","BUNGOMA","BUNGOMA EAST","24",685,877,1562
"2122","BUNGOMA","BUNGOMA EAST","20-24",4349,4904,9253
"2123","BUNGOMA","BUNGOMA EAST","25",778,984,1762
"2124","BUNGOMA","BUNGOMA EAST","26",580,782,1362
"2125","BUNGOMA","BUNGOMA EAST","27",590,809,1399
"2126","BUNGOMA","BUNGOMA EAST","28",487,589,1076
"2127","BUNGOMA","BUNGOMA EAST","29",599,696,1295
"2128","BUNGOMA","BUNGOMA EAST","25-29",3034,3860,6894
"2129","BUNGOMA","BUNGOMA EAST","30",676,906,1582
"2130","BUNGOMA","BUNGOMA EAST","31",594,775,1369
"2131","BUNGOMA","BUNGOMA EAST","32",753,915,1668
"2132","BUNGOMA","BUNGOMA EAST","33",593,737,1330
"2133","BUNGOMA","BUNGOMA EAST","34",481,558,1039
"2134","BUNGOMA","BUNGOMA EAST","30-34",3097,3891,6988
"2135","BUNGOMA","BUNGOMA EAST","35",617,670,1287
"2136","BUNGOMA","BUNGOMA EAST","36",478,481,959
"2137","BUNGOMA","BUNGOMA EAST","37",545,511,1056
"2138","BUNGOMA","BUNGOMA EAST","38",377,411,788
"2139","BUNGOMA","BUNGOMA EAST","39",478,465,943
"2140","BUNGOMA","BUNGOMA EAST","35-39",2495,2538,5033
"2141","BUNGOMA","BUNGOMA EAST","40",490,556,1046
"2142","BUNGOMA","BUNGOMA EAST","41",488,576,1064
"2143","BUNGOMA","BUNGOMA EAST","42",514,553,1067
"2144","BUNGOMA","BUNGOMA EAST","43",470,474,944
"2145","BUNGOMA","BUNGOMA EAST","44",323,388,711
"2146","BUNGOMA","BUNGOMA EAST","40-44",2285,2547,4832
"2147","BUNGOMA","BUNGOMA EAST","45",523,519,1042
"2148","BUNGOMA","BUNGOMA EAST","46",388,429,817
"2149","BUNGOMA","BUNGOMA EAST","47",357,415,772
"2150","BUNGOMA","BUNGOMA EAST","48",251,288,539
"2151","BUNGOMA","BUNGOMA EAST","49",344,318,662
"2152","BUNGOMA","BUNGOMA EAST","45-49",1863,1969,3832
"2153","BUNGOMA","BUNGOMA EAST","50",358,384,742
"2154","BUNGOMA","BUNGOMA EAST","51",304,344,648
"2155","BUNGOMA","BUNGOMA EAST","52",289,279,568
"2156","BUNGOMA","BUNGOMA EAST","53",225,255,480
"2157","BUNGOMA","BUNGOMA EAST","54",243,276,519
"2158","BUNGOMA","BUNGOMA EAST","50-54",1419,1538,2957
"2159","BUNGOMA","BUNGOMA EAST","55",273,289,562
"2160","BUNGOMA","BUNGOMA EAST","56",292,299,591
"2161","BUNGOMA","BUNGOMA EAST","57",328,350,678
"2162","BUNGOMA","BUNGOMA EAST","58",207,253,460
"2163","BUNGOMA","BUNGOMA EAST","59",310,312,622
"2164","BUNGOMA","BUNGOMA EAST","55-59",1410,1503,2913
"2165","BUNGOMA","BUNGOMA EAST","60",299,290,589
"2166","BUNGOMA","BUNGOMA EAST","61",255,281,536
"2167","BUNGOMA","BUNGOMA EAST","62",198,231,429
"2168","BUNGOMA","BUNGOMA EAST","63",230,262,492
"2169","BUNGOMA","BUNGOMA EAST","64",172,178,350
"2170","BUNGOMA","BUNGOMA EAST","60-64",1154,1242,2396
"2171","BUNGOMA","BUNGOMA EAST","65",201,258,459
"2172","BUNGOMA","BUNGOMA EAST","66",126,175,301
"2173","BUNGOMA","BUNGOMA EAST","67",163,209,372
"2174","BUNGOMA","BUNGOMA EAST","68",87,101,188
"2175","BUNGOMA","BUNGOMA EAST","69",164,165,329
"2176","BUNGOMA","BUNGOMA EAST","65-69",741,908,1649
"2177","BUNGOMA","BUNGOMA EAST","70",131,184,315
"2178","BUNGOMA","BUNGOMA EAST","71",129,156,285
"2179","BUNGOMA","BUNGOMA EAST","72",106,112,218
"2180","BUNGOMA","BUNGOMA EAST","73",108,139,247
"2181","BUNGOMA","BUNGOMA EAST","74",96,94,190
"2182","BUNGOMA","BUNGOMA EAST","70-74",570,685,1255
"2183","BUNGOMA","BUNGOMA EAST","75",80,101,181
"2184","BUNGOMA","BUNGOMA EAST","76",62,85,147
"2185","BUNGOMA","BUNGOMA EAST","77",58,111,169
"2186","BUNGOMA","BUNGOMA EAST","78",36,56,92
"2187","BUNGOMA","BUNGOMA EAST","79",48,63,111
"2188","BUNGOMA","BUNGOMA EAST","75-79",284,416,700
"2189","BUNGOMA","BUNGOMA EAST","80",79,83,162
"2190","BUNGOMA","BUNGOMA EAST","81",34,50,84
"2191","BUNGOMA","BUNGOMA EAST","82",36,42,78
"2192","BUNGOMA","BUNGOMA EAST","83",60,69,129
"2193","BUNGOMA","BUNGOMA EAST","84",34,39,73
"2194","BUNGOMA","BUNGOMA EAST","80-84",243,283,526
"2195","BUNGOMA","BUNGOMA EAST","85",32,45,77
"2196","BUNGOMA","BUNGOMA EAST","86",22,22,44
"2197","BUNGOMA","BUNGOMA EAST","87",36,44,80
"2198","BUNGOMA","BUNGOMA EAST","88",13,15,28
"2199","BUNGOMA","BUNGOMA EAST","89",22,29,51
"2200","BUNGOMA","BUNGOMA EAST","85-89",125,155,280
"2201","BUNGOMA","BUNGOMA EAST","90",18,19,37
"2202","BUNGOMA","BUNGOMA EAST","91",5,14,19
"2203","BUNGOMA","BUNGOMA EAST","92",4,17,21
"2204","BUNGOMA","BUNGOMA EAST","93",4,13,17
"2205","BUNGOMA","BUNGOMA EAST","94",6,4,10
"2206","BUNGOMA","BUNGOMA EAST","90-94",37,67,104
"2207","BUNGOMA","BUNGOMA EAST","95",7,10,17
"2208","BUNGOMA","BUNGOMA EAST","96",3,6,9
"2209","BUNGOMA","BUNGOMA EAST","97",3,5,8
"2210","BUNGOMA","BUNGOMA EAST","98",NA,5,5
"2211","BUNGOMA","BUNGOMA EAST","99",3,3,6
"2212","BUNGOMA","BUNGOMA EAST","95-99",16,29,45
"2213","BUNGOMA","BUNGOMA EAST","100+",4,5,9
"2214","BUNGOMA","BUNGOMA EAST","Not Stated",1,1,2
"2215","BUNGOMA","BUNGOMA NORTH","Total",58790,62526,121316
"2216","BUNGOMA","BUNGOMA NORTH","0",1469,1498,2967
"2217","BUNGOMA","BUNGOMA NORTH","1",1484,1480,2964
"2218","BUNGOMA","BUNGOMA NORTH","2",1528,1527,3055
"2219","BUNGOMA","BUNGOMA NORTH","3",1630,1691,3321
"2220","BUNGOMA","BUNGOMA NORTH","4",1722,1686,3408
"2221","BUNGOMA","BUNGOMA NORTH","0 - 4",7833,7882,15715
"2222","BUNGOMA","BUNGOMA NORTH","5",1789,1683,3472
"2223","BUNGOMA","BUNGOMA NORTH","6",1750,1775,3525
"2224","BUNGOMA","BUNGOMA NORTH","7",1801,1773,3574
"2225","BUNGOMA","BUNGOMA NORTH","8",1715,1713,3428
"2226","BUNGOMA","BUNGOMA NORTH","9",1982,1888,3870
"2227","BUNGOMA","BUNGOMA NORTH","5-9",9037,8832,17869
"2228","BUNGOMA","BUNGOMA NORTH","10",2019,2058,4077
"2229","BUNGOMA","BUNGOMA NORTH","11",1895,1940,3835
"2230","BUNGOMA","BUNGOMA NORTH","12",2053,1999,4052
"2231","BUNGOMA","BUNGOMA NORTH","13",2050,2201,4251
"2232","BUNGOMA","BUNGOMA NORTH","14",1923,1910,3833
"2233","BUNGOMA","BUNGOMA NORTH","10 -14",9940,10108,20048
"2234","BUNGOMA","BUNGOMA NORTH","15",1928,1892,3820
"2235","BUNGOMA","BUNGOMA NORTH","16",1769,1789,3558
"2236","BUNGOMA","BUNGOMA NORTH","17",1845,1817,3662
"2237","BUNGOMA","BUNGOMA NORTH","18",1491,1250,2741
"2238","BUNGOMA","BUNGOMA NORTH","19",1542,1383,2925
"2239","BUNGOMA","BUNGOMA NORTH","15-19",8575,8131,16706
"2240","BUNGOMA","BUNGOMA NORTH","20",1215,1123,2338
"2241","BUNGOMA","BUNGOMA NORTH","21",1011,1032,2043
"2242","BUNGOMA","BUNGOMA NORTH","22",920,979,1899
"2243","BUNGOMA","BUNGOMA NORTH","23",921,1019,1940
"2244","BUNGOMA","BUNGOMA NORTH","24",727,827,1554
"2245","BUNGOMA","BUNGOMA NORTH","20-24",4794,4980,9774
"2246","BUNGOMA","BUNGOMA NORTH","25",766,925,1691
"2247","BUNGOMA","BUNGOMA NORTH","26",626,786,1412
"2248","BUNGOMA","BUNGOMA NORTH","27",661,826,1487
"2249","BUNGOMA","BUNGOMA NORTH","28",479,609,1088
"2250","BUNGOMA","BUNGOMA NORTH","29",568,735,1303
"2251","BUNGOMA","BUNGOMA NORTH","25-29",3100,3881,6981
"2252","BUNGOMA","BUNGOMA NORTH","30",731,881,1612
"2253","BUNGOMA","BUNGOMA NORTH","31",565,717,1282
"2254","BUNGOMA","BUNGOMA NORTH","32",653,882,1535
"2255","BUNGOMA","BUNGOMA NORTH","33",559,683,1242
"2256","BUNGOMA","BUNGOMA NORTH","34",482,596,1078
"2257","BUNGOMA","BUNGOMA NORTH","30-34",2990,3759,6749
"2258","BUNGOMA","BUNGOMA NORTH","35",565,626,1191
"2259","BUNGOMA","BUNGOMA NORTH","36",411,500,911
"2260","BUNGOMA","BUNGOMA NORTH","37",476,504,980
"2261","BUNGOMA","BUNGOMA NORTH","38",346,373,719
"2262","BUNGOMA","BUNGOMA NORTH","39",378,469,847
"2263","BUNGOMA","BUNGOMA NORTH","35-39",2176,2472,4648
"2264","BUNGOMA","BUNGOMA NORTH","40",485,544,1029
"2265","BUNGOMA","BUNGOMA NORTH","41",452,592,1044
"2266","BUNGOMA","BUNGOMA NORTH","42",487,589,1076
"2267","BUNGOMA","BUNGOMA NORTH","43",474,603,1077
"2268","BUNGOMA","BUNGOMA NORTH","44",348,404,752
"2269","BUNGOMA","BUNGOMA NORTH","40-44",2246,2732,4978
"2270","BUNGOMA","BUNGOMA NORTH","45",508,599,1107
"2271","BUNGOMA","BUNGOMA NORTH","46",334,429,763
"2272","BUNGOMA","BUNGOMA NORTH","47",411,463,874
"2273","BUNGOMA","BUNGOMA NORTH","48",291,346,637
"2274","BUNGOMA","BUNGOMA NORTH","49",332,403,735
"2275","BUNGOMA","BUNGOMA NORTH","45-49",1876,2240,4116
"2276","BUNGOMA","BUNGOMA NORTH","50",421,495,916
"2277","BUNGOMA","BUNGOMA NORTH","51",319,463,782
"2278","BUNGOMA","BUNGOMA NORTH","52",325,382,707
"2279","BUNGOMA","BUNGOMA NORTH","53",257,336,593
"2280","BUNGOMA","BUNGOMA NORTH","54",272,372,644
"2281","BUNGOMA","BUNGOMA NORTH","50-54",1594,2048,3642
"2282","BUNGOMA","BUNGOMA NORTH","55",309,357,666
"2283","BUNGOMA","BUNGOMA NORTH","56",287,373,660
"2284","BUNGOMA","BUNGOMA NORTH","57",320,399,719
"2285","BUNGOMA","BUNGOMA NORTH","58",246,283,529
"2286","BUNGOMA","BUNGOMA NORTH","59",312,364,676
"2287","BUNGOMA","BUNGOMA NORTH","55-59",1474,1776,3250
"2288","BUNGOMA","BUNGOMA NORTH","60",317,309,626
"2289","BUNGOMA","BUNGOMA NORTH","61",285,289,574
"2290","BUNGOMA","BUNGOMA NORTH","62",244,242,486
"2291","BUNGOMA","BUNGOMA NORTH","63",282,275,557
"2292","BUNGOMA","BUNGOMA NORTH","64",165,167,332
"2293","BUNGOMA","BUNGOMA NORTH","60-64",1293,1282,2575
"2294","BUNGOMA","BUNGOMA NORTH","65",238,219,457
"2295","BUNGOMA","BUNGOMA NORTH","66",148,136,284
"2296","BUNGOMA","BUNGOMA NORTH","67",157,197,354
"2297","BUNGOMA","BUNGOMA NORTH","68",95,95,190
"2298","BUNGOMA","BUNGOMA NORTH","69",149,152,301
"2299","BUNGOMA","BUNGOMA NORTH","65-69",787,799,1586
"2300","BUNGOMA","BUNGOMA NORTH","70",104,138,242
"2301","BUNGOMA","BUNGOMA NORTH","71",114,124,238
"2302","BUNGOMA","BUNGOMA NORTH","72",89,105,194
"2303","BUNGOMA","BUNGOMA NORTH","73",55,127,182
"2304","BUNGOMA","BUNGOMA NORTH","74",60,97,157
"2305","BUNGOMA","BUNGOMA NORTH","70-74",422,591,1013
"2306","BUNGOMA","BUNGOMA NORTH","75",64,94,158
"2307","BUNGOMA","BUNGOMA NORTH","76",40,97,137
"2308","BUNGOMA","BUNGOMA NORTH","77",61,115,176
"2309","BUNGOMA","BUNGOMA NORTH","78",38,53,91
"2310","BUNGOMA","BUNGOMA NORTH","79",37,72,109
"2311","BUNGOMA","BUNGOMA NORTH","75-79",240,431,671
"2312","BUNGOMA","BUNGOMA NORTH","80",57,80,137
"2313","BUNGOMA","BUNGOMA NORTH","81",46,57,103
"2314","BUNGOMA","BUNGOMA NORTH","82",45,46,91
"2315","BUNGOMA","BUNGOMA NORTH","83",43,93,136
"2316","BUNGOMA","BUNGOMA NORTH","84",25,32,57
"2317","BUNGOMA","BUNGOMA NORTH","80-84",216,308,524
"2318","BUNGOMA","BUNGOMA NORTH","85",44,43,87
"2319","BUNGOMA","BUNGOMA NORTH","86",24,25,49
"2320","BUNGOMA","BUNGOMA NORTH","87",43,63,106
"2321","BUNGOMA","BUNGOMA NORTH","88",10,17,27
"2322","BUNGOMA","BUNGOMA NORTH","89",26,32,58
"2323","BUNGOMA","BUNGOMA NORTH","85-89",147,180,327
"2324","BUNGOMA","BUNGOMA NORTH","90",7,24,31
"2325","BUNGOMA","BUNGOMA NORTH","91",12,14,26
"2326","BUNGOMA","BUNGOMA NORTH","92",8,13,21
"2327","BUNGOMA","BUNGOMA NORTH","93",4,14,18
"2328","BUNGOMA","BUNGOMA NORTH","94",2,2,4
"2329","BUNGOMA","BUNGOMA NORTH","90-94",33,67,100
"2330","BUNGOMA","BUNGOMA NORTH","95",7,10,17
"2331","BUNGOMA","BUNGOMA NORTH","96",2,3,5
"2332","BUNGOMA","BUNGOMA NORTH","97",4,6,10
"2333","BUNGOMA","BUNGOMA NORTH","98",1,1,2
"2334","BUNGOMA","BUNGOMA NORTH","99",NA,4,4
"2335","BUNGOMA","BUNGOMA NORTH","95-99",14,24,38
"2336","BUNGOMA","BUNGOMA NORTH","100+",2,3,5
"2337","BUNGOMA","BUNGOMA NORTH","Not Stated",1,NA,1
"2338","BUNGOMA","BUNGOMA SOUTH","Total",139705,148055,287760
"2339","BUNGOMA","BUNGOMA SOUTH","0",3363,3427,6790
"2340","BUNGOMA","BUNGOMA SOUTH","1",3760,3693,7453
"2341","BUNGOMA","BUNGOMA SOUTH","2",3592,3592,7184
"2342","BUNGOMA","BUNGOMA SOUTH","3",3718,3893,7611
"2343","BUNGOMA","BUNGOMA SOUTH","4",3797,3795,7592
"2344","BUNGOMA","BUNGOMA SOUTH","0 - 4",18230,18400,36630
"2345","BUNGOMA","BUNGOMA SOUTH","5",4053,3874,7927
"2346","BUNGOMA","BUNGOMA SOUTH","6",3936,3993,7929
"2347","BUNGOMA","BUNGOMA SOUTH","7",3916,3895,7811
"2348","BUNGOMA","BUNGOMA SOUTH","8",3500,3788,7288
"2349","BUNGOMA","BUNGOMA SOUTH","9",4243,4238,8481
"2350","BUNGOMA","BUNGOMA SOUTH","5-9",19648,19788,39436
"2351","BUNGOMA","BUNGOMA SOUTH","10",4272,4346,8618
"2352","BUNGOMA","BUNGOMA SOUTH","11",3742,4137,7879
"2353","BUNGOMA","BUNGOMA SOUTH","12",4165,4042,8207
"2354","BUNGOMA","BUNGOMA SOUTH","13",4251,4384,8635
"2355","BUNGOMA","BUNGOMA SOUTH","14",3847,3994,7841
"2356","BUNGOMA","BUNGOMA SOUTH","10 -14",20277,20903,41180
"2357","BUNGOMA","BUNGOMA SOUTH","15",3851,4014,7865
"2358","BUNGOMA","BUNGOMA SOUTH","16",3407,3699,7106
"2359","BUNGOMA","BUNGOMA SOUTH","17",3686,3891,7577
"2360","BUNGOMA","BUNGOMA SOUTH","18",2891,3006,5897
"2361","BUNGOMA","BUNGOMA SOUTH","19",3317,3466,6783
"2362","BUNGOMA","BUNGOMA SOUTH","15-19",17152,18076,35228
"2363","BUNGOMA","BUNGOMA SOUTH","20",2785,3208,5993
"2364","BUNGOMA","BUNGOMA SOUTH","21",2607,3043,5650
"2365","BUNGOMA","BUNGOMA SOUTH","22",2599,3120,5719
"2366","BUNGOMA","BUNGOMA SOUTH","23",2938,3434,6372
"2367","BUNGOMA","BUNGOMA SOUTH","24",2515,2886,5401
"2368","BUNGOMA","BUNGOMA SOUTH","20-24",13444,15691,29135
"2369","BUNGOMA","BUNGOMA SOUTH","25",2795,3168,5963
"2370","BUNGOMA","BUNGOMA SOUTH","26",2174,2501,4675
"2371","BUNGOMA","BUNGOMA SOUTH","27",2337,2687,5024
"2372","BUNGOMA","BUNGOMA SOUTH","28",1773,2031,3804
"2373","BUNGOMA","BUNGOMA SOUTH","29",2006,2116,4122
"2374","BUNGOMA","BUNGOMA SOUTH","25-29",11085,12503,23588
"2375","BUNGOMA","BUNGOMA SOUTH","30",2508,2917,5425
"2376","BUNGOMA","BUNGOMA SOUTH","31",1855,2252,4107
"2377","BUNGOMA","BUNGOMA SOUTH","32",2231,2706,4937
"2378","BUNGOMA","BUNGOMA SOUTH","33",1725,2000,3725
"2379","BUNGOMA","BUNGOMA SOUTH","34",1534,1630,3164
"2380","BUNGOMA","BUNGOMA SOUTH","30-34",9853,11505,21358
"2381","BUNGOMA","BUNGOMA SOUTH","35",1933,1898,3831
"2382","BUNGOMA","BUNGOMA SOUTH","36",1510,1393,2903
"2383","BUNGOMA","BUNGOMA SOUTH","37",1446,1407,2853
"2384","BUNGOMA","BUNGOMA SOUTH","38",1094,1124,2218
"2385","BUNGOMA","BUNGOMA SOUTH","39",1293,1195,2488
"2386","BUNGOMA","BUNGOMA SOUTH","35-39",7276,7017,14293
"2387","BUNGOMA","BUNGOMA SOUTH","40",1514,1387,2901
"2388","BUNGOMA","BUNGOMA SOUTH","41",1333,1308,2641
"2389","BUNGOMA","BUNGOMA SOUTH","42",1285,1253,2538
"2390","BUNGOMA","BUNGOMA SOUTH","43",1233,1172,2405
"2391","BUNGOMA","BUNGOMA SOUTH","44",825,870,1695
"2392","BUNGOMA","BUNGOMA SOUTH","40-44",6190,5990,12180
"2393","BUNGOMA","BUNGOMA SOUTH","45",1343,1246,2589
"2394","BUNGOMA","BUNGOMA SOUTH","46",940,886,1826
"2395","BUNGOMA","BUNGOMA SOUTH","47",1067,991,2058
"2396","BUNGOMA","BUNGOMA SOUTH","48",628,656,1284
"2397","BUNGOMA","BUNGOMA SOUTH","49",752,720,1472
"2398","BUNGOMA","BUNGOMA SOUTH","45-49",4730,4499,9229
"2399","BUNGOMA","BUNGOMA SOUTH","50",901,899,1800
"2400","BUNGOMA","BUNGOMA SOUTH","51",722,712,1434
"2401","BUNGOMA","BUNGOMA SOUTH","52",590,647,1237
"2402","BUNGOMA","BUNGOMA SOUTH","53",531,598,1129
"2403","BUNGOMA","BUNGOMA SOUTH","54",562,582,1144
"2404","BUNGOMA","BUNGOMA SOUTH","50-54",3306,3438,6744
"2405","BUNGOMA","BUNGOMA SOUTH","55",587,630,1217
"2406","BUNGOMA","BUNGOMA SOUTH","56",606,628,1234
"2407","BUNGOMA","BUNGOMA SOUTH","57",618,715,1333
"2408","BUNGOMA","BUNGOMA SOUTH","58",429,503,932
"2409","BUNGOMA","BUNGOMA SOUTH","59",604,644,1248
"2410","BUNGOMA","BUNGOMA SOUTH","55-59",2844,3120,5964
"2411","BUNGOMA","BUNGOMA SOUTH","60",548,598,1146
"2412","BUNGOMA","BUNGOMA SOUTH","61",492,541,1033
"2413","BUNGOMA","BUNGOMA SOUTH","62",342,377,719
"2414","BUNGOMA","BUNGOMA SOUTH","63",435,494,929
"2415","BUNGOMA","BUNGOMA SOUTH","64",292,367,659
"2416","BUNGOMA","BUNGOMA SOUTH","60-64",2109,2377,4486
"2417","BUNGOMA","BUNGOMA SOUTH","65",410,480,890
"2418","BUNGOMA","BUNGOMA SOUTH","66",259,304,563
"2419","BUNGOMA","BUNGOMA SOUTH","67",340,449,789
"2420","BUNGOMA","BUNGOMA SOUTH","68",146,181,327
"2421","BUNGOMA","BUNGOMA SOUTH","69",280,327,607
"2422","BUNGOMA","BUNGOMA SOUTH","65-69",1435,1741,3176
"2423","BUNGOMA","BUNGOMA SOUTH","70",246,304,550
"2424","BUNGOMA","BUNGOMA SOUTH","71",190,293,483
"2425","BUNGOMA","BUNGOMA SOUTH","72",149,215,364
"2426","BUNGOMA","BUNGOMA SOUTH","73",170,260,430
"2427","BUNGOMA","BUNGOMA SOUTH","74",155,196,351
"2428","BUNGOMA","BUNGOMA SOUTH","70-74",910,1268,2178
"2429","BUNGOMA","BUNGOMA SOUTH","75",123,186,309
"2430","BUNGOMA","BUNGOMA SOUTH","76",118,152,270
"2431","BUNGOMA","BUNGOMA SOUTH","77",148,212,360
"2432","BUNGOMA","BUNGOMA SOUTH","78",94,90,184
"2433","BUNGOMA","BUNGOMA SOUTH","79",73,120,193
"2434","BUNGOMA","BUNGOMA SOUTH","75-79",556,760,1316
"2435","BUNGOMA","BUNGOMA SOUTH","80",109,175,284
"2436","BUNGOMA","BUNGOMA SOUTH","81",55,83,138
"2437","BUNGOMA","BUNGOMA SOUTH","82",71,83,154
"2438","BUNGOMA","BUNGOMA SOUTH","83",88,108,196
"2439","BUNGOMA","BUNGOMA SOUTH","84",49,58,107
"2440","BUNGOMA","BUNGOMA SOUTH","80-84",372,507,879
"2441","BUNGOMA","BUNGOMA SOUTH","85",60,96,156
"2442","BUNGOMA","BUNGOMA SOUTH","86",29,49,78
"2443","BUNGOMA","BUNGOMA SOUTH","87",56,89,145
"2444","BUNGOMA","BUNGOMA SOUTH","88",12,19,31
"2445","BUNGOMA","BUNGOMA SOUTH","89",34,60,94
"2446","BUNGOMA","BUNGOMA SOUTH","85-89",191,313,504
"2447","BUNGOMA","BUNGOMA SOUTH","90",17,26,43
"2448","BUNGOMA","BUNGOMA SOUTH","91",25,28,53
"2449","BUNGOMA","BUNGOMA SOUTH","92",8,4,12
"2450","BUNGOMA","BUNGOMA SOUTH","93",8,12,20
"2451","BUNGOMA","BUNGOMA SOUTH","94",2,7,9
"2452","BUNGOMA","BUNGOMA SOUTH","90-94",60,77,137
"2453","BUNGOMA","BUNGOMA SOUTH","95",16,32,48
"2454","BUNGOMA","BUNGOMA SOUTH","96",4,5,9
"2455","BUNGOMA","BUNGOMA SOUTH","97",7,15,22
"2456","BUNGOMA","BUNGOMA SOUTH","98",1,6,7
"2457","BUNGOMA","BUNGOMA SOUTH","99",2,11,13
"2458","BUNGOMA","BUNGOMA SOUTH","95-99",30,69,99
"2459","BUNGOMA","BUNGOMA SOUTH","100+",5,13,18
"2460","BUNGOMA","BUNGOMA SOUTH","Not Stated",2,NA,2
"2461","BUNGOMA","CHEPTAIS","Total",67717,68312,136029
"2462","BUNGOMA","CHEPTAIS","0",1697,1790,3487
"2463","BUNGOMA","CHEPTAIS","1",1935,1985,3920
"2464","BUNGOMA","CHEPTAIS","2",2090,2103,4193
"2465","BUNGOMA","CHEPTAIS","3",2225,2239,4464
"2466","BUNGOMA","CHEPTAIS","4",2286,2227,4513
"2467","BUNGOMA","CHEPTAIS","0 - 4",10233,10344,20577
"2468","BUNGOMA","CHEPTAIS","5",2529,2390,4919
"2469","BUNGOMA","CHEPTAIS","6",2398,2365,4763
"2470","BUNGOMA","CHEPTAIS","7",2385,2361,4746
"2471","BUNGOMA","CHEPTAIS","8",2100,2143,4243
"2472","BUNGOMA","CHEPTAIS","9",2609,2393,5002
"2473","BUNGOMA","CHEPTAIS","5-9",12021,11652,23673
"2474","BUNGOMA","CHEPTAIS","10",2278,2162,4440
"2475","BUNGOMA","CHEPTAIS","11",2389,2263,4652
"2476","BUNGOMA","CHEPTAIS","12",2355,2314,4669
"2477","BUNGOMA","CHEPTAIS","13",2427,2328,4755
"2478","BUNGOMA","CHEPTAIS","14",2152,2000,4152
"2479","BUNGOMA","CHEPTAIS","10 -14",11601,11067,22668
"2480","BUNGOMA","CHEPTAIS","15",2188,2010,4198
"2481","BUNGOMA","CHEPTAIS","16",1776,1612,3388
"2482","BUNGOMA","CHEPTAIS","17",1854,1772,3626
"2483","BUNGOMA","CHEPTAIS","18",1237,1151,2388
"2484","BUNGOMA","CHEPTAIS","19",1524,1508,3032
"2485","BUNGOMA","CHEPTAIS","15-19",8579,8053,16632
"2486","BUNGOMA","CHEPTAIS","20",1206,1276,2482
"2487","BUNGOMA","CHEPTAIS","21",1133,1113,2246
"2488","BUNGOMA","CHEPTAIS","22",998,1054,2052
"2489","BUNGOMA","CHEPTAIS","23",1001,1157,2158
"2490","BUNGOMA","CHEPTAIS","24",867,997,1864
"2491","BUNGOMA","CHEPTAIS","20-24",5205,5597,10802
"2492","BUNGOMA","CHEPTAIS","25",1036,1123,2159
"2493","BUNGOMA","CHEPTAIS","26",795,890,1685
"2494","BUNGOMA","CHEPTAIS","27",930,923,1853
"2495","BUNGOMA","CHEPTAIS","28",587,606,1193
"2496","BUNGOMA","CHEPTAIS","29",739,799,1538
"2497","BUNGOMA","CHEPTAIS","25-29",4087,4341,8428
"2498","BUNGOMA","CHEPTAIS","30",918,999,1917
"2499","BUNGOMA","CHEPTAIS","31",811,969,1780
"2500","BUNGOMA","CHEPTAIS","32",909,993,1902
"2501","BUNGOMA","CHEPTAIS","33",672,793,1465
"2502","BUNGOMA","CHEPTAIS","34",634,592,1226
"2503","BUNGOMA","CHEPTAIS","30-34",3944,4346,8290
"2504","BUNGOMA","CHEPTAIS","35",831,687,1518
"2505","BUNGOMA","CHEPTAIS","36",627,452,1079
"2506","BUNGOMA","CHEPTAIS","37",559,447,1006
"2507","BUNGOMA","CHEPTAIS","38",321,268,589
"2508","BUNGOMA","CHEPTAIS","39",389,357,746
"2509","BUNGOMA","CHEPTAIS","35-39",2727,2211,4938
"2510","BUNGOMA","CHEPTAIS","40",416,410,826
"2511","BUNGOMA","CHEPTAIS","41",536,594,1130
"2512","BUNGOMA","CHEPTAIS","42",503,580,1083
"2513","BUNGOMA","CHEPTAIS","43",384,429,813
"2514","BUNGOMA","CHEPTAIS","44",259,273,532
"2515","BUNGOMA","CHEPTAIS","40-44",2098,2286,4384
"2516","BUNGOMA","CHEPTAIS","45",564,486,1050
"2517","BUNGOMA","CHEPTAIS","46",539,443,982
"2518","BUNGOMA","CHEPTAIS","47",447,387,834
"2519","BUNGOMA","CHEPTAIS","48",241,249,490
"2520","BUNGOMA","CHEPTAIS","49",262,224,486
"2521","BUNGOMA","CHEPTAIS","45-49",2053,1789,3842
"2522","BUNGOMA","CHEPTAIS","50",299,376,675
"2523","BUNGOMA","CHEPTAIS","51",279,359,638
"2524","BUNGOMA","CHEPTAIS","52",213,227,440
"2525","BUNGOMA","CHEPTAIS","53",204,284,488
"2526","BUNGOMA","CHEPTAIS","54",224,270,494
"2527","BUNGOMA","CHEPTAIS","50-54",1219,1516,2735
"2528","BUNGOMA","CHEPTAIS","55",252,304,556
"2529","BUNGOMA","CHEPTAIS","56",226,302,528
"2530","BUNGOMA","CHEPTAIS","57",218,362,580
"2531","BUNGOMA","CHEPTAIS","58",211,247,458
"2532","BUNGOMA","CHEPTAIS","59",311,357,668
"2533","BUNGOMA","CHEPTAIS","55-59",1218,1572,2790
"2534","BUNGOMA","CHEPTAIS","60",258,268,526
"2535","BUNGOMA","CHEPTAIS","61",213,266,479
"2536","BUNGOMA","CHEPTAIS","62",159,205,364
"2537","BUNGOMA","CHEPTAIS","63",198,200,398
"2538","BUNGOMA","CHEPTAIS","64",143,186,329
"2539","BUNGOMA","CHEPTAIS","60-64",971,1125,2096
"2540","BUNGOMA","CHEPTAIS","65",200,260,460
"2541","BUNGOMA","CHEPTAIS","66",105,147,252
"2542","BUNGOMA","CHEPTAIS","67",162,218,380
"2543","BUNGOMA","CHEPTAIS","68",72,76,148
"2544","BUNGOMA","CHEPTAIS","69",118,159,277
"2545","BUNGOMA","CHEPTAIS","65-69",657,860,1517
"2546","BUNGOMA","CHEPTAIS","70",107,135,242
"2547","BUNGOMA","CHEPTAIS","71",98,157,255
"2548","BUNGOMA","CHEPTAIS","72",73,97,170
"2549","BUNGOMA","CHEPTAIS","73",96,112,208
"2550","BUNGOMA","CHEPTAIS","74",59,62,121
"2551","BUNGOMA","CHEPTAIS","70-74",433,563,996
"2552","BUNGOMA","CHEPTAIS","75",87,107,194
"2553","BUNGOMA","CHEPTAIS","76",44,71,115
"2554","BUNGOMA","CHEPTAIS","77",73,120,193
"2555","BUNGOMA","CHEPTAIS","78",31,34,65
"2556","BUNGOMA","CHEPTAIS","79",43,62,105
"2557","BUNGOMA","CHEPTAIS","75-79",278,394,672
"2558","BUNGOMA","CHEPTAIS","80",55,69,124
"2559","BUNGOMA","CHEPTAIS","81",52,50,102
"2560","BUNGOMA","CHEPTAIS","82",34,46,80
"2561","BUNGOMA","CHEPTAIS","83",41,64,105
"2562","BUNGOMA","CHEPTAIS","84",27,39,66
"2563","BUNGOMA","CHEPTAIS","80-84",209,268,477
"2564","BUNGOMA","CHEPTAIS","85",23,45,68
"2565","BUNGOMA","CHEPTAIS","86",13,39,52
"2566","BUNGOMA","CHEPTAIS","87",31,55,86
"2567","BUNGOMA","CHEPTAIS","88",11,13,24
"2568","BUNGOMA","CHEPTAIS","89",24,38,62
"2569","BUNGOMA","CHEPTAIS","85-89",102,190,292
"2570","BUNGOMA","CHEPTAIS","90",13,18,31
"2571","BUNGOMA","CHEPTAIS","91",17,21,38
"2572","BUNGOMA","CHEPTAIS","92",7,14,21
"2573","BUNGOMA","CHEPTAIS","93",6,20,26
"2574","BUNGOMA","CHEPTAIS","94",9,4,13
"2575","BUNGOMA","CHEPTAIS","90-94",52,77,129
"2576","BUNGOMA","CHEPTAIS","95",9,18,27
"2577","BUNGOMA","CHEPTAIS","96",4,3,7
"2578","BUNGOMA","CHEPTAIS","97",7,10,17
"2579","BUNGOMA","CHEPTAIS","98",NA,5,5
"2580","BUNGOMA","CHEPTAIS","99",4,14,18
"2581","BUNGOMA","CHEPTAIS","95-99",24,50,74
"2582","BUNGOMA","CHEPTAIS","100+",5,11,16
"2583","BUNGOMA","CHEPTAIS","Not Stated",1,NA,1
"2584","BUNGOMA","KIMILILI","Total",78560,83475,162035
"2585","BUNGOMA","KIMILILI","0",1869,1879,3748
"2586","BUNGOMA","KIMILILI","1",1986,1933,3919
"2587","BUNGOMA","KIMILILI","2",2099,2071,4170
"2588","BUNGOMA","KIMILILI","3",2191,2185,4376
"2589","BUNGOMA","KIMILILI","4",2201,2255,4456
"2590","BUNGOMA","KIMILILI","0 - 4",10346,10323,20669
"2591","BUNGOMA","KIMILILI","5",2363,2369,4732
"2592","BUNGOMA","KIMILILI","6",2420,2429,4849
"2593","BUNGOMA","KIMILILI","7",2386,2381,4767
"2594","BUNGOMA","KIMILILI","8",2285,2281,4566
"2595","BUNGOMA","KIMILILI","9",2644,2776,5420
"2596","BUNGOMA","KIMILILI","5-9",12098,12236,24334
"2597","BUNGOMA","KIMILILI","10",2676,2616,5292
"2598","BUNGOMA","KIMILILI","11",2550,2546,5096
"2599","BUNGOMA","KIMILILI","12",2628,2647,5275
"2600","BUNGOMA","KIMILILI","13",2688,2823,5511
"2601","BUNGOMA","KIMILILI","14",2401,2462,4863
"2602","BUNGOMA","KIMILILI","10 -14",12943,13094,26037
"2603","BUNGOMA","KIMILILI","15",2462,2495,4957
"2604","BUNGOMA","KIMILILI","16",2239,2266,4505
"2605","BUNGOMA","KIMILILI","17",2416,2214,4630
"2606","BUNGOMA","KIMILILI","18",1688,1631,3319
"2607","BUNGOMA","KIMILILI","19",1911,1773,3684
"2608","BUNGOMA","KIMILILI","15-19",10716,10379,21095
"2609","BUNGOMA","KIMILILI","20",1478,1630,3108
"2610","BUNGOMA","KIMILILI","21",1341,1450,2791
"2611","BUNGOMA","KIMILILI","22",1120,1283,2403
"2612","BUNGOMA","KIMILILI","23",1209,1433,2642
"2613","BUNGOMA","KIMILILI","24",1005,1244,2249
"2614","BUNGOMA","KIMILILI","20-24",6153,7040,13193
"2615","BUNGOMA","KIMILILI","25",1127,1349,2476
"2616","BUNGOMA","KIMILILI","26",915,1154,2069
"2617","BUNGOMA","KIMILILI","27",984,1175,2159
"2618","BUNGOMA","KIMILILI","28",641,892,1533
"2619","BUNGOMA","KIMILILI","29",850,1008,1858
"2620","BUNGOMA","KIMILILI","25-29",4517,5578,10095
"2621","BUNGOMA","KIMILILI","30",1071,1353,2424
"2622","BUNGOMA","KIMILILI","31",805,1033,1838
"2623","BUNGOMA","KIMILILI","32",994,1277,2271
"2624","BUNGOMA","KIMILILI","33",812,997,1809
"2625","BUNGOMA","KIMILILI","34",705,829,1534
"2626","BUNGOMA","KIMILILI","30-34",4387,5489,9876
"2627","BUNGOMA","KIMILILI","35",970,964,1934
"2628","BUNGOMA","KIMILILI","36",705,731,1436
"2629","BUNGOMA","KIMILILI","37",727,739,1466
"2630","BUNGOMA","KIMILILI","38",537,581,1118
"2631","BUNGOMA","KIMILILI","39",629,700,1329
"2632","BUNGOMA","KIMILILI","35-39",3568,3715,7283
"2633","BUNGOMA","KIMILILI","40",711,770,1481
"2634","BUNGOMA","KIMILILI","41",695,862,1557
"2635","BUNGOMA","KIMILILI","42",664,815,1479
"2636","BUNGOMA","KIMILILI","43",647,707,1354
"2637","BUNGOMA","KIMILILI","44",510,517,1027
"2638","BUNGOMA","KIMILILI","40-44",3227,3671,6898
"2639","BUNGOMA","KIMILILI","45",753,743,1496
"2640","BUNGOMA","KIMILILI","46",536,510,1046
"2641","BUNGOMA","KIMILILI","47",570,563,1133
"2642","BUNGOMA","KIMILILI","48",400,412,812
"2643","BUNGOMA","KIMILILI","49",443,476,919
"2644","BUNGOMA","KIMILILI","45-49",2702,2704,5406
"2645","BUNGOMA","KIMILILI","50",478,571,1049
"2646","BUNGOMA","KIMILILI","51",398,450,848
"2647","BUNGOMA","KIMILILI","52",407,358,765
"2648","BUNGOMA","KIMILILI","53",326,377,703
"2649","BUNGOMA","KIMILILI","54",335,391,726
"2650","BUNGOMA","KIMILILI","50-54",1944,2147,4091
"2651","BUNGOMA","KIMILILI","55",357,438,795
"2652","BUNGOMA","KIMILILI","56",370,411,781
"2653","BUNGOMA","KIMILILI","57",403,522,925
"2654","BUNGOMA","KIMILILI","58",308,350,658
"2655","BUNGOMA","KIMILILI","59",432,428,860
"2656","BUNGOMA","KIMILILI","55-59",1870,2149,4019
"2657","BUNGOMA","KIMILILI","60",395,406,801
"2658","BUNGOMA","KIMILILI","61",322,313,635
"2659","BUNGOMA","KIMILILI","62",261,298,559
"2660","BUNGOMA","KIMILILI","63",279,342,621
"2661","BUNGOMA","KIMILILI","64",217,284,501
"2662","BUNGOMA","KIMILILI","60-64",1474,1643,3117
"2663","BUNGOMA","KIMILILI","65",274,279,553
"2664","BUNGOMA","KIMILILI","66",178,169,347
"2665","BUNGOMA","KIMILILI","67",220,257,477
"2666","BUNGOMA","KIMILILI","68",118,150,268
"2667","BUNGOMA","KIMILILI","69",176,227,403
"2668","BUNGOMA","KIMILILI","65-69",966,1082,2048
"2669","BUNGOMA","KIMILILI","70",190,234,424
"2670","BUNGOMA","KIMILILI","71",158,178,336
"2671","BUNGOMA","KIMILILI","72",148,158,306
"2672","BUNGOMA","KIMILILI","73",118,123,241
"2673","BUNGOMA","KIMILILI","74",108,129,237
"2674","BUNGOMA","KIMILILI","70-74",722,822,1544
"2675","BUNGOMA","KIMILILI","75",95,129,224
"2676","BUNGOMA","KIMILILI","76",79,110,189
"2677","BUNGOMA","KIMILILI","77",97,160,257
"2678","BUNGOMA","KIMILILI","78",66,69,135
"2679","BUNGOMA","KIMILILI","79",74,85,159
"2680","BUNGOMA","KIMILILI","75-79",411,553,964
"2681","BUNGOMA","KIMILILI","80",71,109,180
"2682","BUNGOMA","KIMILILI","81",45,57,102
"2683","BUNGOMA","KIMILILI","82",53,73,126
"2684","BUNGOMA","KIMILILI","83",66,108,174
"2685","BUNGOMA","KIMILILI","84",29,64,93
"2686","BUNGOMA","KIMILILI","80-84",264,411,675
"2687","BUNGOMA","KIMILILI","85",53,67,120
"2688","BUNGOMA","KIMILILI","86",25,47,72
"2689","BUNGOMA","KIMILILI","87",50,77,127
"2690","BUNGOMA","KIMILILI","88",22,23,45
"2691","BUNGOMA","KIMILILI","89",21,54,75
"2692","BUNGOMA","KIMILILI","85-89",171,268,439
"2693","BUNGOMA","KIMILILI","90",25,38,63
"2694","BUNGOMA","KIMILILI","91",14,23,37
"2695","BUNGOMA","KIMILILI","92",11,22,33
"2696","BUNGOMA","KIMILILI","93",8,14,22
"2697","BUNGOMA","KIMILILI","94",4,11,15
"2698","BUNGOMA","KIMILILI","90-94",62,108,170
"2699","BUNGOMA","KIMILILI","95",10,22,32
"2700","BUNGOMA","KIMILILI","96",3,9,12
"2701","BUNGOMA","KIMILILI","97",3,10,13
"2702","BUNGOMA","KIMILILI","98",NA,4,4
"2703","BUNGOMA","KIMILILI","99",1,6,7
"2704","BUNGOMA","KIMILILI","95-99",17,51,68
"2705","BUNGOMA","KIMILILI","100+",1,12,13
"2706","BUNGOMA","KIMILILI","Not Stated",1,NA,1
"2707","BUNGOMA","MT ELGON","Total",38977,39893,78870
"2708","BUNGOMA","MT ELGON","0",984,961,1945
"2709","BUNGOMA","MT ELGON","1",949,1011,1960
"2710","BUNGOMA","MT ELGON","2",1086,1074,2160
"2711","BUNGOMA","MT ELGON","3",1155,1188,2343
"2712","BUNGOMA","MT ELGON","4",1245,1201,2446
"2713","BUNGOMA","MT ELGON","0 - 4",5419,5435,10854
"2714","BUNGOMA","MT ELGON","5",1244,1242,2486
"2715","BUNGOMA","MT ELGON","6",1278,1269,2547
"2716","BUNGOMA","MT ELGON","7",1253,1279,2532
"2717","BUNGOMA","MT ELGON","8",1183,1187,2370
"2718","BUNGOMA","MT ELGON","9",1369,1319,2688
"2719","BUNGOMA","MT ELGON","5-9",6327,6296,12623
"2720","BUNGOMA","MT ELGON","10",1329,1233,2562
"2721","BUNGOMA","MT ELGON","11",1189,1257,2446
"2722","BUNGOMA","MT ELGON","12",1457,1376,2833
"2723","BUNGOMA","MT ELGON","13",1341,1322,2663
"2724","BUNGOMA","MT ELGON","14",1257,1168,2425
"2725","BUNGOMA","MT ELGON","10 -14",6573,6356,12929
"2726","BUNGOMA","MT ELGON","15",1336,1234,2570
"2727","BUNGOMA","MT ELGON","16",1057,1062,2119
"2728","BUNGOMA","MT ELGON","17",1150,1142,2292
"2729","BUNGOMA","MT ELGON","18",816,723,1539
"2730","BUNGOMA","MT ELGON","19",970,896,1866
"2731","BUNGOMA","MT ELGON","15-19",5329,5057,10386
"2732","BUNGOMA","MT ELGON","20",755,754,1509
"2733","BUNGOMA","MT ELGON","21",644,692,1336
"2734","BUNGOMA","MT ELGON","22",593,661,1254
"2735","BUNGOMA","MT ELGON","23",617,705,1322
"2736","BUNGOMA","MT ELGON","24",534,556,1090
"2737","BUNGOMA","MT ELGON","20-24",3143,3368,6511
"2738","BUNGOMA","MT ELGON","25",586,640,1226
"2739","BUNGOMA","MT ELGON","26",464,498,962
"2740","BUNGOMA","MT ELGON","27",542,564,1106
"2741","BUNGOMA","MT ELGON","28",301,368,669
"2742","BUNGOMA","MT ELGON","29",418,435,853
"2743","BUNGOMA","MT ELGON","25-29",2311,2505,4816
"2744","BUNGOMA","MT ELGON","30",462,585,1047
"2745","BUNGOMA","MT ELGON","31",424,509,933
"2746","BUNGOMA","MT ELGON","32",512,591,1103
"2747","BUNGOMA","MT ELGON","33",365,474,839
"2748","BUNGOMA","MT ELGON","34",324,351,675
"2749","BUNGOMA","MT ELGON","30-34",2087,2510,4597
"2750","BUNGOMA","MT ELGON","35",525,401,926
"2751","BUNGOMA","MT ELGON","36",359,334,693
"2752","BUNGOMA","MT ELGON","37",341,307,648
"2753","BUNGOMA","MT ELGON","38",181,193,374
"2754","BUNGOMA","MT ELGON","39",243,240,483
"2755","BUNGOMA","MT ELGON","35-39",1649,1475,3124
"2756","BUNGOMA","MT ELGON","40",258,270,528
"2757","BUNGOMA","MT ELGON","41",323,359,682
"2758","BUNGOMA","MT ELGON","42",273,350,623
"2759","BUNGOMA","MT ELGON","43",293,318,611
"2760","BUNGOMA","MT ELGON","44",188,194,382
"2761","BUNGOMA","MT ELGON","40-44",1335,1491,2826
"2762","BUNGOMA","MT ELGON","45",363,319,682
"2763","BUNGOMA","MT ELGON","46",265,262,527
"2764","BUNGOMA","MT ELGON","47",305,268,573
"2765","BUNGOMA","MT ELGON","48",165,147,312
"2766","BUNGOMA","MT ELGON","49",197,184,381
"2767","BUNGOMA","MT ELGON","45-49",1295,1180,2475
"2768","BUNGOMA","MT ELGON","50",202,181,383
"2769","BUNGOMA","MT ELGON","51",177,175,352
"2770","BUNGOMA","MT ELGON","52",145,165,310
"2771","BUNGOMA","MT ELGON","53",149,151,300
"2772","BUNGOMA","MT ELGON","54",134,173,307
"2773","BUNGOMA","MT ELGON","50-54",807,845,1652
"2774","BUNGOMA","MT ELGON","55",171,185,356
"2775","BUNGOMA","MT ELGON","56",189,205,394
"2776","BUNGOMA","MT ELGON","57",163,237,400
"2777","BUNGOMA","MT ELGON","58",135,138,273
"2778","BUNGOMA","MT ELGON","59",211,209,420
"2779","BUNGOMA","MT ELGON","55-59",869,974,1843
"2780","BUNGOMA","MT ELGON","60",155,145,300
"2781","BUNGOMA","MT ELGON","61",163,182,345
"2782","BUNGOMA","MT ELGON","62",105,119,224
"2783","BUNGOMA","MT ELGON","63",149,155,304
"2784","BUNGOMA","MT ELGON","64",79,95,174
"2785","BUNGOMA","MT ELGON","60-64",651,696,1347
"2786","BUNGOMA","MT ELGON","65",130,155,285
"2787","BUNGOMA","MT ELGON","66",70,99,169
"2788","BUNGOMA","MT ELGON","67",93,157,250
"2789","BUNGOMA","MT ELGON","68",52,62,114
"2790","BUNGOMA","MT ELGON","69",91,95,186
"2791","BUNGOMA","MT ELGON","65-69",436,568,1004
"2792","BUNGOMA","MT ELGON","70",77,94,171
"2793","BUNGOMA","MT ELGON","71",71,110,181
"2794","BUNGOMA","MT ELGON","72",62,74,136
"2795","BUNGOMA","MT ELGON","73",65,72,137
"2796","BUNGOMA","MT ELGON","74",42,59,101
"2797","BUNGOMA","MT ELGON","70-74",317,409,726
"2798","BUNGOMA","MT ELGON","75",45,89,134
"2799","BUNGOMA","MT ELGON","76",39,47,86
"2800","BUNGOMA","MT ELGON","77",54,92,146
"2801","BUNGOMA","MT ELGON","78",25,38,63
"2802","BUNGOMA","MT ELGON","79",23,58,81
"2803","BUNGOMA","MT ELGON","75-79",186,324,510
"2804","BUNGOMA","MT ELGON","80",22,46,68
"2805","BUNGOMA","MT ELGON","81",14,38,52
"2806","BUNGOMA","MT ELGON","82",16,23,39
"2807","BUNGOMA","MT ELGON","83",38,55,93
"2808","BUNGOMA","MT ELGON","84",15,22,37
"2809","BUNGOMA","MT ELGON","80-84",105,184,289
"2810","BUNGOMA","MT ELGON","85",22,26,48
"2811","BUNGOMA","MT ELGON","86",12,23,35
"2812","BUNGOMA","MT ELGON","87",31,29,60
"2813","BUNGOMA","MT ELGON","88",6,5,11
"2814","BUNGOMA","MT ELGON","89",12,30,42
"2815","BUNGOMA","MT ELGON","85-89",83,113,196
"2816","BUNGOMA","MT ELGON","90",11,15,26
"2817","BUNGOMA","MT ELGON","91",10,15,25
"2818","BUNGOMA","MT ELGON","92",11,4,15
"2819","BUNGOMA","MT ELGON","93",2,9,11
"2820","BUNGOMA","MT ELGON","94",2,4,6
"2821","BUNGOMA","MT ELGON","90-94",36,47,83
"2822","BUNGOMA","MT ELGON","95",7,17,24
"2823","BUNGOMA","MT ELGON","96",1,6,7
"2824","BUNGOMA","MT ELGON","97",4,17,21
"2825","BUNGOMA","MT ELGON","98",1,3,4
"2826","BUNGOMA","MT ELGON","99",3,4,7
"2827","BUNGOMA","MT ELGON","95-99",16,47,63
"2828","BUNGOMA","MT ELGON","100+",2,13,15
"2829","BUNGOMA","MT ELGON","Not Stated",1,NA,1
"2830","BUNGOMA","BUNGOMA WEST","Total",58225,61649,119874
"2831","BUNGOMA","BUNGOMA WEST","0",1380,1483,2863
"2832","BUNGOMA","BUNGOMA WEST","1",1518,1527,3045
"2833","BUNGOMA","BUNGOMA WEST","2",1574,1475,3049
"2834","BUNGOMA","BUNGOMA WEST","3",1707,1755,3462
"2835","BUNGOMA","BUNGOMA WEST","4",1701,1732,3433
"2836","BUNGOMA","BUNGOMA WEST","0 - 4",7880,7972,15852
"2837","BUNGOMA","BUNGOMA WEST","5",1911,1881,3792
"2838","BUNGOMA","BUNGOMA WEST","6",1876,1974,3850
"2839","BUNGOMA","BUNGOMA WEST","7",1906,1899,3805
"2840","BUNGOMA","BUNGOMA WEST","8",1741,1816,3557
"2841","BUNGOMA","BUNGOMA WEST","9",2138,2049,4187
"2842","BUNGOMA","BUNGOMA WEST","5-9",9572,9619,19191
"2843","BUNGOMA","BUNGOMA WEST","10",1974,1968,3942
"2844","BUNGOMA","BUNGOMA WEST","11",1982,1969,3951
"2845","BUNGOMA","BUNGOMA WEST","12",1912,1978,3890
"2846","BUNGOMA","BUNGOMA WEST","13",2135,2111,4246
"2847","BUNGOMA","BUNGOMA WEST","14",1870,1841,3711
"2848","BUNGOMA","BUNGOMA WEST","10 -14",9873,9867,19740
"2849","BUNGOMA","BUNGOMA WEST","15",1913,1923,3836
"2850","BUNGOMA","BUNGOMA WEST","16",1572,1559,3131
"2851","BUNGOMA","BUNGOMA WEST","17",1650,1550,3200
"2852","BUNGOMA","BUNGOMA WEST","18",1184,1094,2278
"2853","BUNGOMA","BUNGOMA WEST","19",1305,1271,2576
"2854","BUNGOMA","BUNGOMA WEST","15-19",7624,7397,15021
"2855","BUNGOMA","BUNGOMA WEST","20",1017,1099,2116
"2856","BUNGOMA","BUNGOMA WEST","21",868,1030,1898
"2857","BUNGOMA","BUNGOMA WEST","22",748,934,1682
"2858","BUNGOMA","BUNGOMA WEST","23",844,993,1837
"2859","BUNGOMA","BUNGOMA WEST","24",672,892,1564
"2860","BUNGOMA","BUNGOMA WEST","20-24",4149,4948,9097
"2861","BUNGOMA","BUNGOMA WEST","25",808,1061,1869
"2862","BUNGOMA","BUNGOMA WEST","26",666,820,1486
"2863","BUNGOMA","BUNGOMA WEST","27",723,879,1602
"2864","BUNGOMA","BUNGOMA WEST","28",470,635,1105
"2865","BUNGOMA","BUNGOMA WEST","29",601,679,1280
"2866","BUNGOMA","BUNGOMA WEST","25-29",3268,4074,7342
"2867","BUNGOMA","BUNGOMA WEST","30",695,848,1543
"2868","BUNGOMA","BUNGOMA WEST","31",666,883,1549
"2869","BUNGOMA","BUNGOMA WEST","32",763,861,1624
"2870","BUNGOMA","BUNGOMA WEST","33",658,648,1306
"2871","BUNGOMA","BUNGOMA WEST","34",485,491,976
"2872","BUNGOMA","BUNGOMA WEST","30-34",3267,3731,6998
"2873","BUNGOMA","BUNGOMA WEST","35",643,618,1261
"2874","BUNGOMA","BUNGOMA WEST","36",496,448,944
"2875","BUNGOMA","BUNGOMA WEST","37",532,481,1013
"2876","BUNGOMA","BUNGOMA WEST","38",366,331,697
"2877","BUNGOMA","BUNGOMA WEST","39",429,392,821
"2878","BUNGOMA","BUNGOMA WEST","35-39",2466,2270,4736
"2879","BUNGOMA","BUNGOMA WEST","40",471,456,927
"2880","BUNGOMA","BUNGOMA WEST","41",480,509,989
"2881","BUNGOMA","BUNGOMA WEST","42",495,562,1057
"2882","BUNGOMA","BUNGOMA WEST","43",503,523,1026
"2883","BUNGOMA","BUNGOMA WEST","44",323,362,685
"2884","BUNGOMA","BUNGOMA WEST","40-44",2272,2412,4684
"2885","BUNGOMA","BUNGOMA WEST","45",509,518,1027
"2886","BUNGOMA","BUNGOMA WEST","46",426,393,819
"2887","BUNGOMA","BUNGOMA WEST","47",412,392,804
"2888","BUNGOMA","BUNGOMA WEST","48",251,259,510
"2889","BUNGOMA","BUNGOMA WEST","49",289,303,592
"2890","BUNGOMA","BUNGOMA WEST","45-49",1887,1865,3752
"2891","BUNGOMA","BUNGOMA WEST","50",284,360,644
"2892","BUNGOMA","BUNGOMA WEST","51",321,337,658
"2893","BUNGOMA","BUNGOMA WEST","52",236,276,512
"2894","BUNGOMA","BUNGOMA WEST","53",235,297,532
"2895","BUNGOMA","BUNGOMA WEST","54",259,267,526
"2896","BUNGOMA","BUNGOMA WEST","50-54",1335,1537,2872
"2897","BUNGOMA","BUNGOMA WEST","55",328,356,684
"2898","BUNGOMA","BUNGOMA WEST","56",240,306,546
"2899","BUNGOMA","BUNGOMA WEST","57",268,423,691
"2900","BUNGOMA","BUNGOMA WEST","58",213,268,481
"2901","BUNGOMA","BUNGOMA WEST","59",344,335,679
"2902","BUNGOMA","BUNGOMA WEST","55-59",1393,1688,3081
"2903","BUNGOMA","BUNGOMA WEST","60",298,315,613
"2904","BUNGOMA","BUNGOMA WEST","61",232,318,550
"2905","BUNGOMA","BUNGOMA WEST","62",180,188,368
"2906","BUNGOMA","BUNGOMA WEST","63",258,280,538
"2907","BUNGOMA","BUNGOMA WEST","64",167,219,386
"2908","BUNGOMA","BUNGOMA WEST","60-64",1135,1320,2455
"2909","BUNGOMA","BUNGOMA WEST","65",189,261,450
"2910","BUNGOMA","BUNGOMA WEST","66",143,196,339
"2911","BUNGOMA","BUNGOMA WEST","67",182,244,426
"2912","BUNGOMA","BUNGOMA WEST","68",97,124,221
"2913","BUNGOMA","BUNGOMA WEST","69",169,180,349
"2914","BUNGOMA","BUNGOMA WEST","65-69",780,1005,1785
"2915","BUNGOMA","BUNGOMA WEST","70",137,180,317
"2916","BUNGOMA","BUNGOMA WEST","71",146,193,339
"2917","BUNGOMA","BUNGOMA WEST","72",94,133,227
"2918","BUNGOMA","BUNGOMA WEST","73",116,140,256
"2919","BUNGOMA","BUNGOMA WEST","74",88,106,194
"2920","BUNGOMA","BUNGOMA WEST","70-74",581,752,1333
"2921","BUNGOMA","BUNGOMA WEST","75",82,126,208
"2922","BUNGOMA","BUNGOMA WEST","76",52,86,138
"2923","BUNGOMA","BUNGOMA WEST","77",74,156,230
"2924","BUNGOMA","BUNGOMA WEST","78",52,54,106
"2925","BUNGOMA","BUNGOMA WEST","79",51,74,125
"2926","BUNGOMA","BUNGOMA WEST","75-79",311,496,807
"2927","BUNGOMA","BUNGOMA WEST","80",63,84,147
"2928","BUNGOMA","BUNGOMA WEST","81",43,61,104
"2929","BUNGOMA","BUNGOMA WEST","82",39,65,104
"2930","BUNGOMA","BUNGOMA WEST","83",58,79,137
"2931","BUNGOMA","BUNGOMA WEST","84",43,41,84
"2932","BUNGOMA","BUNGOMA WEST","80-84",246,330,576
"2933","BUNGOMA","BUNGOMA WEST","85",30,58,88
"2934","BUNGOMA","BUNGOMA WEST","86",18,45,63
"2935","BUNGOMA","BUNGOMA WEST","87",27,64,91
"2936","BUNGOMA","BUNGOMA WEST","88",18,24,42
"2937","BUNGOMA","BUNGOMA WEST","89",23,51,74
"2938","BUNGOMA","BUNGOMA WEST","85-89",116,242,358
"2939","BUNGOMA","BUNGOMA WEST","90",13,15,28
"2940","BUNGOMA","BUNGOMA WEST","91",21,27,48
"2941","BUNGOMA","BUNGOMA WEST","92",4,14,18
"2942","BUNGOMA","BUNGOMA WEST","93",8,14,22
"2943","BUNGOMA","BUNGOMA WEST","94",2,7,9
"2944","BUNGOMA","BUNGOMA WEST","90-94",48,77,125
"2945","BUNGOMA","BUNGOMA WEST","95",10,16,26
"2946","BUNGOMA","BUNGOMA WEST","96",1,4,5
"2947","BUNGOMA","BUNGOMA WEST","97",4,19,23
"2948","BUNGOMA","BUNGOMA WEST","98",2,2,4
"2949","BUNGOMA","BUNGOMA WEST","99",NA,2,2
"2950","BUNGOMA","BUNGOMA WEST","95-99",17,43,60
"2951","BUNGOMA","BUNGOMA WEST","100+",5,4,9
"2952","BUNGOMA","BUNGOMA WEST","Not Stated",NA,NA,NA
"2953","BUNGOMA","TONGAREN","Total",48685,51657,100342
"2954","BUNGOMA","TONGAREN","0",1155,1170,2325
"2955","BUNGOMA","TONGAREN","1",1227,1214,2441
"2956","BUNGOMA","TONGAREN","2",1303,1309,2612
"2957","BUNGOMA","TONGAREN","3",1384,1432,2816
"2958","BUNGOMA","TONGAREN","4",1383,1383,2766
"2959","BUNGOMA","TONGAREN","0 - 4",6452,6508,12960
"2960","BUNGOMA","TONGAREN","5",1459,1398,2857
"2961","BUNGOMA","TONGAREN","6",1474,1506,2980
"2962","BUNGOMA","TONGAREN","7",1511,1463,2974
"2963","BUNGOMA","TONGAREN","8",1428,1396,2824
"2964","BUNGOMA","TONGAREN","9",1738,1614,3352
"2965","BUNGOMA","TONGAREN","5-9",7610,7377,14987
"2966","BUNGOMA","TONGAREN","10",1682,1616,3298
"2967","BUNGOMA","TONGAREN","11",1521,1634,3155
"2968","BUNGOMA","TONGAREN","12",1765,1666,3431
"2969","BUNGOMA","TONGAREN","13",1685,1699,3384
"2970","BUNGOMA","TONGAREN","14",1581,1523,3104
"2971","BUNGOMA","TONGAREN","10 -14",8234,8138,16372
"2972","BUNGOMA","TONGAREN","15",1500,1521,3021
"2973","BUNGOMA","TONGAREN","16",1422,1400,2822
"2974","BUNGOMA","TONGAREN","17",1538,1349,2887
"2975","BUNGOMA","TONGAREN","18",1206,1037,2243
"2976","BUNGOMA","TONGAREN","19",1249,1139,2388
"2977","BUNGOMA","TONGAREN","15-19",6915,6446,13361
"2978","BUNGOMA","TONGAREN","20",986,976,1962
"2979","BUNGOMA","TONGAREN","21",817,782,1599
"2980","BUNGOMA","TONGAREN","22",703,741,1444
"2981","BUNGOMA","TONGAREN","23",694,752,1446
"2982","BUNGOMA","TONGAREN","24",562,652,1214
"2983","BUNGOMA","TONGAREN","20-24",3762,3903,7665
"2984","BUNGOMA","TONGAREN","25",609,750,1359
"2985","BUNGOMA","TONGAREN","26",495,620,1115
"2986","BUNGOMA","TONGAREN","27",518,595,1113
"2987","BUNGOMA","TONGAREN","28",393,484,877
"2988","BUNGOMA","TONGAREN","29",493,573,1066
"2989","BUNGOMA","TONGAREN","25-29",2508,3022,5530
"2990","BUNGOMA","TONGAREN","30",537,717,1254
"2991","BUNGOMA","TONGAREN","31",479,617,1096
"2992","BUNGOMA","TONGAREN","32",512,710,1222
"2993","BUNGOMA","TONGAREN","33",503,580,1083
"2994","BUNGOMA","TONGAREN","34",414,443,857
"2995","BUNGOMA","TONGAREN","30-34",2445,3067,5512
"2996","BUNGOMA","TONGAREN","35",485,568,1053
"2997","BUNGOMA","TONGAREN","36",394,490,884
"2998","BUNGOMA","TONGAREN","37",382,432,814
"2999","BUNGOMA","TONGAREN","38",320,403,723
"3000","BUNGOMA","TONGAREN","39",344,418,762
"3001","BUNGOMA","TONGAREN","35-39",1925,2311,4236
"3002","BUNGOMA","TONGAREN","40",394,436,830
"3003","BUNGOMA","TONGAREN","41",394,548,942
"3004","BUNGOMA","TONGAREN","42",387,517,904
"3005","BUNGOMA","TONGAREN","43",379,486,865
"3006","BUNGOMA","TONGAREN","44",304,379,683
"3007","BUNGOMA","TONGAREN","40-44",1858,2366,4224
"3008","BUNGOMA","TONGAREN","45",439,485,924
"3009","BUNGOMA","TONGAREN","46",324,390,714
"3010","BUNGOMA","TONGAREN","47",322,404,726
"3011","BUNGOMA","TONGAREN","48",254,319,573
"3012","BUNGOMA","TONGAREN","49",293,362,655
"3013","BUNGOMA","TONGAREN","45-49",1632,1960,3592
"3014","BUNGOMA","TONGAREN","50",316,381,697
"3015","BUNGOMA","TONGAREN","51",319,380,699
"3016","BUNGOMA","TONGAREN","52",264,347,611
"3017","BUNGOMA","TONGAREN","53",209,294,503
"3018","BUNGOMA","TONGAREN","54",234,291,525
"3019","BUNGOMA","TONGAREN","50-54",1342,1693,3035
"3020","BUNGOMA","TONGAREN","55",241,313,554
"3021","BUNGOMA","TONGAREN","56",240,289,529
"3022","BUNGOMA","TONGAREN","57",290,346,636
"3023","BUNGOMA","TONGAREN","58",203,259,462
"3024","BUNGOMA","TONGAREN","59",309,323,632
"3025","BUNGOMA","TONGAREN","55-59",1283,1530,2813
"3026","BUNGOMA","TONGAREN","60",303,290,593
"3027","BUNGOMA","TONGAREN","61",209,227,436
"3028","BUNGOMA","TONGAREN","62",185,208,393
"3029","BUNGOMA","TONGAREN","63",220,245,465
"3030","BUNGOMA","TONGAREN","64",137,149,286
"3031","BUNGOMA","TONGAREN","60-64",1054,1119,2173
"3032","BUNGOMA","TONGAREN","65",188,192,380
"3033","BUNGOMA","TONGAREN","66",111,163,274
"3034","BUNGOMA","TONGAREN","67",140,169,309
"3035","BUNGOMA","TONGAREN","68",87,110,197
"3036","BUNGOMA","TONGAREN","69",116,140,256
"3037","BUNGOMA","TONGAREN","65-69",642,774,1416
"3038","BUNGOMA","TONGAREN","70",118,146,264
"3039","BUNGOMA","TONGAREN","71",110,106,216
"3040","BUNGOMA","TONGAREN","72",78,93,171
"3041","BUNGOMA","TONGAREN","73",65,112,177
"3042","BUNGOMA","TONGAREN","74",54,84,138
"3043","BUNGOMA","TONGAREN","70-74",425,541,966
"3044","BUNGOMA","TONGAREN","75",49,81,130
"3045","BUNGOMA","TONGAREN","76",63,114,177
"3046","BUNGOMA","TONGAREN","77",49,103,152
"3047","BUNGOMA","TONGAREN","78",38,49,87
"3048","BUNGOMA","TONGAREN","79",38,51,89
"3049","BUNGOMA","TONGAREN","75-79",237,398,635
"3050","BUNGOMA","TONGAREN","80",48,74,122
"3051","BUNGOMA","TONGAREN","81",36,43,79
"3052","BUNGOMA","TONGAREN","82",36,46,82
"3053","BUNGOMA","TONGAREN","83",43,59,102
"3054","BUNGOMA","TONGAREN","84",22,32,54
"3055","BUNGOMA","TONGAREN","80-84",185,254,439
"3056","BUNGOMA","TONGAREN","85",25,45,70
"3057","BUNGOMA","TONGAREN","86",15,27,42
"3058","BUNGOMA","TONGAREN","87",20,39,59
"3059","BUNGOMA","TONGAREN","88",12,15,27
"3060","BUNGOMA","TONGAREN","89",27,33,60
"3061","BUNGOMA","TONGAREN","85-89",99,159,258
"3062","BUNGOMA","TONGAREN","90",18,9,27
"3063","BUNGOMA","TONGAREN","91",10,20,30
"3064","BUNGOMA","TONGAREN","92",11,11,22
"3065","BUNGOMA","TONGAREN","93",2,12,14
"3066","BUNGOMA","TONGAREN","94",3,8,11
"3067","BUNGOMA","TONGAREN","90-94",44,60,104
"3068","BUNGOMA","TONGAREN","95",16,7,23
"3069","BUNGOMA","TONGAREN","96",5,2,7
"3070","BUNGOMA","TONGAREN","97",5,12,17
"3071","BUNGOMA","TONGAREN","98",2,3,5
"3072","BUNGOMA","TONGAREN","99",2,1,3
"3073","BUNGOMA","TONGAREN","95-99",30,25,55
"3074","BUNGOMA","TONGAREN","100+",3,6,9
"3075","BUNGOMA","TONGAREN","Not Stated",NA,NA,NA
"3076","BUNGOMA","WEBUYE WEST","Total",74180,78331,152511
"3077","BUNGOMA","WEBUYE WEST","0",1810,1857,3667
"3078","BUNGOMA","WEBUYE WEST","1",1835,1893,3728
"3079","BUNGOMA","WEBUYE WEST","2",1913,1960,3873
"3080","BUNGOMA","WEBUYE WEST","3",2041,2104,4145
"3081","BUNGOMA","WEBUYE WEST","4",2140,2035,4175
"3082","BUNGOMA","WEBUYE WEST","0 - 4",9739,9849,19588
"3083","BUNGOMA","WEBUYE WEST","5",2337,2288,4625
"3084","BUNGOMA","WEBUYE WEST","6",2293,2279,4572
"3085","BUNGOMA","WEBUYE WEST","7",2221,2250,4471
"3086","BUNGOMA","WEBUYE WEST","8",2134,2151,4285
"3087","BUNGOMA","WEBUYE WEST","9",2505,2458,4963
"3088","BUNGOMA","WEBUYE WEST","5-9",11490,11426,22916
"3089","BUNGOMA","WEBUYE WEST","10",2456,2517,4973
"3090","BUNGOMA","WEBUYE WEST","11",2386,2452,4838
"3091","BUNGOMA","WEBUYE WEST","12",2545,2444,4989
"3092","BUNGOMA","WEBUYE WEST","13",2576,2588,5164
"3093","BUNGOMA","WEBUYE WEST","14",2409,2318,4727
"3094","BUNGOMA","WEBUYE WEST","10 -14",12372,12319,24691
"3095","BUNGOMA","WEBUYE WEST","15",2415,2247,4662
"3096","BUNGOMA","WEBUYE WEST","16",2141,2087,4228
"3097","BUNGOMA","WEBUYE WEST","17",2189,2124,4313
"3098","BUNGOMA","WEBUYE WEST","18",1629,1505,3134
"3099","BUNGOMA","WEBUYE WEST","19",1788,1751,3539
"3100","BUNGOMA","WEBUYE WEST","15-19",10162,9714,19876
"3101","BUNGOMA","WEBUYE WEST","20",1372,1535,2907
"3102","BUNGOMA","WEBUYE WEST","21",1167,1316,2483
"3103","BUNGOMA","WEBUYE WEST","22",1072,1248,2320
"3104","BUNGOMA","WEBUYE WEST","23",1147,1402,2549
"3105","BUNGOMA","WEBUYE WEST","24",926,1139,2065
"3106","BUNGOMA","WEBUYE WEST","20-24",5684,6640,12324
"3107","BUNGOMA","WEBUYE WEST","25",1089,1367,2456
"3108","BUNGOMA","WEBUYE WEST","26",793,1065,1858
"3109","BUNGOMA","WEBUYE WEST","27",963,1084,2047
"3110","BUNGOMA","WEBUYE WEST","28",680,852,1532
"3111","BUNGOMA","WEBUYE WEST","29",816,982,1798
"3112","BUNGOMA","WEBUYE WEST","25-29",4341,5350,9691
"3113","BUNGOMA","WEBUYE WEST","30",896,1164,2060
"3114","BUNGOMA","WEBUYE WEST","31",822,1150,1972
"3115","BUNGOMA","WEBUYE WEST","32",1041,1284,2325
"3116","BUNGOMA","WEBUYE WEST","33",794,964,1758
"3117","BUNGOMA","WEBUYE WEST","34",674,773,1447
"3118","BUNGOMA","WEBUYE WEST","30-34",4227,5335,9562
"3119","BUNGOMA","WEBUYE WEST","35",843,879,1722
"3120","BUNGOMA","WEBUYE WEST","36",673,666,1339
"3121","BUNGOMA","WEBUYE WEST","37",690,654,1344
"3122","BUNGOMA","WEBUYE WEST","38",542,544,1086
"3123","BUNGOMA","WEBUYE WEST","39",586,645,1231
"3124","BUNGOMA","WEBUYE WEST","35-39",3334,3388,6722
"3125","BUNGOMA","WEBUYE WEST","40",622,749,1371
"3126","BUNGOMA","WEBUYE WEST","41",719,721,1440
"3127","BUNGOMA","WEBUYE WEST","42",704,714,1418
"3128","BUNGOMA","WEBUYE WEST","43",638,627,1265
"3129","BUNGOMA","WEBUYE WEST","44",402,420,822
"3130","BUNGOMA","WEBUYE WEST","40-44",3085,3231,6316
"3131","BUNGOMA","WEBUYE WEST","45",752,678,1430
"3132","BUNGOMA","WEBUYE WEST","46",528,525,1053
"3133","BUNGOMA","WEBUYE WEST","47",545,592,1137
"3134","BUNGOMA","WEBUYE WEST","48",319,374,693
"3135","BUNGOMA","WEBUYE WEST","49",430,371,801
"3136","BUNGOMA","WEBUYE WEST","45-49",2574,2540,5114
"3137","BUNGOMA","WEBUYE WEST","50",402,553,955
"3138","BUNGOMA","WEBUYE WEST","51",382,414,796
"3139","BUNGOMA","WEBUYE WEST","52",348,354,702
"3140","BUNGOMA","WEBUYE WEST","53",261,319,580
"3141","BUNGOMA","WEBUYE WEST","54",274,335,609
"3142","BUNGOMA","WEBUYE WEST","50-54",1667,1975,3642
"3143","BUNGOMA","WEBUYE WEST","55",337,397,734
"3144","BUNGOMA","WEBUYE WEST","56",317,425,742
"3145","BUNGOMA","WEBUYE WEST","57",364,422,786
"3146","BUNGOMA","WEBUYE WEST","58",289,322,611
"3147","BUNGOMA","WEBUYE WEST","59",420,394,814
"3148","BUNGOMA","WEBUYE WEST","55-59",1727,1960,3687
"3149","BUNGOMA","WEBUYE WEST","60",305,374,679
"3150","BUNGOMA","WEBUYE WEST","61",291,320,611
"3151","BUNGOMA","WEBUYE WEST","62",248,280,528
"3152","BUNGOMA","WEBUYE WEST","63",249,325,574
"3153","BUNGOMA","WEBUYE WEST","64",212,208,420
"3154","BUNGOMA","WEBUYE WEST","60-64",1305,1507,2812
"3155","BUNGOMA","WEBUYE WEST","65",246,305,551
"3156","BUNGOMA","WEBUYE WEST","66",157,188,345
"3157","BUNGOMA","WEBUYE WEST","67",214,234,448
"3158","BUNGOMA","WEBUYE WEST","68",112,133,245
"3159","BUNGOMA","WEBUYE WEST","69",176,195,371
"3160","BUNGOMA","WEBUYE WEST","65-69",905,1055,1960
"3161","BUNGOMA","WEBUYE WEST","70",162,205,367
"3162","BUNGOMA","WEBUYE WEST","71",160,161,321
"3163","BUNGOMA","WEBUYE WEST","72",120,168,288
"3164","BUNGOMA","WEBUYE WEST","73",115,137,252
"3165","BUNGOMA","WEBUYE WEST","74",100,123,223
"3166","BUNGOMA","WEBUYE WEST","70-74",657,794,1451
"3167","BUNGOMA","WEBUYE WEST","75",82,129,211
"3168","BUNGOMA","WEBUYE WEST","76",74,120,194
"3169","BUNGOMA","WEBUYE WEST","77",101,151,252
"3170","BUNGOMA","WEBUYE WEST","78",66,61,127
"3171","BUNGOMA","WEBUYE WEST","79",68,84,152
"3172","BUNGOMA","WEBUYE WEST","75-79",391,545,936
"3173","BUNGOMA","WEBUYE WEST","80",94,93,187
"3174","BUNGOMA","WEBUYE WEST","81",53,70,123
"3175","BUNGOMA","WEBUYE WEST","82",46,60,106
"3176","BUNGOMA","WEBUYE WEST","83",58,96,154
"3177","BUNGOMA","WEBUYE WEST","84",32,30,62
"3178","BUNGOMA","WEBUYE WEST","80-84",283,349,632
"3179","BUNGOMA","WEBUYE WEST","85",31,59,90
"3180","BUNGOMA","WEBUYE WEST","86",28,31,59
"3181","BUNGOMA","WEBUYE WEST","87",38,66,104
"3182","BUNGOMA","WEBUYE WEST","88",22,25,47
"3183","BUNGOMA","WEBUYE WEST","89",30,52,82
"3184","BUNGOMA","WEBUYE WEST","85-89",149,233,382
"3185","BUNGOMA","WEBUYE WEST","90",13,11,24
"3186","BUNGOMA","WEBUYE WEST","91",13,22,35
"3187","BUNGOMA","WEBUYE WEST","92",12,13,25
"3188","BUNGOMA","WEBUYE WEST","93",8,18,26
"3189","BUNGOMA","WEBUYE WEST","94",5,9,14
"3190","BUNGOMA","WEBUYE WEST","90-94",51,73,124
"3191","BUNGOMA","WEBUYE WEST","95",13,13,26
"3192","BUNGOMA","WEBUYE WEST","96",4,7,11
"3193","BUNGOMA","WEBUYE WEST","97",9,16,25
"3194","BUNGOMA","WEBUYE WEST","98",2,2,4
"3195","BUNGOMA","WEBUYE WEST","99",4,2,6
"3196","BUNGOMA","WEBUYE WEST","95-99",32,40,72
"3197","BUNGOMA","WEBUYE WEST","100+",5,8,13
"3198","BUNGOMA","WEBUYE WEST","Not Stated",NA,NA,NA
"3199","BUNGOMA","MT ELGON FOREST","Total",1862,1759,3621
"3200","BUNGOMA","MT ELGON FOREST","0",61,70,131
"3201","BUNGOMA","MT ELGON FOREST","1",45,61,106
"3202","BUNGOMA","MT ELGON FOREST","2",58,62,120
"3203","BUNGOMA","MT ELGON FOREST","3",86,75,161
"3204","BUNGOMA","MT ELGON FOREST","4",66,64,130
"3205","BUNGOMA","MT ELGON FOREST","0 - 4",316,332,648
"3206","BUNGOMA","MT ELGON FOREST","5",75,63,138
"3207","BUNGOMA","MT ELGON FOREST","6",78,62,140
"3208","BUNGOMA","MT ELGON FOREST","7",48,61,109
"3209","BUNGOMA","MT ELGON FOREST","8",39,51,90
"3210","BUNGOMA","MT ELGON FOREST","9",44,60,104
"3211","BUNGOMA","MT ELGON FOREST","5-9",284,297,581
"3212","BUNGOMA","MT ELGON FOREST","10",53,59,112
"3213","BUNGOMA","MT ELGON FOREST","11",44,43,87
"3214","BUNGOMA","MT ELGON FOREST","12",76,63,139
"3215","BUNGOMA","MT ELGON FOREST","13",62,37,99
"3216","BUNGOMA","MT ELGON FOREST","14",55,49,104
"3217","BUNGOMA","MT ELGON FOREST","10 -14",290,251,541
"3218","BUNGOMA","MT ELGON FOREST","15",50,33,83
"3219","BUNGOMA","MT ELGON FOREST","16",51,38,89
"3220","BUNGOMA","MT ELGON FOREST","17",45,34,79
"3221","BUNGOMA","MT ELGON FOREST","18",30,25,55
"3222","BUNGOMA","MT ELGON FOREST","19",39,52,91
"3223","BUNGOMA","MT ELGON FOREST","15-19",215,182,397
"3224","BUNGOMA","MT ELGON FOREST","20",47,43,90
"3225","BUNGOMA","MT ELGON FOREST","21",29,31,60
"3226","BUNGOMA","MT ELGON FOREST","22",46,34,80
"3227","BUNGOMA","MT ELGON FOREST","23",26,30,56
"3228","BUNGOMA","MT ELGON FOREST","24",27,32,59
"3229","BUNGOMA","MT ELGON FOREST","20-24",175,170,345
"3230","BUNGOMA","MT ELGON FOREST","25",33,20,53
"3231","BUNGOMA","MT ELGON FOREST","26",26,26,52
"3232","BUNGOMA","MT ELGON FOREST","27",32,27,59
"3233","BUNGOMA","MT ELGON FOREST","28",21,9,30
"3234","BUNGOMA","MT ELGON FOREST","29",34,27,61
"3235","BUNGOMA","MT ELGON FOREST","25-29",146,109,255
"3236","BUNGOMA","MT ELGON FOREST","30",27,30,57
"3237","BUNGOMA","MT ELGON FOREST","31",21,8,29
"3238","BUNGOMA","MT ELGON FOREST","32",25,21,46
"3239","BUNGOMA","MT ELGON FOREST","33",15,14,29
"3240","BUNGOMA","MT ELGON FOREST","34",12,11,23
"3241","BUNGOMA","MT ELGON FOREST","30-34",100,84,184
"3242","BUNGOMA","MT ELGON FOREST","35",25,11,36
"3243","BUNGOMA","MT ELGON FOREST","36",16,4,20
"3244","BUNGOMA","MT ELGON FOREST","37",13,8,21
"3245","BUNGOMA","MT ELGON FOREST","38",11,10,21
"3246","BUNGOMA","MT ELGON FOREST","39",9,7,16
"3247","BUNGOMA","MT ELGON FOREST","35-39",74,40,114
"3248","BUNGOMA","MT ELGON FOREST","40",10,11,21
"3249","BUNGOMA","MT ELGON FOREST","41",4,9,13
"3250","BUNGOMA","MT ELGON FOREST","42",14,14,28
"3251","BUNGOMA","MT ELGON FOREST","43",5,4,9
"3252","BUNGOMA","MT ELGON FOREST","44",5,5,10
"3253","BUNGOMA","MT ELGON FOREST","40-44",38,43,81
"3254","BUNGOMA","MT ELGON FOREST","45",12,10,22
"3255","BUNGOMA","MT ELGON FOREST","46",8,10,18
"3256","BUNGOMA","MT ELGON FOREST","47",7,10,17
"3257","BUNGOMA","MT ELGON FOREST","48",3,11,14
"3258","BUNGOMA","MT ELGON FOREST","49",4,3,7
"3259","BUNGOMA","MT ELGON FOREST","45-49",34,44,78
"3260","BUNGOMA","MT ELGON FOREST","50",10,9,19
"3261","BUNGOMA","MT ELGON FOREST","51",6,3,9
"3262","BUNGOMA","MT ELGON FOREST","52",8,4,12
"3263","BUNGOMA","MT ELGON FOREST","53",7,9,16
"3264","BUNGOMA","MT ELGON FOREST","54",6,7,13
"3265","BUNGOMA","MT ELGON FOREST","50-54",37,32,69
"3266","BUNGOMA","MT ELGON FOREST","55",6,14,20
"3267","BUNGOMA","MT ELGON FOREST","56",7,12,19
"3268","BUNGOMA","MT ELGON FOREST","57",10,6,16
"3269","BUNGOMA","MT ELGON FOREST","58",8,3,11
"3270","BUNGOMA","MT ELGON FOREST","59",9,17,26
"3271","BUNGOMA","MT ELGON FOREST","55-59",40,52,92
"3272","BUNGOMA","MT ELGON FOREST","60",10,14,24
"3273","BUNGOMA","MT ELGON FOREST","61",6,8,14
"3274","BUNGOMA","MT ELGON FOREST","62",8,7,15
"3275","BUNGOMA","MT ELGON FOREST","63",7,7,14
"3276","BUNGOMA","MT ELGON FOREST","64",5,6,11
"3277","BUNGOMA","MT ELGON FOREST","60-64",36,42,78
"3278","BUNGOMA","MT ELGON FOREST","65",11,10,21
"3279","BUNGOMA","MT ELGON FOREST","66",7,9,16
"3280","BUNGOMA","MT ELGON FOREST","67",7,8,15
"3281","BUNGOMA","MT ELGON FOREST","68",1,7,8
"3282","BUNGOMA","MT ELGON FOREST","69",5,7,12
"3283","BUNGOMA","MT ELGON FOREST","65-69",31,41,72
"3284","BUNGOMA","MT ELGON FOREST","70",2,5,7
"3285","BUNGOMA","MT ELGON FOREST","71",6,3,9
"3286","BUNGOMA","MT ELGON FOREST","72",4,3,7
"3287","BUNGOMA","MT ELGON FOREST","73",4,3,7
"3288","BUNGOMA","MT ELGON FOREST","74",5,NA,5
"3289","BUNGOMA","MT ELGON FOREST","70-74",21,14,35
"3290","BUNGOMA","MT ELGON FOREST","75",5,3,8
"3291","BUNGOMA","MT ELGON FOREST","76",1,1,2
"3292","BUNGOMA","MT ELGON FOREST","77",3,3,6
"3293","BUNGOMA","MT ELGON FOREST","78",2,1,3
"3294","BUNGOMA","MT ELGON FOREST","79",1,1,2
"3295","BUNGOMA","MT ELGON FOREST","75-79",12,9,21
"3296","BUNGOMA","MT ELGON FOREST","80",1,4,5
"3297","BUNGOMA","MT ELGON FOREST","81",2,2,4
"3298","BUNGOMA","MT ELGON FOREST","82",1,2,3
"3299","BUNGOMA","MT ELGON FOREST","83",1,1,2
"3300","BUNGOMA","MT ELGON FOREST","84",1,NA,1
"3301","BUNGOMA","MT ELGON FOREST","80-84",6,9,15
"3302","BUNGOMA","MT ELGON FOREST","85",2,1,3
"3303","BUNGOMA","MT ELGON FOREST","86",NA,NA,NA
"3304","BUNGOMA","MT ELGON FOREST","87",1,1,2
"3305","BUNGOMA","MT ELGON FOREST","88",NA,NA,NA
"3306","BUNGOMA","MT ELGON FOREST","89",1,1,2
"3307","BUNGOMA","MT ELGON FOREST","85-89",4,3,7
"3308","BUNGOMA","MT ELGON FOREST","90",NA,NA,NA
"3309","BUNGOMA","MT ELGON FOREST","91",1,NA,1
"3310","BUNGOMA","MT ELGON FOREST","92",NA,1,1
"3311","BUNGOMA","MT ELGON FOREST","93",NA,NA,NA
"3312","BUNGOMA","MT ELGON FOREST","94",1,2,3
"3313","BUNGOMA","MT ELGON FOREST","90-94",2,3,5
"3314","BUNGOMA","MT ELGON FOREST","95",1,1,2
"3315","BUNGOMA","MT ELGON FOREST","96",NA,NA,NA
"3316","BUNGOMA","MT ELGON FOREST","97",NA,NA,NA
"3317","BUNGOMA","MT ELGON FOREST","98",NA,1,1
"3318","BUNGOMA","MT ELGON FOREST","99",NA,NA,NA
"3319","BUNGOMA","MT ELGON FOREST","95-99",1,2,3
"3320","BUNGOMA","MT ELGON FOREST","100+",NA,NA,NA
"3321","BUNGOMA","MT ELGON FOREST","Not Stated",NA,NA,NA
"3322","BUSIA","ALL","Total",426252,467401,893653
"3323","BUSIA","ALL","0",10487,10707,21194
"3324","BUSIA","ALL","1",11275,11341,22616
"3325","BUSIA","ALL","2",11265,11220,22485
"3326","BUSIA","ALL","3",11671,12072,23743
"3327","BUSIA","ALL","4",11617,11649,23266
"3328","BUSIA","ALL","0 - 4",56315,56989,113304
"3329","BUSIA","ALL","5",11926,12123,24049
"3330","BUSIA","ALL","6",12614,13057,25671
"3331","BUSIA","ALL","7",12819,12909,25728
"3332","BUSIA","ALL","8",12147,12669,24816
"3333","BUSIA","ALL","9",13329,13690,27019
"3334","BUSIA","ALL","5-9",62835,64448,127283
"3335","BUSIA","ALL","10",14050,14084,28134
"3336","BUSIA","ALL","11",12849,13607,26456
"3337","BUSIA","ALL","12",14570,14457,29027
"3338","BUSIA","ALL","13",14102,14564,28666
"3339","BUSIA","ALL","14",13247,13404,26651
"3340","BUSIA","ALL","10 -14",68818,70116,138934
"3341","BUSIA","ALL","15",13190,13268,26458
"3342","BUSIA","ALL","16",12152,12607,24759
"3343","BUSIA","ALL","17",12563,12436,24999
"3344","BUSIA","ALL","18",10336,9811,20147
"3345","BUSIA","ALL","19",10460,10469,20929
"3346","BUSIA","ALL","15-19",58701,58591,117292
"3347","BUSIA","ALL","20",9205,9767,18972
"3348","BUSIA","ALL","21",7253,8000,15253
"3349","BUSIA","ALL","22",6799,8220,15019
"3350","BUSIA","ALL","23",6454,7962,14416
"3351","BUSIA","ALL","24",5874,7236,13110
"3352","BUSIA","ALL","20-24",35585,41185,76770
"3353","BUSIA","ALL","25",6278,7824,14102
"3354","BUSIA","ALL","26",5196,6911,12107
"3355","BUSIA","ALL","27",5437,6780,12217
"3356","BUSIA","ALL","28",4310,5782,10092
"3357","BUSIA","ALL","29",4474,5585,10059
"3358","BUSIA","ALL","25-29",25695,32882,58577
"3359","BUSIA","ALL","30",5647,7743,13390
"3360","BUSIA","ALL","31",4328,5601,9929
"3361","BUSIA","ALL","32",5619,7174,12793
"3362","BUSIA","ALL","33",4577,5757,10334
"3363","BUSIA","ALL","34",4093,4897,8990
"3364","BUSIA","ALL","30-34",24264,31172,55436
"3365","BUSIA","ALL","35",5137,5446,10583
"3366","BUSIA","ALL","36",3960,3974,7934
"3367","BUSIA","ALL","37",4114,3994,8108
"3368","BUSIA","ALL","38",2978,3130,6108
"3369","BUSIA","ALL","39",3361,3368,6729
"3370","BUSIA","ALL","35-39",19550,19912,39462
"3371","BUSIA","ALL","40",4086,4493,8579
"3372","BUSIA","ALL","41",3509,4009,7518
"3373","BUSIA","ALL","42",3742,4118,7860
"3374","BUSIA","ALL","43",3355,3583,6938
"3375","BUSIA","ALL","44",2585,2738,5323
"3376","BUSIA","ALL","40-44",17277,18941,36218
"3377","BUSIA","ALL","45",3672,4030,7702
"3378","BUSIA","ALL","46",2530,2686,5216
"3379","BUSIA","ALL","47",2849,3118,5967
"3380","BUSIA","ALL","48",1871,2118,3989
"3381","BUSIA","ALL","49",2045,2392,4437
"3382","BUSIA","ALL","45-49",12967,14344,27311
"3383","BUSIA","ALL","50",2845,4000,6845
"3384","BUSIA","ALL","51",2351,3030,5381
"3385","BUSIA","ALL","52",1942,2412,4354
"3386","BUSIA","ALL","53",1710,2128,3838
"3387","BUSIA","ALL","54",1774,2105,3879
"3388","BUSIA","ALL","50-54",10622,13675,24297
"3389","BUSIA","ALL","55",1952,2290,4242
"3390","BUSIA","ALL","56",1969,2324,4293
"3391","BUSIA","ALL","57",2094,3296,5390
"3392","BUSIA","ALL","58",1650,2096,3746
"3393","BUSIA","ALL","59",2072,2579,4651
"3394","BUSIA","ALL","55-59",9737,12585,22322
"3395","BUSIA","ALL","60",2206,2887,5093
"3396","BUSIA","ALL","61",1755,2135,3890
"3397","BUSIA","ALL","62",1393,1745,3138
"3398","BUSIA","ALL","63",1443,1787,3230
"3399","BUSIA","ALL","64",1154,1610,2764
"3400","BUSIA","ALL","60-64",7951,10164,18115
"3401","BUSIA","ALL","65",1476,2041,3517
"3402","BUSIA","ALL","66",990,1276,2266
"3403","BUSIA","ALL","67",1471,2002,3473
"3404","BUSIA","ALL","68",675,808,1483
"3405","BUSIA","ALL","69",1039,1438,2477
"3406","BUSIA","ALL","65-69",5651,7565,13216
"3407","BUSIA","ALL","70",1314,2132,3446
"3408","BUSIA","ALL","71",1027,1214,2241
"3409","BUSIA","ALL","72",784,877,1661
"3410","BUSIA","ALL","73",652,787,1439
"3411","BUSIA","ALL","74",660,982,1642
"3412","BUSIA","ALL","70-74",4437,5992,10429
"3413","BUSIA","ALL","75",619,915,1534
"3414","BUSIA","ALL","76",490,594,1084
"3415","BUSIA","ALL","77",653,869,1522
"3416","BUSIA","ALL","78",324,407,731
"3417","BUSIA","ALL","79",434,849,1283
"3418","BUSIA","ALL","75-79",2520,3634,6154
"3419","BUSIA","ALL","80",492,901,1393
"3420","BUSIA","ALL","81",362,476,838
"3421","BUSIA","ALL","82",288,341,629
"3422","BUSIA","ALL","83",352,396,748
"3423","BUSIA","ALL","84",265,460,725
"3424","BUSIA","ALL","80-84",1759,2574,4333
"3425","BUSIA","ALL","85",207,371,578
"3426","BUSIA","ALL","86",253,278,531
"3427","BUSIA","ALL","87",261,414,675
"3428","BUSIA","ALL","88",128,160,288
"3429","BUSIA","ALL","89",196,446,642
"3430","BUSIA","ALL","85-89",1045,1669,2714
"3431","BUSIA","ALL","90",93,227,320
"3432","BUSIA","ALL","91",106,123,229
"3433","BUSIA","ALL","92",51,64,115
"3434","BUSIA","ALL","93",59,68,127
"3435","BUSIA","ALL","94",40,110,150
"3436","BUSIA","ALL","90-94",349,592,941
"3437","BUSIA","ALL","95",45,79,124
"3438","BUSIA","ALL","96",25,36,61
"3439","BUSIA","ALL","97",46,49,95
"3440","BUSIA","ALL","98",8,37,45
"3441","BUSIA","ALL","99",16,58,74
"3442","BUSIA","ALL","95-99",140,259,399
"3443","BUSIA","ALL","100+",29,108,137
"3444","BUSIA","ALL","Not Stated",5,4,9
"3445","BUSIA","BUNYALA","Total",41465,44511,85976
"3446","BUSIA","BUNYALA","0",961,973,1934
"3447","BUSIA","BUNYALA","1",1037,991,2028
"3448","BUSIA","BUNYALA","2",1051,1058,2109
"3449","BUSIA","BUNYALA","3",1081,1104,2185
"3450","BUSIA","BUNYALA","4",1080,1076,2156
"3451","BUSIA","BUNYALA","0 - 4",5210,5202,10412
"3452","BUSIA","BUNYALA","5",1140,1160,2300
"3453","BUSIA","BUNYALA","6",1169,1246,2415
"3454","BUSIA","BUNYALA","7",1341,1319,2660
"3455","BUSIA","BUNYALA","8",1190,1168,2358
"3456","BUSIA","BUNYALA","9",1215,1342,2557
"3457","BUSIA","BUNYALA","5-9",6055,6235,12290
"3458","BUSIA","BUNYALA","10",1275,1290,2565
"3459","BUSIA","BUNYALA","11",1220,1292,2512
"3460","BUSIA","BUNYALA","12",1451,1375,2826
"3461","BUSIA","BUNYALA","13",1377,1331,2708
"3462","BUSIA","BUNYALA","14",1328,1241,2569
"3463","BUSIA","BUNYALA","10 -14",6651,6529,13180
"3464","BUSIA","BUNYALA","15",1227,1204,2431
"3465","BUSIA","BUNYALA","16",1120,1186,2306
"3466","BUSIA","BUNYALA","17",1204,1075,2279
"3467","BUSIA","BUNYALA","18",977,889,1866
"3468","BUSIA","BUNYALA","19",1001,898,1899
"3469","BUSIA","BUNYALA","15-19",5529,5252,10781
"3470","BUSIA","BUNYALA","20",887,961,1848
"3471","BUSIA","BUNYALA","21",671,694,1365
"3472","BUSIA","BUNYALA","22",691,807,1498
"3473","BUSIA","BUNYALA","23",674,720,1394
"3474","BUSIA","BUNYALA","24",569,651,1220
"3475","BUSIA","BUNYALA","20-24",3492,3833,7325
"3476","BUSIA","BUNYALA","25",630,753,1383
"3477","BUSIA","BUNYALA","26",495,624,1119
"3478","BUSIA","BUNYALA","27",596,655,1251
"3479","BUSIA","BUNYALA","28",468,572,1040
"3480","BUSIA","BUNYALA","29",454,544,998
"3481","BUSIA","BUNYALA","25-29",2643,3148,5791
"3482","BUSIA","BUNYALA","30",579,859,1438
"3483","BUSIA","BUNYALA","31",496,573,1069
"3484","BUSIA","BUNYALA","32",639,765,1404
"3485","BUSIA","BUNYALA","33",535,577,1112
"3486","BUSIA","BUNYALA","34",461,479,940
"3487","BUSIA","BUNYALA","30-34",2710,3253,5963
"3488","BUSIA","BUNYALA","35",575,540,1115
"3489","BUSIA","BUNYALA","36",412,369,781
"3490","BUSIA","BUNYALA","37",475,394,869
"3491","BUSIA","BUNYALA","38",315,287,602
"3492","BUSIA","BUNYALA","39",363,370,733
"3493","BUSIA","BUNYALA","35-39",2140,1960,4100
"3494","BUSIA","BUNYALA","40",447,456,903
"3495","BUSIA","BUNYALA","41",378,327,705
"3496","BUSIA","BUNYALA","42",401,370,771
"3497","BUSIA","BUNYALA","43",339,343,682
"3498","BUSIA","BUNYALA","44",241,278,519
"3499","BUSIA","BUNYALA","40-44",1806,1774,3580
"3500","BUSIA","BUNYALA","45",376,370,746
"3501","BUSIA","BUNYALA","46",242,230,472
"3502","BUSIA","BUNYALA","47",266,263,529
"3503","BUSIA","BUNYALA","48",148,142,290
"3504","BUSIA","BUNYALA","49",151,194,345
"3505","BUSIA","BUNYALA","45-49",1183,1199,2382
"3506","BUSIA","BUNYALA","50",270,377,647
"3507","BUSIA","BUNYALA","51",213,271,484
"3508","BUSIA","BUNYALA","52",218,258,476
"3509","BUSIA","BUNYALA","53",149,203,352
"3510","BUSIA","BUNYALA","54",163,186,349
"3511","BUSIA","BUNYALA","50-54",1013,1295,2308
"3512","BUSIA","BUNYALA","55",184,226,410
"3513","BUSIA","BUNYALA","56",147,231,378
"3514","BUSIA","BUNYALA","57",208,375,583
"3515","BUSIA","BUNYALA","58",169,203,372
"3516","BUSIA","BUNYALA","59",193,244,437
"3517","BUSIA","BUNYALA","55-59",901,1279,2180
"3518","BUSIA","BUNYALA","60",195,342,537
"3519","BUSIA","BUNYALA","61",141,213,354
"3520","BUSIA","BUNYALA","62",123,173,296
"3521","BUSIA","BUNYALA","63",128,156,284
"3522","BUSIA","BUNYALA","64",122,172,294
"3523","BUSIA","BUNYALA","60-64",709,1056,1765
"3524","BUSIA","BUNYALA","65",153,209,362
"3525","BUSIA","BUNYALA","66",79,120,199
"3526","BUSIA","BUNYALA","67",155,208,363
"3527","BUSIA","BUNYALA","68",62,91,153
"3528","BUSIA","BUNYALA","69",92,171,263
"3529","BUSIA","BUNYALA","65-69",541,799,1340
"3530","BUSIA","BUNYALA","70",109,247,356
"3531","BUSIA","BUNYALA","71",97,118,215
"3532","BUSIA","BUNYALA","72",54,100,154
"3533","BUSIA","BUNYALA","73",56,93,149
"3534","BUSIA","BUNYALA","74",77,94,171
"3535","BUSIA","BUNYALA","70-74",393,652,1045
"3536","BUSIA","BUNYALA","75",53,135,188
"3537","BUSIA","BUNYALA","76",51,51,102
"3538","BUSIA","BUNYALA","77",54,96,150
"3539","BUSIA","BUNYALA","78",35,36,71
"3540","BUSIA","BUNYALA","79",31,88,119
"3541","BUSIA","BUNYALA","75-79",224,406,630
"3542","BUSIA","BUNYALA","80",40,139,179
"3543","BUSIA","BUNYALA","81",34,55,89
"3544","BUSIA","BUNYALA","82",24,38,62
"3545","BUSIA","BUNYALA","83",29,35,64
"3546","BUSIA","BUNYALA","84",24,63,87
"3547","BUSIA","BUNYALA","80-84",151,330,481
"3548","BUSIA","BUNYALA","85",21,39,60
"3549","BUSIA","BUNYALA","86",12,26,38
"3550","BUSIA","BUNYALA","87",16,40,56
"3551","BUSIA","BUNYALA","88",8,26,34
"3552","BUSIA","BUNYALA","89",11,48,59
"3553","BUSIA","BUNYALA","85-89",68,179,247
"3554","BUSIA","BUNYALA","90",9,38,47
"3555","BUSIA","BUNYALA","91",13,17,30
"3556","BUSIA","BUNYALA","92",4,11,15
"3557","BUSIA","BUNYALA","93",2,9,11
"3558","BUSIA","BUNYALA","94",3,14,17
"3559","BUSIA","BUNYALA","90-94",31,89,120
"3560","BUSIA","BUNYALA","95",1,12,13
"3561","BUSIA","BUNYALA","96",5,4,9
"3562","BUSIA","BUNYALA","97",4,8,12
"3563","BUSIA","BUNYALA","98",NA,6,6
"3564","BUSIA","BUNYALA","99",1,4,5
"3565","BUSIA","BUNYALA","95-99",11,34,45
"3566","BUSIA","BUNYALA","100+",4,7,11
"3567","BUSIA","BUNYALA","Not Stated",NA,NA,NA
"3568","BUSIA","BUSIA","Total",69034,73373,142407
"3569","BUSIA","BUSIA","0",1703,1741,3444
"3570","BUSIA","BUSIA","1",1738,1713,3451
"3571","BUSIA","BUSIA","2",1761,1715,3476
"3572","BUSIA","BUSIA","3",1803,1937,3740
"3573","BUSIA","BUSIA","4",1819,1792,3611
"3574","BUSIA","BUSIA","0 - 4",8824,8898,17722
"3575","BUSIA","BUSIA","5",1792,1873,3665
"3576","BUSIA","BUSIA","6",1871,1961,3832
"3577","BUSIA","BUSIA","7",1885,1965,3850
"3578","BUSIA","BUSIA","8",1776,1879,3655
"3579","BUSIA","BUSIA","9",1999,2104,4103
"3580","BUSIA","BUSIA","5-9",9323,9782,19105
"3581","BUSIA","BUSIA","10",2128,2160,4288
"3582","BUSIA","BUSIA","11",1937,1957,3894
"3583","BUSIA","BUSIA","12",2201,2078,4279
"3584","BUSIA","BUSIA","13",2081,2113,4194
"3585","BUSIA","BUSIA","14",1934,2067,4001
"3586","BUSIA","BUSIA","10 -14",10281,10375,20656
"3587","BUSIA","BUSIA","15",1916,2016,3932
"3588","BUSIA","BUSIA","16",1792,1950,3742
"3589","BUSIA","BUSIA","17",1786,1948,3734
"3590","BUSIA","BUSIA","18",1630,1504,3134
"3591","BUSIA","BUSIA","19",1593,1701,3294
"3592","BUSIA","BUSIA","15-19",8717,9119,17836
"3593","BUSIA","BUSIA","20",1544,1617,3161
"3594","BUSIA","BUSIA","21",1158,1336,2494
"3595","BUSIA","BUSIA","22",1198,1449,2647
"3596","BUSIA","BUSIA","23",1216,1385,2601
"3597","BUSIA","BUSIA","24",1121,1321,2442
"3598","BUSIA","BUSIA","20-24",6237,7108,13345
"3599","BUSIA","BUSIA","25",1216,1399,2615
"3600","BUSIA","BUSIA","26",1027,1250,2277
"3601","BUSIA","BUSIA","27",1086,1239,2325
"3602","BUSIA","BUSIA","28",850,1082,1932
"3603","BUSIA","BUSIA","29",886,1008,1894
"3604","BUSIA","BUSIA","25-29",5065,5978,11043
"3605","BUSIA","BUSIA","30",1257,1427,2684
"3606","BUSIA","BUSIA","31",811,909,1720
"3607","BUSIA","BUSIA","32",1100,1219,2319
"3608","BUSIA","BUSIA","33",842,928,1770
"3609","BUSIA","BUSIA","34",759,794,1553
"3610","BUSIA","BUSIA","30-34",4769,5277,10046
"3611","BUSIA","BUSIA","35",1069,990,2059
"3612","BUSIA","BUSIA","36",715,720,1435
"3613","BUSIA","BUSIA","37",746,676,1422
"3614","BUSIA","BUSIA","38",603,563,1166
"3615","BUSIA","BUSIA","39",615,524,1139
"3616","BUSIA","BUSIA","35-39",3748,3473,7221
"3617","BUSIA","BUSIA","40",890,825,1715
"3618","BUSIA","BUSIA","41",628,638,1266
"3619","BUSIA","BUSIA","42",673,622,1295
"3620","BUSIA","BUSIA","43",523,546,1069
"3621","BUSIA","BUSIA","44",425,383,808
"3622","BUSIA","BUSIA","40-44",3139,3014,6153
"3623","BUSIA","BUSIA","45",694,648,1342
"3624","BUSIA","BUSIA","46",455,397,852
"3625","BUSIA","BUSIA","47",523,452,975
"3626","BUSIA","BUSIA","48",353,364,717
"3627","BUSIA","BUSIA","49",376,352,728
"3628","BUSIA","BUSIA","45-49",2401,2213,4614
"3629","BUSIA","BUSIA","50",535,636,1171
"3630","BUSIA","BUSIA","51",380,452,832
"3631","BUSIA","BUSIA","52",307,339,646
"3632","BUSIA","BUSIA","53",290,279,569
"3633","BUSIA","BUSIA","54",290,325,615
"3634","BUSIA","BUSIA","50-54",1802,2031,3833
"3635","BUSIA","BUSIA","55",321,358,679
"3636","BUSIA","BUSIA","56",301,338,639
"3637","BUSIA","BUSIA","57",271,437,708
"3638","BUSIA","BUSIA","58",219,297,516
"3639","BUSIA","BUSIA","59",329,368,697
"3640","BUSIA","BUSIA","55-59",1441,1798,3239
"3641","BUSIA","BUSIA","60",350,405,755
"3642","BUSIA","BUSIA","61",260,329,589
"3643","BUSIA","BUSIA","62",226,196,422
"3644","BUSIA","BUSIA","63",212,227,439
"3645","BUSIA","BUSIA","64",189,214,403
"3646","BUSIA","BUSIA","60-64",1237,1371,2608
"3647","BUSIA","BUSIA","65",209,255,464
"3648","BUSIA","BUSIA","66",135,167,302
"3649","BUSIA","BUSIA","67",199,285,484
"3650","BUSIA","BUSIA","68",93,97,190
"3651","BUSIA","BUSIA","69",129,185,314
"3652","BUSIA","BUSIA","65-69",765,989,1754
"3653","BUSIA","BUSIA","70",169,297,466
"3654","BUSIA","BUSIA","71",121,156,277
"3655","BUSIA","BUSIA","72",110,127,237
"3656","BUSIA","BUSIA","73",88,101,189
"3657","BUSIA","BUSIA","74",85,114,199
"3658","BUSIA","BUSIA","70-74",573,795,1368
"3659","BUSIA","BUSIA","75",88,139,227
"3660","BUSIA","BUSIA","76",54,79,133
"3661","BUSIA","BUSIA","77",81,88,169
"3662","BUSIA","BUSIA","78",40,59,99
"3663","BUSIA","BUSIA","79",54,113,167
"3664","BUSIA","BUSIA","75-79",317,478,795
"3665","BUSIA","BUSIA","80",56,113,169
"3666","BUSIA","BUSIA","81",43,54,97
"3667","BUSIA","BUSIA","82",48,62,110
"3668","BUSIA","BUSIA","83",36,42,78
"3669","BUSIA","BUSIA","84",25,71,96
"3670","BUSIA","BUSIA","80-84",208,342,550
"3671","BUSIA","BUSIA","85",23,36,59
"3672","BUSIA","BUSIA","86",39,42,81
"3673","BUSIA","BUSIA","87",30,41,71
"3674","BUSIA","BUSIA","88",9,19,28
"3675","BUSIA","BUSIA","89",23,61,84
"3676","BUSIA","BUSIA","85-89",124,199,323
"3677","BUSIA","BUSIA","90",5,34,39
"3678","BUSIA","BUSIA","91",14,20,34
"3679","BUSIA","BUSIA","92",6,8,14
"3680","BUSIA","BUSIA","93",9,10,19
"3681","BUSIA","BUSIA","94",2,19,21
"3682","BUSIA","BUSIA","90-94",36,91,127
"3683","BUSIA","BUSIA","95",5,7,12
"3684","BUSIA","BUSIA","96",3,2,5
"3685","BUSIA","BUSIA","97",9,1,10
"3686","BUSIA","BUSIA","98",2,6,8
"3687","BUSIA","BUSIA","99",2,8,10
"3688","BUSIA","BUSIA","95-99",21,24,45
"3689","BUSIA","BUSIA","100+",3,15,18
"3690","BUSIA","BUSIA","Not Stated",3,3,6
"3691","BUSIA","BUTULA","Total",65136,75195,140331
"3692","BUSIA","BUTULA","0",1595,1685,3280
"3693","BUSIA","BUTULA","1",1817,1762,3579
"3694","BUSIA","BUTULA","2",1736,1726,3462
"3695","BUSIA","BUTULA","3",1886,1885,3771
"3696","BUSIA","BUTULA","4",1817,1855,3672
"3697","BUSIA","BUTULA","0 - 4",8851,8913,17764
"3698","BUSIA","BUTULA","5",1911,1997,3908
"3699","BUSIA","BUTULA","6",2071,2016,4087
"3700","BUSIA","BUTULA","7",1988,2151,4139
"3701","BUSIA","BUTULA","8",1895,2058,3953
"3702","BUSIA","BUTULA","9",2195,2203,4398
"3703","BUSIA","BUTULA","5-9",10060,10425,20485
"3704","BUSIA","BUTULA","10",2379,2266,4645
"3705","BUSIA","BUTULA","11",2068,2182,4250
"3706","BUSIA","BUTULA","12",2420,2431,4851
"3707","BUSIA","BUTULA","13",2338,2468,4806
"3708","BUSIA","BUTULA","14",2214,2204,4418
"3709","BUSIA","BUTULA","10 -14",11419,11551,22970
"3710","BUSIA","BUTULA","15",2222,2210,4432
"3711","BUSIA","BUTULA","16",2070,2027,4097
"3712","BUSIA","BUTULA","17",2108,2031,4139
"3713","BUSIA","BUTULA","18",1567,1515,3082
"3714","BUSIA","BUTULA","19",1574,1614,3188
"3715","BUSIA","BUTULA","15-19",9541,9397,18938
"3716","BUSIA","BUTULA","20",1280,1401,2681
"3717","BUSIA","BUTULA","21",974,1146,2120
"3718","BUSIA","BUTULA","22",890,1150,2040
"3719","BUSIA","BUTULA","23",832,1127,1959
"3720","BUSIA","BUTULA","24",696,957,1653
"3721","BUSIA","BUTULA","20-24",4672,5781,10453
"3722","BUSIA","BUTULA","25",785,1040,1825
"3723","BUSIA","BUTULA","26",628,932,1560
"3724","BUSIA","BUTULA","27",718,1041,1759
"3725","BUSIA","BUTULA","28",543,861,1404
"3726","BUSIA","BUTULA","29",568,785,1353
"3727","BUSIA","BUTULA","25-29",3242,4659,7901
"3728","BUSIA","BUTULA","30",739,1174,1913
"3729","BUSIA","BUTULA","31",510,771,1281
"3730","BUSIA","BUTULA","32",680,1043,1723
"3731","BUSIA","BUTULA","33",549,816,1365
"3732","BUSIA","BUTULA","34",487,715,1202
"3733","BUSIA","BUTULA","30-34",2965,4519,7484
"3734","BUSIA","BUTULA","35",649,849,1498
"3735","BUSIA","BUTULA","36",463,582,1045
"3736","BUSIA","BUTULA","37",535,659,1194
"3737","BUSIA","BUTULA","38",392,516,908
"3738","BUSIA","BUTULA","39",434,587,1021
"3739","BUSIA","BUTULA","35-39",2473,3193,5666
"3740","BUSIA","BUTULA","40",554,754,1308
"3741","BUSIA","BUTULA","41",507,692,1199
"3742","BUSIA","BUTULA","42",517,666,1183
"3743","BUSIA","BUTULA","43",433,575,1008
"3744","BUSIA","BUTULA","44",347,433,780
"3745","BUSIA","BUTULA","40-44",2358,3120,5478
"3746","BUSIA","BUTULA","45",496,707,1203
"3747","BUSIA","BUTULA","46",319,456,775
"3748","BUSIA","BUTULA","47",398,515,913
"3749","BUSIA","BUTULA","48",282,397,679
"3750","BUSIA","BUTULA","49",326,408,734
"3751","BUSIA","BUTULA","45-49",1821,2483,4304
"3752","BUSIA","BUTULA","50",460,786,1246
"3753","BUSIA","BUTULA","51",365,561,926
"3754","BUSIA","BUTULA","52",304,442,746
"3755","BUSIA","BUTULA","53",278,422,700
"3756","BUSIA","BUTULA","54",286,406,692
"3757","BUSIA","BUTULA","50-54",1693,2617,4310
"3758","BUSIA","BUTULA","55",340,463,803
"3759","BUSIA","BUTULA","56",288,428,716
"3760","BUSIA","BUTULA","57",335,564,899
"3761","BUSIA","BUTULA","58",289,360,649
"3762","BUSIA","BUTULA","59",341,492,833
"3763","BUSIA","BUTULA","55-59",1593,2307,3900
"3764","BUSIA","BUTULA","60",402,541,943
"3765","BUSIA","BUTULA","61",329,368,697
"3766","BUSIA","BUTULA","62",242,311,553
"3767","BUSIA","BUTULA","63",246,301,547
"3768","BUSIA","BUTULA","64",199,289,488
"3769","BUSIA","BUTULA","60-64",1418,1810,3228
"3770","BUSIA","BUTULA","65",277,391,668
"3771","BUSIA","BUTULA","66",194,246,440
"3772","BUSIA","BUTULA","67",263,389,652
"3773","BUSIA","BUTULA","68",123,160,283
"3774","BUSIA","BUTULA","69",166,261,427
"3775","BUSIA","BUTULA","65-69",1023,1447,2470
"3776","BUSIA","BUTULA","70",265,470,735
"3777","BUSIA","BUTULA","71",172,220,392
"3778","BUSIA","BUTULA","72",161,182,343
"3779","BUSIA","BUTULA","73",129,151,280
"3780","BUSIA","BUTULA","74",121,185,306
"3781","BUSIA","BUTULA","70-74",848,1208,2056
"3782","BUSIA","BUTULA","75",112,183,295
"3783","BUSIA","BUTULA","76",82,140,222
"3784","BUSIA","BUTULA","77",126,172,298
"3785","BUSIA","BUTULA","78",68,84,152
"3786","BUSIA","BUTULA","79",75,174,249
"3787","BUSIA","BUTULA","75-79",463,753,1216
"3788","BUSIA","BUTULA","80",106,196,302
"3789","BUSIA","BUTULA","81",82,85,167
"3790","BUSIA","BUTULA","82",50,70,120
"3791","BUSIA","BUTULA","83",69,92,161
"3792","BUSIA","BUTULA","84",57,74,131
"3793","BUSIA","BUTULA","80-84",364,517,881
"3794","BUSIA","BUTULA","85",49,90,139
"3795","BUSIA","BUTULA","86",63,48,111
"3796","BUSIA","BUTULA","87",48,83,131
"3797","BUSIA","BUTULA","88",23,35,58
"3798","BUSIA","BUTULA","89",36,69,105
"3799","BUSIA","BUTULA","85-89",219,325,544
"3800","BUSIA","BUTULA","90",25,43,68
"3801","BUSIA","BUTULA","91",23,31,54
"3802","BUSIA","BUTULA","92",13,10,23
"3803","BUSIA","BUTULA","93",11,7,18
"3804","BUSIA","BUTULA","94",11,16,27
"3805","BUSIA","BUTULA","90-94",83,107,190
"3806","BUSIA","BUTULA","95",7,16,23
"3807","BUSIA","BUTULA","96",6,6,12
"3808","BUSIA","BUTULA","97",6,7,13
"3809","BUSIA","BUTULA","98",1,4,5
"3810","BUSIA","BUTULA","99",2,9,11
"3811","BUSIA","BUTULA","95-99",22,42,64
"3812","BUSIA","BUTULA","100+",8,21,29
"3813","BUSIA","BUTULA","Not Stated",NA,NA,NA
"3814","BUSIA","NAMBALE","Total",52900,58732,111632
"3815","BUSIA","NAMBALE","0",1312,1285,2597
"3816","BUSIA","NAMBALE","1",1419,1444,2863
"3817","BUSIA","NAMBALE","2",1463,1450,2913
"3818","BUSIA","NAMBALE","3",1416,1514,2930
"3819","BUSIA","NAMBALE","4",1414,1518,2932
"3820","BUSIA","NAMBALE","0 - 4",7024,7211,14235
"3821","BUSIA","NAMBALE","5",1501,1545,3046
"3822","BUSIA","NAMBALE","6",1598,1739,3337
"3823","BUSIA","NAMBALE","7",1645,1659,3304
"3824","BUSIA","NAMBALE","8",1613,1641,3254
"3825","BUSIA","NAMBALE","9",1752,1872,3624
"3826","BUSIA","NAMBALE","5-9",8109,8456,16565
"3827","BUSIA","NAMBALE","10",1889,1917,3806
"3828","BUSIA","NAMBALE","11",1723,1829,3552
"3829","BUSIA","NAMBALE","12",1879,1894,3773
"3830","BUSIA","NAMBALE","13",1823,1798,3621
"3831","BUSIA","NAMBALE","14",1697,1713,3410
"3832","BUSIA","NAMBALE","10 -14",9011,9151,18162
"3833","BUSIA","NAMBALE","15",1715,1753,3468
"3834","BUSIA","NAMBALE","16",1623,1672,3295
"3835","BUSIA","NAMBALE","17",1593,1674,3267
"3836","BUSIA","NAMBALE","18",1360,1252,2612
"3837","BUSIA","NAMBALE","19",1296,1299,2595
"3838","BUSIA","NAMBALE","15-19",7587,7650,15237
"3839","BUSIA","NAMBALE","20",1180,1239,2419
"3840","BUSIA","NAMBALE","21",858,947,1805
"3841","BUSIA","NAMBALE","22",769,990,1759
"3842","BUSIA","NAMBALE","23",749,919,1668
"3843","BUSIA","NAMBALE","24",711,815,1526
"3844","BUSIA","NAMBALE","20-24",4267,4910,9177
"3845","BUSIA","NAMBALE","25",694,924,1618
"3846","BUSIA","NAMBALE","26",611,821,1432
"3847","BUSIA","NAMBALE","27",558,792,1350
"3848","BUSIA","NAMBALE","28",477,664,1141
"3849","BUSIA","NAMBALE","29",478,640,1118
"3850","BUSIA","NAMBALE","25-29",2818,3841,6659
"3851","BUSIA","NAMBALE","30",604,920,1524
"3852","BUSIA","NAMBALE","31",450,665,1115
"3853","BUSIA","NAMBALE","32",609,808,1417
"3854","BUSIA","NAMBALE","33",472,668,1140
"3855","BUSIA","NAMBALE","34",467,609,1076
"3856","BUSIA","NAMBALE","30-34",2602,3670,6272
"3857","BUSIA","NAMBALE","35",553,694,1247
"3858","BUSIA","NAMBALE","36",463,511,974
"3859","BUSIA","NAMBALE","37",458,495,953
"3860","BUSIA","NAMBALE","38",352,429,781
"3861","BUSIA","NAMBALE","39",363,433,796
"3862","BUSIA","NAMBALE","35-39",2189,2562,4751
"3863","BUSIA","NAMBALE","40",463,568,1031
"3864","BUSIA","NAMBALE","41",387,531,918
"3865","BUSIA","NAMBALE","42",435,570,1005
"3866","BUSIA","NAMBALE","43",396,470,866
"3867","BUSIA","NAMBALE","44",318,384,702
"3868","BUSIA","NAMBALE","40-44",1999,2523,4522
"3869","BUSIA","NAMBALE","45",449,513,962
"3870","BUSIA","NAMBALE","46",321,349,670
"3871","BUSIA","NAMBALE","47",348,435,783
"3872","BUSIA","NAMBALE","48",242,282,524
"3873","BUSIA","NAMBALE","49",271,309,580
"3874","BUSIA","NAMBALE","45-49",1631,1888,3519
"3875","BUSIA","NAMBALE","50",304,446,750
"3876","BUSIA","NAMBALE","51",307,376,683
"3877","BUSIA","NAMBALE","52",261,310,571
"3878","BUSIA","NAMBALE","53",220,277,497
"3879","BUSIA","NAMBALE","54",226,246,472
"3880","BUSIA","NAMBALE","50-54",1318,1655,2973
"3881","BUSIA","NAMBALE","55",259,294,553
"3882","BUSIA","NAMBALE","56",285,291,576
"3883","BUSIA","NAMBALE","57",270,352,622
"3884","BUSIA","NAMBALE","58",196,265,461
"3885","BUSIA","NAMBALE","59",260,309,569
"3886","BUSIA","NAMBALE","55-59",1270,1511,2781
"3887","BUSIA","NAMBALE","60",314,320,634
"3888","BUSIA","NAMBALE","61",216,250,466
"3889","BUSIA","NAMBALE","62",169,196,365
"3890","BUSIA","NAMBALE","63",178,225,403
"3891","BUSIA","NAMBALE","64",134,209,343
"3892","BUSIA","NAMBALE","60-64",1011,1200,2211
"3893","BUSIA","NAMBALE","65",201,257,458
"3894","BUSIA","NAMBALE","66",139,146,285
"3895","BUSIA","NAMBALE","67",190,229,419
"3896","BUSIA","NAMBALE","68",81,84,165
"3897","BUSIA","NAMBALE","69",138,165,303
"3898","BUSIA","NAMBALE","65-69",749,881,1630
"3899","BUSIA","NAMBALE","70",142,228,370
"3900","BUSIA","NAMBALE","71",129,145,274
"3901","BUSIA","NAMBALE","72",92,116,208
"3902","BUSIA","NAMBALE","73",85,91,176
"3903","BUSIA","NAMBALE","74",90,114,204
"3904","BUSIA","NAMBALE","70-74",538,694,1232
"3905","BUSIA","NAMBALE","75",81,96,177
"3906","BUSIA","NAMBALE","76",74,67,141
"3907","BUSIA","NAMBALE","77",90,100,190
"3908","BUSIA","NAMBALE","78",33,37,70
"3909","BUSIA","NAMBALE","79",59,59,118
"3910","BUSIA","NAMBALE","75-79",337,359,696
"3911","BUSIA","NAMBALE","80",69,103,172
"3912","BUSIA","NAMBALE","81",54,54,108
"3913","BUSIA","NAMBALE","82",30,39,69
"3914","BUSIA","NAMBALE","83",49,50,99
"3915","BUSIA","NAMBALE","84",31,40,71
"3916","BUSIA","NAMBALE","80-84",233,286,519
"3917","BUSIA","NAMBALE","85",24,41,65
"3918","BUSIA","NAMBALE","86",25,31,56
"3919","BUSIA","NAMBALE","87",34,51,85
"3920","BUSIA","NAMBALE","88",19,16,35
"3921","BUSIA","NAMBALE","89",24,52,76
"3922","BUSIA","NAMBALE","85-89",126,191,317
"3923","BUSIA","NAMBALE","90",15,23,38
"3924","BUSIA","NAMBALE","91",12,15,27
"3925","BUSIA","NAMBALE","92",8,5,13
"3926","BUSIA","NAMBALE","93",11,10,21
"3927","BUSIA","NAMBALE","94",7,6,13
"3928","BUSIA","NAMBALE","90-94",53,59,112
"3929","BUSIA","NAMBALE","95",9,7,16
"3930","BUSIA","NAMBALE","96",5,2,7
"3931","BUSIA","NAMBALE","97",5,4,9
"3932","BUSIA","NAMBALE","98",1,5,6
"3933","BUSIA","NAMBALE","99",3,5,8
"3934","BUSIA","NAMBALE","95-99",23,23,46
"3935","BUSIA","NAMBALE","100+",4,10,14
"3936","BUSIA","NAMBALE","Not Stated",1,1,2
"3937","BUSIA","SAMIA","Total",50821,56341,107162
"3938","BUSIA","SAMIA","0",1207,1240,2447
"3939","BUSIA","SAMIA","1",1385,1414,2799
"3940","BUSIA","SAMIA","2",1331,1327,2658
"3941","BUSIA","SAMIA","3",1384,1466,2850
"3942","BUSIA","SAMIA","4",1414,1433,2847
"3943","BUSIA","SAMIA","0 - 4",6721,6880,13601
"3944","BUSIA","SAMIA","5",1459,1432,2891
"3945","BUSIA","SAMIA","6",1423,1523,2946
"3946","BUSIA","SAMIA","7",1537,1442,2979
"3947","BUSIA","SAMIA","8",1411,1450,2861
"3948","BUSIA","SAMIA","9",1578,1638,3216
"3949","BUSIA","SAMIA","5-9",7408,7485,14893
"3950","BUSIA","SAMIA","10",1580,1730,3310
"3951","BUSIA","SAMIA","11",1466,1589,3055
"3952","BUSIA","SAMIA","12",1687,1749,3436
"3953","BUSIA","SAMIA","13",1702,1771,3473
"3954","BUSIA","SAMIA","14",1678,1589,3267
"3955","BUSIA","SAMIA","10 -14",8113,8428,16541
"3956","BUSIA","SAMIA","15",1674,1608,3282
"3957","BUSIA","SAMIA","16",1484,1458,2942
"3958","BUSIA","SAMIA","17",1585,1451,3036
"3959","BUSIA","SAMIA","18",1299,1181,2480
"3960","BUSIA","SAMIA","19",1308,1285,2593
"3961","BUSIA","SAMIA","15-19",7350,6983,14333
"3962","BUSIA","SAMIA","20",1112,1086,2198
"3963","BUSIA","SAMIA","21",872,909,1781
"3964","BUSIA","SAMIA","22",772,890,1662
"3965","BUSIA","SAMIA","23",755,858,1613
"3966","BUSIA","SAMIA","24",655,834,1489
"3967","BUSIA","SAMIA","20-24",4166,4577,8743
"3968","BUSIA","SAMIA","25",739,865,1604
"3969","BUSIA","SAMIA","26",533,745,1278
"3970","BUSIA","SAMIA","27",601,666,1267
"3971","BUSIA","SAMIA","28",452,617,1069
"3972","BUSIA","SAMIA","29",489,663,1152
"3973","BUSIA","SAMIA","25-29",2814,3556,6370
"3974","BUSIA","SAMIA","30",588,833,1421
"3975","BUSIA","SAMIA","31",466,666,1132
"3976","BUSIA","SAMIA","32",627,786,1413
"3977","BUSIA","SAMIA","33",530,661,1191
"3978","BUSIA","SAMIA","34",477,567,1044
"3979","BUSIA","SAMIA","30-34",2688,3513,6201
"3980","BUSIA","SAMIA","35",546,598,1144
"3981","BUSIA","SAMIA","36",478,495,973
"3982","BUSIA","SAMIA","37",506,476,982
"3983","BUSIA","SAMIA","38",331,385,716
"3984","BUSIA","SAMIA","39",379,353,732
"3985","BUSIA","SAMIA","35-39",2240,2307,4547
"3986","BUSIA","SAMIA","40",456,514,970
"3987","BUSIA","SAMIA","41",382,475,857
"3988","BUSIA","SAMIA","42",389,473,862
"3989","BUSIA","SAMIA","43",401,374,775
"3990","BUSIA","SAMIA","44",256,282,538
"3991","BUSIA","SAMIA","40-44",1884,2118,4002
"3992","BUSIA","SAMIA","45",429,458,887
"3993","BUSIA","SAMIA","46",331,331,662
"3994","BUSIA","SAMIA","47",305,361,666
"3995","BUSIA","SAMIA","48",202,246,448
"3996","BUSIA","SAMIA","49",187,285,472
"3997","BUSIA","SAMIA","45-49",1454,1681,3135
"3998","BUSIA","SAMIA","50",331,560,891
"3999","BUSIA","SAMIA","51",306,425,731
"4000","BUSIA","SAMIA","52",217,330,547
"4001","BUSIA","SAMIA","53",226,278,504
"4002","BUSIA","SAMIA","54",246,307,553
"4003","BUSIA","SAMIA","50-54",1326,1900,3226
"4004","BUSIA","SAMIA","55",251,306,557
"4005","BUSIA","SAMIA","56",245,286,531
"4006","BUSIA","SAMIA","57",309,517,826
"4007","BUSIA","SAMIA","58",235,317,552
"4008","BUSIA","SAMIA","59",275,360,635
"4009","BUSIA","SAMIA","55-59",1315,1786,3101
"4010","BUSIA","SAMIA","60",296,467,763
"4011","BUSIA","SAMIA","61",228,299,527
"4012","BUSIA","SAMIA","62",200,287,487
"4013","BUSIA","SAMIA","63",185,264,449
"4014","BUSIA","SAMIA","64",170,229,399
"4015","BUSIA","SAMIA","60-64",1079,1546,2625
"4016","BUSIA","SAMIA","65",215,302,517
"4017","BUSIA","SAMIA","66",123,211,334
"4018","BUSIA","SAMIA","67",208,309,517
"4019","BUSIA","SAMIA","68",85,117,202
"4020","BUSIA","SAMIA","69",154,196,350
"4021","BUSIA","SAMIA","65-69",785,1135,1920
"4022","BUSIA","SAMIA","70",209,334,543
"4023","BUSIA","SAMIA","71",157,175,332
"4024","BUSIA","SAMIA","72",119,118,237
"4025","BUSIA","SAMIA","73",93,114,207
"4026","BUSIA","SAMIA","74",103,198,301
"4027","BUSIA","SAMIA","70-74",681,939,1620
"4028","BUSIA","SAMIA","75",85,140,225
"4029","BUSIA","SAMIA","76",73,99,172
"4030","BUSIA","SAMIA","77",82,134,216
"4031","BUSIA","SAMIA","78",57,62,119
"4032","BUSIA","SAMIA","79",67,132,199
"4033","BUSIA","SAMIA","75-79",364,567,931
"4034","BUSIA","SAMIA","80",67,136,203
"4035","BUSIA","SAMIA","81",53,98,151
"4036","BUSIA","SAMIA","82",33,45,78
"4037","BUSIA","SAMIA","83",45,61,106
"4038","BUSIA","SAMIA","84",38,76,114
"4039","BUSIA","SAMIA","80-84",236,416,652
"4040","BUSIA","SAMIA","85",30,59,89
"4041","BUSIA","SAMIA","86",27,58,85
"4042","BUSIA","SAMIA","87",30,86,116
"4043","BUSIA","SAMIA","88",20,25,45
"4044","BUSIA","SAMIA","89",25,93,118
"4045","BUSIA","SAMIA","85-89",132,321,453
"4046","BUSIA","SAMIA","90",15,43,58
"4047","BUSIA","SAMIA","91",13,17,30
"4048","BUSIA","SAMIA","92",9,17,26
"4049","BUSIA","SAMIA","93",7,10,17
"4050","BUSIA","SAMIA","94",4,29,33
"4051","BUSIA","SAMIA","90-94",48,116,164
"4052","BUSIA","SAMIA","95",8,13,21
"4053","BUSIA","SAMIA","96",1,10,11
"4054","BUSIA","SAMIA","97",2,9,11
"4055","BUSIA","SAMIA","98",NA,8,8
"4056","BUSIA","SAMIA","99",2,23,25
"4057","BUSIA","SAMIA","95-99",13,63,76
"4058","BUSIA","SAMIA","100+",4,24,28
"4059","BUSIA","SAMIA","Not Stated",NA,NA,NA
"4060","BUSIA","TESO NORTH","Total",66412,71619,138031
"4061","BUSIA","TESO NORTH","0",1683,1700,3383
"4062","BUSIA","TESO NORTH","1",1680,1926,3606
"4063","BUSIA","TESO NORTH","2",1759,1718,3477
"4064","BUSIA","TESO NORTH","3",1893,1905,3798
"4065","BUSIA","TESO NORTH","4",1787,1773,3560
"4066","BUSIA","TESO NORTH","0 - 4",8802,9022,17824
"4067","BUSIA","TESO NORTH","5",1904,1931,3835
"4068","BUSIA","TESO NORTH","6",2017,2091,4108
"4069","BUSIA","TESO NORTH","7",2042,1998,4040
"4070","BUSIA","TESO NORTH","8",1924,1985,3909
"4071","BUSIA","TESO NORTH","9",2084,2015,4099
"4072","BUSIA","TESO NORTH","5-9",9971,10020,19991
"4073","BUSIA","TESO NORTH","10",2243,2168,4411
"4074","BUSIA","TESO NORTH","11",2009,2114,4123
"4075","BUSIA","TESO NORTH","12",2111,2191,4302
"4076","BUSIA","TESO NORTH","13",2100,2275,4375
"4077","BUSIA","TESO NORTH","14",1954,2017,3971
"4078","BUSIA","TESO NORTH","10 -14",10417,10765,21182
"4079","BUSIA","TESO NORTH","15",1975,1958,3933
"4080","BUSIA","TESO NORTH","16",1785,1921,3706
"4081","BUSIA","TESO NORTH","17",1946,1945,3891
"4082","BUSIA","TESO NORTH","18",1569,1515,3084
"4083","BUSIA","TESO NORTH","19",1696,1688,3384
"4084","BUSIA","TESO NORTH","15-19",8971,9027,17998
"4085","BUSIA","TESO NORTH","20",1444,1513,2957
"4086","BUSIA","TESO NORTH","21",1207,1316,2523
"4087","BUSIA","TESO NORTH","22",1098,1336,2434
"4088","BUSIA","TESO NORTH","23",1012,1343,2355
"4089","BUSIA","TESO NORTH","24",953,1171,2124
"4090","BUSIA","TESO NORTH","20-24",5714,6679,12393
"4091","BUSIA","TESO NORTH","25",974,1279,2253
"4092","BUSIA","TESO NORTH","26",860,1152,2012
"4093","BUSIA","TESO NORTH","27",793,1073,1866
"4094","BUSIA","TESO NORTH","28",693,844,1537
"4095","BUSIA","TESO NORTH","29",705,824,1529
"4096","BUSIA","TESO NORTH","25-29",4025,5172,9197
"4097","BUSIA","TESO NORTH","30",807,1109,1916
"4098","BUSIA","TESO NORTH","31",760,907,1667
"4099","BUSIA","TESO NORTH","32",881,1124,2005
"4100","BUSIA","TESO NORTH","33",798,996,1794
"4101","BUSIA","TESO NORTH","34",658,787,1445
"4102","BUSIA","TESO NORTH","30-34",3904,4923,8827
"4103","BUSIA","TESO NORTH","35",805,805,1610
"4104","BUSIA","TESO NORTH","36",677,566,1243
"4105","BUSIA","TESO NORTH","37",677,594,1271
"4106","BUSIA","TESO NORTH","38",462,441,903
"4107","BUSIA","TESO NORTH","39",534,503,1037
"4108","BUSIA","TESO NORTH","35-39",3155,2909,6064
"4109","BUSIA","TESO NORTH","40",547,612,1159
"4110","BUSIA","TESO NORTH","41",584,606,1190
"4111","BUSIA","TESO NORTH","42",599,681,1280
"4112","BUSIA","TESO NORTH","43",599,580,1179
"4113","BUSIA","TESO NORTH","44",449,454,903
"4114","BUSIA","TESO NORTH","40-44",2778,2933,5711
"4115","BUSIA","TESO NORTH","45",589,611,1200
"4116","BUSIA","TESO NORTH","46",414,426,840
"4117","BUSIA","TESO NORTH","47",476,475,951
"4118","BUSIA","TESO NORTH","48",296,311,607
"4119","BUSIA","TESO NORTH","49",330,355,685
"4120","BUSIA","TESO NORTH","45-49",2105,2178,4283
"4121","BUSIA","TESO NORTH","50",427,485,912
"4122","BUSIA","TESO NORTH","51",341,382,723
"4123","BUSIA","TESO NORTH","52",270,331,601
"4124","BUSIA","TESO NORTH","53",244,322,566
"4125","BUSIA","TESO NORTH","54",254,297,551
"4126","BUSIA","TESO NORTH","50-54",1536,1817,3353
"4127","BUSIA","TESO NORTH","55",300,311,611
"4128","BUSIA","TESO NORTH","56",302,320,622
"4129","BUSIA","TESO NORTH","57",314,517,831
"4130","BUSIA","TESO NORTH","58",250,296,546
"4131","BUSIA","TESO NORTH","59",318,378,696
"4132","BUSIA","TESO NORTH","55-59",1484,1822,3306
"4133","BUSIA","TESO NORTH","60",314,337,651
"4134","BUSIA","TESO NORTH","61",282,308,590
"4135","BUSIA","TESO NORTH","62",221,261,482
"4136","BUSIA","TESO NORTH","63",240,283,523
"4137","BUSIA","TESO NORTH","64",155,209,364
"4138","BUSIA","TESO NORTH","60-64",1212,1398,2610
"4139","BUSIA","TESO NORTH","65",209,274,483
"4140","BUSIA","TESO NORTH","66",153,183,336
"4141","BUSIA","TESO NORTH","67",200,279,479
"4142","BUSIA","TESO NORTH","68",99,100,199
"4143","BUSIA","TESO NORTH","69",174,209,383
"4144","BUSIA","TESO NORTH","65-69",835,1045,1880
"4145","BUSIA","TESO NORTH","70",188,238,426
"4146","BUSIA","TESO NORTH","71",156,206,362
"4147","BUSIA","TESO NORTH","72",108,127,235
"4148","BUSIA","TESO NORTH","73",97,116,213
"4149","BUSIA","TESO NORTH","74",80,116,196
"4150","BUSIA","TESO NORTH","70-74",629,803,1432
"4151","BUSIA","TESO NORTH","75",98,115,213
"4152","BUSIA","TESO NORTH","76",70,72,142
"4153","BUSIA","TESO NORTH","77",106,138,244
"4154","BUSIA","TESO NORTH","78",35,56,91
"4155","BUSIA","TESO NORTH","79",48,109,157
"4156","BUSIA","TESO NORTH","75-79",357,490,847
"4157","BUSIA","TESO NORTH","80",77,84,161
"4158","BUSIA","TESO NORTH","81",36,69,105
"4159","BUSIA","TESO NORTH","82",45,37,82
"4160","BUSIA","TESO NORTH","83",63,63,126
"4161","BUSIA","TESO NORTH","84",41,45,86
"4162","BUSIA","TESO NORTH","80-84",262,298,560
"4163","BUSIA","TESO NORTH","85",26,36,62
"4164","BUSIA","TESO NORTH","86",37,39,76
"4165","BUSIA","TESO NORTH","87",61,60,121
"4166","BUSIA","TESO NORTH","88",18,22,40
"4167","BUSIA","TESO NORTH","89",35,53,88
"4168","BUSIA","TESO NORTH","85-89",177,210,387
"4169","BUSIA","TESO NORTH","90",11,20,31
"4170","BUSIA","TESO NORTH","91",17,12,29
"4171","BUSIA","TESO NORTH","92",5,9,14
"4172","BUSIA","TESO NORTH","93",9,12,21
"4173","BUSIA","TESO NORTH","94",4,10,14
"4174","BUSIA","TESO NORTH","90-94",46,63,109
"4175","BUSIA","TESO NORTH","95",11,13,24
"4176","BUSIA","TESO NORTH","96",1,3,4
"4177","BUSIA","TESO NORTH","97",12,10,22
"4178","BUSIA","TESO NORTH","98",1,4,5
"4179","BUSIA","TESO NORTH","99",2,4,6
"4180","BUSIA","TESO NORTH","95-99",27,34,61
"4181","BUSIA","TESO NORTH","100+",4,11,15
"4182","BUSIA","TESO NORTH","Not Stated",1,NA,1
"4183","BUSIA","TESO SOUTH","Total",80484,87630,168114
"4184","BUSIA","TESO SOUTH","0",2026,2083,4109
"4185","BUSIA","TESO SOUTH","1",2199,2091,4290
"4186","BUSIA","TESO SOUTH","2",2164,2226,4390
"4187","BUSIA","TESO SOUTH","3",2208,2261,4469
"4188","BUSIA","TESO SOUTH","4",2286,2202,4488
"4189","BUSIA","TESO SOUTH","0 - 4",10883,10863,21746
"4190","BUSIA","TESO SOUTH","5",2219,2185,4404
"4191","BUSIA","TESO SOUTH","6",2465,2481,4946
"4192","BUSIA","TESO SOUTH","7",2381,2375,4756
"4193","BUSIA","TESO SOUTH","8",2338,2488,4826
"4194","BUSIA","TESO SOUTH","9",2506,2516,5022
"4195","BUSIA","TESO SOUTH","5-9",11909,12045,23954
"4196","BUSIA","TESO SOUTH","10",2556,2553,5109
"4197","BUSIA","TESO SOUTH","11",2426,2644,5070
"4198","BUSIA","TESO SOUTH","12",2821,2739,5560
"4199","BUSIA","TESO SOUTH","13",2681,2808,5489
"4200","BUSIA","TESO SOUTH","14",2442,2573,5015
"4201","BUSIA","TESO SOUTH","10 -14",12926,13317,26243
"4202","BUSIA","TESO SOUTH","15",2461,2519,4980
"4203","BUSIA","TESO SOUTH","16",2278,2393,4671
"4204","BUSIA","TESO SOUTH","17",2341,2312,4653
"4205","BUSIA","TESO SOUTH","18",1934,1955,3889
"4206","BUSIA","TESO SOUTH","19",1992,1984,3976
"4207","BUSIA","TESO SOUTH","15-19",11006,11163,22169
"4208","BUSIA","TESO SOUTH","20",1758,1950,3708
"4209","BUSIA","TESO SOUTH","21",1513,1652,3165
"4210","BUSIA","TESO SOUTH","22",1381,1598,2979
"4211","BUSIA","TESO SOUTH","23",1216,1610,2826
"4212","BUSIA","TESO SOUTH","24",1169,1487,2656
"4213","BUSIA","TESO SOUTH","20-24",7037,8297,15334
"4214","BUSIA","TESO SOUTH","25",1240,1564,2804
"4215","BUSIA","TESO SOUTH","26",1042,1387,2429
"4216","BUSIA","TESO SOUTH","27",1085,1314,2399
"4217","BUSIA","TESO SOUTH","28",827,1142,1969
"4218","BUSIA","TESO SOUTH","29",894,1121,2015
"4219","BUSIA","TESO SOUTH","25-29",5088,6528,11616
"4220","BUSIA","TESO SOUTH","30",1073,1421,2494
"4221","BUSIA","TESO SOUTH","31",835,1110,1945
"4222","BUSIA","TESO SOUTH","32",1083,1429,2512
"4223","BUSIA","TESO SOUTH","33",851,1111,1962
"4224","BUSIA","TESO SOUTH","34",784,946,1730
"4225","BUSIA","TESO SOUTH","30-34",4626,6017,10643
"4226","BUSIA","TESO SOUTH","35",940,970,1910
"4227","BUSIA","TESO SOUTH","36",752,731,1483
"4228","BUSIA","TESO SOUTH","37",717,700,1417
"4229","BUSIA","TESO SOUTH","38",523,509,1032
"4230","BUSIA","TESO SOUTH","39",673,598,1271
"4231","BUSIA","TESO SOUTH","35-39",3605,3508,7113
"4232","BUSIA","TESO SOUTH","40",729,764,1493
"4233","BUSIA","TESO SOUTH","41",643,740,1383
"4234","BUSIA","TESO SOUTH","42",728,736,1464
"4235","BUSIA","TESO SOUTH","43",664,695,1359
"4236","BUSIA","TESO SOUTH","44",549,524,1073
"4237","BUSIA","TESO SOUTH","40-44",3313,3459,6772
"4238","BUSIA","TESO SOUTH","45",639,723,1362
"4239","BUSIA","TESO SOUTH","46",448,497,945
"4240","BUSIA","TESO SOUTH","47",533,617,1150
"4241","BUSIA","TESO SOUTH","48",348,376,724
"4242","BUSIA","TESO SOUTH","49",404,489,893
"4243","BUSIA","TESO SOUTH","45-49",2372,2702,5074
"4244","BUSIA","TESO SOUTH","50",518,710,1228
"4245","BUSIA","TESO SOUTH","51",439,563,1002
"4246","BUSIA","TESO SOUTH","52",365,402,767
"4247","BUSIA","TESO SOUTH","53",303,347,650
"4248","BUSIA","TESO SOUTH","54",309,338,647
"4249","BUSIA","TESO SOUTH","50-54",1934,2360,4294
"4250","BUSIA","TESO SOUTH","55",297,332,629
"4251","BUSIA","TESO SOUTH","56",401,430,831
"4252","BUSIA","TESO SOUTH","57",387,534,921
"4253","BUSIA","TESO SOUTH","58",292,358,650
"4254","BUSIA","TESO SOUTH","59",356,428,784
"4255","BUSIA","TESO SOUTH","55-59",1733,2082,3815
"4256","BUSIA","TESO SOUTH","60",335,475,810
"4257","BUSIA","TESO SOUTH","61",299,368,667
"4258","BUSIA","TESO SOUTH","62",212,321,533
"4259","BUSIA","TESO SOUTH","63",254,331,585
"4260","BUSIA","TESO SOUTH","64",185,288,473
"4261","BUSIA","TESO SOUTH","60-64",1285,1783,3068
"4262","BUSIA","TESO SOUTH","65",212,353,565
"4263","BUSIA","TESO SOUTH","66",167,203,370
"4264","BUSIA","TESO SOUTH","67",256,303,559
"4265","BUSIA","TESO SOUTH","68",132,159,291
"4266","BUSIA","TESO SOUTH","69",186,251,437
"4267","BUSIA","TESO SOUTH","65-69",953,1269,2222
"4268","BUSIA","TESO SOUTH","70",232,318,550
"4269","BUSIA","TESO SOUTH","71",195,194,389
"4270","BUSIA","TESO SOUTH","72",140,107,247
"4271","BUSIA","TESO SOUTH","73",104,121,225
"4272","BUSIA","TESO SOUTH","74",104,161,265
"4273","BUSIA","TESO SOUTH","70-74",775,901,1676
"4274","BUSIA","TESO SOUTH","75",102,107,209
"4275","BUSIA","TESO SOUTH","76",86,86,172
"4276","BUSIA","TESO SOUTH","77",114,141,255
"4277","BUSIA","TESO SOUTH","78",56,73,129
"4278","BUSIA","TESO SOUTH","79",100,174,274
"4279","BUSIA","TESO SOUTH","75-79",458,581,1039
"4280","BUSIA","TESO SOUTH","80",77,130,207
"4281","BUSIA","TESO SOUTH","81",60,61,121
"4282","BUSIA","TESO SOUTH","82",58,50,108
"4283","BUSIA","TESO SOUTH","83",61,53,114
"4284","BUSIA","TESO SOUTH","84",49,91,140
"4285","BUSIA","TESO SOUTH","80-84",305,385,690
"4286","BUSIA","TESO SOUTH","85",34,70,104
"4287","BUSIA","TESO SOUTH","86",50,34,84
"4288","BUSIA","TESO SOUTH","87",42,53,95
"4289","BUSIA","TESO SOUTH","88",31,17,48
"4290","BUSIA","TESO SOUTH","89",42,70,112
"4291","BUSIA","TESO SOUTH","85-89",199,244,443
"4292","BUSIA","TESO SOUTH","90",13,26,39
"4293","BUSIA","TESO SOUTH","91",14,11,25
"4294","BUSIA","TESO SOUTH","92",6,4,10
"4295","BUSIA","TESO SOUTH","93",10,10,20
"4296","BUSIA","TESO SOUTH","94",9,16,25
"4297","BUSIA","TESO SOUTH","90-94",52,67,119
"4298","BUSIA","TESO SOUTH","95",4,11,15
"4299","BUSIA","TESO SOUTH","96",4,9,13
"4300","BUSIA","TESO SOUTH","97",8,10,18
"4301","BUSIA","TESO SOUTH","98",3,4,7
"4302","BUSIA","TESO SOUTH","99",4,5,9
"4303","BUSIA","TESO SOUTH","95-99",23,39,62
"4304","BUSIA","TESO SOUTH","100+",2,20,22
"4305","BUSIA","TESO SOUTH","Not Stated",NA,NA,NA
"4306","ELGEYO-MARAKWET","ALL","Total",227317,227151,454468
"4307","ELGEYO-MARAKWET","ALL","0",5668,5731,11399
"4308","ELGEYO-MARAKWET","ALL","1",5888,5634,11522
"4309","ELGEYO-MARAKWET","ALL","2",5915,5830,11745
"4310","ELGEYO-MARAKWET","ALL","3",6344,6442,12786
"4311","ELGEYO-MARAKWET","ALL","4",6771,6709,13480
"4312","ELGEYO-MARAKWET","ALL","0 - 4",30586,30346,60932
"4313","ELGEYO-MARAKWET","ALL","5",6654,6480,13134
"4314","ELGEYO-MARAKWET","ALL","6",6705,6616,13321
"4315","ELGEYO-MARAKWET","ALL","7",6605,6458,13063
"4316","ELGEYO-MARAKWET","ALL","8",5932,5842,11774
"4317","ELGEYO-MARAKWET","ALL","9",6876,6533,13409
"4318","ELGEYO-MARAKWET","ALL","5-9",32772,31929,64701
"4319","ELGEYO-MARAKWET","ALL","10",6846,6615,13461
"4320","ELGEYO-MARAKWET","ALL","11",6052,6247,12299
"4321","ELGEYO-MARAKWET","ALL","12",6935,6739,13674
"4322","ELGEYO-MARAKWET","ALL","13",6584,6720,13304
"4323","ELGEYO-MARAKWET","ALL","14",6489,6314,12803
"4324","ELGEYO-MARAKWET","ALL","10 -14",32906,32635,65541
"4325","ELGEYO-MARAKWET","ALL","15",6431,6242,12673
"4326","ELGEYO-MARAKWET","ALL","16",5775,5768,11543
"4327","ELGEYO-MARAKWET","ALL","17",5904,5541,11445
"4328","ELGEYO-MARAKWET","ALL","18",4479,4289,8768
"4329","ELGEYO-MARAKWET","ALL","19",5551,5272,10823
"4330","ELGEYO-MARAKWET","ALL","15-19",28140,27112,55252
"4331","ELGEYO-MARAKWET","ALL","20",4989,4813,9802
"4332","ELGEYO-MARAKWET","ALL","21",4515,4408,8923
"4333","ELGEYO-MARAKWET","ALL","22",4133,4106,8239
"4334","ELGEYO-MARAKWET","ALL","23",4113,4275,8388
"4335","ELGEYO-MARAKWET","ALL","24",3657,3857,7514
"4336","ELGEYO-MARAKWET","ALL","20-24",21407,21459,42866
"4337","ELGEYO-MARAKWET","ALL","25",4241,4278,8519
"4338","ELGEYO-MARAKWET","ALL","26",3217,3405,6622
"4339","ELGEYO-MARAKWET","ALL","27",3361,3411,6772
"4340","ELGEYO-MARAKWET","ALL","28",2491,2575,5066
"4341","ELGEYO-MARAKWET","ALL","29",2973,3030,6003
"4342","ELGEYO-MARAKWET","ALL","25-29",16283,16699,32982
"4343","ELGEYO-MARAKWET","ALL","30",3408,3650,7058
"4344","ELGEYO-MARAKWET","ALL","31",2522,2629,5151
"4345","ELGEYO-MARAKWET","ALL","32",3098,3359,6457
"4346","ELGEYO-MARAKWET","ALL","33",2645,2893,5538
"4347","ELGEYO-MARAKWET","ALL","34",2245,2499,4744
"4348","ELGEYO-MARAKWET","ALL","30-34",13918,15030,28948
"4349","ELGEYO-MARAKWET","ALL","35",3517,3316,6833
"4350","ELGEYO-MARAKWET","ALL","36",1982,1736,3718
"4351","ELGEYO-MARAKWET","ALL","37",2168,1835,4003
"4352","ELGEYO-MARAKWET","ALL","38",1311,1213,2524
"4353","ELGEYO-MARAKWET","ALL","39",1813,1751,3564
"4354","ELGEYO-MARAKWET","ALL","35-39",10791,9851,20642
"4355","ELGEYO-MARAKWET","ALL","40",2197,1874,4071
"4356","ELGEYO-MARAKWET","ALL","41",2154,2028,4182
"4357","ELGEYO-MARAKWET","ALL","42",2052,1931,3983
"4358","ELGEYO-MARAKWET","ALL","43",1750,1759,3509
"4359","ELGEYO-MARAKWET","ALL","44",1183,1273,2456
"4360","ELGEYO-MARAKWET","ALL","40-44",9336,8865,18201
"4361","ELGEYO-MARAKWET","ALL","45",3044,2753,5797
"4362","ELGEYO-MARAKWET","ALL","46",1564,1570,3134
"4363","ELGEYO-MARAKWET","ALL","47",1660,1633,3293
"4364","ELGEYO-MARAKWET","ALL","48",840,891,1731
"4365","ELGEYO-MARAKWET","ALL","49",1196,1223,2419
"4366","ELGEYO-MARAKWET","ALL","45-49",8304,8070,16374
"4367","ELGEYO-MARAKWET","ALL","50",1453,1541,2994
"4368","ELGEYO-MARAKWET","ALL","51",1057,1130,2187
"4369","ELGEYO-MARAKWET","ALL","52",870,913,1783
"4370","ELGEYO-MARAKWET","ALL","53",637,686,1323
"4371","ELGEYO-MARAKWET","ALL","54",1067,1009,2076
"4372","ELGEYO-MARAKWET","ALL","50-54",5084,5279,10363
"4373","ELGEYO-MARAKWET","ALL","55",1004,876,1880
"4374","ELGEYO-MARAKWET","ALL","56",938,1048,1986
"4375","ELGEYO-MARAKWET","ALL","57",938,1165,2103
"4376","ELGEYO-MARAKWET","ALL","58",1099,1215,2314
"4377","ELGEYO-MARAKWET","ALL","59",1096,987,2083
"4378","ELGEYO-MARAKWET","ALL","55-59",5075,5291,10366
"4379","ELGEYO-MARAKWET","ALL","60",1233,1234,2467
"4380","ELGEYO-MARAKWET","ALL","61",981,950,1931
"4381","ELGEYO-MARAKWET","ALL","62",632,605,1237
"4382","ELGEYO-MARAKWET","ALL","63",688,801,1489
"4383","ELGEYO-MARAKWET","ALL","64",463,495,958
"4384","ELGEYO-MARAKWET","ALL","60-64",3997,4085,8082
"4385","ELGEYO-MARAKWET","ALL","65",948,952,1900
"4386","ELGEYO-MARAKWET","ALL","66",418,413,831
"4387","ELGEYO-MARAKWET","ALL","67",849,805,1654
"4388","ELGEYO-MARAKWET","ALL","68",381,358,739
"4389","ELGEYO-MARAKWET","ALL","69",733,774,1507
"4390","ELGEYO-MARAKWET","ALL","65-69",3329,3302,6631
"4391","ELGEYO-MARAKWET","ALL","70",760,933,1693
"4392","ELGEYO-MARAKWET","ALL","71",581,679,1260
"4393","ELGEYO-MARAKWET","ALL","72",383,387,770
"4394","ELGEYO-MARAKWET","ALL","73",343,392,735
"4395","ELGEYO-MARAKWET","ALL","74",348,456,804
"4396","ELGEYO-MARAKWET","ALL","70-74",2415,2847,5262
"4397","ELGEYO-MARAKWET","ALL","75",370,453,823
"4398","ELGEYO-MARAKWET","ALL","76",290,314,604
"4399","ELGEYO-MARAKWET","ALL","77",252,310,562
"4400","ELGEYO-MARAKWET","ALL","78",144,151,295
"4401","ELGEYO-MARAKWET","ALL","79",266,501,767
"4402","ELGEYO-MARAKWET","ALL","75-79",1322,1729,3051
"4403","ELGEYO-MARAKWET","ALL","80",278,457,735
"4404","ELGEYO-MARAKWET","ALL","81",154,282,436
"4405","ELGEYO-MARAKWET","ALL","82",83,139,222
"4406","ELGEYO-MARAKWET","ALL","83",146,209,355
"4407","ELGEYO-MARAKWET","ALL","84",136,203,339
"4408","ELGEYO-MARAKWET","ALL","80-84",797,1290,2087
"4409","ELGEYO-MARAKWET","ALL","85",97,154,251
"4410","ELGEYO-MARAKWET","ALL","86",75,71,146
"4411","ELGEYO-MARAKWET","ALL","87",91,113,204
"4412","ELGEYO-MARAKWET","ALL","88",53,70,123
"4413","ELGEYO-MARAKWET","ALL","89",165,274,439
"4414","ELGEYO-MARAKWET","ALL","85-89",481,682,1163
"4415","ELGEYO-MARAKWET","ALL","90",74,143,217
"4416","ELGEYO-MARAKWET","ALL","91",43,69,112
"4417","ELGEYO-MARAKWET","ALL","92",16,40,56
"4418","ELGEYO-MARAKWET","ALL","93",34,38,72
"4419","ELGEYO-MARAKWET","ALL","94",31,47,78
"4420","ELGEYO-MARAKWET","ALL","90-94",198,337,535
"4421","ELGEYO-MARAKWET","ALL","95",64,81,145
"4422","ELGEYO-MARAKWET","ALL","96",12,20,32
"4423","ELGEYO-MARAKWET","ALL","97",13,20,33
"4424","ELGEYO-MARAKWET","ALL","98",13,18,31
"4425","ELGEYO-MARAKWET","ALL","99",31,63,94
"4426","ELGEYO-MARAKWET","ALL","95-99",133,202,335
"4427","ELGEYO-MARAKWET","ALL","100+",43,110,153
"4428","ELGEYO-MARAKWET","ALL","Not Stated",NA,1,1
"4429","ELGEYO-MARAKWET","KEIYO NORTH","Total",49601,49574,99175
"4430","ELGEYO-MARAKWET","KEIYO NORTH","0",1241,1270,2511
"4431","ELGEYO-MARAKWET","KEIYO NORTH","1",1246,1106,2352
"4432","ELGEYO-MARAKWET","KEIYO NORTH","2",1215,1181,2396
"4433","ELGEYO-MARAKWET","KEIYO NORTH","3",1275,1382,2657
"4434","ELGEYO-MARAKWET","KEIYO NORTH","4",1351,1344,2695
"4435","ELGEYO-MARAKWET","KEIYO NORTH","0 - 4",6328,6283,12611
"4436","ELGEYO-MARAKWET","KEIYO NORTH","5",1378,1252,2630
"4437","ELGEYO-MARAKWET","KEIYO NORTH","6",1368,1306,2674
"4438","ELGEYO-MARAKWET","KEIYO NORTH","7",1346,1293,2639
"4439","ELGEYO-MARAKWET","KEIYO NORTH","8",1187,1212,2399
"4440","ELGEYO-MARAKWET","KEIYO NORTH","9",1405,1292,2697
"4441","ELGEYO-MARAKWET","KEIYO NORTH","5-9",6684,6355,13039
"4442","ELGEYO-MARAKWET","KEIYO NORTH","10",1288,1307,2595
"4443","ELGEYO-MARAKWET","KEIYO NORTH","11",1247,1223,2470
"4444","ELGEYO-MARAKWET","KEIYO NORTH","12",1359,1290,2649
"4445","ELGEYO-MARAKWET","KEIYO NORTH","13",1282,1317,2599
"4446","ELGEYO-MARAKWET","KEIYO NORTH","14",1282,1252,2534
"4447","ELGEYO-MARAKWET","KEIYO NORTH","10 -14",6458,6389,12847
"4448","ELGEYO-MARAKWET","KEIYO NORTH","15",1253,1245,2498
"4449","ELGEYO-MARAKWET","KEIYO NORTH","16",1100,1197,2297
"4450","ELGEYO-MARAKWET","KEIYO NORTH","17",1333,1261,2594
"4451","ELGEYO-MARAKWET","KEIYO NORTH","18",986,934,1920
"4452","ELGEYO-MARAKWET","KEIYO NORTH","19",1191,1172,2363
"4453","ELGEYO-MARAKWET","KEIYO NORTH","15-19",5863,5809,11672
"4454","ELGEYO-MARAKWET","KEIYO NORTH","20",1134,1172,2306
"4455","ELGEYO-MARAKWET","KEIYO NORTH","21",1069,1049,2118
"4456","ELGEYO-MARAKWET","KEIYO NORTH","22",980,1023,2003
"4457","ELGEYO-MARAKWET","KEIYO NORTH","23",1053,1180,2233
"4458","ELGEYO-MARAKWET","KEIYO NORTH","24",895,1034,1929
"4459","ELGEYO-MARAKWET","KEIYO NORTH","20-24",5131,5458,10589
"4460","ELGEYO-MARAKWET","KEIYO NORTH","25",1047,1058,2105
"4461","ELGEYO-MARAKWET","KEIYO NORTH","26",825,861,1686
"4462","ELGEYO-MARAKWET","KEIYO NORTH","27",816,833,1649
"4463","ELGEYO-MARAKWET","KEIYO NORTH","28",664,621,1285
"4464","ELGEYO-MARAKWET","KEIYO NORTH","29",789,795,1584
"4465","ELGEYO-MARAKWET","KEIYO NORTH","25-29",4141,4168,8309
"4466","ELGEYO-MARAKWET","KEIYO NORTH","30",857,839,1696
"4467","ELGEYO-MARAKWET","KEIYO NORTH","31",641,606,1247
"4468","ELGEYO-MARAKWET","KEIYO NORTH","32",804,783,1587
"4469","ELGEYO-MARAKWET","KEIYO NORTH","33",645,662,1307
"4470","ELGEYO-MARAKWET","KEIYO NORTH","34",572,638,1210
"4471","ELGEYO-MARAKWET","KEIYO NORTH","30-34",3519,3528,7047
"4472","ELGEYO-MARAKWET","KEIYO NORTH","35",849,825,1674
"4473","ELGEYO-MARAKWET","KEIYO NORTH","36",500,431,931
"4474","ELGEYO-MARAKWET","KEIYO NORTH","37",530,481,1011
"4475","ELGEYO-MARAKWET","KEIYO NORTH","38",344,324,668
"4476","ELGEYO-MARAKWET","KEIYO NORTH","39",470,480,950
"4477","ELGEYO-MARAKWET","KEIYO NORTH","35-39",2693,2541,5234
"4478","ELGEYO-MARAKWET","KEIYO NORTH","40",530,441,971
"4479","ELGEYO-MARAKWET","KEIYO NORTH","41",522,493,1015
"4480","ELGEYO-MARAKWET","KEIYO NORTH","42",473,415,888
"4481","ELGEYO-MARAKWET","KEIYO NORTH","43",401,401,802
"4482","ELGEYO-MARAKWET","KEIYO NORTH","44",299,296,595
"4483","ELGEYO-MARAKWET","KEIYO NORTH","40-44",2225,2046,4271
"4484","ELGEYO-MARAKWET","KEIYO NORTH","45",627,534,1161
"4485","ELGEYO-MARAKWET","KEIYO NORTH","46",361,361,722
"4486","ELGEYO-MARAKWET","KEIYO NORTH","47",401,347,748
"4487","ELGEYO-MARAKWET","KEIYO NORTH","48",189,258,447
"4488","ELGEYO-MARAKWET","KEIYO NORTH","49",307,313,620
"4489","ELGEYO-MARAKWET","KEIYO NORTH","45-49",1885,1813,3698
"4490","ELGEYO-MARAKWET","KEIYO NORTH","50",329,329,658
"4491","ELGEYO-MARAKWET","KEIYO NORTH","51",233,248,481
"4492","ELGEYO-MARAKWET","KEIYO NORTH","52",177,204,381
"4493","ELGEYO-MARAKWET","KEIYO NORTH","53",156,142,298
"4494","ELGEYO-MARAKWET","KEIYO NORTH","54",222,233,455
"4495","ELGEYO-MARAKWET","KEIYO NORTH","50-54",1117,1156,2273
"4496","ELGEYO-MARAKWET","KEIYO NORTH","55",202,194,396
"4497","ELGEYO-MARAKWET","KEIYO NORTH","56",218,237,455
"4498","ELGEYO-MARAKWET","KEIYO NORTH","57",176,241,417
"4499","ELGEYO-MARAKWET","KEIYO NORTH","58",229,267,496
"4500","ELGEYO-MARAKWET","KEIYO NORTH","59",228,220,448
"4501","ELGEYO-MARAKWET","KEIYO NORTH","55-59",1053,1159,2212
"4502","ELGEYO-MARAKWET","KEIYO NORTH","60",239,258,497
"4503","ELGEYO-MARAKWET","KEIYO NORTH","61",229,219,448
"4504","ELGEYO-MARAKWET","KEIYO NORTH","62",155,150,305
"4505","ELGEYO-MARAKWET","KEIYO NORTH","63",139,178,317
"4506","ELGEYO-MARAKWET","KEIYO NORTH","64",113,100,213
"4507","ELGEYO-MARAKWET","KEIYO NORTH","60-64",875,905,1780
"4508","ELGEYO-MARAKWET","KEIYO NORTH","65",192,194,386
"4509","ELGEYO-MARAKWET","KEIYO NORTH","66",86,91,177
"4510","ELGEYO-MARAKWET","KEIYO NORTH","67",161,191,352
"4511","ELGEYO-MARAKWET","KEIYO NORTH","68",75,59,134
"4512","ELGEYO-MARAKWET","KEIYO NORTH","69",132,130,262
"4513","ELGEYO-MARAKWET","KEIYO NORTH","65-69",646,665,1311
"4514","ELGEYO-MARAKWET","KEIYO NORTH","70",135,127,262
"4515","ELGEYO-MARAKWET","KEIYO NORTH","71",104,131,235
"4516","ELGEYO-MARAKWET","KEIYO NORTH","72",76,62,138
"4517","ELGEYO-MARAKWET","KEIYO NORTH","73",74,73,147
"4518","ELGEYO-MARAKWET","KEIYO NORTH","74",74,79,153
"4519","ELGEYO-MARAKWET","KEIYO NORTH","70-74",463,472,935
"4520","ELGEYO-MARAKWET","KEIYO NORTH","75",58,79,137
"4521","ELGEYO-MARAKWET","KEIYO NORTH","76",55,69,124
"4522","ELGEYO-MARAKWET","KEIYO NORTH","77",48,59,107
"4523","ELGEYO-MARAKWET","KEIYO NORTH","78",24,34,58
"4524","ELGEYO-MARAKWET","KEIYO NORTH","79",39,94,133
"4525","ELGEYO-MARAKWET","KEIYO NORTH","75-79",224,335,559
"4526","ELGEYO-MARAKWET","KEIYO NORTH","80",45,80,125
"4527","ELGEYO-MARAKWET","KEIYO NORTH","81",36,59,95
"4528","ELGEYO-MARAKWET","KEIYO NORTH","82",14,36,50
"4529","ELGEYO-MARAKWET","KEIYO NORTH","83",31,53,84
"4530","ELGEYO-MARAKWET","KEIYO NORTH","84",26,42,68
"4531","ELGEYO-MARAKWET","KEIYO NORTH","80-84",152,270,422
"4532","ELGEYO-MARAKWET","KEIYO NORTH","85",21,29,50
"4533","ELGEYO-MARAKWET","KEIYO NORTH","86",21,14,35
"4534","ELGEYO-MARAKWET","KEIYO NORTH","87",12,18,30
"4535","ELGEYO-MARAKWET","KEIYO NORTH","88",9,7,16
"4536","ELGEYO-MARAKWET","KEIYO NORTH","89",20,37,57
"4537","ELGEYO-MARAKWET","KEIYO NORTH","85-89",83,105,188
"4538","ELGEYO-MARAKWET","KEIYO NORTH","90",7,14,21
"4539","ELGEYO-MARAKWET","KEIYO NORTH","91",8,15,23
"4540","ELGEYO-MARAKWET","KEIYO NORTH","92",8,4,12
"4541","ELGEYO-MARAKWET","KEIYO NORTH","93",4,13,17
"4542","ELGEYO-MARAKWET","KEIYO NORTH","94",4,7,11
"4543","ELGEYO-MARAKWET","KEIYO NORTH","90-94",31,53,84
"4544","ELGEYO-MARAKWET","KEIYO NORTH","95",10,21,31
"4545","ELGEYO-MARAKWET","KEIYO NORTH","96",NA,4,4
"4546","ELGEYO-MARAKWET","KEIYO NORTH","97",6,5,11
"4547","ELGEYO-MARAKWET","KEIYO NORTH","98",3,4,7
"4548","ELGEYO-MARAKWET","KEIYO NORTH","99",1,12,13
"4549","ELGEYO-MARAKWET","KEIYO NORTH","95-99",20,46,66
"4550","ELGEYO-MARAKWET","KEIYO NORTH","100+",10,17,27
"4551","ELGEYO-MARAKWET","KEIYO NORTH","Not Stated",NA,1,1
"4552","ELGEYO-MARAKWET","KEIYO SOUTH","Total",60919,59827,120746
"4553","ELGEYO-MARAKWET","KEIYO SOUTH","0",1391,1393,2784
"4554","ELGEYO-MARAKWET","KEIYO SOUTH","1",1382,1389,2771
"4555","ELGEYO-MARAKWET","KEIYO SOUTH","2",1469,1385,2854
"4556","ELGEYO-MARAKWET","KEIYO SOUTH","3",1542,1547,3089
"4557","ELGEYO-MARAKWET","KEIYO SOUTH","4",1618,1573,3191
"4558","ELGEYO-MARAKWET","KEIYO SOUTH","0 - 4",7402,7287,14689
"4559","ELGEYO-MARAKWET","KEIYO SOUTH","5",1476,1478,2954
"4560","ELGEYO-MARAKWET","KEIYO SOUTH","6",1623,1578,3201
"4561","ELGEYO-MARAKWET","KEIYO SOUTH","7",1567,1563,3130
"4562","ELGEYO-MARAKWET","KEIYO SOUTH","8",1448,1434,2882
"4563","ELGEYO-MARAKWET","KEIYO SOUTH","9",1742,1646,3388
"4564","ELGEYO-MARAKWET","KEIYO SOUTH","5-9",7856,7699,15555
"4565","ELGEYO-MARAKWET","KEIYO SOUTH","10",1748,1603,3351
"4566","ELGEYO-MARAKWET","KEIYO SOUTH","11",1588,1633,3221
"4567","ELGEYO-MARAKWET","KEIYO SOUTH","12",1864,1703,3567
"4568","ELGEYO-MARAKWET","KEIYO SOUTH","13",1741,1752,3493
"4569","ELGEYO-MARAKWET","KEIYO SOUTH","14",1666,1634,3300
"4570","ELGEYO-MARAKWET","KEIYO SOUTH","10 -14",8607,8325,16932
"4571","ELGEYO-MARAKWET","KEIYO SOUTH","15",1734,1692,3426
"4572","ELGEYO-MARAKWET","KEIYO SOUTH","16",1570,1521,3091
"4573","ELGEYO-MARAKWET","KEIYO SOUTH","17",1733,1647,3380
"4574","ELGEYO-MARAKWET","KEIYO SOUTH","18",1287,1229,2516
"4575","ELGEYO-MARAKWET","KEIYO SOUTH","19",1607,1373,2980
"4576","ELGEYO-MARAKWET","KEIYO SOUTH","15-19",7931,7462,15393
"4577","ELGEYO-MARAKWET","KEIYO SOUTH","20",1424,1235,2659
"4578","ELGEYO-MARAKWET","KEIYO SOUTH","21",1303,1221,2524
"4579","ELGEYO-MARAKWET","KEIYO SOUTH","22",1235,1086,2321
"4580","ELGEYO-MARAKWET","KEIYO SOUTH","23",1263,1137,2400
"4581","ELGEYO-MARAKWET","KEIYO SOUTH","24",1036,1018,2054
"4582","ELGEYO-MARAKWET","KEIYO SOUTH","20-24",6261,5697,11958
"4583","ELGEYO-MARAKWET","KEIYO SOUTH","25",1047,1029,2076
"4584","ELGEYO-MARAKWET","KEIYO SOUTH","26",811,814,1625
"4585","ELGEYO-MARAKWET","KEIYO SOUTH","27",832,813,1645
"4586","ELGEYO-MARAKWET","KEIYO SOUTH","28",651,652,1303
"4587","ELGEYO-MARAKWET","KEIYO SOUTH","29",772,770,1542
"4588","ELGEYO-MARAKWET","KEIYO SOUTH","25-29",4113,4078,8191
"4589","ELGEYO-MARAKWET","KEIYO SOUTH","30",905,939,1844
"4590","ELGEYO-MARAKWET","KEIYO SOUTH","31",692,682,1374
"4591","ELGEYO-MARAKWET","KEIYO SOUTH","32",826,897,1723
"4592","ELGEYO-MARAKWET","KEIYO SOUTH","33",728,806,1534
"4593","ELGEYO-MARAKWET","KEIYO SOUTH","34",622,684,1306
"4594","ELGEYO-MARAKWET","KEIYO SOUTH","30-34",3773,4008,7781
"4595","ELGEYO-MARAKWET","KEIYO SOUTH","35",944,938,1882
"4596","ELGEYO-MARAKWET","KEIYO SOUTH","36",578,512,1090
"4597","ELGEYO-MARAKWET","KEIYO SOUTH","37",683,617,1300
"4598","ELGEYO-MARAKWET","KEIYO SOUTH","38",371,384,755
"4599","ELGEYO-MARAKWET","KEIYO SOUTH","39",560,554,1114
"4600","ELGEYO-MARAKWET","KEIYO SOUTH","35-39",3136,3005,6141
"4601","ELGEYO-MARAKWET","KEIYO SOUTH","40",614,560,1174
"4602","ELGEYO-MARAKWET","KEIYO SOUTH","41",673,605,1278
"4603","ELGEYO-MARAKWET","KEIYO SOUTH","42",582,537,1119
"4604","ELGEYO-MARAKWET","KEIYO SOUTH","43",512,512,1024
"4605","ELGEYO-MARAKWET","KEIYO SOUTH","44",312,371,683
"4606","ELGEYO-MARAKWET","KEIYO SOUTH","40-44",2693,2585,5278
"4607","ELGEYO-MARAKWET","KEIYO SOUTH","45",840,765,1605
"4608","ELGEYO-MARAKWET","KEIYO SOUTH","46",458,488,946
"4609","ELGEYO-MARAKWET","KEIYO SOUTH","47",463,487,950
"4610","ELGEYO-MARAKWET","KEIYO SOUTH","48",269,274,543
"4611","ELGEYO-MARAKWET","KEIYO SOUTH","49",335,377,712
"4612","ELGEYO-MARAKWET","KEIYO SOUTH","45-49",2365,2391,4756
"4613","ELGEYO-MARAKWET","KEIYO SOUTH","50",398,409,807
"4614","ELGEYO-MARAKWET","KEIYO SOUTH","51",332,343,675
"4615","ELGEYO-MARAKWET","KEIYO SOUTH","52",262,287,549
"4616","ELGEYO-MARAKWET","KEIYO SOUTH","53",206,217,423
"4617","ELGEYO-MARAKWET","KEIYO SOUTH","54",335,330,665
"4618","ELGEYO-MARAKWET","KEIYO SOUTH","50-54",1533,1586,3119
"4619","ELGEYO-MARAKWET","KEIYO SOUTH","55",285,242,527
"4620","ELGEYO-MARAKWET","KEIYO SOUTH","56",236,265,501
"4621","ELGEYO-MARAKWET","KEIYO SOUTH","57",265,362,627
"4622","ELGEYO-MARAKWET","KEIYO SOUTH","58",346,443,789
"4623","ELGEYO-MARAKWET","KEIYO SOUTH","59",326,297,623
"4624","ELGEYO-MARAKWET","KEIYO SOUTH","55-59",1458,1609,3067
"4625","ELGEYO-MARAKWET","KEIYO SOUTH","60",333,351,684
"4626","ELGEYO-MARAKWET","KEIYO SOUTH","61",262,274,536
"4627","ELGEYO-MARAKWET","KEIYO SOUTH","62",190,188,378
"4628","ELGEYO-MARAKWET","KEIYO SOUTH","63",195,216,411
"4629","ELGEYO-MARAKWET","KEIYO SOUTH","64",138,173,311
"4630","ELGEYO-MARAKWET","KEIYO SOUTH","60-64",1118,1202,2320
"4631","ELGEYO-MARAKWET","KEIYO SOUTH","65",293,266,559
"4632","ELGEYO-MARAKWET","KEIYO SOUTH","66",140,110,250
"4633","ELGEYO-MARAKWET","KEIYO SOUTH","67",325,268,593
"4634","ELGEYO-MARAKWET","KEIYO SOUTH","68",113,109,222
"4635","ELGEYO-MARAKWET","KEIYO SOUTH","69",239,211,450
"4636","ELGEYO-MARAKWET","KEIYO SOUTH","65-69",1110,964,2074
"4637","ELGEYO-MARAKWET","KEIYO SOUTH","70",210,271,481
"4638","ELGEYO-MARAKWET","KEIYO SOUTH","71",178,161,339
"4639","ELGEYO-MARAKWET","KEIYO SOUTH","72",127,107,234
"4640","ELGEYO-MARAKWET","KEIYO SOUTH","73",94,83,177
"4641","ELGEYO-MARAKWET","KEIYO SOUTH","74",92,133,225
"4642","ELGEYO-MARAKWET","KEIYO SOUTH","70-74",701,755,1456
"4643","ELGEYO-MARAKWET","KEIYO SOUTH","75",100,113,213
"4644","ELGEYO-MARAKWET","KEIYO SOUTH","76",109,100,209
"4645","ELGEYO-MARAKWET","KEIYO SOUTH","77",66,68,134
"4646","ELGEYO-MARAKWET","KEIYO SOUTH","78",44,46,90
"4647","ELGEYO-MARAKWET","KEIYO SOUTH","79",68,145,213
"4648","ELGEYO-MARAKWET","KEIYO SOUTH","75-79",387,472,859
"4649","ELGEYO-MARAKWET","KEIYO SOUTH","80",77,119,196
"4650","ELGEYO-MARAKWET","KEIYO SOUTH","81",39,52,91
"4651","ELGEYO-MARAKWET","KEIYO SOUTH","82",31,35,66
"4652","ELGEYO-MARAKWET","KEIYO SOUTH","83",45,34,79
"4653","ELGEYO-MARAKWET","KEIYO SOUTH","84",31,61,92
"4654","ELGEYO-MARAKWET","KEIYO SOUTH","80-84",223,301,524
"4655","ELGEYO-MARAKWET","KEIYO SOUTH","85",24,43,67
"4656","ELGEYO-MARAKWET","KEIYO SOUTH","86",20,19,39
"4657","ELGEYO-MARAKWET","KEIYO SOUTH","87",26,25,51
"4658","ELGEYO-MARAKWET","KEIYO SOUTH","88",17,15,32
"4659","ELGEYO-MARAKWET","KEIYO SOUTH","89",48,93,141
"4660","ELGEYO-MARAKWET","KEIYO SOUTH","85-89",135,195,330
"4661","ELGEYO-MARAKWET","KEIYO SOUTH","90",23,50,73
"4662","ELGEYO-MARAKWET","KEIYO SOUTH","91",17,15,32
"4663","ELGEYO-MARAKWET","KEIYO SOUTH","92",7,15,22
"4664","ELGEYO-MARAKWET","KEIYO SOUTH","93",7,9,16
"4665","ELGEYO-MARAKWET","KEIYO SOUTH","94",8,15,23
"4666","ELGEYO-MARAKWET","KEIYO SOUTH","90-94",62,104,166
"4667","ELGEYO-MARAKWET","KEIYO SOUTH","95",19,25,44
"4668","ELGEYO-MARAKWET","KEIYO SOUTH","96",5,6,11
"4669","ELGEYO-MARAKWET","KEIYO SOUTH","97",1,5,6
"4670","ELGEYO-MARAKWET","KEIYO SOUTH","98",5,5,10
"4671","ELGEYO-MARAKWET","KEIYO SOUTH","99",14,22,36
"4672","ELGEYO-MARAKWET","KEIYO SOUTH","95-99",44,63,107
"4673","ELGEYO-MARAKWET","KEIYO SOUTH","100+",11,39,50
"4674","ELGEYO-MARAKWET","KEIYO SOUTH","Not Stated",NA,NA,NA
"4675","ELGEYO-MARAKWET","MARAKWET EAST","Total",47849,49190,97039
"4676","ELGEYO-MARAKWET","MARAKWET EAST","0",1251,1335,2586
"4677","ELGEYO-MARAKWET","MARAKWET EAST","1",1318,1262,2580
"4678","ELGEYO-MARAKWET","MARAKWET EAST","2",1392,1370,2762
"4679","ELGEYO-MARAKWET","MARAKWET EAST","3",1499,1575,3074
"4680","ELGEYO-MARAKWET","MARAKWET EAST","4",1737,1715,3452
"4681","ELGEYO-MARAKWET","MARAKWET EAST","0 - 4",7197,7257,14454
"4682","ELGEYO-MARAKWET","MARAKWET EAST","5",1659,1599,3258
"4683","ELGEYO-MARAKWET","MARAKWET EAST","6",1696,1672,3368
"4684","ELGEYO-MARAKWET","MARAKWET EAST","7",1654,1657,3311
"4685","ELGEYO-MARAKWET","MARAKWET EAST","8",1521,1454,2975
"4686","ELGEYO-MARAKWET","MARAKWET EAST","9",1627,1518,3145
"4687","ELGEYO-MARAKWET","MARAKWET EAST","5-9",8157,7900,16057
"4688","ELGEYO-MARAKWET","MARAKWET EAST","10",1752,1743,3495
"4689","ELGEYO-MARAKWET","MARAKWET EAST","11",1274,1540,2814
"4690","ELGEYO-MARAKWET","MARAKWET EAST","12",1624,1633,3257
"4691","ELGEYO-MARAKWET","MARAKWET EAST","13",1503,1562,3065
"4692","ELGEYO-MARAKWET","MARAKWET EAST","14",1422,1410,2832
"4693","ELGEYO-MARAKWET","MARAKWET EAST","10 -14",7575,7888,15463
"4694","ELGEYO-MARAKWET","MARAKWET EAST","15",1373,1302,2675
"4695","ELGEYO-MARAKWET","MARAKWET EAST","16",1224,1214,2438
"4696","ELGEYO-MARAKWET","MARAKWET EAST","17",1119,1016,2135
"4697","ELGEYO-MARAKWET","MARAKWET EAST","18",849,803,1652
"4698","ELGEYO-MARAKWET","MARAKWET EAST","19",1017,1031,2048
"4699","ELGEYO-MARAKWET","MARAKWET EAST","15-19",5582,5366,10948
"4700","ELGEYO-MARAKWET","MARAKWET EAST","20",967,900,1867
"4701","ELGEYO-MARAKWET","MARAKWET EAST","21",802,807,1609
"4702","ELGEYO-MARAKWET","MARAKWET EAST","22",720,768,1488
"4703","ELGEYO-MARAKWET","MARAKWET EAST","23",660,750,1410
"4704","ELGEYO-MARAKWET","MARAKWET EAST","24",651,687,1338
"4705","ELGEYO-MARAKWET","MARAKWET EAST","20-24",3800,3912,7712
"4706","ELGEYO-MARAKWET","MARAKWET EAST","25",867,943,1810
"4707","ELGEYO-MARAKWET","MARAKWET EAST","26",632,705,1337
"4708","ELGEYO-MARAKWET","MARAKWET EAST","27",685,779,1464
"4709","ELGEYO-MARAKWET","MARAKWET EAST","28",465,566,1031
"4710","ELGEYO-MARAKWET","MARAKWET EAST","29",528,627,1155
"4711","ELGEYO-MARAKWET","MARAKWET EAST","25-29",3177,3620,6797
"4712","ELGEYO-MARAKWET","MARAKWET EAST","30",641,745,1386
"4713","ELGEYO-MARAKWET","MARAKWET EAST","31",456,510,966
"4714","ELGEYO-MARAKWET","MARAKWET EAST","32",536,660,1196
"4715","ELGEYO-MARAKWET","MARAKWET EAST","33",467,528,995
"4716","ELGEYO-MARAKWET","MARAKWET EAST","34",387,435,822
"4717","ELGEYO-MARAKWET","MARAKWET EAST","30-34",2487,2878,5365
"4718","ELGEYO-MARAKWET","MARAKWET EAST","35",671,573,1244
"4719","ELGEYO-MARAKWET","MARAKWET EAST","36",333,301,634
"4720","ELGEYO-MARAKWET","MARAKWET EAST","37",331,265,596
"4721","ELGEYO-MARAKWET","MARAKWET EAST","38",224,175,399
"4722","ELGEYO-MARAKWET","MARAKWET EAST","39",273,246,519
"4723","ELGEYO-MARAKWET","MARAKWET EAST","35-39",1832,1560,3392
"4724","ELGEYO-MARAKWET","MARAKWET EAST","40",410,346,756
"4725","ELGEYO-MARAKWET","MARAKWET EAST","41",393,369,762
"4726","ELGEYO-MARAKWET","MARAKWET EAST","42",367,424,791
"4727","ELGEYO-MARAKWET","MARAKWET EAST","43",272,295,567
"4728","ELGEYO-MARAKWET","MARAKWET EAST","44",171,198,369
"4729","ELGEYO-MARAKWET","MARAKWET EAST","40-44",1613,1632,3245
"4730","ELGEYO-MARAKWET","MARAKWET EAST","45",723,679,1402
"4731","ELGEYO-MARAKWET","MARAKWET EAST","46",285,250,535
"4732","ELGEYO-MARAKWET","MARAKWET EAST","47",305,299,604
"4733","ELGEYO-MARAKWET","MARAKWET EAST","48",135,101,236
"4734","ELGEYO-MARAKWET","MARAKWET EAST","49",187,177,364
"4735","ELGEYO-MARAKWET","MARAKWET EAST","45-49",1635,1506,3141
"4736","ELGEYO-MARAKWET","MARAKWET EAST","50",298,333,631
"4737","ELGEYO-MARAKWET","MARAKWET EAST","51",166,176,342
"4738","ELGEYO-MARAKWET","MARAKWET EAST","52",171,163,334
"4739","ELGEYO-MARAKWET","MARAKWET EAST","53",87,106,193
"4740","ELGEYO-MARAKWET","MARAKWET EAST","54",189,161,350
"4741","ELGEYO-MARAKWET","MARAKWET EAST","50-54",911,939,1850
"4742","ELGEYO-MARAKWET","MARAKWET EAST","55",186,169,355
"4743","ELGEYO-MARAKWET","MARAKWET EAST","56",156,192,348
"4744","ELGEYO-MARAKWET","MARAKWET EAST","57",167,208,375
"4745","ELGEYO-MARAKWET","MARAKWET EAST","58",180,177,357
"4746","ELGEYO-MARAKWET","MARAKWET EAST","59",205,208,413
"4747","ELGEYO-MARAKWET","MARAKWET EAST","55-59",894,954,1848
"4748","ELGEYO-MARAKWET","MARAKWET EAST","60",304,308,612
"4749","ELGEYO-MARAKWET","MARAKWET EAST","61",182,185,367
"4750","ELGEYO-MARAKWET","MARAKWET EAST","62",112,107,219
"4751","ELGEYO-MARAKWET","MARAKWET EAST","63",141,195,336
"4752","ELGEYO-MARAKWET","MARAKWET EAST","64",91,105,196
"4753","ELGEYO-MARAKWET","MARAKWET EAST","60-64",830,900,1730
"4754","ELGEYO-MARAKWET","MARAKWET EAST","65",239,245,484
"4755","ELGEYO-MARAKWET","MARAKWET EAST","66",78,102,180
"4756","ELGEYO-MARAKWET","MARAKWET EAST","67",164,161,325
"4757","ELGEYO-MARAKWET","MARAKWET EAST","68",101,102,203
"4758","ELGEYO-MARAKWET","MARAKWET EAST","69",179,229,408
"4759","ELGEYO-MARAKWET","MARAKWET EAST","65-69",761,839,1600
"4760","ELGEYO-MARAKWET","MARAKWET EAST","70",195,301,496
"4761","ELGEYO-MARAKWET","MARAKWET EAST","71",138,204,342
"4762","ELGEYO-MARAKWET","MARAKWET EAST","72",83,131,214
"4763","ELGEYO-MARAKWET","MARAKWET EAST","73",89,129,218
"4764","ELGEYO-MARAKWET","MARAKWET EAST","74",92,129,221
"4765","ELGEYO-MARAKWET","MARAKWET EAST","70-74",597,894,1491
"4766","ELGEYO-MARAKWET","MARAKWET EAST","75",112,140,252
"4767","ELGEYO-MARAKWET","MARAKWET EAST","76",50,73,123
"4768","ELGEYO-MARAKWET","MARAKWET EAST","77",64,83,147
"4769","ELGEYO-MARAKWET","MARAKWET EAST","78",39,45,84
"4770","ELGEYO-MARAKWET","MARAKWET EAST","79",93,144,237
"4771","ELGEYO-MARAKWET","MARAKWET EAST","75-79",358,485,843
"4772","ELGEYO-MARAKWET","MARAKWET EAST","80",87,132,219
"4773","ELGEYO-MARAKWET","MARAKWET EAST","81",37,78,115
"4774","ELGEYO-MARAKWET","MARAKWET EAST","82",22,34,56
"4775","ELGEYO-MARAKWET","MARAKWET EAST","83",34,51,85
"4776","ELGEYO-MARAKWET","MARAKWET EAST","84",37,39,76
"4777","ELGEYO-MARAKWET","MARAKWET EAST","80-84",217,334,551
"4778","ELGEYO-MARAKWET","MARAKWET EAST","85",26,38,64
"4779","ELGEYO-MARAKWET","MARAKWET EAST","86",13,17,30
"4780","ELGEYO-MARAKWET","MARAKWET EAST","87",25,33,58
"4781","ELGEYO-MARAKWET","MARAKWET EAST","88",8,17,25
"4782","ELGEYO-MARAKWET","MARAKWET EAST","89",55,71,126
"4783","ELGEYO-MARAKWET","MARAKWET EAST","85-89",127,176,303
"4784","ELGEYO-MARAKWET","MARAKWET EAST","90",22,37,59
"4785","ELGEYO-MARAKWET","MARAKWET EAST","91",11,19,30
"4786","ELGEYO-MARAKWET","MARAKWET EAST","92",NA,6,6
"4787","ELGEYO-MARAKWET","MARAKWET EAST","93",10,7,17
"4788","ELGEYO-MARAKWET","MARAKWET EAST","94",10,13,23
"4789","ELGEYO-MARAKWET","MARAKWET EAST","90-94",53,82,135
"4790","ELGEYO-MARAKWET","MARAKWET EAST","95",14,17,31
"4791","ELGEYO-MARAKWET","MARAKWET EAST","96",4,5,9
"4792","ELGEYO-MARAKWET","MARAKWET EAST","97",NA,6,6
"4793","ELGEYO-MARAKWET","MARAKWET EAST","98",3,4,7
"4794","ELGEYO-MARAKWET","MARAKWET EAST","99",12,14,26
"4795","ELGEYO-MARAKWET","MARAKWET EAST","95-99",33,46,79
"4796","ELGEYO-MARAKWET","MARAKWET EAST","100+",13,22,35
"4797","ELGEYO-MARAKWET","MARAKWET EAST","Not Stated",NA,NA,NA
"4798","ELGEYO-MARAKWET","MARAKWET WEST","Total",68948,68560,137508
"4799","ELGEYO-MARAKWET","MARAKWET WEST","0",1785,1733,3518
"4800","ELGEYO-MARAKWET","MARAKWET WEST","1",1942,1877,3819
"4801","ELGEYO-MARAKWET","MARAKWET WEST","2",1839,1894,3733
"4802","ELGEYO-MARAKWET","MARAKWET WEST","3",2028,1938,3966
"4803","ELGEYO-MARAKWET","MARAKWET WEST","4",2065,2077,4142
"4804","ELGEYO-MARAKWET","MARAKWET WEST","0 - 4",9659,9519,19178
"4805","ELGEYO-MARAKWET","MARAKWET WEST","5",2141,2151,4292
"4806","ELGEYO-MARAKWET","MARAKWET WEST","6",2018,2060,4078
"4807","ELGEYO-MARAKWET","MARAKWET WEST","7",2038,1945,3983
"4808","ELGEYO-MARAKWET","MARAKWET WEST","8",1776,1742,3518
"4809","ELGEYO-MARAKWET","MARAKWET WEST","9",2102,2077,4179
"4810","ELGEYO-MARAKWET","MARAKWET WEST","5-9",10075,9975,20050
"4811","ELGEYO-MARAKWET","MARAKWET WEST","10",2058,1962,4020
"4812","ELGEYO-MARAKWET","MARAKWET WEST","11",1943,1851,3794
"4813","ELGEYO-MARAKWET","MARAKWET WEST","12",2088,2113,4201
"4814","ELGEYO-MARAKWET","MARAKWET WEST","13",2058,2089,4147
"4815","ELGEYO-MARAKWET","MARAKWET WEST","14",2119,2018,4137
"4816","ELGEYO-MARAKWET","MARAKWET WEST","10 -14",10266,10033,20299
"4817","ELGEYO-MARAKWET","MARAKWET WEST","15",2071,2003,4074
"4818","ELGEYO-MARAKWET","MARAKWET WEST","16",1881,1836,3717
"4819","ELGEYO-MARAKWET","MARAKWET WEST","17",1719,1617,3336
"4820","ELGEYO-MARAKWET","MARAKWET WEST","18",1357,1323,2680
"4821","ELGEYO-MARAKWET","MARAKWET WEST","19",1736,1696,3432
"4822","ELGEYO-MARAKWET","MARAKWET WEST","15-19",8764,8475,17239
"4823","ELGEYO-MARAKWET","MARAKWET WEST","20",1464,1506,2970
"4824","ELGEYO-MARAKWET","MARAKWET WEST","21",1341,1331,2672
"4825","ELGEYO-MARAKWET","MARAKWET WEST","22",1198,1229,2427
"4826","ELGEYO-MARAKWET","MARAKWET WEST","23",1137,1208,2345
"4827","ELGEYO-MARAKWET","MARAKWET WEST","24",1075,1118,2193
"4828","ELGEYO-MARAKWET","MARAKWET WEST","20-24",6215,6392,12607
"4829","ELGEYO-MARAKWET","MARAKWET WEST","25",1280,1248,2528
"4830","ELGEYO-MARAKWET","MARAKWET WEST","26",949,1025,1974
"4831","ELGEYO-MARAKWET","MARAKWET WEST","27",1028,986,2014
"4832","ELGEYO-MARAKWET","MARAKWET WEST","28",711,736,1447
"4833","ELGEYO-MARAKWET","MARAKWET WEST","29",884,838,1722
"4834","ELGEYO-MARAKWET","MARAKWET WEST","25-29",4852,4833,9685
"4835","ELGEYO-MARAKWET","MARAKWET WEST","30",1005,1127,2132
"4836","ELGEYO-MARAKWET","MARAKWET WEST","31",733,831,1564
"4837","ELGEYO-MARAKWET","MARAKWET WEST","32",932,1019,1951
"4838","ELGEYO-MARAKWET","MARAKWET WEST","33",805,897,1702
"4839","ELGEYO-MARAKWET","MARAKWET WEST","34",664,742,1406
"4840","ELGEYO-MARAKWET","MARAKWET WEST","30-34",4139,4616,8755
"4841","ELGEYO-MARAKWET","MARAKWET WEST","35",1053,980,2033
"4842","ELGEYO-MARAKWET","MARAKWET WEST","36",571,492,1063
"4843","ELGEYO-MARAKWET","MARAKWET WEST","37",624,472,1096
"4844","ELGEYO-MARAKWET","MARAKWET WEST","38",372,330,702
"4845","ELGEYO-MARAKWET","MARAKWET WEST","39",510,471,981
"4846","ELGEYO-MARAKWET","MARAKWET WEST","35-39",3130,2745,5875
"4847","ELGEYO-MARAKWET","MARAKWET WEST","40",643,527,1170
"4848","ELGEYO-MARAKWET","MARAKWET WEST","41",566,561,1127
"4849","ELGEYO-MARAKWET","MARAKWET WEST","42",630,555,1185
"4850","ELGEYO-MARAKWET","MARAKWET WEST","43",565,551,1116
"4851","ELGEYO-MARAKWET","MARAKWET WEST","44",401,408,809
"4852","ELGEYO-MARAKWET","MARAKWET WEST","40-44",2805,2602,5407
"4853","ELGEYO-MARAKWET","MARAKWET WEST","45",854,775,1629
"4854","ELGEYO-MARAKWET","MARAKWET WEST","46",460,471,931
"4855","ELGEYO-MARAKWET","MARAKWET WEST","47",491,500,991
"4856","ELGEYO-MARAKWET","MARAKWET WEST","48",247,258,505
"4857","ELGEYO-MARAKWET","MARAKWET WEST","49",367,356,723
"4858","ELGEYO-MARAKWET","MARAKWET WEST","45-49",2419,2360,4779
"4859","ELGEYO-MARAKWET","MARAKWET WEST","50",428,470,898
"4860","ELGEYO-MARAKWET","MARAKWET WEST","51",326,363,689
"4861","ELGEYO-MARAKWET","MARAKWET WEST","52",260,259,519
"4862","ELGEYO-MARAKWET","MARAKWET WEST","53",188,221,409
"4863","ELGEYO-MARAKWET","MARAKWET WEST","54",321,285,606
"4864","ELGEYO-MARAKWET","MARAKWET WEST","50-54",1523,1598,3121
"4865","ELGEYO-MARAKWET","MARAKWET WEST","55",331,271,602
"4866","ELGEYO-MARAKWET","MARAKWET WEST","56",328,354,682
"4867","ELGEYO-MARAKWET","MARAKWET WEST","57",330,354,684
"4868","ELGEYO-MARAKWET","MARAKWET WEST","58",344,328,672
"4869","ELGEYO-MARAKWET","MARAKWET WEST","59",337,262,599
"4870","ELGEYO-MARAKWET","MARAKWET WEST","55-59",1670,1569,3239
"4871","ELGEYO-MARAKWET","MARAKWET WEST","60",357,317,674
"4872","ELGEYO-MARAKWET","MARAKWET WEST","61",308,272,580
"4873","ELGEYO-MARAKWET","MARAKWET WEST","62",175,160,335
"4874","ELGEYO-MARAKWET","MARAKWET WEST","63",213,212,425
"4875","ELGEYO-MARAKWET","MARAKWET WEST","64",121,117,238
"4876","ELGEYO-MARAKWET","MARAKWET WEST","60-64",1174,1078,2252
"4877","ELGEYO-MARAKWET","MARAKWET WEST","65",224,247,471
"4878","ELGEYO-MARAKWET","MARAKWET WEST","66",114,110,224
"4879","ELGEYO-MARAKWET","MARAKWET WEST","67",199,185,384
"4880","ELGEYO-MARAKWET","MARAKWET WEST","68",92,88,180
"4881","ELGEYO-MARAKWET","MARAKWET WEST","69",183,204,387
"4882","ELGEYO-MARAKWET","MARAKWET WEST","65-69",812,834,1646
"4883","ELGEYO-MARAKWET","MARAKWET WEST","70",220,234,454
"4884","ELGEYO-MARAKWET","MARAKWET WEST","71",161,183,344
"4885","ELGEYO-MARAKWET","MARAKWET WEST","72",97,87,184
"4886","ELGEYO-MARAKWET","MARAKWET WEST","73",86,107,193
"4887","ELGEYO-MARAKWET","MARAKWET WEST","74",90,115,205
"4888","ELGEYO-MARAKWET","MARAKWET WEST","70-74",654,726,1380
"4889","ELGEYO-MARAKWET","MARAKWET WEST","75",100,121,221
"4890","ELGEYO-MARAKWET","MARAKWET WEST","76",76,72,148
"4891","ELGEYO-MARAKWET","MARAKWET WEST","77",74,100,174
"4892","ELGEYO-MARAKWET","MARAKWET WEST","78",37,26,63
"4893","ELGEYO-MARAKWET","MARAKWET WEST","79",66,118,184
"4894","ELGEYO-MARAKWET","MARAKWET WEST","75-79",353,437,790
"4895","ELGEYO-MARAKWET","MARAKWET WEST","80",69,126,195
"4896","ELGEYO-MARAKWET","MARAKWET WEST","81",42,93,135
"4897","ELGEYO-MARAKWET","MARAKWET WEST","82",16,34,50
"4898","ELGEYO-MARAKWET","MARAKWET WEST","83",36,71,107
"4899","ELGEYO-MARAKWET","MARAKWET WEST","84",42,61,103
"4900","ELGEYO-MARAKWET","MARAKWET WEST","80-84",205,385,590
"4901","ELGEYO-MARAKWET","MARAKWET WEST","85",26,44,70
"4902","ELGEYO-MARAKWET","MARAKWET WEST","86",21,21,42
"4903","ELGEYO-MARAKWET","MARAKWET WEST","87",28,37,65
"4904","ELGEYO-MARAKWET","MARAKWET WEST","88",19,31,50
"4905","ELGEYO-MARAKWET","MARAKWET WEST","89",42,73,115
"4906","ELGEYO-MARAKWET","MARAKWET WEST","85-89",136,206,342
"4907","ELGEYO-MARAKWET","MARAKWET WEST","90",22,42,64
"4908","ELGEYO-MARAKWET","MARAKWET WEST","91",7,20,27
"4909","ELGEYO-MARAKWET","MARAKWET WEST","92",1,15,16
"4910","ELGEYO-MARAKWET","MARAKWET WEST","93",13,9,22
"4911","ELGEYO-MARAKWET","MARAKWET WEST","94",9,12,21
"4912","ELGEYO-MARAKWET","MARAKWET WEST","90-94",52,98,150
"4913","ELGEYO-MARAKWET","MARAKWET WEST","95",21,18,39
"4914","ELGEYO-MARAKWET","MARAKWET WEST","96",3,5,8
"4915","ELGEYO-MARAKWET","MARAKWET WEST","97",6,4,10
"4916","ELGEYO-MARAKWET","MARAKWET WEST","98",2,5,7
"4917","ELGEYO-MARAKWET","MARAKWET WEST","99",4,15,19
"4918","ELGEYO-MARAKWET","MARAKWET WEST","95-99",36,47,83
"4919","ELGEYO-MARAKWET","MARAKWET WEST","100+",9,32,41
"4920","ELGEYO-MARAKWET","MARAKWET WEST","Not Stated",NA,NA,NA
"4921","EMBU","ALL","Total",304208,304367,608575
"4922","EMBU","ALL","0",5812,5846,11658
"4923","EMBU","ALL","1",6602,6238,12840
"4924","EMBU","ALL","2",6134,6076,12210
"4925","EMBU","ALL","3",6389,6202,12591
"4926","EMBU","ALL","4",6221,6027,12248
"4927","EMBU","ALL","0 - 4",31158,30389,61547
"4928","EMBU","ALL","5",6031,5765,11796
"4929","EMBU","ALL","6",5805,5992,11797
"4930","EMBU","ALL","7",6090,6026,12116
"4931","EMBU","ALL","8",6094,5936,12030
"4932","EMBU","ALL","9",6603,6527,13130
"4933","EMBU","ALL","5-9",30623,30246,60869
"4934","EMBU","ALL","10",6560,6460,13020
"4935","EMBU","ALL","11",6327,6450,12777
"4936","EMBU","ALL","12",7234,6828,14062
"4937","EMBU","ALL","13",7294,7160,14454
"4938","EMBU","ALL","14",7000,6655,13655
"4939","EMBU","ALL","10 -14",34415,33553,67968
"4940","EMBU","ALL","15",6791,6727,13518
"4941","EMBU","ALL","16",6870,6744,13614
"4942","EMBU","ALL","17",6948,6386,13334
"4943","EMBU","ALL","18",5772,5405,11177
"4944","EMBU","ALL","19",6150,5671,11821
"4945","EMBU","ALL","15-19",32531,30933,63464
"4946","EMBU","ALL","20",5905,5666,11571
"4947","EMBU","ALL","21",5139,4998,10137
"4948","EMBU","ALL","22",5240,5335,10575
"4949","EMBU","ALL","23",5378,5534,10912
"4950","EMBU","ALL","24",4949,4697,9646
"4951","EMBU","ALL","20-24",26611,26230,52841
"4952","EMBU","ALL","25",5230,4832,10062
"4953","EMBU","ALL","26",4343,4223,8566
"4954","EMBU","ALL","27",4729,4337,9066
"4955","EMBU","ALL","28",4240,4022,8262
"4956","EMBU","ALL","29",4640,4564,9204
"4957","EMBU","ALL","25-29",23182,21978,45160
"4958","EMBU","ALL","30",5597,5484,11081
"4959","EMBU","ALL","31",4039,3959,7998
"4960","EMBU","ALL","32",4950,5165,10115
"4961","EMBU","ALL","33",4658,4743,9401
"4962","EMBU","ALL","34",3979,4160,8139
"4963","EMBU","ALL","30-34",23223,23511,46734
"4964","EMBU","ALL","35",5545,5175,10720
"4965","EMBU","ALL","36",3969,4013,7982
"4966","EMBU","ALL","37",4291,3875,8166
"4967","EMBU","ALL","38",3566,3565,7131
"4968","EMBU","ALL","39",4143,3964,8107
"4969","EMBU","ALL","35-39",21514,20592,42106
"4970","EMBU","ALL","40",4769,4409,9178
"4971","EMBU","ALL","41",3885,3563,7448
"4972","EMBU","ALL","42",3634,3469,7103
"4973","EMBU","ALL","43",3385,3306,6691
"4974","EMBU","ALL","44",3044,2862,5906
"4975","EMBU","ALL","40-44",18717,17609,36326
"4976","EMBU","ALL","45",3978,3851,7829
"4977","EMBU","ALL","46",3101,3073,6174
"4978","EMBU","ALL","47",3058,2946,6004
"4979","EMBU","ALL","48",2528,2472,5000
"4980","EMBU","ALL","49",2785,2694,5479
"4981","EMBU","ALL","45-49",15450,15036,30486
"4982","EMBU","ALL","50",3074,3320,6394
"4983","EMBU","ALL","51",2513,2526,5039
"4984","EMBU","ALL","52",2483,2527,5010
"4985","EMBU","ALL","53",1860,2095,3955
"4986","EMBU","ALL","54",2147,2187,4334
"4987","EMBU","ALL","50-54",12077,12655,24732
"4988","EMBU","ALL","55",2477,2414,4891
"4989","EMBU","ALL","56",2755,2887,5642
"4990","EMBU","ALL","57",2045,2394,4439
"4991","EMBU","ALL","58",1606,1778,3384
"4992","EMBU","ALL","59",1953,2080,4033
"4993","EMBU","ALL","55-59",10836,11553,22389
"4994","EMBU","ALL","60",2288,2306,4594
"4995","EMBU","ALL","61",1641,1731,3372
"4996","EMBU","ALL","62",1408,1439,2847
"4997","EMBU","ALL","63",1103,1269,2372
"4998","EMBU","ALL","64",949,1040,1989
"4999","EMBU","ALL","60-64",7389,7785,15174
"5000","EMBU","ALL","65",1551,1770,3321
"5001","EMBU","ALL","66",1202,1156,2358
"5002","EMBU","ALL","67",1839,1772,3611
"5003","EMBU","ALL","68",779,844,1623
"5004","EMBU","ALL","69",1099,1343,2442
"5005","EMBU","ALL","65-69",6470,6885,13355
"5006","EMBU","ALL","70",1316,2080,3396
"5007","EMBU","ALL","71",935,1148,2083
"5008","EMBU","ALL","72",715,844,1559
"5009","EMBU","ALL","73",620,754,1374
"5010","EMBU","ALL","74",555,826,1381
"5011","EMBU","ALL","70-74",4141,5652,9793
"5012","EMBU","ALL","75",554,881,1435
"5013","EMBU","ALL","76",417,492,909
"5014","EMBU","ALL","77",463,623,1086
"5015","EMBU","ALL","78",358,382,740
"5016","EMBU","ALL","79",428,755,1183
"5017","EMBU","ALL","75-79",2220,3133,5353
"5018","EMBU","ALL","80",603,1126,1729
"5019","EMBU","ALL","81",290,560,850
"5020","EMBU","ALL","82",271,296,567
"5021","EMBU","ALL","83",316,373,689
"5022","EMBU","ALL","84",295,459,754
"5023","EMBU","ALL","80-84",1775,2814,4589
"5024","EMBU","ALL","85",270,421,691
"5025","EMBU","ALL","86",187,216,403
"5026","EMBU","ALL","87",209,293,502
"5027","EMBU","ALL","88",126,172,298
"5028","EMBU","ALL","89",227,562,789
"5029","EMBU","ALL","85-89",1019,1664,2683
"5030","EMBU","ALL","90",151,440,591
"5031","EMBU","ALL","91",140,341,481
"5032","EMBU","ALL","92",75,128,203
"5033","EMBU","ALL","93",42,146,188
"5034","EMBU","ALL","94",55,136,191
"5035","EMBU","ALL","90-94",463,1191,1654
"5036","EMBU","ALL","95",84,189,273
"5037","EMBU","ALL","96",33,89,122
"5038","EMBU","ALL","97",61,88,149
"5039","EMBU","ALL","98",31,69,100
"5040","EMBU","ALL","99",61,163,224
"5041","EMBU","ALL","95-99",270,598,868
"5042","EMBU","ALL","100+",120,357,477
"5043","EMBU","ALL","Not Stated",4,3,7
"5044","EMBU","EMBU EAST","Total",64571,64991,129562
"5045","EMBU","EMBU EAST","0",1054,1084,2138
"5046","EMBU","EMBU EAST","1",1288,1208,2496
"5047","EMBU","EMBU EAST","2",1215,1202,2417
"5048","EMBU","EMBU EAST","3",1254,1225,2479
"5049","EMBU","EMBU EAST","4",1278,1254,2532
"5050","EMBU","EMBU EAST","0 - 4",6089,5973,12062
"5051","EMBU","EMBU EAST","5",1249,1117,2366
"5052","EMBU","EMBU EAST","6",1189,1068,2257
"5053","EMBU","EMBU EAST","7",1266,1225,2491
"5054","EMBU","EMBU EAST","8",1241,1165,2406
"5055","EMBU","EMBU EAST","9",1343,1278,2621
"5056","EMBU","EMBU EAST","5-9",6288,5853,12141
"5057","EMBU","EMBU EAST","10",1262,1311,2573
"5058","EMBU","EMBU EAST","11",1209,1250,2459
"5059","EMBU","EMBU EAST","12",1425,1433,2858
"5060","EMBU","EMBU EAST","13",1460,1463,2923
"5061","EMBU","EMBU EAST","14",1441,1329,2770
"5062","EMBU","EMBU EAST","10 -14",6797,6786,13583
"5063","EMBU","EMBU EAST","15",1404,1414,2818
"5064","EMBU","EMBU EAST","16",1395,1360,2755
"5065","EMBU","EMBU EAST","17",1408,1338,2746
"5066","EMBU","EMBU EAST","18",1241,1101,2342
"5067","EMBU","EMBU EAST","19",1285,1128,2413
"5068","EMBU","EMBU EAST","15-19",6733,6341,13074
"5069","EMBU","EMBU EAST","20",1133,1080,2213
"5070","EMBU","EMBU EAST","21",1007,914,1921
"5071","EMBU","EMBU EAST","22",1049,1008,2057
"5072","EMBU","EMBU EAST","23",1034,995,2029
"5073","EMBU","EMBU EAST","24",902,892,1794
"5074","EMBU","EMBU EAST","20-24",5125,4889,10014
"5075","EMBU","EMBU EAST","25",867,864,1731
"5076","EMBU","EMBU EAST","26",802,731,1533
"5077","EMBU","EMBU EAST","27",835,834,1669
"5078","EMBU","EMBU EAST","28",790,786,1576
"5079","EMBU","EMBU EAST","29",822,835,1657
"5080","EMBU","EMBU EAST","25-29",4116,4050,8166
"5081","EMBU","EMBU EAST","30",1046,1098,2144
"5082","EMBU","EMBU EAST","31",758,837,1595
"5083","EMBU","EMBU EAST","32",986,1031,2017
"5084","EMBU","EMBU EAST","33",985,948,1933
"5085","EMBU","EMBU EAST","34",914,911,1825
"5086","EMBU","EMBU EAST","30-34",4689,4825,9514
"5087","EMBU","EMBU EAST","35",1194,1149,2343
"5088","EMBU","EMBU EAST","36",883,877,1760
"5089","EMBU","EMBU EAST","37",931,885,1816
"5090","EMBU","EMBU EAST","38",851,811,1662
"5091","EMBU","EMBU EAST","39",879,924,1803
"5092","EMBU","EMBU EAST","35-39",4738,4646,9384
"5093","EMBU","EMBU EAST","40",1075,1030,2105
"5094","EMBU","EMBU EAST","41",817,836,1653
"5095","EMBU","EMBU EAST","42",861,811,1672
"5096","EMBU","EMBU EAST","43",772,771,1543
"5097","EMBU","EMBU EAST","44",764,651,1415
"5098","EMBU","EMBU EAST","40-44",4289,4099,8388
"5099","EMBU","EMBU EAST","45",841,901,1742
"5100","EMBU","EMBU EAST","46",734,777,1511
"5101","EMBU","EMBU EAST","47",726,791,1517
"5102","EMBU","EMBU EAST","48",639,620,1259
"5103","EMBU","EMBU EAST","49",678,711,1389
"5104","EMBU","EMBU EAST","45-49",3618,3800,7418
"5105","EMBU","EMBU EAST","50",719,811,1530
"5106","EMBU","EMBU EAST","51",640,588,1228
"5107","EMBU","EMBU EAST","52",595,617,1212
"5108","EMBU","EMBU EAST","53",449,440,889
"5109","EMBU","EMBU EAST","54",542,553,1095
"5110","EMBU","EMBU EAST","50-54",2945,3009,5954
"5111","EMBU","EMBU EAST","55",635,625,1260
"5112","EMBU","EMBU EAST","56",750,771,1521
"5113","EMBU","EMBU EAST","57",566,630,1196
"5114","EMBU","EMBU EAST","58",394,452,846
"5115","EMBU","EMBU EAST","59",544,541,1085
"5116","EMBU","EMBU EAST","55-59",2889,3019,5908
"5117","EMBU","EMBU EAST","60",610,612,1222
"5118","EMBU","EMBU EAST","61",452,433,885
"5119","EMBU","EMBU EAST","62",401,374,775
"5120","EMBU","EMBU EAST","63",263,307,570
"5121","EMBU","EMBU EAST","64",245,253,498
"5122","EMBU","EMBU EAST","60-64",1971,1979,3950
"5123","EMBU","EMBU EAST","65",380,445,825
"5124","EMBU","EMBU EAST","66",349,334,683
"5125","EMBU","EMBU EAST","67",464,426,890
"5126","EMBU","EMBU EAST","68",202,222,424
"5127","EMBU","EMBU EAST","69",296,358,654
"5128","EMBU","EMBU EAST","65-69",1691,1785,3476
"5129","EMBU","EMBU EAST","70",328,549,877
"5130","EMBU","EMBU EAST","71",239,322,561
"5131","EMBU","EMBU EAST","72",200,227,427
"5132","EMBU","EMBU EAST","73",146,199,345
"5133","EMBU","EMBU EAST","74",147,188,335
"5134","EMBU","EMBU EAST","70-74",1060,1485,2545
"5135","EMBU","EMBU EAST","75",147,226,373
"5136","EMBU","EMBU EAST","76",106,159,265
"5137","EMBU","EMBU EAST","77",140,159,299
"5138","EMBU","EMBU EAST","78",99,105,204
"5139","EMBU","EMBU EAST","79",111,158,269
"5140","EMBU","EMBU EAST","75-79",603,807,1410
"5141","EMBU","EMBU EAST","80",173,245,418
"5142","EMBU","EMBU EAST","81",77,141,218
"5143","EMBU","EMBU EAST","82",75,80,155
"5144","EMBU","EMBU EAST","83",93,116,209
"5145","EMBU","EMBU EAST","84",77,105,182
"5146","EMBU","EMBU EAST","80-84",495,687,1182
"5147","EMBU","EMBU EAST","85",65,111,176
"5148","EMBU","EMBU EAST","86",56,77,133
"5149","EMBU","EMBU EAST","87",47,64,111
"5150","EMBU","EMBU EAST","88",37,44,81
"5151","EMBU","EMBU EAST","89",41,113,154
"5152","EMBU","EMBU EAST","85-89",246,409,655
"5153","EMBU","EMBU EAST","90",33,99,132
"5154","EMBU","EMBU EAST","91",29,110,139
"5155","EMBU","EMBU EAST","92",18,45,63
"5156","EMBU","EMBU EAST","93",14,26,40
"5157","EMBU","EMBU EAST","94",10,43,53
"5158","EMBU","EMBU EAST","90-94",104,323,427
"5159","EMBU","EMBU EAST","95",12,36,48
"5160","EMBU","EMBU EAST","96",8,22,30
"5161","EMBU","EMBU EAST","97",13,26,39
"5162","EMBU","EMBU EAST","98",9,18,27
"5163","EMBU","EMBU EAST","99",10,31,41
"5164","EMBU","EMBU EAST","95-99",52,133,185
"5165","EMBU","EMBU EAST","100+",32,93,125
"5166","EMBU","EMBU EAST","Not Stated",1,NA,1
"5167","EMBU","EMBU NORTH","Total",39665,39888,79553
"5168","EMBU","EMBU NORTH","0",694,696,1390
"5169","EMBU","EMBU NORTH","1",727,681,1408
"5170","EMBU","EMBU NORTH","2",747,726,1473
"5171","EMBU","EMBU NORTH","3",785,750,1535
"5172","EMBU","EMBU NORTH","4",780,754,1534
"5173","EMBU","EMBU NORTH","0 - 4",3733,3607,7340
"5174","EMBU","EMBU NORTH","5",746,678,1424
"5175","EMBU","EMBU NORTH","6",757,748,1505
"5176","EMBU","EMBU NORTH","7",689,744,1433
"5177","EMBU","EMBU NORTH","8",756,655,1411
"5178","EMBU","EMBU NORTH","9",765,763,1528
"5179","EMBU","EMBU NORTH","5-9",3713,3588,7301
"5180","EMBU","EMBU NORTH","10",778,752,1530
"5181","EMBU","EMBU NORTH","11",744,739,1483
"5182","EMBU","EMBU NORTH","12",882,782,1664
"5183","EMBU","EMBU NORTH","13",941,829,1770
"5184","EMBU","EMBU NORTH","14",841,788,1629
"5185","EMBU","EMBU NORTH","10 -14",4186,3890,8076
"5186","EMBU","EMBU NORTH","15",826,867,1693
"5187","EMBU","EMBU NORTH","16",884,821,1705
"5188","EMBU","EMBU NORTH","17",871,806,1677
"5189","EMBU","EMBU NORTH","18",818,726,1544
"5190","EMBU","EMBU NORTH","19",832,672,1504
"5191","EMBU","EMBU NORTH","15-19",4231,3892,8123
"5192","EMBU","EMBU NORTH","20",752,634,1386
"5193","EMBU","EMBU NORTH","21",661,574,1235
"5194","EMBU","EMBU NORTH","22",656,598,1254
"5195","EMBU","EMBU NORTH","23",635,625,1260
"5196","EMBU","EMBU NORTH","24",607,543,1150
"5197","EMBU","EMBU NORTH","20-24",3311,2974,6285
"5198","EMBU","EMBU NORTH","25",581,538,1119
"5199","EMBU","EMBU NORTH","26",492,512,1004
"5200","EMBU","EMBU NORTH","27",525,495,1020
"5201","EMBU","EMBU NORTH","28",462,457,919
"5202","EMBU","EMBU NORTH","29",520,558,1078
"5203","EMBU","EMBU NORTH","25-29",2580,2560,5140
"5204","EMBU","EMBU NORTH","30",683,694,1377
"5205","EMBU","EMBU NORTH","31",490,510,1000
"5206","EMBU","EMBU NORTH","32",639,732,1371
"5207","EMBU","EMBU NORTH","33",520,618,1138
"5208","EMBU","EMBU NORTH","34",545,631,1176
"5209","EMBU","EMBU NORTH","30-34",2877,3185,6062
"5210","EMBU","EMBU NORTH","35",699,735,1434
"5211","EMBU","EMBU NORTH","36",538,564,1102
"5212","EMBU","EMBU NORTH","37",605,521,1126
"5213","EMBU","EMBU NORTH","38",480,537,1017
"5214","EMBU","EMBU NORTH","39",573,582,1155
"5215","EMBU","EMBU NORTH","35-39",2895,2939,5834
"5216","EMBU","EMBU NORTH","40",651,626,1277
"5217","EMBU","EMBU NORTH","41",552,521,1073
"5218","EMBU","EMBU NORTH","42",499,524,1023
"5219","EMBU","EMBU NORTH","43",500,492,992
"5220","EMBU","EMBU NORTH","44",431,401,832
"5221","EMBU","EMBU NORTH","40-44",2633,2564,5197
"5222","EMBU","EMBU NORTH","45",605,573,1178
"5223","EMBU","EMBU NORTH","46",467,486,953
"5224","EMBU","EMBU NORTH","47",478,414,892
"5225","EMBU","EMBU NORTH","48",401,386,787
"5226","EMBU","EMBU NORTH","49",419,420,839
"5227","EMBU","EMBU NORTH","45-49",2370,2279,4649
"5228","EMBU","EMBU NORTH","50",507,530,1037
"5229","EMBU","EMBU NORTH","51",401,385,786
"5230","EMBU","EMBU NORTH","52",431,409,840
"5231","EMBU","EMBU NORTH","53",324,346,670
"5232","EMBU","EMBU NORTH","54",345,364,709
"5233","EMBU","EMBU NORTH","50-54",2008,2034,4042
"5234","EMBU","EMBU NORTH","55",384,370,754
"5235","EMBU","EMBU NORTH","56",432,470,902
"5236","EMBU","EMBU NORTH","57",317,368,685
"5237","EMBU","EMBU NORTH","58",269,281,550
"5238","EMBU","EMBU NORTH","59",332,337,669
"5239","EMBU","EMBU NORTH","55-59",1734,1826,3560
"5240","EMBU","EMBU NORTH","60",354,354,708
"5241","EMBU","EMBU NORTH","61",233,296,529
"5242","EMBU","EMBU NORTH","62",195,243,438
"5243","EMBU","EMBU NORTH","63",162,163,325
"5244","EMBU","EMBU NORTH","64",121,129,250
"5245","EMBU","EMBU NORTH","60-64",1065,1185,2250
"5246","EMBU","EMBU NORTH","65",234,260,494
"5247","EMBU","EMBU NORTH","66",182,171,353
"5248","EMBU","EMBU NORTH","67",239,252,491
"5249","EMBU","EMBU NORTH","68",115,116,231
"5250","EMBU","EMBU NORTH","69",166,174,340
"5251","EMBU","EMBU NORTH","65-69",936,973,1909
"5252","EMBU","EMBU NORTH","70",203,301,504
"5253","EMBU","EMBU NORTH","71",135,154,289
"5254","EMBU","EMBU NORTH","72",94,121,215
"5255","EMBU","EMBU NORTH","73",95,123,218
"5256","EMBU","EMBU NORTH","74",77,119,196
"5257","EMBU","EMBU NORTH","70-74",604,818,1422
"5258","EMBU","EMBU NORTH","75",72,133,205
"5259","EMBU","EMBU NORTH","76",68,72,140
"5260","EMBU","EMBU NORTH","77",57,111,168
"5261","EMBU","EMBU NORTH","78",47,67,114
"5262","EMBU","EMBU NORTH","79",65,125,190
"5263","EMBU","EMBU NORTH","75-79",309,508,817
"5264","EMBU","EMBU NORTH","80",68,178,246
"5265","EMBU","EMBU NORTH","81",40,75,115
"5266","EMBU","EMBU NORTH","82",28,43,71
"5267","EMBU","EMBU NORTH","83",39,55,94
"5268","EMBU","EMBU NORTH","84",38,75,113
"5269","EMBU","EMBU NORTH","80-84",213,426,639
"5270","EMBU","EMBU NORTH","85",34,72,106
"5271","EMBU","EMBU NORTH","86",35,28,63
"5272","EMBU","EMBU NORTH","87",35,58,93
"5273","EMBU","EMBU NORTH","88",21,31,52
"5274","EMBU","EMBU NORTH","89",31,81,112
"5275","EMBU","EMBU NORTH","85-89",156,270,426
"5276","EMBU","EMBU NORTH","90",24,67,91
"5277","EMBU","EMBU NORTH","91",25,71,96
"5278","EMBU","EMBU NORTH","92",7,33,40
"5279","EMBU","EMBU NORTH","93",6,38,44
"5280","EMBU","EMBU NORTH","94",10,19,29
"5281","EMBU","EMBU NORTH","90-94",72,228,300
"5282","EMBU","EMBU NORTH","95",6,29,35
"5283","EMBU","EMBU NORTH","96",1,15,16
"5284","EMBU","EMBU NORTH","97",9,18,27
"5285","EMBU","EMBU NORTH","98",3,12,15
"5286","EMBU","EMBU NORTH","99",7,24,31
"5287","EMBU","EMBU NORTH","95-99",26,98,124
"5288","EMBU","EMBU NORTH","100+",13,44,57
"5289","EMBU","EMBU NORTH","Not Stated",NA,NA,NA
"5290","EMBU","EMBU WEST","Total",63125,63966,127091
"5291","EMBU","EMBU WEST","0",1319,1386,2705
"5292","EMBU","EMBU WEST","1",1426,1284,2710
"5293","EMBU","EMBU WEST","2",1256,1253,2509
"5294","EMBU","EMBU WEST","3",1245,1210,2455
"5295","EMBU","EMBU WEST","4",1183,1128,2311
"5296","EMBU","EMBU WEST","0 - 4",6429,6261,12690
"5297","EMBU","EMBU WEST","5",1091,1135,2226
"5298","EMBU","EMBU WEST","6",1071,1183,2254
"5299","EMBU","EMBU WEST","7",1182,1118,2300
"5300","EMBU","EMBU WEST","8",1050,1068,2118
"5301","EMBU","EMBU WEST","9",1163,1179,2342
"5302","EMBU","EMBU WEST","5-9",5557,5683,11240
"5303","EMBU","EMBU WEST","10",1128,1147,2275
"5304","EMBU","EMBU WEST","11",1045,1094,2139
"5305","EMBU","EMBU WEST","12",1241,1154,2395
"5306","EMBU","EMBU WEST","13",1183,1202,2385
"5307","EMBU","EMBU WEST","14",1165,1131,2296
"5308","EMBU","EMBU WEST","10 -14",5762,5728,11490
"5309","EMBU","EMBU WEST","15",1093,1128,2221
"5310","EMBU","EMBU WEST","16",1130,1208,2338
"5311","EMBU","EMBU WEST","17",1158,1144,2302
"5312","EMBU","EMBU WEST","18",1009,1086,2095
"5313","EMBU","EMBU WEST","19",1208,1385,2593
"5314","EMBU","EMBU WEST","15-19",5598,5951,11549
"5315","EMBU","EMBU WEST","20",1227,1410,2637
"5316","EMBU","EMBU WEST","21",1188,1338,2526
"5317","EMBU","EMBU WEST","22",1291,1527,2818
"5318","EMBU","EMBU WEST","23",1391,1593,2984
"5319","EMBU","EMBU WEST","24",1284,1349,2633
"5320","EMBU","EMBU WEST","20-24",6381,7217,13598
"5321","EMBU","EMBU WEST","25",1401,1355,2756
"5322","EMBU","EMBU WEST","26",1174,1199,2373
"5323","EMBU","EMBU WEST","27",1261,1142,2403
"5324","EMBU","EMBU WEST","28",1116,1063,2179
"5325","EMBU","EMBU WEST","29",1174,1161,2335
"5326","EMBU","EMBU WEST","25-29",6126,5920,12046
"5327","EMBU","EMBU WEST","30",1415,1371,2786
"5328","EMBU","EMBU WEST","31",976,966,1942
"5329","EMBU","EMBU WEST","32",1219,1257,2476
"5330","EMBU","EMBU WEST","33",1144,1160,2304
"5331","EMBU","EMBU WEST","34",972,995,1967
"5332","EMBU","EMBU WEST","30-34",5726,5749,11475
"5333","EMBU","EMBU WEST","35",1317,1181,2498
"5334","EMBU","EMBU WEST","36",914,931,1845
"5335","EMBU","EMBU WEST","37",955,838,1793
"5336","EMBU","EMBU WEST","38",838,836,1674
"5337","EMBU","EMBU WEST","39",977,843,1820
"5338","EMBU","EMBU WEST","35-39",5001,4629,9630
"5339","EMBU","EMBU WEST","40",1087,983,2070
"5340","EMBU","EMBU WEST","41",827,755,1582
"5341","EMBU","EMBU WEST","42",830,765,1595
"5342","EMBU","EMBU WEST","43",730,654,1384
"5343","EMBU","EMBU WEST","44",634,632,1266
"5344","EMBU","EMBU WEST","40-44",4108,3789,7897
"5345","EMBU","EMBU WEST","45",865,844,1709
"5346","EMBU","EMBU WEST","46",649,589,1238
"5347","EMBU","EMBU WEST","47",626,586,1212
"5348","EMBU","EMBU WEST","48",530,529,1059
"5349","EMBU","EMBU WEST","49",593,474,1067
"5350","EMBU","EMBU WEST","45-49",3263,3022,6285
"5351","EMBU","EMBU WEST","50",679,673,1352
"5352","EMBU","EMBU WEST","51",502,521,1023
"5353","EMBU","EMBU WEST","52",589,547,1136
"5354","EMBU","EMBU WEST","53",411,451,862
"5355","EMBU","EMBU WEST","54",455,456,911
"5356","EMBU","EMBU WEST","50-54",2636,2648,5284
"5357","EMBU","EMBU WEST","55",541,490,1031
"5358","EMBU","EMBU WEST","56",537,599,1136
"5359","EMBU","EMBU WEST","57",412,448,860
"5360","EMBU","EMBU WEST","58",371,387,758
"5361","EMBU","EMBU WEST","59",382,402,784
"5362","EMBU","EMBU WEST","55-59",2243,2326,4569
"5363","EMBU","EMBU WEST","60",487,457,944
"5364","EMBU","EMBU WEST","61",287,302,589
"5365","EMBU","EMBU WEST","62",280,249,529
"5366","EMBU","EMBU WEST","63",188,218,406
"5367","EMBU","EMBU WEST","64",189,178,367
"5368","EMBU","EMBU WEST","60-64",1431,1404,2835
"5369","EMBU","EMBU WEST","65",270,300,570
"5370","EMBU","EMBU WEST","66",204,218,422
"5371","EMBU","EMBU WEST","67",351,305,656
"5372","EMBU","EMBU WEST","68",166,140,306
"5373","EMBU","EMBU WEST","69",207,203,410
"5374","EMBU","EMBU WEST","65-69",1198,1166,2364
"5375","EMBU","EMBU WEST","70",217,303,520
"5376","EMBU","EMBU WEST","71",163,179,342
"5377","EMBU","EMBU WEST","72",109,129,238
"5378","EMBU","EMBU WEST","73",119,130,249
"5379","EMBU","EMBU WEST","74",102,142,244
"5380","EMBU","EMBU WEST","70-74",710,883,1593
"5381","EMBU","EMBU WEST","75",95,160,255
"5382","EMBU","EMBU WEST","76",73,84,157
"5383","EMBU","EMBU WEST","77",81,110,191
"5384","EMBU","EMBU WEST","78",55,57,112
"5385","EMBU","EMBU WEST","79",71,106,177
"5386","EMBU","EMBU WEST","75-79",375,517,892
"5387","EMBU","EMBU WEST","80",65,194,259
"5388","EMBU","EMBU WEST","81",48,99,147
"5389","EMBU","EMBU WEST","82",42,36,78
"5390","EMBU","EMBU WEST","83",69,55,124
"5391","EMBU","EMBU WEST","84",52,66,118
"5392","EMBU","EMBU WEST","80-84",276,450,726
"5393","EMBU","EMBU WEST","85",64,61,125
"5394","EMBU","EMBU WEST","86",33,34,67
"5395","EMBU","EMBU WEST","87",27,58,85
"5396","EMBU","EMBU WEST","88",21,21,42
"5397","EMBU","EMBU WEST","89",28,89,117
"5398","EMBU","EMBU WEST","85-89",173,263,436
"5399","EMBU","EMBU WEST","90",18,78,96
"5400","EMBU","EMBU WEST","91",32,61,93
"5401","EMBU","EMBU WEST","92",10,18,28
"5402","EMBU","EMBU WEST","93",9,15,24
"5403","EMBU","EMBU WEST","94",7,18,25
"5404","EMBU","EMBU WEST","90-94",76,190,266
"5405","EMBU","EMBU WEST","95",12,28,40
"5406","EMBU","EMBU WEST","96",6,15,21
"5407","EMBU","EMBU WEST","97",9,17,26
"5408","EMBU","EMBU WEST","98",3,15,18
"5409","EMBU","EMBU WEST","99",9,23,32
"5410","EMBU","EMBU WEST","95-99",39,98,137
"5411","EMBU","EMBU WEST","100+",17,72,89
"5412","EMBU","EMBU WEST","Not Stated",NA,NA,NA
"5413","EMBU","MBEERE SOUTH","Total",83311,80159,163470
"5414","EMBU","MBEERE SOUTH","0",1583,1557,3140
"5415","EMBU","MBEERE SOUTH","1",1856,1825,3681
"5416","EMBU","MBEERE SOUTH","2",1720,1691,3411
"5417","EMBU","MBEERE SOUTH","3",1796,1768,3564
"5418","EMBU","MBEERE SOUTH","4",1783,1663,3446
"5419","EMBU","MBEERE SOUTH","0 - 4",8738,8504,17242
"5420","EMBU","MBEERE SOUTH","5",1754,1707,3461
"5421","EMBU","MBEERE SOUTH","6",1541,1658,3199
"5422","EMBU","MBEERE SOUTH","7",1729,1736,3465
"5423","EMBU","MBEERE SOUTH","8",1774,1777,3551
"5424","EMBU","MBEERE SOUTH","9",1987,1963,3950
"5425","EMBU","MBEERE SOUTH","5-9",8785,8841,17626
"5426","EMBU","MBEERE SOUTH","10",2002,1826,3828
"5427","EMBU","MBEERE SOUTH","11",1907,1952,3859
"5428","EMBU","MBEERE SOUTH","12",2154,1973,4127
"5429","EMBU","MBEERE SOUTH","13",2166,2105,4271
"5430","EMBU","MBEERE SOUTH","14",2165,2005,4170
"5431","EMBU","MBEERE SOUTH","10 -14",10394,9861,20255
"5432","EMBU","MBEERE SOUTH","15",2094,2027,4121
"5433","EMBU","MBEERE SOUTH","16",2100,1944,4044
"5434","EMBU","MBEERE SOUTH","17",2073,1861,3934
"5435","EMBU","MBEERE SOUTH","18",1615,1466,3081
"5436","EMBU","MBEERE SOUTH","19",1701,1443,3144
"5437","EMBU","MBEERE SOUTH","15-19",9583,8741,18324
"5438","EMBU","MBEERE SOUTH","20",1732,1530,3262
"5439","EMBU","MBEERE SOUTH","21",1434,1292,2726
"5440","EMBU","MBEERE SOUTH","22",1445,1328,2773
"5441","EMBU","MBEERE SOUTH","23",1503,1365,2868
"5442","EMBU","MBEERE SOUTH","24",1375,1155,2530
"5443","EMBU","MBEERE SOUTH","20-24",7489,6670,14159
"5444","EMBU","MBEERE SOUTH","25",1505,1216,2721
"5445","EMBU","MBEERE SOUTH","26",1149,1062,2211
"5446","EMBU","MBEERE SOUTH","27",1321,1083,2404
"5447","EMBU","MBEERE SOUTH","28",1168,1004,2172
"5448","EMBU","MBEERE SOUTH","29",1309,1266,2575
"5449","EMBU","MBEERE SOUTH","25-29",6452,5631,12083
"5450","EMBU","MBEERE SOUTH","30",1537,1336,2873
"5451","EMBU","MBEERE SOUTH","31",1117,1007,2124
"5452","EMBU","MBEERE SOUTH","32",1313,1268,2581
"5453","EMBU","MBEERE SOUTH","33",1251,1217,2468
"5454","EMBU","MBEERE SOUTH","34",975,976,1951
"5455","EMBU","MBEERE SOUTH","30-34",6193,5804,11997
"5456","EMBU","MBEERE SOUTH","35",1438,1232,2670
"5457","EMBU","MBEERE SOUTH","36",1041,1012,2053
"5458","EMBU","MBEERE SOUTH","37",1086,1004,2090
"5459","EMBU","MBEERE SOUTH","38",882,815,1697
"5460","EMBU","MBEERE SOUTH","39",1122,978,2100
"5461","EMBU","MBEERE SOUTH","35-39",5569,5041,10610
"5462","EMBU","MBEERE SOUTH","40",1236,1106,2342
"5463","EMBU","MBEERE SOUTH","41",1049,878,1927
"5464","EMBU","MBEERE SOUTH","42",907,849,1756
"5465","EMBU","MBEERE SOUTH","43",891,832,1723
"5466","EMBU","MBEERE SOUTH","44",756,660,1416
"5467","EMBU","MBEERE SOUTH","40-44",4839,4325,9164
"5468","EMBU","MBEERE SOUTH","45",1050,897,1947
"5469","EMBU","MBEERE SOUTH","46",787,728,1515
"5470","EMBU","MBEERE SOUTH","47",781,704,1485
"5471","EMBU","MBEERE SOUTH","48",613,603,1216
"5472","EMBU","MBEERE SOUTH","49",702,691,1393
"5473","EMBU","MBEERE SOUTH","45-49",3933,3623,7556
"5474","EMBU","MBEERE SOUTH","50",759,801,1560
"5475","EMBU","MBEERE SOUTH","51",634,661,1295
"5476","EMBU","MBEERE SOUTH","52",550,601,1151
"5477","EMBU","MBEERE SOUTH","53",401,506,907
"5478","EMBU","MBEERE SOUTH","54",501,495,996
"5479","EMBU","MBEERE SOUTH","50-54",2845,3064,5909
"5480","EMBU","MBEERE SOUTH","55",559,546,1105
"5481","EMBU","MBEERE SOUTH","56",625,611,1236
"5482","EMBU","MBEERE SOUTH","57",468,566,1034
"5483","EMBU","MBEERE SOUTH","58",339,369,708
"5484","EMBU","MBEERE SOUTH","59",447,463,910
"5485","EMBU","MBEERE SOUTH","55-59",2438,2555,4993
"5486","EMBU","MBEERE SOUTH","60",516,528,1044
"5487","EMBU","MBEERE SOUTH","61",401,412,813
"5488","EMBU","MBEERE SOUTH","62",333,359,692
"5489","EMBU","MBEERE SOUTH","63",309,300,609
"5490","EMBU","MBEERE SOUTH","64",238,285,523
"5491","EMBU","MBEERE SOUTH","60-64",1797,1884,3681
"5492","EMBU","MBEERE SOUTH","65",386,407,793
"5493","EMBU","MBEERE SOUTH","66",284,277,561
"5494","EMBU","MBEERE SOUTH","67",497,513,1010
"5495","EMBU","MBEERE SOUTH","68",184,243,427
"5496","EMBU","MBEERE SOUTH","69",266,353,619
"5497","EMBU","MBEERE SOUTH","65-69",1617,1793,3410
"5498","EMBU","MBEERE SOUTH","70",361,536,897
"5499","EMBU","MBEERE SOUTH","71",241,295,536
"5500","EMBU","MBEERE SOUTH","72",200,201,401
"5501","EMBU","MBEERE SOUTH","73",155,173,328
"5502","EMBU","MBEERE SOUTH","74",119,199,318
"5503","EMBU","MBEERE SOUTH","70-74",1076,1404,2480
"5504","EMBU","MBEERE SOUTH","75",142,203,345
"5505","EMBU","MBEERE SOUTH","76",109,105,214
"5506","EMBU","MBEERE SOUTH","77",115,145,260
"5507","EMBU","MBEERE SOUTH","78",82,93,175
"5508","EMBU","MBEERE SOUTH","79",113,188,301
"5509","EMBU","MBEERE SOUTH","75-79",561,734,1295
"5510","EMBU","MBEERE SOUTH","80",186,321,507
"5511","EMBU","MBEERE SOUTH","81",77,115,192
"5512","EMBU","MBEERE SOUTH","82",73,84,157
"5513","EMBU","MBEERE SOUTH","83",77,87,164
"5514","EMBU","MBEERE SOUTH","84",67,124,191
"5515","EMBU","MBEERE SOUTH","80-84",480,731,1211
"5516","EMBU","MBEERE SOUTH","85",61,124,185
"5517","EMBU","MBEERE SOUTH","86",40,49,89
"5518","EMBU","MBEERE SOUTH","87",58,66,124
"5519","EMBU","MBEERE SOUTH","88",32,48,80
"5520","EMBU","MBEERE SOUTH","89",63,142,205
"5521","EMBU","MBEERE SOUTH","85-89",254,429,683
"5522","EMBU","MBEERE SOUTH","90",48,112,160
"5523","EMBU","MBEERE SOUTH","91",41,63,104
"5524","EMBU","MBEERE SOUTH","92",30,21,51
"5525","EMBU","MBEERE SOUTH","93",8,40,48
"5526","EMBU","MBEERE SOUTH","94",14,28,42
"5527","EMBU","MBEERE SOUTH","90-94",141,264,405
"5528","EMBU","MBEERE SOUTH","95",29,68,97
"5529","EMBU","MBEERE SOUTH","96",12,17,29
"5530","EMBU","MBEERE SOUTH","97",19,20,39
"5531","EMBU","MBEERE SOUTH","98",10,16,26
"5532","EMBU","MBEERE SOUTH","99",20,40,60
"5533","EMBU","MBEERE SOUTH","95-99",90,161,251
"5534","EMBU","MBEERE SOUTH","100+",36,96,132
"5535","EMBU","MBEERE SOUTH","Not Stated",1,3,4
"5536","EMBU","MBEERE NORTH","Total",53517,55360,108877
"5537","EMBU","MBEERE NORTH","0",1162,1123,2285
"5538","EMBU","MBEERE NORTH","1",1305,1240,2545
"5539","EMBU","MBEERE NORTH","2",1195,1204,2399
"5540","EMBU","MBEERE NORTH","3",1309,1249,2558
"5541","EMBU","MBEERE NORTH","4",1197,1228,2425
"5542","EMBU","MBEERE NORTH","0 - 4",6168,6044,12212
"5543","EMBU","MBEERE NORTH","5",1191,1128,2319
"5544","EMBU","MBEERE NORTH","6",1247,1335,2582
"5545","EMBU","MBEERE NORTH","7",1224,1203,2427
"5546","EMBU","MBEERE NORTH","8",1273,1271,2544
"5547","EMBU","MBEERE NORTH","9",1345,1344,2689
"5548","EMBU","MBEERE NORTH","5-9",6280,6281,12561
"5549","EMBU","MBEERE NORTH","10",1390,1424,2814
"5550","EMBU","MBEERE NORTH","11",1422,1415,2837
"5551","EMBU","MBEERE NORTH","12",1532,1486,3018
"5552","EMBU","MBEERE NORTH","13",1544,1561,3105
"5553","EMBU","MBEERE NORTH","14",1388,1402,2790
"5554","EMBU","MBEERE NORTH","10 -14",7276,7288,14564
"5555","EMBU","MBEERE NORTH","15",1374,1291,2665
"5556","EMBU","MBEERE NORTH","16",1361,1411,2772
"5557","EMBU","MBEERE NORTH","17",1438,1237,2675
"5558","EMBU","MBEERE NORTH","18",1089,1026,2115
"5559","EMBU","MBEERE NORTH","19",1124,1043,2167
"5560","EMBU","MBEERE NORTH","15-19",6386,6008,12394
"5561","EMBU","MBEERE NORTH","20",1061,1012,2073
"5562","EMBU","MBEERE NORTH","21",849,880,1729
"5563","EMBU","MBEERE NORTH","22",799,874,1673
"5564","EMBU","MBEERE NORTH","23",815,956,1771
"5565","EMBU","MBEERE NORTH","24",781,758,1539
"5566","EMBU","MBEERE NORTH","20-24",4305,4480,8785
"5567","EMBU","MBEERE NORTH","25",876,858,1734
"5568","EMBU","MBEERE NORTH","26",726,718,1444
"5569","EMBU","MBEERE NORTH","27",784,783,1567
"5570","EMBU","MBEERE NORTH","28",702,712,1414
"5571","EMBU","MBEERE NORTH","29",814,744,1558
"5572","EMBU","MBEERE NORTH","25-29",3902,3815,7717
"5573","EMBU","MBEERE NORTH","30",916,985,1901
"5574","EMBU","MBEERE NORTH","31",697,639,1336
"5575","EMBU","MBEERE NORTH","32",793,876,1669
"5576","EMBU","MBEERE NORTH","33",758,800,1558
"5577","EMBU","MBEERE NORTH","34",573,647,1220
"5578","EMBU","MBEERE NORTH","30-34",3737,3947,7684
"5579","EMBU","MBEERE NORTH","35",896,878,1774
"5580","EMBU","MBEERE NORTH","36",593,629,1222
"5581","EMBU","MBEERE NORTH","37",712,627,1339
"5582","EMBU","MBEERE NORTH","38",514,566,1080
"5583","EMBU","MBEERE NORTH","39",591,637,1228
"5584","EMBU","MBEERE NORTH","35-39",3306,3337,6643
"5585","EMBU","MBEERE NORTH","40",719,664,1383
"5586","EMBU","MBEERE NORTH","41",640,573,1213
"5587","EMBU","MBEERE NORTH","42",537,520,1057
"5588","EMBU","MBEERE NORTH","43",491,557,1048
"5589","EMBU","MBEERE NORTH","44",459,518,977
"5590","EMBU","MBEERE NORTH","40-44",2846,2832,5678
"5591","EMBU","MBEERE NORTH","45",617,636,1253
"5592","EMBU","MBEERE NORTH","46",464,493,957
"5593","EMBU","MBEERE NORTH","47",447,451,898
"5594","EMBU","MBEERE NORTH","48",344,334,678
"5595","EMBU","MBEERE NORTH","49",392,398,790
"5596","EMBU","MBEERE NORTH","45-49",2264,2312,4576
"5597","EMBU","MBEERE NORTH","50",410,505,915
"5598","EMBU","MBEERE NORTH","51",336,371,707
"5599","EMBU","MBEERE NORTH","52",318,353,671
"5600","EMBU","MBEERE NORTH","53",275,352,627
"5601","EMBU","MBEERE NORTH","54",304,319,623
"5602","EMBU","MBEERE NORTH","50-54",1643,1900,3543
"5603","EMBU","MBEERE NORTH","55",358,383,741
"5604","EMBU","MBEERE NORTH","56",410,436,846
"5605","EMBU","MBEERE NORTH","57",282,382,664
"5606","EMBU","MBEERE NORTH","58",232,289,521
"5607","EMBU","MBEERE NORTH","59",248,337,585
"5608","EMBU","MBEERE NORTH","55-59",1530,1827,3357
"5609","EMBU","MBEERE NORTH","60",321,355,676
"5610","EMBU","MBEERE NORTH","61",268,288,556
"5611","EMBU","MBEERE NORTH","62",199,214,413
"5612","EMBU","MBEERE NORTH","63",181,281,462
"5613","EMBU","MBEERE NORTH","64",156,195,351
"5614","EMBU","MBEERE NORTH","60-64",1125,1333,2458
"5615","EMBU","MBEERE NORTH","65",281,358,639
"5616","EMBU","MBEERE NORTH","66",183,156,339
"5617","EMBU","MBEERE NORTH","67",288,276,564
"5618","EMBU","MBEERE NORTH","68",112,123,235
"5619","EMBU","MBEERE NORTH","69",164,255,419
"5620","EMBU","MBEERE NORTH","65-69",1028,1168,2196
"5621","EMBU","MBEERE NORTH","70",207,391,598
"5622","EMBU","MBEERE NORTH","71",157,198,355
"5623","EMBU","MBEERE NORTH","72",112,166,278
"5624","EMBU","MBEERE NORTH","73",105,129,234
"5625","EMBU","MBEERE NORTH","74",110,178,288
"5626","EMBU","MBEERE NORTH","70-74",691,1062,1753
"5627","EMBU","MBEERE NORTH","75",98,159,257
"5628","EMBU","MBEERE NORTH","76",61,72,133
"5629","EMBU","MBEERE NORTH","77",70,98,168
"5630","EMBU","MBEERE NORTH","78",75,60,135
"5631","EMBU","MBEERE NORTH","79",68,178,246
"5632","EMBU","MBEERE NORTH","75-79",372,567,939
"5633","EMBU","MBEERE NORTH","80",111,188,299
"5634","EMBU","MBEERE NORTH","81",48,130,178
"5635","EMBU","MBEERE NORTH","82",53,53,106
"5636","EMBU","MBEERE NORTH","83",38,60,98
"5637","EMBU","MBEERE NORTH","84",61,89,150
"5638","EMBU","MBEERE NORTH","80-84",311,520,831
"5639","EMBU","MBEERE NORTH","85",46,53,99
"5640","EMBU","MBEERE NORTH","86",23,28,51
"5641","EMBU","MBEERE NORTH","87",42,47,89
"5642","EMBU","MBEERE NORTH","88",15,28,43
"5643","EMBU","MBEERE NORTH","89",64,137,201
"5644","EMBU","MBEERE NORTH","85-89",190,293,483
"5645","EMBU","MBEERE NORTH","90",28,84,112
"5646","EMBU","MBEERE NORTH","91",13,36,49
"5647","EMBU","MBEERE NORTH","92",10,11,21
"5648","EMBU","MBEERE NORTH","93",5,27,32
"5649","EMBU","MBEERE NORTH","94",14,28,42
"5650","EMBU","MBEERE NORTH","90-94",70,186,256
"5651","EMBU","MBEERE NORTH","95",25,28,53
"5652","EMBU","MBEERE NORTH","96",6,20,26
"5653","EMBU","MBEERE NORTH","97",11,7,18
"5654","EMBU","MBEERE NORTH","98",6,8,14
"5655","EMBU","MBEERE NORTH","99",15,45,60
"5656","EMBU","MBEERE NORTH","95-99",63,108,171
"5657","EMBU","MBEERE NORTH","100+",22,52,74
"5658","EMBU","MBEERE NORTH","Not Stated",2,NA,2
"5659","EMBU","MT. KENYA FOREST","Total",19,3,22
"5660","EMBU","MT. KENYA FOREST","0",NA,NA,NA
"5661","EMBU","MT. KENYA FOREST","1",NA,NA,NA
"5662","EMBU","MT. KENYA FOREST","2",1,NA,1
"5663","EMBU","MT. KENYA FOREST","3",NA,NA,NA
"5664","EMBU","MT. KENYA FOREST","4",NA,NA,NA
"5665","EMBU","MT. KENYA FOREST","0 - 4",1,NA,1
"5666","EMBU","MT. KENYA FOREST","5",NA,NA,NA
"5667","EMBU","MT. KENYA FOREST","6",NA,NA,NA
"5668","EMBU","MT. KENYA FOREST","7",NA,NA,NA
"5669","EMBU","MT. KENYA FOREST","8",NA,NA,NA
"5670","EMBU","MT. KENYA FOREST","9",NA,NA,NA
"5671","EMBU","MT. KENYA FOREST","5-9",NA,NA,NA
"5672","EMBU","MT. KENYA FOREST","10",NA,NA,NA
"5673","EMBU","MT. KENYA FOREST","11",NA,NA,NA
"5674","EMBU","MT. KENYA FOREST","12",NA,NA,NA
"5675","EMBU","MT. KENYA FOREST","13",NA,NA,NA
"5676","EMBU","MT. KENYA FOREST","14",NA,NA,NA
"5677","EMBU","MT. KENYA FOREST","10 -14",NA,NA,NA
"5678","EMBU","MT. KENYA FOREST","15",NA,NA,NA
"5679","EMBU","MT. KENYA FOREST","16",NA,NA,NA
"5680","EMBU","MT. KENYA FOREST","17",NA,NA,NA
"5681","EMBU","MT. KENYA FOREST","18",NA,NA,NA
"5682","EMBU","MT. KENYA FOREST","19",NA,NA,NA
"5683","EMBU","MT. KENYA FOREST","15-19",NA,NA,NA
"5684","EMBU","MT. KENYA FOREST","20",NA,NA,NA
"5685","EMBU","MT. KENYA FOREST","21",NA,NA,NA
"5686","EMBU","MT. KENYA FOREST","22",NA,NA,NA
"5687","EMBU","MT. KENYA FOREST","23",NA,NA,NA
"5688","EMBU","MT. KENYA FOREST","24",NA,NA,NA
"5689","EMBU","MT. KENYA FOREST","20-24",NA,NA,NA
"5690","EMBU","MT. KENYA FOREST","25",NA,1,1
"5691","EMBU","MT. KENYA FOREST","26",NA,1,1
"5692","EMBU","MT. KENYA FOREST","27",3,NA,3
"5693","EMBU","MT. KENYA FOREST","28",2,NA,2
"5694","EMBU","MT. KENYA FOREST","29",1,NA,1
"5695","EMBU","MT. KENYA FOREST","25-29",6,2,8
"5696","EMBU","MT. KENYA FOREST","30",NA,NA,NA
"5697","EMBU","MT. KENYA FOREST","31",1,NA,1
"5698","EMBU","MT. KENYA FOREST","32",NA,1,1
"5699","EMBU","MT. KENYA FOREST","33",NA,NA,NA
"5700","EMBU","MT. KENYA FOREST","34",NA,NA,NA
"5701","EMBU","MT. KENYA FOREST","30-34",1,1,2
"5702","EMBU","MT. KENYA FOREST","35",1,NA,1
"5703","EMBU","MT. KENYA FOREST","36",NA,NA,NA
"5704","EMBU","MT. KENYA FOREST","37",2,NA,2
"5705","EMBU","MT. KENYA FOREST","38",1,NA,1
"5706","EMBU","MT. KENYA FOREST","39",1,NA,1
"5707","EMBU","MT. KENYA FOREST","35-39",5,NA,5
"5708","EMBU","MT. KENYA FOREST","40",1,NA,1
"5709","EMBU","MT. KENYA FOREST","41",NA,NA,NA
"5710","EMBU","MT. KENYA FOREST","42",NA,NA,NA
"5711","EMBU","MT. KENYA FOREST","43",1,NA,1
"5712","EMBU","MT. KENYA FOREST","44",NA,NA,NA
"5713","EMBU","MT. KENYA FOREST","40-44",2,NA,2
"5714","EMBU","MT. KENYA FOREST","45",NA,NA,NA
"5715","EMBU","MT. KENYA FOREST","46",NA,NA,NA
"5716","EMBU","MT. KENYA FOREST","47",NA,NA,NA
"5717","EMBU","MT. KENYA FOREST","48",1,NA,1
"5718","EMBU","MT. KENYA FOREST","49",1,NA,1
"5719","EMBU","MT. KENYA FOREST","45-49",2,NA,2
"5720","EMBU","MT. KENYA FOREST","50",NA,NA,NA
"5721","EMBU","MT. KENYA FOREST","51",NA,NA,NA
"5722","EMBU","MT. KENYA FOREST","52",NA,NA,NA
"5723","EMBU","MT. KENYA FOREST","53",NA,NA,NA
"5724","EMBU","MT. KENYA FOREST","54",NA,NA,NA
"5725","EMBU","MT. KENYA FOREST","50-54",NA,NA,NA
"5726","EMBU","MT. KENYA FOREST","55",NA,NA,NA
"5727","EMBU","MT. KENYA FOREST","56",1,NA,1
"5728","EMBU","MT. KENYA FOREST","57",NA,NA,NA
"5729","EMBU","MT. KENYA FOREST","58",1,NA,1
"5730","EMBU","MT. KENYA FOREST","59",NA,NA,NA
"5731","EMBU","MT. KENYA FOREST","55-59",2,NA,2
"5732","EMBU","MT. KENYA FOREST","60",NA,NA,NA
"5733","EMBU","MT. KENYA FOREST","61",NA,NA,NA
"5734","EMBU","MT. KENYA FOREST","62",NA,NA,NA
"5735","EMBU","MT. KENYA FOREST","63",NA,NA,NA
"5736","EMBU","MT. KENYA FOREST","64",NA,NA,NA
"5737","EMBU","MT. KENYA FOREST","60-64",NA,NA,NA
"5738","EMBU","MT. KENYA FOREST","65",NA,NA,NA
"5739","EMBU","MT. KENYA FOREST","66",NA,NA,NA
"5740","EMBU","MT. KENYA FOREST","67",NA,NA,NA
"5741","EMBU","MT. KENYA FOREST","68",NA,NA,NA
"5742","EMBU","MT. KENYA FOREST","69",NA,NA,NA
"5743","EMBU","MT. KENYA FOREST","65-69",NA,NA,NA
"5744","EMBU","MT. KENYA FOREST","70",NA,NA,NA
"5745","EMBU","MT. KENYA FOREST","71",NA,NA,NA
"5746","EMBU","MT. KENYA FOREST","72",NA,NA,NA
"5747","EMBU","MT. KENYA FOREST","73",NA,NA,NA
"5748","EMBU","MT. KENYA FOREST","74",NA,NA,NA
"5749","EMBU","MT. KENYA FOREST","70-74",NA,NA,NA
"5750","EMBU","MT. KENYA FOREST","75",NA,NA,NA
"5751","EMBU","MT. KENYA FOREST","76",NA,NA,NA
"5752","EMBU","MT. KENYA FOREST","77",NA,NA,NA
"5753","EMBU","MT. KENYA FOREST","78",NA,NA,NA
"5754","EMBU","MT. KENYA FOREST","79",NA,NA,NA
"5755","EMBU","MT. KENYA FOREST","75-79",NA,NA,NA
"5756","EMBU","MT. KENYA FOREST","80",NA,NA,NA
"5757","EMBU","MT. KENYA FOREST","81",NA,NA,NA
"5758","EMBU","MT. KENYA FOREST","82",NA,NA,NA
"5759","EMBU","MT. KENYA FOREST","83",NA,NA,NA
"5760","EMBU","MT. KENYA FOREST","84",NA,NA,NA
"5761","EMBU","MT. KENYA FOREST","80-84",NA,NA,NA
"5762","EMBU","MT. KENYA FOREST","85",NA,NA,NA
"5763","EMBU","MT. KENYA FOREST","86",NA,NA,NA
"5764","EMBU","MT. KENYA FOREST","87",NA,NA,NA
"5765","EMBU","MT. KENYA FOREST","88",NA,NA,NA
"5766","EMBU","MT. KENYA FOREST","89",NA,NA,NA
"5767","EMBU","MT. KENYA FOREST","85-89",NA,NA,NA
"5768","EMBU","MT. KENYA FOREST","90",NA,NA,NA
"5769","EMBU","MT. KENYA FOREST","91",NA,NA,NA
"5770","EMBU","MT. KENYA FOREST","92",NA,NA,NA
"5771","EMBU","MT. KENYA FOREST","93",NA,NA,NA
"5772","EMBU","MT. KENYA FOREST","94",NA,NA,NA
"5773","EMBU","MT. KENYA FOREST","90-94",NA,NA,NA
"5774","EMBU","MT. KENYA FOREST","95",NA,NA,NA
"5775","EMBU","MT. KENYA FOREST","96",NA,NA,NA
"5776","EMBU","MT. KENYA FOREST","97",NA,NA,NA
"5777","EMBU","MT. KENYA FOREST","98",NA,NA,NA
"5778","EMBU","MT. KENYA FOREST","99",NA,NA,NA
"5779","EMBU","MT. KENYA FOREST","95-99",NA,NA,NA
"5780","EMBU","MT. KENYA FOREST","100+",NA,NA,NA
"5781","EMBU","MT. KENYA FOREST","Not Stated",NA,NA,NA
"5782","GARISSA","ALL","Total",458975,382344,841319
"5783","GARISSA","ALL","0",6185,6242,12427
"5784","GARISSA","ALL","1",8506,8323,16829
"5785","GARISSA","ALL","2",14351,13897,28248
"5786","GARISSA","ALL","3",12780,12173,24953
"5787","GARISSA","ALL","4",15204,13955,29159
"5788","GARISSA","ALL","0 - 4",57026,54590,111616
"5789","GARISSA","ALL","5",14020,12877,26897
"5790","GARISSA","ALL","6",15676,14411,30087
"5791","GARISSA","ALL","7",11774,10584,22358
"5792","GARISSA","ALL","8",17657,15572,33229
"5793","GARISSA","ALL","9",11900,10745,22645
"5794","GARISSA","ALL","5-9",71027,64189,135216
"5795","GARISSA","ALL","10",22359,18002,40361
"5796","GARISSA","ALL","11",10025,9570,19595
"5797","GARISSA","ALL","12",18139,11715,29854
"5798","GARISSA","ALL","13",12830,8902,21732
"5799","GARISSA","ALL","14",15381,9740,25121
"5800","GARISSA","ALL","10 -14",78734,57929,136663
"5801","GARISSA","ALL","15",18683,11661,30344
"5802","GARISSA","ALL","16",14577,9264,23841
"5803","GARISSA","ALL","17",13681,9001,22682
"5804","GARISSA","ALL","18",14795,10404,25199
"5805","GARISSA","ALL","19",8839,7190,16029
"5806","GARISSA","ALL","15-19",70575,47520,118095
"5807","GARISSA","ALL","20",18115,14578,32693
"5808","GARISSA","ALL","21",6924,5785,12709
"5809","GARISSA","ALL","22",8090,7193,15283
"5810","GARISSA","ALL","23",6991,5982,12973
"5811","GARISSA","ALL","24",6051,5364,11415
"5812","GARISSA","ALL","20-24",46171,38902,85073
"5813","GARISSA","ALL","25",11781,10875,22656
"5814","GARISSA","ALL","26",5408,4836,10244
"5815","GARISSA","ALL","27",4740,4174,8914
"5816","GARISSA","ALL","28",6293,6280,12573
"5817","GARISSA","ALL","29",4554,4327,8881
"5818","GARISSA","ALL","25-29",32776,30492,63268
"5819","GARISSA","ALL","30",13086,12429,25515
"5820","GARISSA","ALL","31",3183,3138,6321
"5821","GARISSA","ALL","32",4630,4589,9219
"5822","GARISSA","ALL","33",3044,2997,6041
"5823","GARISSA","ALL","34",2735,2678,5413
"5824","GARISSA","ALL","30-34",26678,25831,52509
"5825","GARISSA","ALL","35",7043,7163,14206
"5826","GARISSA","ALL","36",2888,3062,5950
"5827","GARISSA","ALL","37",2342,2488,4830
"5828","GARISSA","ALL","38",3412,3574,6986
"5829","GARISSA","ALL","39",2367,2343,4710
"5830","GARISSA","ALL","35-39",18052,18630,36682
"5831","GARISSA","ALL","40",9731,7476,17207
"5832","GARISSA","ALL","41",2222,2261,4483
"5833","GARISSA","ALL","42",2639,2164,4803
"5834","GARISSA","ALL","43",1990,1837,3827
"5835","GARISSA","ALL","44",1143,910,2053
"5836","GARISSA","ALL","40-44",17725,14648,32373
"5837","GARISSA","ALL","45",5187,3904,9091
"5838","GARISSA","ALL","46",1400,1141,2541
"5839","GARISSA","ALL","47",1329,1041,2370
"5840","GARISSA","ALL","48",1668,1292,2960
"5841","GARISSA","ALL","49",1241,1079,2320
"5842","GARISSA","ALL","45-49",10825,8457,19282
"5843","GARISSA","ALL","50",5838,3934,9772
"5844","GARISSA","ALL","51",903,668,1571
"5845","GARISSA","ALL","52",1619,1156,2775
"5846","GARISSA","ALL","53",810,572,1382
"5847","GARISSA","ALL","54",1110,782,1892
"5848","GARISSA","ALL","50-54",10280,7112,17392
"5849","GARISSA","ALL","55",1591,1142,2733
"5850","GARISSA","ALL","56",1036,789,1825
"5851","GARISSA","ALL","57",765,617,1382
"5852","GARISSA","ALL","58",988,718,1706
"5853","GARISSA","ALL","59",959,738,1697
"5854","GARISSA","ALL","55-59",5339,4004,9343
"5855","GARISSA","ALL","60",3210,2266,5476
"5856","GARISSA","ALL","61",670,440,1110
"5857","GARISSA","ALL","62",691,391,1082
"5858","GARISSA","ALL","63",619,410,1029
"5859","GARISSA","ALL","64",443,280,723
"5860","GARISSA","ALL","60-64",5633,3787,9420
"5861","GARISSA","ALL","65",1041,767,1808
"5862","GARISSA","ALL","66",393,294,687
"5863","GARISSA","ALL","67",378,314,692
"5864","GARISSA","ALL","68",463,277,740
"5865","GARISSA","ALL","69",505,365,870
"5866","GARISSA","ALL","65-69",2780,2017,4797
"5867","GARISSA","ALL","70",1598,1175,2773
"5868","GARISSA","ALL","71",290,334,624
"5869","GARISSA","ALL","72",290,181,471
"5870","GARISSA","ALL","73",232,123,355
"5871","GARISSA","ALL","74",225,151,376
"5872","GARISSA","ALL","70-74",2635,1964,4599
"5873","GARISSA","ALL","75",358,261,619
"5874","GARISSA","ALL","76",170,100,270
"5875","GARISSA","ALL","77",113,86,199
"5876","GARISSA","ALL","78",189,113,302
"5877","GARISSA","ALL","79",203,115,318
"5878","GARISSA","ALL","75-79",1033,675,1708
"5879","GARISSA","ALL","80",654,606,1260
"5880","GARISSA","ALL","81",114,156,270
"5881","GARISSA","ALL","82",87,76,163
"5882","GARISSA","ALL","83",69,47,116
"5883","GARISSA","ALL","84",105,66,171
"5884","GARISSA","ALL","80-84",1029,951,1980
"5885","GARISSA","ALL","85",119,99,218
"5886","GARISSA","ALL","86",55,39,94
"5887","GARISSA","ALL","87",50,47,97
"5888","GARISSA","ALL","88",31,35,66
"5889","GARISSA","ALL","89",65,44,109
"5890","GARISSA","ALL","85-89",320,264,584
"5891","GARISSA","ALL","90",154,188,342
"5892","GARISSA","ALL","91",23,37,60
"5893","GARISSA","ALL","92",15,12,27
"5894","GARISSA","ALL","93",13,6,19
"5895","GARISSA","ALL","94",9,13,22
"5896","GARISSA","ALL","90-94",214,256,470
"5897","GARISSA","ALL","95",30,30,60
"5898","GARISSA","ALL","96",14,19,33
"5899","GARISSA","ALL","97",4,2,6
"5900","GARISSA","ALL","98",16,9,25
"5901","GARISSA","ALL","99",18,12,30
"5902","GARISSA","ALL","95-99",82,72,154
"5903","GARISSA","ALL","100+",37,53,90
"5904","GARISSA","ALL","Not Stated",4,1,5
"5905","GARISSA","BALAMBALA","Total",20277,11979,32256
"5906","GARISSA","BALAMBALA","0",52,47,99
"5907","GARISSA","BALAMBALA","1",144,141,285
"5908","GARISSA","BALAMBALA","2",306,244,550
"5909","GARISSA","BALAMBALA","3",272,243,515
"5910","GARISSA","BALAMBALA","4",429,289,718
"5911","GARISSA","BALAMBALA","0 - 4",1203,964,2167
"5912","GARISSA","BALAMBALA","5",377,282,659
"5913","GARISSA","BALAMBALA","6",514,400,914
"5914","GARISSA","BALAMBALA","7",366,287,653
"5915","GARISSA","BALAMBALA","8",634,480,1114
"5916","GARISSA","BALAMBALA","9",408,364,772
"5917","GARISSA","BALAMBALA","5-9",2299,1813,4112
"5918","GARISSA","BALAMBALA","10",979,581,1560
"5919","GARISSA","BALAMBALA","11",410,392,802
"5920","GARISSA","BALAMBALA","12",800,396,1196
"5921","GARISSA","BALAMBALA","13",552,269,821
"5922","GARISSA","BALAMBALA","14",782,340,1122
"5923","GARISSA","BALAMBALA","10 -14",3523,1978,5501
"5924","GARISSA","BALAMBALA","15",795,328,1123
"5925","GARISSA","BALAMBALA","16",821,314,1135
"5926","GARISSA","BALAMBALA","17",536,231,767
"5927","GARISSA","BALAMBALA","18",989,430,1419
"5928","GARISSA","BALAMBALA","19",450,217,667
"5929","GARISSA","BALAMBALA","15-19",3591,1520,5111
"5930","GARISSA","BALAMBALA","20",1139,444,1583
"5931","GARISSA","BALAMBALA","21",484,162,646
"5932","GARISSA","BALAMBALA","22",585,240,825
"5933","GARISSA","BALAMBALA","23",484,206,690
"5934","GARISSA","BALAMBALA","24",467,178,645
"5935","GARISSA","BALAMBALA","20-24",3159,1230,4389
"5936","GARISSA","BALAMBALA","25",646,271,917
"5937","GARISSA","BALAMBALA","26",340,169,509
"5938","GARISSA","BALAMBALA","27",329,117,446
"5939","GARISSA","BALAMBALA","28",438,201,639
"5940","GARISSA","BALAMBALA","29",224,146,370
"5941","GARISSA","BALAMBALA","25-29",1977,904,2881
"5942","GARISSA","BALAMBALA","30",516,338,854
"5943","GARISSA","BALAMBALA","31",126,80,206
"5944","GARISSA","BALAMBALA","32",163,136,299
"5945","GARISSA","BALAMBALA","33",115,89,204
"5946","GARISSA","BALAMBALA","34",117,91,208
"5947","GARISSA","BALAMBALA","30-34",1037,734,1771
"5948","GARISSA","BALAMBALA","35",243,256,499
"5949","GARISSA","BALAMBALA","36",105,125,230
"5950","GARISSA","BALAMBALA","37",88,85,173
"5951","GARISSA","BALAMBALA","38",134,192,326
"5952","GARISSA","BALAMBALA","39",114,120,234
"5953","GARISSA","BALAMBALA","35-39",684,778,1462
"5954","GARISSA","BALAMBALA","40",401,411,812
"5955","GARISSA","BALAMBALA","41",63,68,131
"5956","GARISSA","BALAMBALA","42",153,118,271
"5957","GARISSA","BALAMBALA","43",67,83,150
"5958","GARISSA","BALAMBALA","44",57,42,99
"5959","GARISSA","BALAMBALA","40-44",741,722,1463
"5960","GARISSA","BALAMBALA","45",236,244,480
"5961","GARISSA","BALAMBALA","46",60,67,127
"5962","GARISSA","BALAMBALA","47",73,55,128
"5963","GARISSA","BALAMBALA","48",120,86,206
"5964","GARISSA","BALAMBALA","49",61,66,127
"5965","GARISSA","BALAMBALA","45-49",550,518,1068
"5966","GARISSA","BALAMBALA","50",361,209,570
"5967","GARISSA","BALAMBALA","51",32,21,53
"5968","GARISSA","BALAMBALA","52",87,45,132
"5969","GARISSA","BALAMBALA","53",32,26,58
"5970","GARISSA","BALAMBALA","54",66,33,99
"5971","GARISSA","BALAMBALA","50-54",578,334,912
"5972","GARISSA","BALAMBALA","55",72,72,144
"5973","GARISSA","BALAMBALA","56",39,21,60
"5974","GARISSA","BALAMBALA","57",54,18,72
"5975","GARISSA","BALAMBALA","58",52,38,90
"5976","GARISSA","BALAMBALA","59",34,26,60
"5977","GARISSA","BALAMBALA","55-59",251,175,426
"5978","GARISSA","BALAMBALA","60",199,103,302
"5979","GARISSA","BALAMBALA","61",22,8,30
"5980","GARISSA","BALAMBALA","62",29,14,43
"5981","GARISSA","BALAMBALA","63",22,9,31
"5982","GARISSA","BALAMBALA","64",18,13,31
"5983","GARISSA","BALAMBALA","60-64",290,147,437
"5984","GARISSA","BALAMBALA","65",64,30,94
"5985","GARISSA","BALAMBALA","66",29,9,38
"5986","GARISSA","BALAMBALA","67",19,9,28
"5987","GARISSA","BALAMBALA","68",23,13,36
"5988","GARISSA","BALAMBALA","69",27,11,38
"5989","GARISSA","BALAMBALA","65-69",162,72,234
"5990","GARISSA","BALAMBALA","70",100,23,123
"5991","GARISSA","BALAMBALA","71",11,4,15
"5992","GARISSA","BALAMBALA","72",16,6,22
"5993","GARISSA","BALAMBALA","73",6,3,9
"5994","GARISSA","BALAMBALA","74",5,3,8
"5995","GARISSA","BALAMBALA","70-74",138,39,177
"5996","GARISSA","BALAMBALA","75",14,3,17
"5997","GARISSA","BALAMBALA","76",8,3,11
"5998","GARISSA","BALAMBALA","77",8,3,11
"5999","GARISSA","BALAMBALA","78",10,8,18
"6000","GARISSA","BALAMBALA","79",8,1,9
"6001","GARISSA","BALAMBALA","75-79",48,18,66
"6002","GARISSA","BALAMBALA","80",30,20,50
"6003","GARISSA","BALAMBALA","81",1,2,3
"6004","GARISSA","BALAMBALA","82",2,5,7
"6005","GARISSA","BALAMBALA","83",NA,NA,NA
"6006","GARISSA","BALAMBALA","84",4,NA,4
"6007","GARISSA","BALAMBALA","80-84",37,27,64
"6008","GARISSA","BALAMBALA","85",NA,3,3
"6009","GARISSA","BALAMBALA","86",NA,1,1
"6010","GARISSA","BALAMBALA","87",NA,1,1
"6011","GARISSA","BALAMBALA","88",2,NA,2
"6012","GARISSA","BALAMBALA","89",NA,NA,NA
"6013","GARISSA","BALAMBALA","85-89",2,5,7
"6014","GARISSA","BALAMBALA","90",6,1,7
"6015","GARISSA","BALAMBALA","91",NA,NA,NA
"6016","GARISSA","BALAMBALA","92",NA,NA,NA
"6017","GARISSA","BALAMBALA","93",NA,NA,NA
"6018","GARISSA","BALAMBALA","94",NA,NA,NA
"6019","GARISSA","BALAMBALA","90-94",6,1,7
"6020","GARISSA","BALAMBALA","95",NA,NA,NA
"6021","GARISSA","BALAMBALA","96",NA,NA,NA
"6022","GARISSA","BALAMBALA","97",NA,NA,NA
"6023","GARISSA","BALAMBALA","98",NA,NA,NA
"6024","GARISSA","BALAMBALA","99",NA,NA,NA
"6025","GARISSA","BALAMBALA","95-99",NA,NA,NA
"6026","GARISSA","BALAMBALA","100+",1,NA,1
"6027","GARISSA","BALAMBALA","Not Stated",NA,NA,NA
"6028","GARISSA","DADAAB","Total",99059,86185,185244
"6029","GARISSA","DADAAB","0",1212,1112,2324
"6030","GARISSA","DADAAB","1",1813,1659,3472
"6031","GARISSA","DADAAB","2",3112,2983,6095
"6032","GARISSA","DADAAB","3",2673,2555,5228
"6033","GARISSA","DADAAB","4",3258,2989,6247
"6034","GARISSA","DADAAB","0 - 4",12068,11298,23366
"6035","GARISSA","DADAAB","5",2809,2610,5419
"6036","GARISSA","DADAAB","6",3181,3079,6260
"6037","GARISSA","DADAAB","7",2260,2223,4483
"6038","GARISSA","DADAAB","8",3385,3228,6613
"6039","GARISSA","DADAAB","9",2281,2168,4449
"6040","GARISSA","DADAAB","5-9",13916,13308,27224
"6041","GARISSA","DADAAB","10",4404,3673,8077
"6042","GARISSA","DADAAB","11",1962,2044,4006
"6043","GARISSA","DADAAB","12",3577,2579,6156
"6044","GARISSA","DADAAB","13",2388,1841,4229
"6045","GARISSA","DADAAB","14",2981,2044,5025
"6046","GARISSA","DADAAB","10 -14",15312,12181,27493
"6047","GARISSA","DADAAB","15",3603,2406,6009
"6048","GARISSA","DADAAB","16",2884,2055,4939
"6049","GARISSA","DADAAB","17",2274,1666,3940
"6050","GARISSA","DADAAB","18",3185,2451,5636
"6051","GARISSA","DADAAB","19",2111,1852,3963
"6052","GARISSA","DADAAB","15-19",14057,10430,24487
"6053","GARISSA","DADAAB","20",4303,3825,8128
"6054","GARISSA","DADAAB","21",1658,1374,3032
"6055","GARISSA","DADAAB","22",1823,1747,3570
"6056","GARISSA","DADAAB","23",1701,1395,3096
"6057","GARISSA","DADAAB","24",1343,1374,2717
"6058","GARISSA","DADAAB","20-24",10828,9715,20543
"6059","GARISSA","DADAAB","25",2625,2692,5317
"6060","GARISSA","DADAAB","26",1191,1143,2334
"6061","GARISSA","DADAAB","27",1068,929,1997
"6062","GARISSA","DADAAB","28",1478,1541,3019
"6063","GARISSA","DADAAB","29",1176,1107,2283
"6064","GARISSA","DADAAB","25-29",7538,7412,14950
"6065","GARISSA","DADAAB","30",3298,3021,6319
"6066","GARISSA","DADAAB","31",742,663,1405
"6067","GARISSA","DADAAB","32",1114,1068,2182
"6068","GARISSA","DADAAB","33",758,736,1494
"6069","GARISSA","DADAAB","34",604,674,1278
"6070","GARISSA","DADAAB","30-34",6516,6162,12678
"6071","GARISSA","DADAAB","35",1829,2034,3863
"6072","GARISSA","DADAAB","36",709,783,1492
"6073","GARISSA","DADAAB","37",511,568,1079
"6074","GARISSA","DADAAB","38",857,961,1818
"6075","GARISSA","DADAAB","39",566,616,1182
"6076","GARISSA","DADAAB","35-39",4472,4962,9434
"6077","GARISSA","DADAAB","40",2578,2023,4601
"6078","GARISSA","DADAAB","41",497,472,969
"6079","GARISSA","DADAAB","42",665,543,1208
"6080","GARISSA","DADAAB","43",468,375,843
"6081","GARISSA","DADAAB","44",262,279,541
"6082","GARISSA","DADAAB","40-44",4470,3692,8162
"6083","GARISSA","DADAAB","45",1372,947,2319
"6084","GARISSA","DADAAB","46",347,277,624
"6085","GARISSA","DADAAB","47",325,261,586
"6086","GARISSA","DADAAB","48",427,340,767
"6087","GARISSA","DADAAB","49",335,339,674
"6088","GARISSA","DADAAB","45-49",2806,2164,4970
"6089","GARISSA","DADAAB","50",1463,952,2415
"6090","GARISSA","DADAAB","51",212,166,378
"6091","GARISSA","DADAAB","52",406,283,689
"6092","GARISSA","DADAAB","53",223,128,351
"6093","GARISSA","DADAAB","54",253,188,441
"6094","GARISSA","DADAAB","50-54",2557,1717,4274
"6095","GARISSA","DADAAB","55",358,264,622
"6096","GARISSA","DADAAB","56",259,189,448
"6097","GARISSA","DADAAB","57",167,113,280
"6098","GARISSA","DADAAB","58",232,138,370
"6099","GARISSA","DADAAB","59",193,157,350
"6100","GARISSA","DADAAB","55-59",1209,861,2070
"6101","GARISSA","DADAAB","60",775,514,1289
"6102","GARISSA","DADAAB","61",117,88,205
"6103","GARISSA","DADAAB","62",180,107,287
"6104","GARISSA","DADAAB","63",136,97,233
"6105","GARISSA","DADAAB","64",108,85,193
"6106","GARISSA","DADAAB","60-64",1316,891,2207
"6107","GARISSA","DADAAB","65",251,153,404
"6108","GARISSA","DADAAB","66",81,49,130
"6109","GARISSA","DADAAB","67",86,52,138
"6110","GARISSA","DADAAB","68",102,61,163
"6111","GARISSA","DADAAB","69",99,77,176
"6112","GARISSA","DADAAB","65-69",619,392,1011
"6113","GARISSA","DADAAB","70",430,276,706
"6114","GARISSA","DADAAB","71",63,47,110
"6115","GARISSA","DADAAB","72",84,45,129
"6116","GARISSA","DADAAB","73",53,28,81
"6117","GARISSA","DADAAB","74",67,33,100
"6118","GARISSA","DADAAB","70-74",697,429,1126
"6119","GARISSA","DADAAB","75",108,67,175
"6120","GARISSA","DADAAB","76",39,30,69
"6121","GARISSA","DADAAB","77",16,20,36
"6122","GARISSA","DADAAB","78",49,27,76
"6123","GARISSA","DADAAB","79",44,22,66
"6124","GARISSA","DADAAB","75-79",256,166,422
"6125","GARISSA","DADAAB","80",178,162,340
"6126","GARISSA","DADAAB","81",27,20,47
"6127","GARISSA","DADAAB","82",24,10,34
"6128","GARISSA","DADAAB","83",17,9,26
"6129","GARISSA","DADAAB","84",24,18,42
"6130","GARISSA","DADAAB","80-84",270,219,489
"6131","GARISSA","DADAAB","85",27,31,58
"6132","GARISSA","DADAAB","86",14,7,21
"6133","GARISSA","DADAAB","87",7,12,19
"6134","GARISSA","DADAAB","88",7,11,18
"6135","GARISSA","DADAAB","89",6,9,15
"6136","GARISSA","DADAAB","85-89",61,70,131
"6137","GARISSA","DADAAB","90",42,60,102
"6138","GARISSA","DADAAB","91",7,8,15
"6139","GARISSA","DADAAB","92",4,4,8
"6140","GARISSA","DADAAB","93",3,2,5
"6141","GARISSA","DADAAB","94",NA,6,6
"6142","GARISSA","DADAAB","90-94",56,80,136
"6143","GARISSA","DADAAB","95",9,11,20
"6144","GARISSA","DADAAB","96",6,6,12
"6145","GARISSA","DADAAB","97",1,1,2
"6146","GARISSA","DADAAB","98",3,2,5
"6147","GARISSA","DADAAB","99",5,2,7
"6148","GARISSA","DADAAB","95-99",24,22,46
"6149","GARISSA","DADAAB","100+",11,14,25
"6150","GARISSA","DADAAB","Not Stated",NA,NA,NA
"6151","GARISSA","FAFI","Total",72617,61413,134030
"6152","GARISSA","FAFI","0",1113,1137,2250
"6153","GARISSA","FAFI","1",1459,1299,2758
"6154","GARISSA","FAFI","2",2329,2091,4420
"6155","GARISSA","FAFI","3",2104,1905,4009
"6156","GARISSA","FAFI","4",2425,2157,4582
"6157","GARISSA","FAFI","0 - 4",9430,8589,18019
"6158","GARISSA","FAFI","5",2186,2012,4198
"6159","GARISSA","FAFI","6",2315,2113,4428
"6160","GARISSA","FAFI","7",1782,1596,3378
"6161","GARISSA","FAFI","8",2734,2355,5089
"6162","GARISSA","FAFI","9",1899,1579,3478
"6163","GARISSA","FAFI","5-9",10916,9655,20571
"6164","GARISSA","FAFI","10",3408,2905,6313
"6165","GARISSA","FAFI","11",1461,1316,2777
"6166","GARISSA","FAFI","12",2647,1949,4596
"6167","GARISSA","FAFI","13",1884,1531,3415
"6168","GARISSA","FAFI","14",2367,1632,3999
"6169","GARISSA","FAFI","10 -14",11767,9333,21100
"6170","GARISSA","FAFI","15",2866,2094,4960
"6171","GARISSA","FAFI","16",2145,1525,3670
"6172","GARISSA","FAFI","17",2065,1473,3538
"6173","GARISSA","FAFI","18",2689,1952,4641
"6174","GARISSA","FAFI","19",1618,1308,2926
"6175","GARISSA","FAFI","15-19",11383,8352,19735
"6176","GARISSA","FAFI","20",3303,2749,6052
"6177","GARISSA","FAFI","21",1123,858,1981
"6178","GARISSA","FAFI","22",1240,1039,2279
"6179","GARISSA","FAFI","23",1014,845,1859
"6180","GARISSA","FAFI","24",852,714,1566
"6181","GARISSA","FAFI","20-24",7532,6205,13737
"6182","GARISSA","FAFI","25",2059,1881,3940
"6183","GARISSA","FAFI","26",828,716,1544
"6184","GARISSA","FAFI","27",675,562,1237
"6185","GARISSA","FAFI","28",970,1027,1997
"6186","GARISSA","FAFI","29",659,629,1288
"6187","GARISSA","FAFI","25-29",5191,4815,10006
"6188","GARISSA","FAFI","30",2163,2277,4440
"6189","GARISSA","FAFI","31",371,357,728
"6190","GARISSA","FAFI","32",743,815,1558
"6191","GARISSA","FAFI","33",354,404,758
"6192","GARISSA","FAFI","34",370,354,724
"6193","GARISSA","FAFI","30-34",4001,4207,8208
"6194","GARISSA","FAFI","35",1163,1295,2458
"6195","GARISSA","FAFI","36",413,456,869
"6196","GARISSA","FAFI","37",324,362,686
"6197","GARISSA","FAFI","38",538,666,1204
"6198","GARISSA","FAFI","39",301,327,628
"6199","GARISSA","FAFI","35-39",2739,3106,5845
"6200","GARISSA","FAFI","40",1909,1518,3427
"6201","GARISSA","FAFI","41",311,222,533
"6202","GARISSA","FAFI","42",460,352,812
"6203","GARISSA","FAFI","43",241,252,493
"6204","GARISSA","FAFI","44",172,118,290
"6205","GARISSA","FAFI","40-44",3093,2462,5555
"6206","GARISSA","FAFI","45",934,647,1581
"6207","GARISSA","FAFI","46",186,159,345
"6208","GARISSA","FAFI","47",164,144,308
"6209","GARISSA","FAFI","48",276,236,512
"6210","GARISSA","FAFI","49",167,141,308
"6211","GARISSA","FAFI","45-49",1727,1327,3054
"6212","GARISSA","FAFI","50",1145,771,1916
"6213","GARISSA","FAFI","51",139,88,227
"6214","GARISSA","FAFI","52",275,167,442
"6215","GARISSA","FAFI","53",125,97,222
"6216","GARISSA","FAFI","54",160,120,280
"6217","GARISSA","FAFI","50-54",1844,1243,3087
"6218","GARISSA","FAFI","55",268,220,488
"6219","GARISSA","FAFI","56",157,125,282
"6220","GARISSA","FAFI","57",110,75,185
"6221","GARISSA","FAFI","58",164,110,274
"6222","GARISSA","FAFI","59",109,77,186
"6223","GARISSA","FAFI","55-59",808,607,1415
"6224","GARISSA","FAFI","60",621,416,1037
"6225","GARISSA","FAFI","61",90,53,143
"6226","GARISSA","FAFI","62",105,55,160
"6227","GARISSA","FAFI","63",81,55,136
"6228","GARISSA","FAFI","64",71,30,101
"6229","GARISSA","FAFI","60-64",968,609,1577
"6230","GARISSA","FAFI","65",168,138,306
"6231","GARISSA","FAFI","66",54,31,85
"6232","GARISSA","FAFI","67",70,48,118
"6233","GARISSA","FAFI","68",62,42,104
"6234","GARISSA","FAFI","69",54,24,78
"6235","GARISSA","FAFI","65-69",408,283,691
"6236","GARISSA","FAFI","70",260,209,469
"6237","GARISSA","FAFI","71",27,25,52
"6238","GARISSA","FAFI","72",35,23,58
"6239","GARISSA","FAFI","73",40,20,60
"6240","GARISSA","FAFI","74",25,22,47
"6241","GARISSA","FAFI","70-74",387,299,686
"6242","GARISSA","FAFI","75",58,53,111
"6243","GARISSA","FAFI","76",22,11,33
"6244","GARISSA","FAFI","77",15,10,25
"6245","GARISSA","FAFI","78",28,15,43
"6246","GARISSA","FAFI","79",24,8,32
"6247","GARISSA","FAFI","75-79",147,97,244
"6248","GARISSA","FAFI","80",106,88,194
"6249","GARISSA","FAFI","81",17,8,25
"6250","GARISSA","FAFI","82",16,10,26
"6251","GARISSA","FAFI","83",9,11,20
"6252","GARISSA","FAFI","84",15,9,24
"6253","GARISSA","FAFI","80-84",163,126,289
"6254","GARISSA","FAFI","85",22,22,44
"6255","GARISSA","FAFI","86",8,8,16
"6256","GARISSA","FAFI","87",4,6,10
"6257","GARISSA","FAFI","88",4,3,7
"6258","GARISSA","FAFI","89",12,5,17
"6259","GARISSA","FAFI","85-89",50,44,94
"6260","GARISSA","FAFI","90",31,28,59
"6261","GARISSA","FAFI","91",1,2,3
"6262","GARISSA","FAFI","92",2,3,5
"6263","GARISSA","FAFI","93",3,2,5
"6264","GARISSA","FAFI","94",1,1,2
"6265","GARISSA","FAFI","90-94",38,36,74
"6266","GARISSA","FAFI","95",6,4,10
"6267","GARISSA","FAFI","96",2,1,3
"6268","GARISSA","FAFI","97",2,1,3
"6269","GARISSA","FAFI","98",3,2,5
"6270","GARISSA","FAFI","99",3,1,4
"6271","GARISSA","FAFI","95-99",16,9,25
"6272","GARISSA","FAFI","100+",9,9,18
"6273","GARISSA","FAFI","Not Stated",NA,NA,NA
"6274","GARISSA","GARISSA","Total",83460,80449,163909
"6275","GARISSA","GARISSA","0",1799,1742,3541
"6276","GARISSA","GARISSA","1",2073,2019,4092
"6277","GARISSA","GARISSA","2",2744,2688,5432
"6278","GARISSA","GARISSA","3",2547,2455,5002
"6279","GARISSA","GARISSA","4",2657,2471,5128
"6280","GARISSA","GARISSA","0 - 4",11820,11375,23195
"6281","GARISSA","GARISSA","5",2532,2487,5019
"6282","GARISSA","GARISSA","6",2661,2570,5231
"6283","GARISSA","GARISSA","7",2344,2201,4545
"6284","GARISSA","GARISSA","8",2835,2645,5480
"6285","GARISSA","GARISSA","9",2230,2228,4458
"6286","GARISSA","GARISSA","5-9",12602,12131,24733
"6287","GARISSA","GARISSA","10",3229,2847,6076
"6288","GARISSA","GARISSA","11",2007,1880,3887
"6289","GARISSA","GARISSA","12",2803,2303,5106
"6290","GARISSA","GARISSA","13",2419,2055,4474
"6291","GARISSA","GARISSA","14",2486,2132,4618
"6292","GARISSA","GARISSA","10 -14",12944,11217,24161
"6293","GARISSA","GARISSA","15",2722,2256,4978
"6294","GARISSA","GARISSA","16",2373,1936,4309
"6295","GARISSA","GARISSA","17",2405,2043,4448
"6296","GARISSA","GARISSA","18",2083,1943,4026
"6297","GARISSA","GARISSA","19",1676,1698,3374
"6298","GARISSA","GARISSA","15-19",11259,9876,21135
"6299","GARISSA","GARISSA","20",2356,2393,4749
"6300","GARISSA","GARISSA","21",1326,1462,2788
"6301","GARISSA","GARISSA","22",1604,1835,3439
"6302","GARISSA","GARISSA","23",1380,1496,2876
"6303","GARISSA","GARISSA","24",1201,1325,2526
"6304","GARISSA","GARISSA","20-24",7867,8511,16378
"6305","GARISSA","GARISSA","25",2149,2378,4527
"6306","GARISSA","GARISSA","26",1169,1256,2425
"6307","GARISSA","GARISSA","27",1055,1196,2251
"6308","GARISSA","GARISSA","28",1116,1349,2465
"6309","GARISSA","GARISSA","29",839,864,1703
"6310","GARISSA","GARISSA","25-29",6328,7043,13371
"6311","GARISSA","GARISSA","30",2263,2386,4649
"6312","GARISSA","GARISSA","31",711,882,1593
"6313","GARISSA","GARISSA","32",1077,1127,2204
"6314","GARISSA","GARISSA","33",758,765,1523
"6315","GARISSA","GARISSA","34",651,696,1347
"6316","GARISSA","GARISSA","30-34",5460,5856,11316
"6317","GARISSA","GARISSA","35",1394,1358,2752
"6318","GARISSA","GARISSA","36",594,672,1266
"6319","GARISSA","GARISSA","37",558,568,1126
"6320","GARISSA","GARISSA","38",618,583,1201
"6321","GARISSA","GARISSA","39",432,399,831
"6322","GARISSA","GARISSA","35-39",3596,3580,7176
"6323","GARISSA","GARISSA","40",1517,1154,2671
"6324","GARISSA","GARISSA","41",552,702,1254
"6325","GARISSA","GARISSA","42",534,499,1033
"6326","GARISSA","GARISSA","43",479,489,968
"6327","GARISSA","GARISSA","44",271,228,499
"6328","GARISSA","GARISSA","40-44",3353,3072,6425
"6329","GARISSA","GARISSA","45",947,852,1799
"6330","GARISSA","GARISSA","46",319,268,587
"6331","GARISSA","GARISSA","47",330,333,663
"6332","GARISSA","GARISSA","48",270,238,508
"6333","GARISSA","GARISSA","49",232,210,442
"6334","GARISSA","GARISSA","45-49",2098,1901,3999
"6335","GARISSA","GARISSA","50",875,745,1620
"6336","GARISSA","GARISSA","51",218,200,418
"6337","GARISSA","GARISSA","52",292,257,549
"6338","GARISSA","GARISSA","53",188,173,361
"6339","GARISSA","GARISSA","54",236,173,409
"6340","GARISSA","GARISSA","50-54",1809,1548,3357
"6341","GARISSA","GARISSA","55",381,292,673
"6342","GARISSA","GARISSA","56",248,226,474
"6343","GARISSA","GARISSA","57",214,209,423
"6344","GARISSA","GARISSA","58",236,190,426
"6345","GARISSA","GARISSA","59",232,223,455
"6346","GARISSA","GARISSA","55-59",1311,1140,2451
"6347","GARISSA","GARISSA","60",550,552,1102
"6348","GARISSA","GARISSA","61",185,163,348
"6349","GARISSA","GARISSA","62",163,110,273
"6350","GARISSA","GARISSA","63",151,128,279
"6351","GARISSA","GARISSA","64",122,72,194
"6352","GARISSA","GARISSA","60-64",1171,1025,2196
"6353","GARISSA","GARISSA","65",231,215,446
"6354","GARISSA","GARISSA","66",101,123,224
"6355","GARISSA","GARISSA","67",101,113,214
"6356","GARISSA","GARISSA","68",94,74,168
"6357","GARISSA","GARISSA","69",118,110,228
"6358","GARISSA","GARISSA","65-69",645,635,1280
"6359","GARISSA","GARISSA","70",318,401,719
"6360","GARISSA","GARISSA","71",69,130,199
"6361","GARISSA","GARISSA","72",57,63,120
"6362","GARISSA","GARISSA","73",56,45,101
"6363","GARISSA","GARISSA","74",55,56,111
"6364","GARISSA","GARISSA","70-74",555,695,1250
"6365","GARISSA","GARISSA","75",73,93,166
"6366","GARISSA","GARISSA","76",43,31,74
"6367","GARISSA","GARISSA","77",39,30,69
"6368","GARISSA","GARISSA","78",40,32,72
"6369","GARISSA","GARISSA","79",42,45,87
"6370","GARISSA","GARISSA","75-79",237,231,468
"6371","GARISSA","GARISSA","80",136,227,363
"6372","GARISSA","GARISSA","81",22,71,93
"6373","GARISSA","GARISSA","82",19,30,49
"6374","GARISSA","GARISSA","83",13,16,29
"6375","GARISSA","GARISSA","84",23,26,49
"6376","GARISSA","GARISSA","80-84",213,370,583
"6377","GARISSA","GARISSA","85",32,31,63
"6378","GARISSA","GARISSA","86",15,14,29
"6379","GARISSA","GARISSA","87",17,19,36
"6380","GARISSA","GARISSA","88",9,12,21
"6381","GARISSA","GARISSA","89",19,17,36
"6382","GARISSA","GARISSA","85-89",92,93,185
"6383","GARISSA","GARISSA","90",43,73,116
"6384","GARISSA","GARISSA","91",3,15,18
"6385","GARISSA","GARISSA","92",7,3,10
"6386","GARISSA","GARISSA","93",4,1,5
"6387","GARISSA","GARISSA","94",6,5,11
"6388","GARISSA","GARISSA","90-94",63,97,160
"6389","GARISSA","GARISSA","95",10,13,23
"6390","GARISSA","GARISSA","96",3,9,12
"6391","GARISSA","GARISSA","97",1,NA,1
"6392","GARISSA","GARISSA","98",5,2,7
"6393","GARISSA","GARISSA","99",5,6,11
"6394","GARISSA","GARISSA","95-99",24,30,54
"6395","GARISSA","GARISSA","100+",10,23,33
"6396","GARISSA","GARISSA","Not Stated",3,NA,3
"6397","GARISSA","HULUGHO","Total",78081,55898,133979
"6398","GARISSA","HULUGHO","0",798,851,1649
"6399","GARISSA","HULUGHO","1",1150,1231,2381
"6400","GARISSA","HULUGHO","2",2520,2249,4769
"6401","GARISSA","HULUGHO","3",2158,1997,4155
"6402","GARISSA","HULUGHO","4",2780,2344,5124
"6403","GARISSA","HULUGHO","0 - 4",9406,8672,18078
"6404","GARISSA","HULUGHO","5",2631,2106,4737
"6405","GARISSA","HULUGHO","6",3097,2420,5517
"6406","GARISSA","HULUGHO","7",2157,1635,3792
"6407","GARISSA","HULUGHO","8",3644,2752,6396
"6408","GARISSA","HULUGHO","9",2252,1718,3970
"6409","GARISSA","HULUGHO","5-9",13781,10631,24412
"6410","GARISSA","HULUGHO","10",4575,3078,7653
"6411","GARISSA","HULUGHO","11",1748,1437,3185
"6412","GARISSA","HULUGHO","12",3417,1564,4981
"6413","GARISSA","HULUGHO","13",2371,1177,3548
"6414","GARISSA","HULUGHO","14",2806,1290,4096
"6415","GARISSA","HULUGHO","10 -14",14917,8546,23463
"6416","GARISSA","HULUGHO","15",3773,1790,5563
"6417","GARISSA","HULUGHO","16",2597,1254,3851
"6418","GARISSA","HULUGHO","17",2557,1375,3932
"6419","GARISSA","HULUGHO","18",2522,1482,4004
"6420","GARISSA","HULUGHO","19",1241,855,2096
"6421","GARISSA","HULUGHO","15-19",12690,6756,19446
"6422","GARISSA","HULUGHO","20",3069,2110,5179
"6423","GARISSA","HULUGHO","21",958,755,1713
"6424","GARISSA","HULUGHO","22",1128,877,2005
"6425","GARISSA","HULUGHO","23",976,819,1795
"6426","GARISSA","HULUGHO","24",929,782,1711
"6427","GARISSA","HULUGHO","20-24",7060,5343,12403
"6428","GARISSA","HULUGHO","25",1802,1451,3253
"6429","GARISSA","HULUGHO","26",831,675,1506
"6430","GARISSA","HULUGHO","27",567,521,1088
"6431","GARISSA","HULUGHO","28",1009,1013,2022
"6432","GARISSA","HULUGHO","29",687,683,1370
"6433","GARISSA","HULUGHO","25-29",4896,4343,9239
"6434","GARISSA","HULUGHO","30",2279,1981,4260
"6435","GARISSA","HULUGHO","31",588,462,1050
"6436","GARISSA","HULUGHO","32",681,622,1303
"6437","GARISSA","HULUGHO","33",435,422,857
"6438","GARISSA","HULUGHO","34",454,389,843
"6439","GARISSA","HULUGHO","30-34",4437,3876,8313
"6440","GARISSA","HULUGHO","35",1056,942,1998
"6441","GARISSA","HULUGHO","36",465,455,920
"6442","GARISSA","HULUGHO","37",373,369,742
"6443","GARISSA","HULUGHO","38",602,507,1109
"6444","GARISSA","HULUGHO","39",383,386,769
"6445","GARISSA","HULUGHO","35-39",2879,2659,5538
"6446","GARISSA","HULUGHO","40",1485,974,2459
"6447","GARISSA","HULUGHO","41",334,314,648
"6448","GARISSA","HULUGHO","42",326,223,549
"6449","GARISSA","HULUGHO","43",268,235,503
"6450","GARISSA","HULUGHO","44",156,86,242
"6451","GARISSA","HULUGHO","40-44",2569,1832,4401
"6452","GARISSA","HULUGHO","45",681,408,1089
"6453","GARISSA","HULUGHO","46",186,138,324
"6454","GARISSA","HULUGHO","47",164,91,255
"6455","GARISSA","HULUGHO","48",232,161,393
"6456","GARISSA","HULUGHO","49",187,109,296
"6457","GARISSA","HULUGHO","45-49",1450,907,2357
"6458","GARISSA","HULUGHO","50",859,532,1391
"6459","GARISSA","HULUGHO","51",135,88,223
"6460","GARISSA","HULUGHO","52",221,167,388
"6461","GARISSA","HULUGHO","53",96,44,140
"6462","GARISSA","HULUGHO","54",179,76,255
"6463","GARISSA","HULUGHO","50-54",1490,907,2397
"6464","GARISSA","HULUGHO","55",178,85,263
"6465","GARISSA","HULUGHO","56",109,82,191
"6466","GARISSA","HULUGHO","57",82,76,158
"6467","GARISSA","HULUGHO","58",128,94,222
"6468","GARISSA","HULUGHO","59",127,97,224
"6469","GARISSA","HULUGHO","55-59",624,434,1058
"6470","GARISSA","HULUGHO","60",573,336,909
"6471","GARISSA","HULUGHO","61",98,37,135
"6472","GARISSA","HULUGHO","62",84,38,122
"6473","GARISSA","HULUGHO","63",87,57,144
"6474","GARISSA","HULUGHO","64",32,29,61
"6475","GARISSA","HULUGHO","60-64",874,497,1371
"6476","GARISSA","HULUGHO","65",128,64,192
"6477","GARISSA","HULUGHO","66",50,27,77
"6478","GARISSA","HULUGHO","67",38,28,66
"6479","GARISSA","HULUGHO","68",84,34,118
"6480","GARISSA","HULUGHO","69",69,52,121
"6481","GARISSA","HULUGHO","65-69",369,205,574
"6482","GARISSA","HULUGHO","70",212,98,310
"6483","GARISSA","HULUGHO","71",42,43,85
"6484","GARISSA","HULUGHO","72",34,14,48
"6485","GARISSA","HULUGHO","73",36,8,44
"6486","GARISSA","HULUGHO","74",24,11,35
"6487","GARISSA","HULUGHO","70-74",348,174,522
"6488","GARISSA","HULUGHO","75",35,9,44
"6489","GARISSA","HULUGHO","76",20,6,26
"6490","GARISSA","HULUGHO","77",15,1,16
"6491","GARISSA","HULUGHO","78",23,12,35
"6492","GARISSA","HULUGHO","79",35,11,46
"6493","GARISSA","HULUGHO","75-79",128,39,167
"6494","GARISSA","HULUGHO","80",87,25,112
"6495","GARISSA","HULUGHO","81",11,10,21
"6496","GARISSA","HULUGHO","82",8,4,12
"6497","GARISSA","HULUGHO","83",6,3,9
"6498","GARISSA","HULUGHO","84",6,5,11
"6499","GARISSA","HULUGHO","80-84",118,47,165
"6500","GARISSA","HULUGHO","85",9,4,13
"6501","GARISSA","HULUGHO","86",3,1,4
"6502","GARISSA","HULUGHO","87",5,2,7
"6503","GARISSA","HULUGHO","88",3,2,5
"6504","GARISSA","HULUGHO","89",9,2,11
"6505","GARISSA","HULUGHO","85-89",29,11,40
"6506","GARISSA","HULUGHO","90",4,5,9
"6507","GARISSA","HULUGHO","91",3,5,8
"6508","GARISSA","HULUGHO","92",NA,2,2
"6509","GARISSA","HULUGHO","93",3,1,4
"6510","GARISSA","HULUGHO","94",1,NA,1
"6511","GARISSA","HULUGHO","90-94",11,13,24
"6512","GARISSA","HULUGHO","95",2,NA,2
"6513","GARISSA","HULUGHO","96",2,2,4
"6514","GARISSA","HULUGHO","97",NA,NA,NA
"6515","GARISSA","HULUGHO","98",NA,NA,NA
"6516","GARISSA","HULUGHO","99",NA,1,1
"6517","GARISSA","HULUGHO","95-99",4,3,7
"6518","GARISSA","HULUGHO","100+",1,3,4
"6519","GARISSA","HULUGHO","Not Stated",NA,NA,NA
"6520","GARISSA","IJARA","Total",80458,61129,141587
"6521","GARISSA","IJARA","0",1007,1042,2049
"6522","GARISSA","IJARA","1",1378,1427,2805
"6523","GARISSA","IJARA","2",2485,2513,4998
"6524","GARISSA","IJARA","3",2264,2082,4346
"6525","GARISSA","IJARA","4",2834,2569,5403
"6526","GARISSA","IJARA","0 - 4",9968,9633,19601
"6527","GARISSA","IJARA","5",2642,2397,5039
"6528","GARISSA","IJARA","6",2975,2715,5690
"6529","GARISSA","IJARA","7",2209,1864,4073
"6530","GARISSA","IJARA","8",3430,2969,6399
"6531","GARISSA","IJARA","9",2223,1993,4216
"6532","GARISSA","IJARA","5-9",13479,11938,25417
"6533","GARISSA","IJARA","10",4478,3622,8100
"6534","GARISSA","IJARA","11",1933,1899,3832
"6535","GARISSA","IJARA","12",3890,2127,6017
"6536","GARISSA","IJARA","13",2643,1465,4108
"6537","GARISSA","IJARA","14",3261,1647,4908
"6538","GARISSA","IJARA","10 -14",16205,10760,26965
"6539","GARISSA","IJARA","15",3976,2062,6038
"6540","GARISSA","IJARA","16",3116,1593,4709
"6541","GARISSA","IJARA","17",3315,1807,5122
"6542","GARISSA","IJARA","18",2654,1551,4205
"6543","GARISSA","IJARA","19",1468,947,2415
"6544","GARISSA","IJARA","15-19",14529,7960,22489
"6545","GARISSA","IJARA","20",3085,2220,5305
"6546","GARISSA","IJARA","21",1100,867,1967
"6547","GARISSA","IJARA","22",1359,1036,2395
"6548","GARISSA","IJARA","23",1160,882,2042
"6549","GARISSA","IJARA","24",949,672,1621
"6550","GARISSA","IJARA","20-24",7653,5677,13330
"6551","GARISSA","IJARA","25",1889,1408,3297
"6552","GARISSA","IJARA","26",797,570,1367
"6553","GARISSA","IJARA","27",806,557,1363
"6554","GARISSA","IJARA","28",961,700,1661
"6555","GARISSA","IJARA","29",645,534,1179
"6556","GARISSA","IJARA","25-29",5098,3769,8867
"6557","GARISSA","IJARA","30",1785,1556,3341
"6558","GARISSA","IJARA","31",432,456,888
"6559","GARISSA","IJARA","32",581,551,1132
"6560","GARISSA","IJARA","33",447,411,858
"6561","GARISSA","IJARA","34",374,314,688
"6562","GARISSA","IJARA","30-34",3619,3288,6907
"6563","GARISSA","IJARA","35",886,747,1633
"6564","GARISSA","IJARA","36",385,344,729
"6565","GARISSA","IJARA","37",335,394,729
"6566","GARISSA","IJARA","38",404,372,776
"6567","GARISSA","IJARA","39",353,294,647
"6568","GARISSA","IJARA","35-39",2363,2151,4514
"6569","GARISSA","IJARA","40",1147,837,1984
"6570","GARISSA","IJARA","41",297,331,628
"6571","GARISSA","IJARA","42",317,271,588
"6572","GARISSA","IJARA","43",316,296,612
"6573","GARISSA","IJARA","44",142,97,239
"6574","GARISSA","IJARA","40-44",2219,1832,4051
"6575","GARISSA","IJARA","45",635,553,1188
"6576","GARISSA","IJARA","46",216,170,386
"6577","GARISSA","IJARA","47",175,108,283
"6578","GARISSA","IJARA","48",195,151,346
"6579","GARISSA","IJARA","49",152,143,295
"6580","GARISSA","IJARA","45-49",1373,1125,2498
"6581","GARISSA","IJARA","50",735,551,1286
"6582","GARISSA","IJARA","51",99,78,177
"6583","GARISSA","IJARA","52",240,189,429
"6584","GARISSA","IJARA","53",91,70,161
"6585","GARISSA","IJARA","54",151,152,303
"6586","GARISSA","IJARA","50-54",1316,1040,2356
"6587","GARISSA","IJARA","55",214,150,364
"6588","GARISSA","IJARA","56",139,110,249
"6589","GARISSA","IJARA","57",92,109,201
"6590","GARISSA","IJARA","58",110,108,218
"6591","GARISSA","IJARA","59",185,129,314
"6592","GARISSA","IJARA","55-59",740,606,1346
"6593","GARISSA","IJARA","60",311,262,573
"6594","GARISSA","IJARA","61",126,81,207
"6595","GARISSA","IJARA","62",87,50,137
"6596","GARISSA","IJARA","63",106,49,155
"6597","GARISSA","IJARA","64",66,41,107
"6598","GARISSA","IJARA","60-64",696,483,1179
"6599","GARISSA","IJARA","65",137,119,256
"6600","GARISSA","IJARA","66",65,45,110
"6601","GARISSA","IJARA","67",41,50,91
"6602","GARISSA","IJARA","68",64,37,101
"6603","GARISSA","IJARA","69",112,70,182
"6604","GARISSA","IJARA","65-69",419,321,740
"6605","GARISSA","IJARA","70",192,131,323
"6606","GARISSA","IJARA","71",63,66,129
"6607","GARISSA","IJARA","72",43,24,67
"6608","GARISSA","IJARA","73",30,16,46
"6609","GARISSA","IJARA","74",34,21,55
"6610","GARISSA","IJARA","70-74",362,258,620
"6611","GARISSA","IJARA","75",54,27,81
"6612","GARISSA","IJARA","76",27,16,43
"6613","GARISSA","IJARA","77",11,15,26
"6614","GARISSA","IJARA","78",15,13,28
"6615","GARISSA","IJARA","79",39,22,61
"6616","GARISSA","IJARA","75-79",146,93,239
"6617","GARISSA","IJARA","80",80,67,147
"6618","GARISSA","IJARA","81",27,37,64
"6619","GARISSA","IJARA","82",11,13,24
"6620","GARISSA","IJARA","83",21,7,28
"6621","GARISSA","IJARA","84",22,7,29
"6622","GARISSA","IJARA","80-84",161,131,292
"6623","GARISSA","IJARA","85",22,8,30
"6624","GARISSA","IJARA","86",12,6,18
"6625","GARISSA","IJARA","87",13,5,18
"6626","GARISSA","IJARA","88",1,4,5
"6627","GARISSA","IJARA","89",16,10,26
"6628","GARISSA","IJARA","85-89",64,33,97
"6629","GARISSA","IJARA","90",22,17,39
"6630","GARISSA","IJARA","91",9,3,12
"6631","GARISSA","IJARA","92",1,NA,1
"6632","GARISSA","IJARA","93",NA,NA,NA
"6633","GARISSA","IJARA","94",1,1,2
"6634","GARISSA","IJARA","90-94",33,21,54
"6635","GARISSA","IJARA","95",2,2,4
"6636","GARISSA","IJARA","96",NA,1,1
"6637","GARISSA","IJARA","97",NA,NA,NA
"6638","GARISSA","IJARA","98",4,2,6
"6639","GARISSA","IJARA","99",4,1,5
"6640","GARISSA","IJARA","95-99",10,6,16
"6641","GARISSA","IJARA","100+",4,4,8
"6642","GARISSA","IJARA","Not Stated",1,NA,1
"6643","GARISSA","LAGDERA","Total",25023,25291,50314
"6644","GARISSA","LAGDERA","0",204,311,515
"6645","GARISSA","LAGDERA","1",489,547,1036
"6646","GARISSA","LAGDERA","2",855,1129,1984
"6647","GARISSA","LAGDERA","3",762,936,1698
"6648","GARISSA","LAGDERA","4",821,1136,1957
"6649","GARISSA","LAGDERA","0 - 4",3131,4059,7190
"6650","GARISSA","LAGDERA","5",843,983,1826
"6651","GARISSA","LAGDERA","6",933,1114,2047
"6652","GARISSA","LAGDERA","7",656,778,1434
"6653","GARISSA","LAGDERA","8",995,1143,2138
"6654","GARISSA","LAGDERA","9",607,695,1302
"6655","GARISSA","LAGDERA","5-9",4034,4713,8747
"6656","GARISSA","LAGDERA","10",1286,1296,2582
"6657","GARISSA","LAGDERA","11",504,602,1106
"6658","GARISSA","LAGDERA","12",1005,797,1802
"6659","GARISSA","LAGDERA","13",573,564,1137
"6660","GARISSA","LAGDERA","14",698,655,1353
"6661","GARISSA","LAGDERA","10 -14",4066,3914,7980
"6662","GARISSA","LAGDERA","15",948,725,1673
"6663","GARISSA","LAGDERA","16",641,587,1228
"6664","GARISSA","LAGDERA","17",529,406,935
"6665","GARISSA","LAGDERA","18",673,595,1268
"6666","GARISSA","LAGDERA","19",275,313,588
"6667","GARISSA","LAGDERA","15-19",3066,2626,5692
"6668","GARISSA","LAGDERA","20",860,837,1697
"6669","GARISSA","LAGDERA","21",275,307,582
"6670","GARISSA","LAGDERA","22",351,419,770
"6671","GARISSA","LAGDERA","23",276,339,615
"6672","GARISSA","LAGDERA","24",310,319,629
"6673","GARISSA","LAGDERA","20-24",2072,2221,4293
"6674","GARISSA","LAGDERA","25",611,794,1405
"6675","GARISSA","LAGDERA","26",252,307,559
"6676","GARISSA","LAGDERA","27",240,292,532
"6677","GARISSA","LAGDERA","28",321,449,770
"6678","GARISSA","LAGDERA","29",324,364,688
"6679","GARISSA","LAGDERA","25-29",1748,2206,3954
"6680","GARISSA","LAGDERA","30",782,870,1652
"6681","GARISSA","LAGDERA","31",213,238,451
"6682","GARISSA","LAGDERA","32",271,270,541
"6683","GARISSA","LAGDERA","33",177,170,347
"6684","GARISSA","LAGDERA","34",165,160,325
"6685","GARISSA","LAGDERA","30-34",1608,1708,3316
"6686","GARISSA","LAGDERA","35",472,531,1003
"6687","GARISSA","LAGDERA","36",217,227,444
"6688","GARISSA","LAGDERA","37",153,142,295
"6689","GARISSA","LAGDERA","38",259,293,552
"6690","GARISSA","LAGDERA","39",218,201,419
"6691","GARISSA","LAGDERA","35-39",1319,1394,2713
"6692","GARISSA","LAGDERA","40",694,559,1253
"6693","GARISSA","LAGDERA","41",168,152,320
"6694","GARISSA","LAGDERA","42",184,158,342
"6695","GARISSA","LAGDERA","43",151,107,258
"6696","GARISSA","LAGDERA","44",83,60,143
"6697","GARISSA","LAGDERA","40-44",1280,1036,2316
"6698","GARISSA","LAGDERA","45",382,253,635
"6699","GARISSA","LAGDERA","46",86,62,148
"6700","GARISSA","LAGDERA","47",98,49,147
"6701","GARISSA","LAGDERA","48",148,80,228
"6702","GARISSA","LAGDERA","49",107,71,178
"6703","GARISSA","LAGDERA","45-49",821,515,1336
"6704","GARISSA","LAGDERA","50",400,174,574
"6705","GARISSA","LAGDERA","51",68,27,95
"6706","GARISSA","LAGDERA","52",98,48,146
"6707","GARISSA","LAGDERA","53",55,34,89
"6708","GARISSA","LAGDERA","54",65,40,105
"6709","GARISSA","LAGDERA","50-54",686,323,1009
"6710","GARISSA","LAGDERA","55",120,59,179
"6711","GARISSA","LAGDERA","56",85,36,121
"6712","GARISSA","LAGDERA","57",46,17,63
"6713","GARISSA","LAGDERA","58",66,40,106
"6714","GARISSA","LAGDERA","59",79,29,108
"6715","GARISSA","LAGDERA","55-59",396,181,577
"6716","GARISSA","LAGDERA","60",181,83,264
"6717","GARISSA","LAGDERA","61",32,10,42
"6718","GARISSA","LAGDERA","62",43,17,60
"6719","GARISSA","LAGDERA","63",36,15,51
"6720","GARISSA","LAGDERA","64",26,10,36
"6721","GARISSA","LAGDERA","60-64",318,135,453
"6722","GARISSA","LAGDERA","65",62,48,110
"6723","GARISSA","LAGDERA","66",13,10,23
"6724","GARISSA","LAGDERA","67",23,14,37
"6725","GARISSA","LAGDERA","68",34,16,50
"6726","GARISSA","LAGDERA","69",26,21,47
"6727","GARISSA","LAGDERA","65-69",158,109,267
"6728","GARISSA","LAGDERA","70",86,37,123
"6729","GARISSA","LAGDERA","71",15,19,34
"6730","GARISSA","LAGDERA","72",21,6,27
"6731","GARISSA","LAGDERA","73",11,3,14
"6732","GARISSA","LAGDERA","74",15,5,20
"6733","GARISSA","LAGDERA","70-74",148,70,218
"6734","GARISSA","LAGDERA","75",16,9,25
"6735","GARISSA","LAGDERA","76",11,3,14
"6736","GARISSA","LAGDERA","77",9,7,16
"6737","GARISSA","LAGDERA","78",24,6,30
"6738","GARISSA","LAGDERA","79",11,6,17
"6739","GARISSA","LAGDERA","75-79",71,31,102
"6740","GARISSA","LAGDERA","80",37,17,54
"6741","GARISSA","LAGDERA","81",9,8,17
"6742","GARISSA","LAGDERA","82",7,4,11
"6743","GARISSA","LAGDERA","83",3,1,4
"6744","GARISSA","LAGDERA","84",11,1,12
"6745","GARISSA","LAGDERA","80-84",67,31,98
"6746","GARISSA","LAGDERA","85",7,NA,7
"6747","GARISSA","LAGDERA","86",3,2,5
"6748","GARISSA","LAGDERA","87",4,2,6
"6749","GARISSA","LAGDERA","88",5,3,8
"6750","GARISSA","LAGDERA","89",3,1,4
"6751","GARISSA","LAGDERA","85-89",22,8,30
"6752","GARISSA","LAGDERA","90",6,4,10
"6753","GARISSA","LAGDERA","91",NA,4,4
"6754","GARISSA","LAGDERA","92",1,NA,1
"6755","GARISSA","LAGDERA","93",NA,NA,NA
"6756","GARISSA","LAGDERA","94",NA,NA,NA
"6757","GARISSA","LAGDERA","90-94",7,8,15
"6758","GARISSA","LAGDERA","95",1,NA,1
"6759","GARISSA","LAGDERA","96",1,NA,1
"6760","GARISSA","LAGDERA","97",NA,NA,NA
"6761","GARISSA","LAGDERA","98",1,1,2
"6762","GARISSA","LAGDERA","99",1,1,2
"6763","GARISSA","LAGDERA","95-99",4,2,6
"6764","GARISSA","LAGDERA","100+",1,NA,1
"6765","GARISSA","LAGDERA","Not Stated",NA,1,1
"6766","HOMA BAY","ALL","Total",539560,592367,1131927
"6767","HOMA BAY","ALL","0",14085,14047,28132
"6768","HOMA BAY","ALL","1",14925,14557,29482
"6769","HOMA BAY","ALL","2",15474,15426,30900
"6770","HOMA BAY","ALL","3",16673,16890,33563
"6771","HOMA BAY","ALL","4",16874,16743,33617
"6772","HOMA BAY","ALL","0 - 4",78031,77663,155694
"6773","HOMA BAY","ALL","5",16994,16660,33654
"6774","HOMA BAY","ALL","6",16780,17333,34113
"6775","HOMA BAY","ALL","7",16157,16481,32638
"6776","HOMA BAY","ALL","8",15649,15636,31285
"6777","HOMA BAY","ALL","9",17539,17732,35271
"6778","HOMA BAY","ALL","5-9",83119,83842,166961
"6779","HOMA BAY","ALL","10",19116,18779,37895
"6780","HOMA BAY","ALL","11",16812,17025,33837
"6781","HOMA BAY","ALL","12",19661,19160,38821
"6782","HOMA BAY","ALL","13",18569,18687,37256
"6783","HOMA BAY","ALL","14",16809,16716,33525
"6784","HOMA BAY","ALL","10 -14",90967,90367,181334
"6785","HOMA BAY","ALL","15",16554,16566,33120
"6786","HOMA BAY","ALL","16",14702,14590,29292
"6787","HOMA BAY","ALL","17",14370,13595,27965
"6788","HOMA BAY","ALL","18",11410,10812,22222
"6789","HOMA BAY","ALL","19",11834,12354,24188
"6790","HOMA BAY","ALL","15-19",68870,67917,136787
"6791","HOMA BAY","ALL","20",10426,12272,22698
"6792","HOMA BAY","ALL","21",8973,10503,19476
"6793","HOMA BAY","ALL","22",7923,10045,17968
"6794","HOMA BAY","ALL","23",8516,10632,19148
"6795","HOMA BAY","ALL","24",7559,9143,16702
"6796","HOMA BAY","ALL","20-24",43397,52595,95992
"6797","HOMA BAY","ALL","25",8938,10465,19403
"6798","HOMA BAY","ALL","26",6752,8797,15549
"6799","HOMA BAY","ALL","27",7085,9403,16488
"6800","HOMA BAY","ALL","28",5057,6816,11873
"6801","HOMA BAY","ALL","29",5146,7045,12191
"6802","HOMA BAY","ALL","25-29",32978,42526,75504
"6803","HOMA BAY","ALL","30",7845,11232,19077
"6804","HOMA BAY","ALL","31",5414,7428,12842
"6805","HOMA BAY","ALL","32",6768,9505,16273
"6806","HOMA BAY","ALL","33",5910,8039,13949
"6807","HOMA BAY","ALL","34",5525,6637,12162
"6808","HOMA BAY","ALL","30-34",31462,42841,74303
"6809","HOMA BAY","ALL","35",7204,7687,14891
"6810","HOMA BAY","ALL","36",5185,4891,10076
"6811","HOMA BAY","ALL","37",5194,4654,9848
"6812","HOMA BAY","ALL","38",3564,3146,6710
"6813","HOMA BAY","ALL","39",4410,4006,8416
"6814","HOMA BAY","ALL","35-39",25557,24384,49941
"6815","HOMA BAY","ALL","40",5493,5683,11176
"6816","HOMA BAY","ALL","41",4665,4495,9160
"6817","HOMA BAY","ALL","42",4193,4405,8598
"6818","HOMA BAY","ALL","43",3951,4399,8350
"6819","HOMA BAY","ALL","44",3122,3593,6715
"6820","HOMA BAY","ALL","40-44",21424,22575,43999
"6821","HOMA BAY","ALL","45",4300,5193,9493
"6822","HOMA BAY","ALL","46",2995,3607,6602
"6823","HOMA BAY","ALL","47",3184,4148,7332
"6824","HOMA BAY","ALL","48",1842,2194,4036
"6825","HOMA BAY","ALL","49",2116,2573,4689
"6826","HOMA BAY","ALL","45-49",14437,17715,32152
"6827","HOMA BAY","ALL","50",2795,3980,6775
"6828","HOMA BAY","ALL","51",2155,2843,4998
"6829","HOMA BAY","ALL","52",1802,2300,4102
"6830","HOMA BAY","ALL","53",1563,1956,3519
"6831","HOMA BAY","ALL","54",1946,2236,4182
"6832","HOMA BAY","ALL","50-54",10261,13315,23576
"6833","HOMA BAY","ALL","55",2285,2643,4928
"6834","HOMA BAY","ALL","56",2260,3421,5681
"6835","HOMA BAY","ALL","57",2298,3821,6119
"6836","HOMA BAY","ALL","58",1369,1924,3293
"6837","HOMA BAY","ALL","59",1871,2608,4479
"6838","HOMA BAY","ALL","55-59",10083,14417,24500
"6839","HOMA BAY","ALL","60",2400,3780,6180
"6840","HOMA BAY","ALL","61",2102,2837,4939
"6841","HOMA BAY","ALL","62",1606,2030,3636
"6842","HOMA BAY","ALL","63",1652,2197,3849
"6843","HOMA BAY","ALL","64",1381,1810,3191
"6844","HOMA BAY","ALL","60-64",9141,12654,21795
"6845","HOMA BAY","ALL","65",1853,2654,4507
"6846","HOMA BAY","ALL","66",1268,1726,2994
"6847","HOMA BAY","ALL","67",1984,2885,4869
"6848","HOMA BAY","ALL","68",782,1047,1829
"6849","HOMA BAY","ALL","69",1304,1849,3153
"6850","HOMA BAY","ALL","65-69",7191,10161,17352
"6851","HOMA BAY","ALL","70",1882,3210,5092
"6852","HOMA BAY","ALL","71",1322,1554,2876
"6853","HOMA BAY","ALL","72",1044,1276,2320
"6854","HOMA BAY","ALL","73",847,1051,1898
"6855","HOMA BAY","ALL","74",799,1249,2048
"6856","HOMA BAY","ALL","70-74",5894,8340,14234
"6857","HOMA BAY","ALL","75",704,1112,1816
"6858","HOMA BAY","ALL","76",496,751,1247
"6859","HOMA BAY","ALL","77",779,1113,1892
"6860","HOMA BAY","ALL","78",343,537,880
"6861","HOMA BAY","ALL","79",489,1070,1559
"6862","HOMA BAY","ALL","75-79",2811,4583,7394
"6863","HOMA BAY","ALL","80",590,1275,1865
"6864","HOMA BAY","ALL","81",430,678,1108
"6865","HOMA BAY","ALL","82",351,407,758
"6866","HOMA BAY","ALL","83",422,529,951
"6867","HOMA BAY","ALL","84",312,562,874
"6868","HOMA BAY","ALL","80-84",2105,3451,5556
"6869","HOMA BAY","ALL","85",264,481,745
"6870","HOMA BAY","ALL","86",242,334,576
"6871","HOMA BAY","ALL","87",299,459,758
"6872","HOMA BAY","ALL","88",118,184,302
"6873","HOMA BAY","ALL","89",236,507,743
"6874","HOMA BAY","ALL","85-89",1159,1965,3124
"6875","HOMA BAY","ALL","90",142,278,420
"6876","HOMA BAY","ALL","91",110,133,243
"6877","HOMA BAY","ALL","92",67,74,141
"6878","HOMA BAY","ALL","93",48,81,129
"6879","HOMA BAY","ALL","94",46,70,116
"6880","HOMA BAY","ALL","90-94",413,636,1049
"6881","HOMA BAY","ALL","95",49,85,134
"6882","HOMA BAY","ALL","96",38,53,91
"6883","HOMA BAY","ALL","97",42,51,93
"6884","HOMA BAY","ALL","98",22,37,59
"6885","HOMA BAY","ALL","99",32,72,104
"6886","HOMA BAY","ALL","95-99",183,298,481
"6887","HOMA BAY","ALL","100+",74,116,190
"6888","HOMA BAY","ALL","Not Stated",3,6,9
"6889","HOMA BAY","HOMA BAY","Total",55756,61681,117437
"6890","HOMA BAY","HOMA BAY","0",1498,1527,3025
"6891","HOMA BAY","HOMA BAY","1",1508,1425,2933
"6892","HOMA BAY","HOMA BAY","2",1588,1571,3159
"6893","HOMA BAY","HOMA BAY","3",1738,1702,3440
"6894","HOMA BAY","HOMA BAY","4",1711,1664,3375
"6895","HOMA BAY","HOMA BAY","0 - 4",8043,7889,15932
"6896","HOMA BAY","HOMA BAY","5",1592,1599,3191
"6897","HOMA BAY","HOMA BAY","6",1646,1658,3304
"6898","HOMA BAY","HOMA BAY","7",1557,1610,3167
"6899","HOMA BAY","HOMA BAY","8",1457,1500,2957
"6900","HOMA BAY","HOMA BAY","9",1623,1781,3404
"6901","HOMA BAY","HOMA BAY","5-9",7875,8148,16023
"6902","HOMA BAY","HOMA BAY","10",1710,1820,3530
"6903","HOMA BAY","HOMA BAY","11",1529,1663,3192
"6904","HOMA BAY","HOMA BAY","12",1838,1856,3694
"6905","HOMA BAY","HOMA BAY","13",1753,1805,3558
"6906","HOMA BAY","HOMA BAY","14",1568,1625,3193
"6907","HOMA BAY","HOMA BAY","10 -14",8398,8769,17167
"6908","HOMA BAY","HOMA BAY","15",1501,1669,3170
"6909","HOMA BAY","HOMA BAY","16",1375,1538,2913
"6910","HOMA BAY","HOMA BAY","17",1463,1438,2901
"6911","HOMA BAY","HOMA BAY","18",1134,1147,2281
"6912","HOMA BAY","HOMA BAY","19",1310,1426,2736
"6913","HOMA BAY","HOMA BAY","15-19",6783,7218,14001
"6914","HOMA BAY","HOMA BAY","20",1120,1419,2539
"6915","HOMA BAY","HOMA BAY","21",1040,1264,2304
"6916","HOMA BAY","HOMA BAY","22",1008,1292,2300
"6917","HOMA BAY","HOMA BAY","23",1065,1421,2486
"6918","HOMA BAY","HOMA BAY","24",976,1242,2218
"6919","HOMA BAY","HOMA BAY","20-24",5209,6638,11847
"6920","HOMA BAY","HOMA BAY","25",1171,1356,2527
"6921","HOMA BAY","HOMA BAY","26",839,1158,1997
"6922","HOMA BAY","HOMA BAY","27",863,1125,1988
"6923","HOMA BAY","HOMA BAY","28",690,852,1542
"6924","HOMA BAY","HOMA BAY","29",686,837,1523
"6925","HOMA BAY","HOMA BAY","25-29",4249,5328,9577
"6926","HOMA BAY","HOMA BAY","30",947,1370,2317
"6927","HOMA BAY","HOMA BAY","31",654,899,1553
"6928","HOMA BAY","HOMA BAY","32",882,1248,2130
"6929","HOMA BAY","HOMA BAY","33",692,995,1687
"6930","HOMA BAY","HOMA BAY","34",684,755,1439
"6931","HOMA BAY","HOMA BAY","30-34",3859,5267,9126
"6932","HOMA BAY","HOMA BAY","35",870,771,1641
"6933","HOMA BAY","HOMA BAY","36",606,527,1133
"6934","HOMA BAY","HOMA BAY","37",599,473,1072
"6935","HOMA BAY","HOMA BAY","38",438,374,812
"6936","HOMA BAY","HOMA BAY","39",505,394,899
"6937","HOMA BAY","HOMA BAY","35-39",3018,2539,5557
"6938","HOMA BAY","HOMA BAY","40",672,614,1286
"6939","HOMA BAY","HOMA BAY","41",504,463,967
"6940","HOMA BAY","HOMA BAY","42",444,459,903
"6941","HOMA BAY","HOMA BAY","43",416,393,809
"6942","HOMA BAY","HOMA BAY","44",318,366,684
"6943","HOMA BAY","HOMA BAY","40-44",2354,2295,4649
"6944","HOMA BAY","HOMA BAY","45",481,523,1004
"6945","HOMA BAY","HOMA BAY","46",282,306,588
"6946","HOMA BAY","HOMA BAY","47",320,362,682
"6947","HOMA BAY","HOMA BAY","48",211,215,426
"6948","HOMA BAY","HOMA BAY","49",239,250,489
"6949","HOMA BAY","HOMA BAY","45-49",1533,1656,3189
"6950","HOMA BAY","HOMA BAY","50",288,417,705
"6951","HOMA BAY","HOMA BAY","51",229,285,514
"6952","HOMA BAY","HOMA BAY","52",199,206,405
"6953","HOMA BAY","HOMA BAY","53",146,195,341
"6954","HOMA BAY","HOMA BAY","54",198,242,440
"6955","HOMA BAY","HOMA BAY","50-54",1060,1345,2405
"6956","HOMA BAY","HOMA BAY","55",245,256,501
"6957","HOMA BAY","HOMA BAY","56",205,291,496
"6958","HOMA BAY","HOMA BAY","57",221,353,574
"6959","HOMA BAY","HOMA BAY","58",145,195,340
"6960","HOMA BAY","HOMA BAY","59",174,242,416
"6961","HOMA BAY","HOMA BAY","55-59",990,1337,2327
"6962","HOMA BAY","HOMA BAY","60",213,325,538
"6963","HOMA BAY","HOMA BAY","61",202,222,424
"6964","HOMA BAY","HOMA BAY","62",143,170,313
"6965","HOMA BAY","HOMA BAY","63",147,166,313
"6966","HOMA BAY","HOMA BAY","64",128,146,274
"6967","HOMA BAY","HOMA BAY","60-64",833,1029,1862
"6968","HOMA BAY","HOMA BAY","65",179,215,394
"6969","HOMA BAY","HOMA BAY","66",104,138,242
"6970","HOMA BAY","HOMA BAY","67",136,201,337
"6971","HOMA BAY","HOMA BAY","68",61,73,134
"6972","HOMA BAY","HOMA BAY","69",96,126,222
"6973","HOMA BAY","HOMA BAY","65-69",576,753,1329
"6974","HOMA BAY","HOMA BAY","70",160,281,441
"6975","HOMA BAY","HOMA BAY","71",96,98,194
"6976","HOMA BAY","HOMA BAY","72",81,94,175
"6977","HOMA BAY","HOMA BAY","73",73,75,148
"6978","HOMA BAY","HOMA BAY","74",79,93,172
"6979","HOMA BAY","HOMA BAY","70-74",489,641,1130
"6980","HOMA BAY","HOMA BAY","75",55,99,154
"6981","HOMA BAY","HOMA BAY","76",37,51,88
"6982","HOMA BAY","HOMA BAY","77",63,77,140
"6983","HOMA BAY","HOMA BAY","78",23,39,62
"6984","HOMA BAY","HOMA BAY","79",39,78,117
"6985","HOMA BAY","HOMA BAY","75-79",217,344,561
"6986","HOMA BAY","HOMA BAY","80",50,114,164
"6987","HOMA BAY","HOMA BAY","81",25,44,69
"6988","HOMA BAY","HOMA BAY","82",22,26,48
"6989","HOMA BAY","HOMA BAY","83",31,36,67
"6990","HOMA BAY","HOMA BAY","84",17,33,50
"6991","HOMA BAY","HOMA BAY","80-84",145,253,398
"6992","HOMA BAY","HOMA BAY","85",24,45,69
"6993","HOMA BAY","HOMA BAY","86",10,24,34
"6994","HOMA BAY","HOMA BAY","87",20,31,51
"6995","HOMA BAY","HOMA BAY","88",16,23,39
"6996","HOMA BAY","HOMA BAY","89",12,35,47
"6997","HOMA BAY","HOMA BAY","85-89",82,158,240
"6998","HOMA BAY","HOMA BAY","90",7,19,26
"6999","HOMA BAY","HOMA BAY","91",3,7,10
"7000","HOMA BAY","HOMA BAY","92",9,5,14
"7001","HOMA BAY","HOMA BAY","93",1,3,4
"7002","HOMA BAY","HOMA BAY","94",4,5,9
"7003","HOMA BAY","HOMA BAY","90-94",24,39,63
"7004","HOMA BAY","HOMA BAY","95",5,9,14
"7005","HOMA BAY","HOMA BAY","96",3,7,10
"7006","HOMA BAY","HOMA BAY","97",3,5,8
"7007","HOMA BAY","HOMA BAY","98",NA,1,1
"7008","HOMA BAY","HOMA BAY","99",3,4,7
"7009","HOMA BAY","HOMA BAY","95-99",14,26,40
"7010","HOMA BAY","HOMA BAY","100+",4,9,13
"7011","HOMA BAY","HOMA BAY","Not Stated",1,NA,1
"7012","HOMA BAY","NDHIWA","Total",103706,114422,218128
"7013","HOMA BAY","NDHIWA","0",2983,3104,6087
"7014","HOMA BAY","NDHIWA","1",3241,3138,6379
"7015","HOMA BAY","NDHIWA","2",3374,3312,6686
"7016","HOMA BAY","NDHIWA","3",3571,3596,7167
"7017","HOMA BAY","NDHIWA","4",3624,3648,7272
"7018","HOMA BAY","NDHIWA","0 - 4",16793,16798,33591
"7019","HOMA BAY","NDHIWA","5",3580,3498,7078
"7020","HOMA BAY","NDHIWA","6",3525,3635,7160
"7021","HOMA BAY","NDHIWA","7",3274,3481,6755
"7022","HOMA BAY","NDHIWA","8",3268,3209,6477
"7023","HOMA BAY","NDHIWA","9",3579,3589,7168
"7024","HOMA BAY","NDHIWA","5-9",17226,17412,34638
"7025","HOMA BAY","NDHIWA","10",3866,3839,7705
"7026","HOMA BAY","NDHIWA","11",3275,3390,6665
"7027","HOMA BAY","NDHIWA","12",3872,3703,7575
"7028","HOMA BAY","NDHIWA","13",3528,3536,7064
"7029","HOMA BAY","NDHIWA","14",3296,3247,6543
"7030","HOMA BAY","NDHIWA","10 -14",17837,17715,35552
"7031","HOMA BAY","NDHIWA","15",3282,3163,6445
"7032","HOMA BAY","NDHIWA","16",2769,2723,5492
"7033","HOMA BAY","NDHIWA","17",2650,2440,5090
"7034","HOMA BAY","NDHIWA","18",2113,2007,4120
"7035","HOMA BAY","NDHIWA","19",2165,2309,4474
"7036","HOMA BAY","NDHIWA","15-19",12979,12642,25621
"7037","HOMA BAY","NDHIWA","20",1949,2439,4388
"7038","HOMA BAY","NDHIWA","21",1652,2011,3663
"7039","HOMA BAY","NDHIWA","22",1532,1860,3392
"7040","HOMA BAY","NDHIWA","23",1571,1962,3533
"7041","HOMA BAY","NDHIWA","24",1412,1676,3088
"7042","HOMA BAY","NDHIWA","20-24",8116,9948,18064
"7043","HOMA BAY","NDHIWA","25",1532,1983,3515
"7044","HOMA BAY","NDHIWA","26",1248,1682,2930
"7045","HOMA BAY","NDHIWA","27",1345,1861,3206
"7046","HOMA BAY","NDHIWA","28",892,1203,2095
"7047","HOMA BAY","NDHIWA","29",963,1329,2292
"7048","HOMA BAY","NDHIWA","25-29",5980,8058,14038
"7049","HOMA BAY","NDHIWA","30",1421,2139,3560
"7050","HOMA BAY","NDHIWA","31",1055,1581,2636
"7051","HOMA BAY","NDHIWA","32",1184,1761,2945
"7052","HOMA BAY","NDHIWA","33",994,1419,2413
"7053","HOMA BAY","NDHIWA","34",934,1083,2017
"7054","HOMA BAY","NDHIWA","30-34",5588,7983,13571
"7055","HOMA BAY","NDHIWA","35",1215,1236,2451
"7056","HOMA BAY","NDHIWA","36",828,748,1576
"7057","HOMA BAY","NDHIWA","37",924,752,1676
"7058","HOMA BAY","NDHIWA","38",557,518,1075
"7059","HOMA BAY","NDHIWA","39",748,691,1439
"7060","HOMA BAY","NDHIWA","35-39",4272,3945,8217
"7061","HOMA BAY","NDHIWA","40",920,1022,1942
"7062","HOMA BAY","NDHIWA","41",829,870,1699
"7063","HOMA BAY","NDHIWA","42",802,888,1690
"7064","HOMA BAY","NDHIWA","43",720,880,1600
"7065","HOMA BAY","NDHIWA","44",560,662,1222
"7066","HOMA BAY","NDHIWA","40-44",3831,4322,8153
"7067","HOMA BAY","NDHIWA","45",702,888,1590
"7068","HOMA BAY","NDHIWA","46",594,701,1295
"7069","HOMA BAY","NDHIWA","47",587,717,1304
"7070","HOMA BAY","NDHIWA","48",283,376,659
"7071","HOMA BAY","NDHIWA","49",340,450,790
"7072","HOMA BAY","NDHIWA","45-49",2506,3132,5638
"7073","HOMA BAY","NDHIWA","50",465,736,1201
"7074","HOMA BAY","NDHIWA","51",395,455,850
"7075","HOMA BAY","NDHIWA","52",322,403,725
"7076","HOMA BAY","NDHIWA","53",271,376,647
"7077","HOMA BAY","NDHIWA","54",345,376,721
"7078","HOMA BAY","NDHIWA","50-54",1798,2346,4144
"7079","HOMA BAY","NDHIWA","55",411,464,875
"7080","HOMA BAY","NDHIWA","56",342,640,982
"7081","HOMA BAY","NDHIWA","57",430,667,1097
"7082","HOMA BAY","NDHIWA","58",222,305,527
"7083","HOMA BAY","NDHIWA","59",302,439,741
"7084","HOMA BAY","NDHIWA","55-59",1707,2515,4222
"7085","HOMA BAY","NDHIWA","60",413,643,1056
"7086","HOMA BAY","NDHIWA","61",347,506,853
"7087","HOMA BAY","NDHIWA","62",302,351,653
"7088","HOMA BAY","NDHIWA","63",284,400,684
"7089","HOMA BAY","NDHIWA","64",231,352,583
"7090","HOMA BAY","NDHIWA","60-64",1577,2252,3829
"7091","HOMA BAY","NDHIWA","65",318,486,804
"7092","HOMA BAY","NDHIWA","66",229,323,552
"7093","HOMA BAY","NDHIWA","67",343,532,875
"7094","HOMA BAY","NDHIWA","68",141,201,342
"7095","HOMA BAY","NDHIWA","69",225,347,572
"7096","HOMA BAY","NDHIWA","65-69",1256,1889,3145
"7097","HOMA BAY","NDHIWA","70",344,588,932
"7098","HOMA BAY","NDHIWA","71",226,254,480
"7099","HOMA BAY","NDHIWA","72",184,237,421
"7100","HOMA BAY","NDHIWA","73",156,202,358
"7101","HOMA BAY","NDHIWA","74",134,234,368
"7102","HOMA BAY","NDHIWA","70-74",1044,1515,2559
"7103","HOMA BAY","NDHIWA","75",108,200,308
"7104","HOMA BAY","NDHIWA","76",82,148,230
"7105","HOMA BAY","NDHIWA","77",143,202,345
"7106","HOMA BAY","NDHIWA","78",60,93,153
"7107","HOMA BAY","NDHIWA","79",80,183,263
"7108","HOMA BAY","NDHIWA","75-79",473,826,1299
"7109","HOMA BAY","NDHIWA","80",111,217,328
"7110","HOMA BAY","NDHIWA","81",69,118,187
"7111","HOMA BAY","NDHIWA","82",63,83,146
"7112","HOMA BAY","NDHIWA","83",70,102,172
"7113","HOMA BAY","NDHIWA","84",60,97,157
"7114","HOMA BAY","NDHIWA","80-84",373,617,990
"7115","HOMA BAY","NDHIWA","85",46,87,133
"7116","HOMA BAY","NDHIWA","86",43,57,100
"7117","HOMA BAY","NDHIWA","87",60,89,149
"7118","HOMA BAY","NDHIWA","88",16,27,43
"7119","HOMA BAY","NDHIWA","89",53,86,139
"7120","HOMA BAY","NDHIWA","85-89",218,346,564
"7121","HOMA BAY","NDHIWA","90",31,39,70
"7122","HOMA BAY","NDHIWA","91",21,22,43
"7123","HOMA BAY","NDHIWA","92",11,7,18
"7124","HOMA BAY","NDHIWA","93",14,18,32
"7125","HOMA BAY","NDHIWA","94",6,12,18
"7126","HOMA BAY","NDHIWA","90-94",83,98,181
"7127","HOMA BAY","NDHIWA","95",10,14,24
"7128","HOMA BAY","NDHIWA","96",5,7,12
"7129","HOMA BAY","NDHIWA","97",8,5,13
"7130","HOMA BAY","NDHIWA","98",5,7,12
"7131","HOMA BAY","NDHIWA","99",4,10,14
"7132","HOMA BAY","NDHIWA","95-99",32,43,75
"7133","HOMA BAY","NDHIWA","100+",17,18,35
"7134","HOMA BAY","NDHIWA","Not Stated",NA,2,2
"7135","HOMA BAY","RACHUONYO NORTH","Total",85409,93273,178682
"7136","HOMA BAY","RACHUONYO NORTH","0",1975,2033,4008
"7137","HOMA BAY","RACHUONYO NORTH","1",2243,2127,4370
"7138","HOMA BAY","RACHUONYO NORTH","2",2306,2223,4529
"7139","HOMA BAY","RACHUONYO NORTH","3",2424,2614,5038
"7140","HOMA BAY","RACHUONYO NORTH","4",2495,2461,4956
"7141","HOMA BAY","RACHUONYO NORTH","0 - 4",11443,11458,22901
"7142","HOMA BAY","RACHUONYO NORTH","5",2577,2472,5049
"7143","HOMA BAY","RACHUONYO NORTH","6",2516,2584,5100
"7144","HOMA BAY","RACHUONYO NORTH","7",2490,2473,4963
"7145","HOMA BAY","RACHUONYO NORTH","8",2336,2355,4691
"7146","HOMA BAY","RACHUONYO NORTH","9",2736,2770,5506
"7147","HOMA BAY","RACHUONYO NORTH","5-9",12655,12654,25309
"7148","HOMA BAY","RACHUONYO NORTH","10",2970,2827,5797
"7149","HOMA BAY","RACHUONYO NORTH","11",2653,2638,5291
"7150","HOMA BAY","RACHUONYO NORTH","12",3112,3004,6116
"7151","HOMA BAY","RACHUONYO NORTH","13",2869,2953,5822
"7152","HOMA BAY","RACHUONYO NORTH","14",2652,2627,5279
"7153","HOMA BAY","RACHUONYO NORTH","10 -14",14256,14049,28305
"7154","HOMA BAY","RACHUONYO NORTH","15",2652,2557,5209
"7155","HOMA BAY","RACHUONYO NORTH","16",2349,2318,4667
"7156","HOMA BAY","RACHUONYO NORTH","17",2454,2191,4645
"7157","HOMA BAY","RACHUONYO NORTH","18",1857,1776,3633
"7158","HOMA BAY","RACHUONYO NORTH","19",1919,1936,3855
"7159","HOMA BAY","RACHUONYO NORTH","15-19",11231,10778,22009
"7160","HOMA BAY","RACHUONYO NORTH","20",1671,1913,3584
"7161","HOMA BAY","RACHUONYO NORTH","21",1572,1615,3187
"7162","HOMA BAY","RACHUONYO NORTH","22",1268,1496,2764
"7163","HOMA BAY","RACHUONYO NORTH","23",1344,1584,2928
"7164","HOMA BAY","RACHUONYO NORTH","24",1128,1381,2509
"7165","HOMA BAY","RACHUONYO NORTH","20-24",6983,7989,14972
"7166","HOMA BAY","RACHUONYO NORTH","25",1374,1469,2843
"7167","HOMA BAY","RACHUONYO NORTH","26",1014,1268,2282
"7168","HOMA BAY","RACHUONYO NORTH","27",1119,1387,2506
"7169","HOMA BAY","RACHUONYO NORTH","28",774,1026,1800
"7170","HOMA BAY","RACHUONYO NORTH","29",759,1077,1836
"7171","HOMA BAY","RACHUONYO NORTH","25-29",5040,6227,11267
"7172","HOMA BAY","RACHUONYO NORTH","30",1237,1724,2961
"7173","HOMA BAY","RACHUONYO NORTH","31",727,980,1707
"7174","HOMA BAY","RACHUONYO NORTH","32",1003,1275,2278
"7175","HOMA BAY","RACHUONYO NORTH","33",887,1169,2056
"7176","HOMA BAY","RACHUONYO NORTH","34",871,1062,1933
"7177","HOMA BAY","RACHUONYO NORTH","30-34",4725,6210,10935
"7178","HOMA BAY","RACHUONYO NORTH","35",1029,1198,2227
"7179","HOMA BAY","RACHUONYO NORTH","36",764,824,1588
"7180","HOMA BAY","RACHUONYO NORTH","37",844,840,1684
"7181","HOMA BAY","RACHUONYO NORTH","38",572,524,1096
"7182","HOMA BAY","RACHUONYO NORTH","39",759,715,1474
"7183","HOMA BAY","RACHUONYO NORTH","35-39",3968,4101,8069
"7184","HOMA BAY","RACHUONYO NORTH","40",878,915,1793
"7185","HOMA BAY","RACHUONYO NORTH","41",705,736,1441
"7186","HOMA BAY","RACHUONYO NORTH","42",676,650,1326
"7187","HOMA BAY","RACHUONYO NORTH","43",657,659,1316
"7188","HOMA BAY","RACHUONYO NORTH","44",494,592,1086
"7189","HOMA BAY","RACHUONYO NORTH","40-44",3410,3552,6962
"7190","HOMA BAY","RACHUONYO NORTH","45",707,846,1553
"7191","HOMA BAY","RACHUONYO NORTH","46",514,611,1125
"7192","HOMA BAY","RACHUONYO NORTH","47",465,667,1132
"7193","HOMA BAY","RACHUONYO NORTH","48",311,376,687
"7194","HOMA BAY","RACHUONYO NORTH","49",351,464,815
"7195","HOMA BAY","RACHUONYO NORTH","45-49",2348,2964,5312
"7196","HOMA BAY","RACHUONYO NORTH","50",496,639,1135
"7197","HOMA BAY","RACHUONYO NORTH","51",384,544,928
"7198","HOMA BAY","RACHUONYO NORTH","52",310,414,724
"7199","HOMA BAY","RACHUONYO NORTH","53",273,344,617
"7200","HOMA BAY","RACHUONYO NORTH","54",348,376,724
"7201","HOMA BAY","RACHUONYO NORTH","50-54",1811,2317,4128
"7202","HOMA BAY","RACHUONYO NORTH","55",405,508,913
"7203","HOMA BAY","RACHUONYO NORTH","56",413,640,1053
"7204","HOMA BAY","RACHUONYO NORTH","57",403,680,1083
"7205","HOMA BAY","RACHUONYO NORTH","58",255,346,601
"7206","HOMA BAY","RACHUONYO NORTH","59",355,478,833
"7207","HOMA BAY","RACHUONYO NORTH","55-59",1831,2652,4483
"7208","HOMA BAY","RACHUONYO NORTH","60",471,699,1170
"7209","HOMA BAY","RACHUONYO NORTH","61",395,534,929
"7210","HOMA BAY","RACHUONYO NORTH","62",298,422,720
"7211","HOMA BAY","RACHUONYO NORTH","63",350,423,773
"7212","HOMA BAY","RACHUONYO NORTH","64",271,324,595
"7213","HOMA BAY","RACHUONYO NORTH","60-64",1785,2402,4187
"7214","HOMA BAY","RACHUONYO NORTH","65",359,518,877
"7215","HOMA BAY","RACHUONYO NORTH","66",256,356,612
"7216","HOMA BAY","RACHUONYO NORTH","67",416,577,993
"7217","HOMA BAY","RACHUONYO NORTH","68",151,192,343
"7218","HOMA BAY","RACHUONYO NORTH","69",266,352,618
"7219","HOMA BAY","RACHUONYO NORTH","65-69",1448,1995,3443
"7220","HOMA BAY","RACHUONYO NORTH","70",360,658,1018
"7221","HOMA BAY","RACHUONYO NORTH","71",271,308,579
"7222","HOMA BAY","RACHUONYO NORTH","72",200,255,455
"7223","HOMA BAY","RACHUONYO NORTH","73",160,218,378
"7224","HOMA BAY","RACHUONYO NORTH","74",164,236,400
"7225","HOMA BAY","RACHUONYO NORTH","70-74",1155,1675,2830
"7226","HOMA BAY","RACHUONYO NORTH","75",146,194,340
"7227","HOMA BAY","RACHUONYO NORTH","76",85,139,224
"7228","HOMA BAY","RACHUONYO NORTH","77",166,224,390
"7229","HOMA BAY","RACHUONYO NORTH","78",74,99,173
"7230","HOMA BAY","RACHUONYO NORTH","79",124,196,320
"7231","HOMA BAY","RACHUONYO NORTH","75-79",595,852,1447
"7232","HOMA BAY","RACHUONYO NORTH","80",108,283,391
"7233","HOMA BAY","RACHUONYO NORTH","81",94,153,247
"7234","HOMA BAY","RACHUONYO NORTH","82",67,86,153
"7235","HOMA BAY","RACHUONYO NORTH","83",66,126,192
"7236","HOMA BAY","RACHUONYO NORTH","84",66,128,194
"7237","HOMA BAY","RACHUONYO NORTH","80-84",401,776,1177
"7238","HOMA BAY","RACHUONYO NORTH","85",41,86,127
"7239","HOMA BAY","RACHUONYO NORTH","86",45,61,106
"7240","HOMA BAY","RACHUONYO NORTH","87",57,98,155
"7241","HOMA BAY","RACHUONYO NORTH","88",25,45,70
"7242","HOMA BAY","RACHUONYO NORTH","89",47,115,162
"7243","HOMA BAY","RACHUONYO NORTH","85-89",215,405,620
"7244","HOMA BAY","RACHUONYO NORTH","90",20,59,79
"7245","HOMA BAY","RACHUONYO NORTH","91",17,17,34
"7246","HOMA BAY","RACHUONYO NORTH","92",15,15,30
"7247","HOMA BAY","RACHUONYO NORTH","93",10,17,27
"7248","HOMA BAY","RACHUONYO NORTH","94",12,16,28
"7249","HOMA BAY","RACHUONYO NORTH","90-94",74,124,198
"7250","HOMA BAY","RACHUONYO NORTH","95",2,20,22
"7251","HOMA BAY","RACHUONYO NORTH","96",4,14,18
"7252","HOMA BAY","RACHUONYO NORTH","97",8,7,15
"7253","HOMA BAY","RACHUONYO NORTH","98",5,13,18
"7254","HOMA BAY","RACHUONYO NORTH","99",5,13,18
"7255","HOMA BAY","RACHUONYO NORTH","95-99",24,67,91
"7256","HOMA BAY","RACHUONYO NORTH","100+",10,24,34
"7257","HOMA BAY","RACHUONYO NORTH","Not Stated",1,2,3
"7258","HOMA BAY","RACHUONYO EAST","Total",57709,64111,121820
"7259","HOMA BAY","RACHUONYO EAST","0",1455,1401,2856
"7260","HOMA BAY","RACHUONYO EAST","1",1489,1473,2962
"7261","HOMA BAY","RACHUONYO EAST","2",1552,1600,3152
"7262","HOMA BAY","RACHUONYO EAST","3",1637,1730,3367
"7263","HOMA BAY","RACHUONYO EAST","4",1684,1704,3388
"7264","HOMA BAY","RACHUONYO EAST","0 - 4",7817,7908,15725
"7265","HOMA BAY","RACHUONYO EAST","5",1744,1709,3453
"7266","HOMA BAY","RACHUONYO EAST","6",1794,1891,3685
"7267","HOMA BAY","RACHUONYO EAST","7",1773,1712,3485
"7268","HOMA BAY","RACHUONYO EAST","8",1727,1685,3412
"7269","HOMA BAY","RACHUONYO EAST","9",1931,1942,3873
"7270","HOMA BAY","RACHUONYO EAST","5-9",8969,8939,17908
"7271","HOMA BAY","RACHUONYO EAST","10",2213,2069,4282
"7272","HOMA BAY","RACHUONYO EAST","11",1993,1954,3947
"7273","HOMA BAY","RACHUONYO EAST","12",2270,2201,4471
"7274","HOMA BAY","RACHUONYO EAST","13",2210,2204,4414
"7275","HOMA BAY","RACHUONYO EAST","14",1966,1968,3934
"7276","HOMA BAY","RACHUONYO EAST","10 -14",10652,10396,21048
"7277","HOMA BAY","RACHUONYO EAST","15",1980,1869,3849
"7278","HOMA BAY","RACHUONYO EAST","16",1728,1679,3407
"7279","HOMA BAY","RACHUONYO EAST","17",1698,1582,3280
"7280","HOMA BAY","RACHUONYO EAST","18",1302,1183,2485
"7281","HOMA BAY","RACHUONYO EAST","19",1251,1302,2553
"7282","HOMA BAY","RACHUONYO EAST","15-19",7959,7615,15574
"7283","HOMA BAY","RACHUONYO EAST","20",1097,1198,2295
"7284","HOMA BAY","RACHUONYO EAST","21",890,977,1867
"7285","HOMA BAY","RACHUONYO EAST","22",774,1004,1778
"7286","HOMA BAY","RACHUONYO EAST","23",775,1042,1817
"7287","HOMA BAY","RACHUONYO EAST","24",660,858,1518
"7288","HOMA BAY","RACHUONYO EAST","20-24",4196,5079,9275
"7289","HOMA BAY","RACHUONYO EAST","25",829,1073,1902
"7290","HOMA BAY","RACHUONYO EAST","26",611,848,1459
"7291","HOMA BAY","RACHUONYO EAST","27",682,945,1627
"7292","HOMA BAY","RACHUONYO EAST","28",481,669,1150
"7293","HOMA BAY","RACHUONYO EAST","29",507,684,1191
"7294","HOMA BAY","RACHUONYO EAST","25-29",3110,4219,7329
"7295","HOMA BAY","RACHUONYO EAST","30",773,1172,1945
"7296","HOMA BAY","RACHUONYO EAST","31",524,708,1232
"7297","HOMA BAY","RACHUONYO EAST","32",580,862,1442
"7298","HOMA BAY","RACHUONYO EAST","33",500,823,1323
"7299","HOMA BAY","RACHUONYO EAST","34",520,708,1228
"7300","HOMA BAY","RACHUONYO EAST","30-34",2897,4273,7170
"7301","HOMA BAY","RACHUONYO EAST","35",683,782,1465
"7302","HOMA BAY","RACHUONYO EAST","36",487,542,1029
"7303","HOMA BAY","RACHUONYO EAST","37",479,540,1019
"7304","HOMA BAY","RACHUONYO EAST","38",308,367,675
"7305","HOMA BAY","RACHUONYO EAST","39",440,431,871
"7306","HOMA BAY","RACHUONYO EAST","35-39",2397,2662,5059
"7307","HOMA BAY","RACHUONYO EAST","40",523,613,1136
"7308","HOMA BAY","RACHUONYO EAST","41",545,519,1064
"7309","HOMA BAY","RACHUONYO EAST","42",396,437,833
"7310","HOMA BAY","RACHUONYO EAST","43",409,533,942
"7311","HOMA BAY","RACHUONYO EAST","44",310,395,705
"7312","HOMA BAY","RACHUONYO EAST","40-44",2183,2497,4680
"7313","HOMA BAY","RACHUONYO EAST","45",485,637,1122
"7314","HOMA BAY","RACHUONYO EAST","46",308,439,747
"7315","HOMA BAY","RACHUONYO EAST","47",336,594,930
"7316","HOMA BAY","RACHUONYO EAST","48",190,300,490
"7317","HOMA BAY","RACHUONYO EAST","49",218,316,534
"7318","HOMA BAY","RACHUONYO EAST","45-49",1537,2286,3823
"7319","HOMA BAY","RACHUONYO EAST","50",275,418,693
"7320","HOMA BAY","RACHUONYO EAST","51",234,296,530
"7321","HOMA BAY","RACHUONYO EAST","52",180,249,429
"7322","HOMA BAY","RACHUONYO EAST","53",170,213,383
"7323","HOMA BAY","RACHUONYO EAST","54",248,297,545
"7324","HOMA BAY","RACHUONYO EAST","50-54",1107,1473,2580
"7325","HOMA BAY","RACHUONYO EAST","55",256,311,567
"7326","HOMA BAY","RACHUONYO EAST","56",268,388,656
"7327","HOMA BAY","RACHUONYO EAST","57",273,494,767
"7328","HOMA BAY","RACHUONYO EAST","58",175,242,417
"7329","HOMA BAY","RACHUONYO EAST","59",240,330,570
"7330","HOMA BAY","RACHUONYO EAST","55-59",1212,1765,2977
"7331","HOMA BAY","RACHUONYO EAST","60",316,489,805
"7332","HOMA BAY","RACHUONYO EAST","61",275,353,628
"7333","HOMA BAY","RACHUONYO EAST","62",199,240,439
"7334","HOMA BAY","RACHUONYO EAST","63",202,251,453
"7335","HOMA BAY","RACHUONYO EAST","64",181,216,397
"7336","HOMA BAY","RACHUONYO EAST","60-64",1173,1549,2722
"7337","HOMA BAY","RACHUONYO EAST","65",209,320,529
"7338","HOMA BAY","RACHUONYO EAST","66",155,195,350
"7339","HOMA BAY","RACHUONYO EAST","67",255,350,605
"7340","HOMA BAY","RACHUONYO EAST","68",108,118,226
"7341","HOMA BAY","RACHUONYO EAST","69",161,230,391
"7342","HOMA BAY","RACHUONYO EAST","65-69",888,1213,2101
"7343","HOMA BAY","RACHUONYO EAST","70",215,356,571
"7344","HOMA BAY","RACHUONYO EAST","71",172,171,343
"7345","HOMA BAY","RACHUONYO EAST","72",139,142,281
"7346","HOMA BAY","RACHUONYO EAST","73",116,118,234
"7347","HOMA BAY","RACHUONYO EAST","74",96,147,243
"7348","HOMA BAY","RACHUONYO EAST","70-74",738,934,1672
"7349","HOMA BAY","RACHUONYO EAST","75",93,135,228
"7350","HOMA BAY","RACHUONYO EAST","76",68,75,143
"7351","HOMA BAY","RACHUONYO EAST","77",91,111,202
"7352","HOMA BAY","RACHUONYO EAST","78",43,68,111
"7353","HOMA BAY","RACHUONYO EAST","79",54,137,191
"7354","HOMA BAY","RACHUONYO EAST","75-79",349,526,875
"7355","HOMA BAY","RACHUONYO EAST","80",72,140,212
"7356","HOMA BAY","RACHUONYO EAST","81",72,89,161
"7357","HOMA BAY","RACHUONYO EAST","82",37,46,83
"7358","HOMA BAY","RACHUONYO EAST","83",51,68,119
"7359","HOMA BAY","RACHUONYO EAST","84",44,75,119
"7360","HOMA BAY","RACHUONYO EAST","80-84",276,418,694
"7361","HOMA BAY","RACHUONYO EAST","85",42,44,86
"7362","HOMA BAY","RACHUONYO EAST","86",28,32,60
"7363","HOMA BAY","RACHUONYO EAST","87",42,45,87
"7364","HOMA BAY","RACHUONYO EAST","88",12,26,38
"7365","HOMA BAY","RACHUONYO EAST","89",30,63,93
"7366","HOMA BAY","RACHUONYO EAST","85-89",154,210,364
"7367","HOMA BAY","RACHUONYO EAST","90",18,30,48
"7368","HOMA BAY","RACHUONYO EAST","91",20,28,48
"7369","HOMA BAY","RACHUONYO EAST","92",6,9,15
"7370","HOMA BAY","RACHUONYO EAST","93",5,13,18
"7371","HOMA BAY","RACHUONYO EAST","94",4,8,12
"7372","HOMA BAY","RACHUONYO EAST","90-94",53,88,141
"7373","HOMA BAY","RACHUONYO EAST","95",9,13,22
"7374","HOMA BAY","RACHUONYO EAST","96",6,6,12
"7375","HOMA BAY","RACHUONYO EAST","97",4,8,12
"7376","HOMA BAY","RACHUONYO EAST","98",8,8,16
"7377","HOMA BAY","RACHUONYO EAST","99",4,12,16
"7378","HOMA BAY","RACHUONYO EAST","95-99",31,47,78
"7379","HOMA BAY","RACHUONYO EAST","100+",11,13,24
"7380","HOMA BAY","RACHUONYO EAST","Not Stated",NA,1,1
"7381","HOMA BAY","RACHUONYO SOUTH","Total",61663,69151,130814
"7382","HOMA BAY","RACHUONYO SOUTH","0",1588,1556,3144
"7383","HOMA BAY","RACHUONYO SOUTH","1",1688,1663,3351
"7384","HOMA BAY","RACHUONYO SOUTH","2",1696,1707,3403
"7385","HOMA BAY","RACHUONYO SOUTH","3",1902,1777,3679
"7386","HOMA BAY","RACHUONYO SOUTH","4",1858,1822,3680
"7387","HOMA BAY","RACHUONYO SOUTH","0 - 4",8732,8525,17257
"7388","HOMA BAY","RACHUONYO SOUTH","5",1856,1809,3665
"7389","HOMA BAY","RACHUONYO SOUTH","6",1795,1960,3755
"7390","HOMA BAY","RACHUONYO SOUTH","7",1825,1917,3742
"7391","HOMA BAY","RACHUONYO SOUTH","8",1691,1823,3514
"7392","HOMA BAY","RACHUONYO SOUTH","9",1980,1986,3966
"7393","HOMA BAY","RACHUONYO SOUTH","5-9",9147,9495,18642
"7394","HOMA BAY","RACHUONYO SOUTH","10",2268,2219,4487
"7395","HOMA BAY","RACHUONYO SOUTH","11",1957,1869,3826
"7396","HOMA BAY","RACHUONYO SOUTH","12",2256,2223,4479
"7397","HOMA BAY","RACHUONYO SOUTH","13",2188,2222,4410
"7398","HOMA BAY","RACHUONYO SOUTH","14",1938,1952,3890
"7399","HOMA BAY","RACHUONYO SOUTH","10 -14",10607,10485,21092
"7400","HOMA BAY","RACHUONYO SOUTH","15",1851,2022,3873
"7401","HOMA BAY","RACHUONYO SOUTH","16",1747,1776,3523
"7402","HOMA BAY","RACHUONYO SOUTH","17",1668,1599,3267
"7403","HOMA BAY","RACHUONYO SOUTH","18",1339,1362,2701
"7404","HOMA BAY","RACHUONYO SOUTH","19",1406,1468,2874
"7405","HOMA BAY","RACHUONYO SOUTH","15-19",8011,8227,16238
"7406","HOMA BAY","RACHUONYO SOUTH","20",1199,1428,2627
"7407","HOMA BAY","RACHUONYO SOUTH","21",1021,1230,2251
"7408","HOMA BAY","RACHUONYO SOUTH","22",892,1172,2064
"7409","HOMA BAY","RACHUONYO SOUTH","23",941,1237,2178
"7410","HOMA BAY","RACHUONYO SOUTH","24",847,1021,1868
"7411","HOMA BAY","RACHUONYO SOUTH","20-24",4900,6088,10988
"7412","HOMA BAY","RACHUONYO SOUTH","25",1019,1232,2251
"7413","HOMA BAY","RACHUONYO SOUTH","26",779,1030,1809
"7414","HOMA BAY","RACHUONYO SOUTH","27",847,1134,1981
"7415","HOMA BAY","RACHUONYO SOUTH","28",631,862,1493
"7416","HOMA BAY","RACHUONYO SOUTH","29",575,850,1425
"7417","HOMA BAY","RACHUONYO SOUTH","25-29",3851,5108,8959
"7418","HOMA BAY","RACHUONYO SOUTH","30",886,1262,2148
"7419","HOMA BAY","RACHUONYO SOUTH","31",573,827,1400
"7420","HOMA BAY","RACHUONYO SOUTH","32",710,1070,1780
"7421","HOMA BAY","RACHUONYO SOUTH","33",695,926,1621
"7422","HOMA BAY","RACHUONYO SOUTH","34",585,796,1381
"7423","HOMA BAY","RACHUONYO SOUTH","30-34",3449,4881,8330
"7424","HOMA BAY","RACHUONYO SOUTH","35",769,928,1697
"7425","HOMA BAY","RACHUONYO SOUTH","36",568,582,1150
"7426","HOMA BAY","RACHUONYO SOUTH","37",609,557,1166
"7427","HOMA BAY","RACHUONYO SOUTH","38",447,424,871
"7428","HOMA BAY","RACHUONYO SOUTH","39",488,509,997
"7429","HOMA BAY","RACHUONYO SOUTH","35-39",2881,3000,5881
"7430","HOMA BAY","RACHUONYO SOUTH","40",661,690,1351
"7431","HOMA BAY","RACHUONYO SOUTH","41",569,581,1150
"7432","HOMA BAY","RACHUONYO SOUTH","42",463,551,1014
"7433","HOMA BAY","RACHUONYO SOUTH","43",451,569,1020
"7434","HOMA BAY","RACHUONYO SOUTH","44",364,407,771
"7435","HOMA BAY","RACHUONYO SOUTH","40-44",2508,2798,5306
"7436","HOMA BAY","RACHUONYO SOUTH","45",497,616,1113
"7437","HOMA BAY","RACHUONYO SOUTH","46",312,448,760
"7438","HOMA BAY","RACHUONYO SOUTH","47",381,515,896
"7439","HOMA BAY","RACHUONYO SOUTH","48",205,265,470
"7440","HOMA BAY","RACHUONYO SOUTH","49",247,275,522
"7441","HOMA BAY","RACHUONYO SOUTH","45-49",1642,2119,3761
"7442","HOMA BAY","RACHUONYO SOUTH","50",338,516,854
"7443","HOMA BAY","RACHUONYO SOUTH","51",230,336,566
"7444","HOMA BAY","RACHUONYO SOUTH","52",218,294,512
"7445","HOMA BAY","RACHUONYO SOUTH","53",177,238,415
"7446","HOMA BAY","RACHUONYO SOUTH","54",241,293,534
"7447","HOMA BAY","RACHUONYO SOUTH","50-54",1204,1677,2881
"7448","HOMA BAY","RACHUONYO SOUTH","55",287,345,632
"7449","HOMA BAY","RACHUONYO SOUTH","56",312,384,696
"7450","HOMA BAY","RACHUONYO SOUTH","57",272,465,737
"7451","HOMA BAY","RACHUONYO SOUTH","58",169,270,439
"7452","HOMA BAY","RACHUONYO SOUTH","59",232,312,544
"7453","HOMA BAY","RACHUONYO SOUTH","55-59",1272,1776,3048
"7454","HOMA BAY","RACHUONYO SOUTH","60",261,489,750
"7455","HOMA BAY","RACHUONYO SOUTH","61",244,384,628
"7456","HOMA BAY","RACHUONYO SOUTH","62",186,243,429
"7457","HOMA BAY","RACHUONYO SOUTH","63",179,284,463
"7458","HOMA BAY","RACHUONYO SOUTH","64",164,183,347
"7459","HOMA BAY","RACHUONYO SOUTH","60-64",1034,1583,2617
"7460","HOMA BAY","RACHUONYO SOUTH","65",219,332,551
"7461","HOMA BAY","RACHUONYO SOUTH","66",159,197,356
"7462","HOMA BAY","RACHUONYO SOUTH","67",253,313,566
"7463","HOMA BAY","RACHUONYO SOUTH","68",93,127,220
"7464","HOMA BAY","RACHUONYO SOUTH","69",146,194,340
"7465","HOMA BAY","RACHUONYO SOUTH","65-69",870,1163,2033
"7466","HOMA BAY","RACHUONYO SOUTH","70",244,388,632
"7467","HOMA BAY","RACHUONYO SOUTH","71",171,184,355
"7468","HOMA BAY","RACHUONYO SOUTH","72",117,157,274
"7469","HOMA BAY","RACHUONYO SOUTH","73",108,121,229
"7470","HOMA BAY","RACHUONYO SOUTH","74",92,125,217
"7471","HOMA BAY","RACHUONYO SOUTH","70-74",732,975,1707
"7472","HOMA BAY","RACHUONYO SOUTH","75",106,128,234
"7473","HOMA BAY","RACHUONYO SOUTH","76",63,83,146
"7474","HOMA BAY","RACHUONYO SOUTH","77",88,132,220
"7475","HOMA BAY","RACHUONYO SOUTH","78",48,63,111
"7476","HOMA BAY","RACHUONYO SOUTH","79",55,105,160
"7477","HOMA BAY","RACHUONYO SOUTH","75-79",360,511,871
"7478","HOMA BAY","RACHUONYO SOUTH","80",72,148,220
"7479","HOMA BAY","RACHUONYO SOUTH","81",36,69,105
"7480","HOMA BAY","RACHUONYO SOUTH","82",41,48,89
"7481","HOMA BAY","RACHUONYO SOUTH","83",60,69,129
"7482","HOMA BAY","RACHUONYO SOUTH","84",37,50,87
"7483","HOMA BAY","RACHUONYO SOUTH","80-84",246,384,630
"7484","HOMA BAY","RACHUONYO SOUTH","85",37,64,101
"7485","HOMA BAY","RACHUONYO SOUTH","86",33,51,84
"7486","HOMA BAY","RACHUONYO SOUTH","87",38,43,81
"7487","HOMA BAY","RACHUONYO SOUTH","88",15,17,32
"7488","HOMA BAY","RACHUONYO SOUTH","89",27,56,83
"7489","HOMA BAY","RACHUONYO SOUTH","85-89",150,231,381
"7490","HOMA BAY","RACHUONYO SOUTH","90",12,41,53
"7491","HOMA BAY","RACHUONYO SOUTH","91",12,13,25
"7492","HOMA BAY","RACHUONYO SOUTH","92",7,11,18
"7493","HOMA BAY","RACHUONYO SOUTH","93",7,4,11
"7494","HOMA BAY","RACHUONYO SOUTH","94",4,10,14
"7495","HOMA BAY","RACHUONYO SOUTH","90-94",42,79,121
"7496","HOMA BAY","RACHUONYO SOUTH","95",5,7,12
"7497","HOMA BAY","RACHUONYO SOUTH","96",6,4,10
"7498","HOMA BAY","RACHUONYO SOUTH","97",6,6,12
"7499","HOMA BAY","RACHUONYO SOUTH","98",NA,1,1
"7500","HOMA BAY","RACHUONYO SOUTH","99",1,9,10
"7501","HOMA BAY","RACHUONYO SOUTH","95-99",18,27,45
"7502","HOMA BAY","RACHUONYO SOUTH","100+",7,19,26
"7503","HOMA BAY","RACHUONYO SOUTH","Not Stated",NA,NA,NA
"7504","HOMA BAY","RANGWE","Total",55404,62325,117729
"7505","HOMA BAY","RANGWE","0",1306,1283,2589
"7506","HOMA BAY","RANGWE","1",1546,1500,3046
"7507","HOMA BAY","RANGWE","2",1614,1547,3161
"7508","HOMA BAY","RANGWE","3",1711,1704,3415
"7509","HOMA BAY","RANGWE","4",1845,1768,3613
"7510","HOMA BAY","RANGWE","0 - 4",8022,7802,15824
"7511","HOMA BAY","RANGWE","5",1863,1742,3605
"7512","HOMA BAY","RANGWE","6",1778,1793,3571
"7513","HOMA BAY","RANGWE","7",1811,1787,3598
"7514","HOMA BAY","RANGWE","8",1736,1633,3369
"7515","HOMA BAY","RANGWE","9",1894,1893,3787
"7516","HOMA BAY","RANGWE","5-9",9082,8848,17930
"7517","HOMA BAY","RANGWE","10",2111,2042,4153
"7518","HOMA BAY","RANGWE","11",1827,1862,3689
"7519","HOMA BAY","RANGWE","12",2135,2070,4205
"7520","HOMA BAY","RANGWE","13",2054,2041,4095
"7521","HOMA BAY","RANGWE","14",1817,1897,3714
"7522","HOMA BAY","RANGWE","10 -14",9944,9912,19856
"7523","HOMA BAY","RANGWE","15",1768,1794,3562
"7524","HOMA BAY","RANGWE","16",1581,1514,3095
"7525","HOMA BAY","RANGWE","17",1497,1472,2969
"7526","HOMA BAY","RANGWE","18",1286,1097,2383
"7527","HOMA BAY","RANGWE","19",1252,1263,2515
"7528","HOMA BAY","RANGWE","15-19",7384,7140,14524
"7529","HOMA BAY","RANGWE","20",1039,1169,2208
"7530","HOMA BAY","RANGWE","21",897,1031,1928
"7531","HOMA BAY","RANGWE","22",740,953,1693
"7532","HOMA BAY","RANGWE","23",778,1018,1796
"7533","HOMA BAY","RANGWE","24",716,870,1586
"7534","HOMA BAY","RANGWE","20-24",4170,5041,9211
"7535","HOMA BAY","RANGWE","25",748,881,1629
"7536","HOMA BAY","RANGWE","26",634,796,1430
"7537","HOMA BAY","RANGWE","27",597,844,1441
"7538","HOMA BAY","RANGWE","28",431,694,1125
"7539","HOMA BAY","RANGWE","29",425,697,1122
"7540","HOMA BAY","RANGWE","25-29",2835,3912,6747
"7541","HOMA BAY","RANGWE","30",624,1106,1730
"7542","HOMA BAY","RANGWE","31",479,770,1249
"7543","HOMA BAY","RANGWE","32",627,1119,1746
"7544","HOMA BAY","RANGWE","33",548,941,1489
"7545","HOMA BAY","RANGWE","34",497,749,1246
"7546","HOMA BAY","RANGWE","30-34",2775,4685,7460
"7547","HOMA BAY","RANGWE","35",689,885,1574
"7548","HOMA BAY","RANGWE","36",487,445,932
"7549","HOMA BAY","RANGWE","37",448,431,879
"7550","HOMA BAY","RANGWE","38",346,290,636
"7551","HOMA BAY","RANGWE","39",409,430,839
"7552","HOMA BAY","RANGWE","35-39",2379,2481,4860
"7553","HOMA BAY","RANGWE","40",489,594,1083
"7554","HOMA BAY","RANGWE","41",434,436,870
"7555","HOMA BAY","RANGWE","42",394,439,833
"7556","HOMA BAY","RANGWE","43",372,437,809
"7557","HOMA BAY","RANGWE","44",259,376,635
"7558","HOMA BAY","RANGWE","40-44",1948,2282,4230
"7559","HOMA BAY","RANGWE","45",398,600,998
"7560","HOMA BAY","RANGWE","46",280,360,640
"7561","HOMA BAY","RANGWE","47",275,407,682
"7562","HOMA BAY","RANGWE","48",172,219,391
"7563","HOMA BAY","RANGWE","49",201,315,516
"7564","HOMA BAY","RANGWE","45-49",1326,1901,3227
"7565","HOMA BAY","RANGWE","50",315,522,837
"7566","HOMA BAY","RANGWE","51",225,381,606
"7567","HOMA BAY","RANGWE","52",191,288,479
"7568","HOMA BAY","RANGWE","53",146,197,343
"7569","HOMA BAY","RANGWE","54",190,250,440
"7570","HOMA BAY","RANGWE","50-54",1067,1638,2705
"7571","HOMA BAY","RANGWE","55",253,284,537
"7572","HOMA BAY","RANGWE","56",257,415,672
"7573","HOMA BAY","RANGWE","57",248,438,686
"7574","HOMA BAY","RANGWE","58",146,208,354
"7575","HOMA BAY","RANGWE","59",196,303,499
"7576","HOMA BAY","RANGWE","55-59",1100,1648,2748
"7577","HOMA BAY","RANGWE","60",285,459,744
"7578","HOMA BAY","RANGWE","61",251,310,561
"7579","HOMA BAY","RANGWE","62",188,248,436
"7580","HOMA BAY","RANGWE","63",204,234,438
"7581","HOMA BAY","RANGWE","64",145,233,378
"7582","HOMA BAY","RANGWE","60-64",1073,1484,2557
"7583","HOMA BAY","RANGWE","65",217,331,548
"7584","HOMA BAY","RANGWE","66",145,196,341
"7585","HOMA BAY","RANGWE","67",220,346,566
"7586","HOMA BAY","RANGWE","68",92,135,227
"7587","HOMA BAY","RANGWE","69",153,223,376
"7588","HOMA BAY","RANGWE","65-69",827,1231,2058
"7589","HOMA BAY","RANGWE","70",252,345,597
"7590","HOMA BAY","RANGWE","71",163,204,367
"7591","HOMA BAY","RANGWE","72",128,155,283
"7592","HOMA BAY","RANGWE","73",90,103,193
"7593","HOMA BAY","RANGWE","74",76,161,237
"7594","HOMA BAY","RANGWE","70-74",709,968,1677
"7595","HOMA BAY","RANGWE","75",78,131,209
"7596","HOMA BAY","RANGWE","76",66,89,155
"7597","HOMA BAY","RANGWE","77",87,141,228
"7598","HOMA BAY","RANGWE","78",34,76,110
"7599","HOMA BAY","RANGWE","79",47,158,205
"7600","HOMA BAY","RANGWE","75-79",312,595,907
"7601","HOMA BAY","RANGWE","80",59,152,211
"7602","HOMA BAY","RANGWE","81",47,80,127
"7603","HOMA BAY","RANGWE","82",42,45,87
"7604","HOMA BAY","RANGWE","83",55,45,100
"7605","HOMA BAY","RANGWE","84",30,71,101
"7606","HOMA BAY","RANGWE","80-84",233,393,626
"7607","HOMA BAY","RANGWE","85",27,55,82
"7608","HOMA BAY","RANGWE","86",37,49,86
"7609","HOMA BAY","RANGWE","87",26,65,91
"7610","HOMA BAY","RANGWE","88",17,16,33
"7611","HOMA BAY","RANGWE","89",27,51,78
"7612","HOMA BAY","RANGWE","85-89",134,236,370
"7613","HOMA BAY","RANGWE","90",18,40,58
"7614","HOMA BAY","RANGWE","91",13,14,27
"7615","HOMA BAY","RANGWE","92",7,13,20
"7616","HOMA BAY","RANGWE","93",6,6,12
"7617","HOMA BAY","RANGWE","94",6,6,12
"7618","HOMA BAY","RANGWE","90-94",50,79,129
"7619","HOMA BAY","RANGWE","95",8,9,17
"7620","HOMA BAY","RANGWE","96",5,4,9
"7621","HOMA BAY","RANGWE","97",4,8,12
"7622","HOMA BAY","RANGWE","98",1,3,4
"7623","HOMA BAY","RANGWE","99",6,10,16
"7624","HOMA BAY","RANGWE","95-99",24,34,58
"7625","HOMA BAY","RANGWE","100+",10,15,25
"7626","HOMA BAY","RANGWE","Not Stated",NA,NA,NA
"7627","HOMA BAY","SUBA NORTH","Total",60530,64406,124936
"7628","HOMA BAY","SUBA NORTH","0",1582,1507,3089
"7629","HOMA BAY","SUBA NORTH","1",1520,1538,3058
"7630","HOMA BAY","SUBA NORTH","2",1616,1707,3323
"7631","HOMA BAY","SUBA NORTH","3",1742,1839,3581
"7632","HOMA BAY","SUBA NORTH","4",1837,1852,3689
"7633","HOMA BAY","SUBA NORTH","0 - 4",8297,8443,16740
"7634","HOMA BAY","SUBA NORTH","5",1778,1872,3650
"7635","HOMA BAY","SUBA NORTH","6",1803,1884,3687
"7636","HOMA BAY","SUBA NORTH","7",1730,1784,3514
"7637","HOMA BAY","SUBA NORTH","8",1672,1654,3326
"7638","HOMA BAY","SUBA NORTH","9",1874,1862,3736
"7639","HOMA BAY","SUBA NORTH","5-9",8857,9056,17913
"7640","HOMA BAY","SUBA NORTH","10",1933,1957,3890
"7641","HOMA BAY","SUBA NORTH","11",1757,1870,3627
"7642","HOMA BAY","SUBA NORTH","12",2065,1970,4035
"7643","HOMA BAY","SUBA NORTH","13",2032,1956,3988
"7644","HOMA BAY","SUBA NORTH","14",1804,1719,3523
"7645","HOMA BAY","SUBA NORTH","10 -14",9591,9472,19063
"7646","HOMA BAY","SUBA NORTH","15",1741,1746,3487
"7647","HOMA BAY","SUBA NORTH","16",1611,1553,3164
"7648","HOMA BAY","SUBA NORTH","17",1486,1465,2951
"7649","HOMA BAY","SUBA NORTH","18",1146,1121,2267
"7650","HOMA BAY","SUBA NORTH","19",1290,1292,2582
"7651","HOMA BAY","SUBA NORTH","15-19",7274,7177,14451
"7652","HOMA BAY","SUBA NORTH","20",1194,1338,2532
"7653","HOMA BAY","SUBA NORTH","21",937,1170,2107
"7654","HOMA BAY","SUBA NORTH","22",859,1183,2042
"7655","HOMA BAY","SUBA NORTH","23",1042,1219,2261
"7656","HOMA BAY","SUBA NORTH","24",925,1050,1975
"7657","HOMA BAY","SUBA NORTH","20-24",4957,5960,10917
"7658","HOMA BAY","SUBA NORTH","25",1147,1319,2466
"7659","HOMA BAY","SUBA NORTH","26",838,1074,1912
"7660","HOMA BAY","SUBA NORTH","27",817,1077,1894
"7661","HOMA BAY","SUBA NORTH","28",651,794,1445
"7662","HOMA BAY","SUBA NORTH","29",659,793,1452
"7663","HOMA BAY","SUBA NORTH","25-29",4112,5057,9169
"7664","HOMA BAY","SUBA NORTH","30",1010,1283,2293
"7665","HOMA BAY","SUBA NORTH","31",717,811,1528
"7666","HOMA BAY","SUBA NORTH","32",984,1139,2123
"7667","HOMA BAY","SUBA NORTH","33",896,969,1865
"7668","HOMA BAY","SUBA NORTH","34",789,836,1625
"7669","HOMA BAY","SUBA NORTH","30-34",4396,5038,9434
"7670","HOMA BAY","SUBA NORTH","35",1043,1024,2067
"7671","HOMA BAY","SUBA NORTH","36",830,687,1517
"7672","HOMA BAY","SUBA NORTH","37",694,552,1246
"7673","HOMA BAY","SUBA NORTH","38",512,366,878
"7674","HOMA BAY","SUBA NORTH","39",592,460,1052
"7675","HOMA BAY","SUBA NORTH","35-39",3671,3089,6760
"7676","HOMA BAY","SUBA NORTH","40",764,654,1418
"7677","HOMA BAY","SUBA NORTH","41",588,473,1061
"7678","HOMA BAY","SUBA NORTH","42",558,490,1048
"7679","HOMA BAY","SUBA NORTH","43",503,508,1011
"7680","HOMA BAY","SUBA NORTH","44",449,401,850
"7681","HOMA BAY","SUBA NORTH","40-44",2862,2526,5388
"7682","HOMA BAY","SUBA NORTH","45",511,516,1027
"7683","HOMA BAY","SUBA NORTH","46",353,343,696
"7684","HOMA BAY","SUBA NORTH","47",405,407,812
"7685","HOMA BAY","SUBA NORTH","48",235,227,462
"7686","HOMA BAY","SUBA NORTH","49",251,234,485
"7687","HOMA BAY","SUBA NORTH","45-49",1755,1727,3482
"7688","HOMA BAY","SUBA NORTH","50",315,353,668
"7689","HOMA BAY","SUBA NORTH","51",229,280,509
"7690","HOMA BAY","SUBA NORTH","52",192,226,418
"7691","HOMA BAY","SUBA NORTH","53",197,213,410
"7692","HOMA BAY","SUBA NORTH","54",201,235,436
"7693","HOMA BAY","SUBA NORTH","50-54",1134,1307,2441
"7694","HOMA BAY","SUBA NORTH","55",234,255,489
"7695","HOMA BAY","SUBA NORTH","56",248,355,603
"7696","HOMA BAY","SUBA NORTH","57",222,376,598
"7697","HOMA BAY","SUBA NORTH","58",137,198,335
"7698","HOMA BAY","SUBA NORTH","59",174,242,416
"7699","HOMA BAY","SUBA NORTH","55-59",1015,1426,2441
"7700","HOMA BAY","SUBA NORTH","60",240,356,596
"7701","HOMA BAY","SUBA NORTH","61",187,280,467
"7702","HOMA BAY","SUBA NORTH","62",151,194,345
"7703","HOMA BAY","SUBA NORTH","63",153,244,397
"7704","HOMA BAY","SUBA NORTH","64",129,182,311
"7705","HOMA BAY","SUBA NORTH","60-64",860,1256,2116
"7706","HOMA BAY","SUBA NORTH","65",179,243,422
"7707","HOMA BAY","SUBA NORTH","66",110,163,273
"7708","HOMA BAY","SUBA NORTH","67",187,299,486
"7709","HOMA BAY","SUBA NORTH","68",63,105,168
"7710","HOMA BAY","SUBA NORTH","69",110,176,286
"7711","HOMA BAY","SUBA NORTH","65-69",649,986,1635
"7712","HOMA BAY","SUBA NORTH","70",162,303,465
"7713","HOMA BAY","SUBA NORTH","71",108,159,267
"7714","HOMA BAY","SUBA NORTH","72",89,118,207
"7715","HOMA BAY","SUBA NORTH","73",70,114,184
"7716","HOMA BAY","SUBA NORTH","74",76,113,189
"7717","HOMA BAY","SUBA NORTH","70-74",505,807,1312
"7718","HOMA BAY","SUBA NORTH","75",61,114,175
"7719","HOMA BAY","SUBA NORTH","76",49,83,132
"7720","HOMA BAY","SUBA NORTH","77",66,111,177
"7721","HOMA BAY","SUBA NORTH","78",33,55,88
"7722","HOMA BAY","SUBA NORTH","79",39,108,147
"7723","HOMA BAY","SUBA NORTH","75-79",248,471,719
"7724","HOMA BAY","SUBA NORTH","80",44,89,133
"7725","HOMA BAY","SUBA NORTH","81",41,71,112
"7726","HOMA BAY","SUBA NORTH","82",40,38,78
"7727","HOMA BAY","SUBA NORTH","83",39,38,77
"7728","HOMA BAY","SUBA NORTH","84",29,52,81
"7729","HOMA BAY","SUBA NORTH","80-84",193,288,481
"7730","HOMA BAY","SUBA NORTH","85",23,57,80
"7731","HOMA BAY","SUBA NORTH","86",19,34,53
"7732","HOMA BAY","SUBA NORTH","87",25,50,75
"7733","HOMA BAY","SUBA NORTH","88",11,15,26
"7734","HOMA BAY","SUBA NORTH","89",10,54,64
"7735","HOMA BAY","SUBA NORTH","85-89",88,210,298
"7736","HOMA BAY","SUBA NORTH","90",22,26,48
"7737","HOMA BAY","SUBA NORTH","91",9,17,26
"7738","HOMA BAY","SUBA NORTH","92",5,8,13
"7739","HOMA BAY","SUBA NORTH","93",3,10,13
"7740","HOMA BAY","SUBA NORTH","94",4,11,15
"7741","HOMA BAY","SUBA NORTH","90-94",43,72,115
"7742","HOMA BAY","SUBA NORTH","95",6,7,13
"7743","HOMA BAY","SUBA NORTH","96",2,8,10
"7744","HOMA BAY","SUBA NORTH","97",4,4,8
"7745","HOMA BAY","SUBA NORTH","98",1,2,3
"7746","HOMA BAY","SUBA NORTH","99",3,5,8
"7747","HOMA BAY","SUBA NORTH","95-99",16,26,42
"7748","HOMA BAY","SUBA NORTH","100+",7,12,19
"7749","HOMA BAY","SUBA NORTH","Not Stated",NA,NA,NA
"7750","HOMA BAY","SUBA SOUTH","Total",59383,62998,122381
"7751","HOMA BAY","SUBA SOUTH","0",1698,1636,3334
"7752","HOMA BAY","SUBA SOUTH","1",1690,1693,3383
"7753","HOMA BAY","SUBA SOUTH","2",1728,1759,3487
"7754","HOMA BAY","SUBA SOUTH","3",1948,1928,3876
"7755","HOMA BAY","SUBA SOUTH","4",1820,1824,3644
"7756","HOMA BAY","SUBA SOUTH","0 - 4",8884,8840,17724
"7757","HOMA BAY","SUBA SOUTH","5",2004,1959,3963
"7758","HOMA BAY","SUBA SOUTH","6",1923,1928,3851
"7759","HOMA BAY","SUBA SOUTH","7",1697,1717,3414
"7760","HOMA BAY","SUBA SOUTH","8",1762,1777,3539
"7761","HOMA BAY","SUBA SOUTH","9",1922,1909,3831
"7762","HOMA BAY","SUBA SOUTH","5-9",9308,9290,18598
"7763","HOMA BAY","SUBA SOUTH","10",2045,2006,4051
"7764","HOMA BAY","SUBA SOUTH","11",1821,1779,3600
"7765","HOMA BAY","SUBA SOUTH","12",2113,2133,4246
"7766","HOMA BAY","SUBA SOUTH","13",1935,1970,3905
"7767","HOMA BAY","SUBA SOUTH","14",1768,1681,3449
"7768","HOMA BAY","SUBA SOUTH","10 -14",9682,9569,19251
"7769","HOMA BAY","SUBA SOUTH","15",1779,1746,3525
"7770","HOMA BAY","SUBA SOUTH","16",1542,1489,3031
"7771","HOMA BAY","SUBA SOUTH","17",1454,1408,2862
"7772","HOMA BAY","SUBA SOUTH","18",1233,1119,2352
"7773","HOMA BAY","SUBA SOUTH","19",1241,1358,2599
"7774","HOMA BAY","SUBA SOUTH","15-19",7249,7120,14369
"7775","HOMA BAY","SUBA SOUTH","20",1157,1368,2525
"7776","HOMA BAY","SUBA SOUTH","21",964,1205,2169
"7777","HOMA BAY","SUBA SOUTH","22",850,1085,1935
"7778","HOMA BAY","SUBA SOUTH","23",1000,1149,2149
"7779","HOMA BAY","SUBA SOUTH","24",895,1045,1940
"7780","HOMA BAY","SUBA SOUTH","20-24",4866,5852,10718
"7781","HOMA BAY","SUBA SOUTH","25",1118,1152,2270
"7782","HOMA BAY","SUBA SOUTH","26",789,941,1730
"7783","HOMA BAY","SUBA SOUTH","27",815,1030,1845
"7784","HOMA BAY","SUBA SOUTH","28",507,716,1223
"7785","HOMA BAY","SUBA SOUTH","29",572,778,1350
"7786","HOMA BAY","SUBA SOUTH","25-29",3801,4617,8418
"7787","HOMA BAY","SUBA SOUTH","30",947,1176,2123
"7788","HOMA BAY","SUBA SOUTH","31",685,852,1537
"7789","HOMA BAY","SUBA SOUTH","32",798,1031,1829
"7790","HOMA BAY","SUBA SOUTH","33",698,797,1495
"7791","HOMA BAY","SUBA SOUTH","34",645,648,1293
"7792","HOMA BAY","SUBA SOUTH","30-34",3773,4504,8277
"7793","HOMA BAY","SUBA SOUTH","35",906,863,1769
"7794","HOMA BAY","SUBA SOUTH","36",615,536,1151
"7795","HOMA BAY","SUBA SOUTH","37",597,509,1106
"7796","HOMA BAY","SUBA SOUTH","38",384,283,667
"7797","HOMA BAY","SUBA SOUTH","39",469,376,845
"7798","HOMA BAY","SUBA SOUTH","35-39",2971,2567,5538
"7799","HOMA BAY","SUBA SOUTH","40",586,581,1167
"7800","HOMA BAY","SUBA SOUTH","41",491,417,908
"7801","HOMA BAY","SUBA SOUTH","42",460,491,951
"7802","HOMA BAY","SUBA SOUTH","43",423,420,843
"7803","HOMA BAY","SUBA SOUTH","44",368,394,762
"7804","HOMA BAY","SUBA SOUTH","40-44",2328,2303,4631
"7805","HOMA BAY","SUBA SOUTH","45",519,567,1086
"7806","HOMA BAY","SUBA SOUTH","46",352,399,751
"7807","HOMA BAY","SUBA SOUTH","47",415,479,894
"7808","HOMA BAY","SUBA SOUTH","48",235,216,451
"7809","HOMA BAY","SUBA SOUTH","49",269,269,538
"7810","HOMA BAY","SUBA SOUTH","45-49",1790,1930,3720
"7811","HOMA BAY","SUBA SOUTH","50",303,379,682
"7812","HOMA BAY","SUBA SOUTH","51",229,266,495
"7813","HOMA BAY","SUBA SOUTH","52",190,220,410
"7814","HOMA BAY","SUBA SOUTH","53",183,180,363
"7815","HOMA BAY","SUBA SOUTH","54",175,167,342
"7816","HOMA BAY","SUBA SOUTH","50-54",1080,1212,2292
"7817","HOMA BAY","SUBA SOUTH","55",194,220,414
"7818","HOMA BAY","SUBA SOUTH","56",215,308,523
"7819","HOMA BAY","SUBA SOUTH","57",229,348,577
"7820","HOMA BAY","SUBA SOUTH","58",120,160,280
"7821","HOMA BAY","SUBA SOUTH","59",198,262,460
"7822","HOMA BAY","SUBA SOUTH","55-59",956,1298,2254
"7823","HOMA BAY","SUBA SOUTH","60",201,320,521
"7824","HOMA BAY","SUBA SOUTH","61",201,248,449
"7825","HOMA BAY","SUBA SOUTH","62",139,162,301
"7826","HOMA BAY","SUBA SOUTH","63",133,195,328
"7827","HOMA BAY","SUBA SOUTH","64",132,174,306
"7828","HOMA BAY","SUBA SOUTH","60-64",806,1099,1905
"7829","HOMA BAY","SUBA SOUTH","65",173,209,382
"7830","HOMA BAY","SUBA SOUTH","66",110,158,268
"7831","HOMA BAY","SUBA SOUTH","67",174,267,441
"7832","HOMA BAY","SUBA SOUTH","68",73,96,169
"7833","HOMA BAY","SUBA SOUTH","69",147,201,348
"7834","HOMA BAY","SUBA SOUTH","65-69",677,931,1608
"7835","HOMA BAY","SUBA SOUTH","70",145,291,436
"7836","HOMA BAY","SUBA SOUTH","71",115,176,291
"7837","HOMA BAY","SUBA SOUTH","72",106,118,224
"7838","HOMA BAY","SUBA SOUTH","73",74,100,174
"7839","HOMA BAY","SUBA SOUTH","74",82,140,222
"7840","HOMA BAY","SUBA SOUTH","70-74",522,825,1347
"7841","HOMA BAY","SUBA SOUTH","75",57,111,168
"7842","HOMA BAY","SUBA SOUTH","76",46,83,129
"7843","HOMA BAY","SUBA SOUTH","77",75,115,190
"7844","HOMA BAY","SUBA SOUTH","78",28,44,72
"7845","HOMA BAY","SUBA SOUTH","79",51,105,156
"7846","HOMA BAY","SUBA SOUTH","75-79",257,458,715
"7847","HOMA BAY","SUBA SOUTH","80",74,132,206
"7848","HOMA BAY","SUBA SOUTH","81",46,54,100
"7849","HOMA BAY","SUBA SOUTH","82",39,35,74
"7850","HOMA BAY","SUBA SOUTH","83",50,45,95
"7851","HOMA BAY","SUBA SOUTH","84",29,56,85
"7852","HOMA BAY","SUBA SOUTH","80-84",238,322,560
"7853","HOMA BAY","SUBA SOUTH","85",24,43,67
"7854","HOMA BAY","SUBA SOUTH","86",27,26,53
"7855","HOMA BAY","SUBA SOUTH","87",31,38,69
"7856","HOMA BAY","SUBA SOUTH","88",6,15,21
"7857","HOMA BAY","SUBA SOUTH","89",30,47,77
"7858","HOMA BAY","SUBA SOUTH","85-89",118,169,287
"7859","HOMA BAY","SUBA SOUTH","90",14,24,38
"7860","HOMA BAY","SUBA SOUTH","91",15,15,30
"7861","HOMA BAY","SUBA SOUTH","92",7,6,13
"7862","HOMA BAY","SUBA SOUTH","93",2,10,12
"7863","HOMA BAY","SUBA SOUTH","94",6,2,8
"7864","HOMA BAY","SUBA SOUTH","90-94",44,57,101
"7865","HOMA BAY","SUBA SOUTH","95",4,6,10
"7866","HOMA BAY","SUBA SOUTH","96",7,3,10
"7867","HOMA BAY","SUBA SOUTH","97",5,8,13
"7868","HOMA BAY","SUBA SOUTH","98",2,2,4
"7869","HOMA BAY","SUBA SOUTH","99",6,9,15
"7870","HOMA BAY","SUBA SOUTH","95-99",24,28,52
"7871","HOMA BAY","SUBA SOUTH","100+",8,6,14
"7872","HOMA BAY","SUBA SOUTH","Not Stated",1,1,2
"7873","ISIOLO","ALL","Total",139510,128483,267993
"7874","ISIOLO","ALL","0",3277,3254,6531
"7875","ISIOLO","ALL","1",3401,3385,6786
"7876","ISIOLO","ALL","2",4691,4527,9218
"7877","ISIOLO","ALL","3",4422,4357,8779
"7878","ISIOLO","ALL","4",4654,4649,9303
"7879","ISIOLO","ALL","0 - 4",20445,20172,40617
"7880","ISIOLO","ALL","5",4515,4318,8833
"7881","ISIOLO","ALL","6",4576,4339,8915
"7882","ISIOLO","ALL","7",3983,3803,7786
"7883","ISIOLO","ALL","8",4459,4269,8728
"7884","ISIOLO","ALL","9",3536,3347,6883
"7885","ISIOLO","ALL","5-9",21069,20076,41145
"7886","ISIOLO","ALL","10",5462,4939,10401
"7887","ISIOLO","ALL","11",3070,3095,6165
"7888","ISIOLO","ALL","12",4618,3781,8399
"7889","ISIOLO","ALL","13",3582,3309,6891
"7890","ISIOLO","ALL","14",3757,3301,7058
"7891","ISIOLO","ALL","10 -14",20489,18425,38914
"7892","ISIOLO","ALL","15",4471,3498,7969
"7893","ISIOLO","ALL","16",3444,2937,6381
"7894","ISIOLO","ALL","17",3784,2986,6770
"7895","ISIOLO","ALL","18",3175,2720,5895
"7896","ISIOLO","ALL","19",2134,2005,4139
"7897","ISIOLO","ALL","15-19",17008,14146,31154
"7898","ISIOLO","ALL","20",3728,3573,7301
"7899","ISIOLO","ALL","21",2048,2048,4096
"7900","ISIOLO","ALL","22",2358,2425,4783
"7901","ISIOLO","ALL","23",2212,2254,4466
"7902","ISIOLO","ALL","24",2096,1981,4077
"7903","ISIOLO","ALL","20-24",12442,12281,24723
"7904","ISIOLO","ALL","25",3177,2942,6119
"7905","ISIOLO","ALL","26",1913,2018,3931
"7906","ISIOLO","ALL","27",1925,1808,3733
"7907","ISIOLO","ALL","28",1960,1847,3807
"7908","ISIOLO","ALL","29",1461,1425,2886
"7909","ISIOLO","ALL","25-29",10436,10040,20476
"7910","ISIOLO","ALL","30",3507,3095,6602
"7911","ISIOLO","ALL","31",1474,1471,2945
"7912","ISIOLO","ALL","32",1894,1882,3776
"7913","ISIOLO","ALL","33",1327,1327,2654
"7914","ISIOLO","ALL","34",1304,1269,2573
"7915","ISIOLO","ALL","30-34",9506,9044,18550
"7916","ISIOLO","ALL","35",2500,2243,4743
"7917","ISIOLO","ALL","36",1287,1151,2438
"7918","ISIOLO","ALL","37",1133,937,2070
"7919","ISIOLO","ALL","38",1084,888,1972
"7920","ISIOLO","ALL","39",799,665,1464
"7921","ISIOLO","ALL","35-39",6803,5884,12687
"7922","ISIOLO","ALL","40",2362,1715,4077
"7923","ISIOLO","ALL","41",1129,1089,2218
"7924","ISIOLO","ALL","42",924,696,1620
"7925","ISIOLO","ALL","43",633,479,1112
"7926","ISIOLO","ALL","44",406,348,754
"7927","ISIOLO","ALL","40-44",5454,4327,9781
"7928","ISIOLO","ALL","45",1450,1285,2735
"7929","ISIOLO","ALL","46",720,651,1371
"7930","ISIOLO","ALL","47",595,543,1138
"7931","ISIOLO","ALL","48",567,427,994
"7932","ISIOLO","ALL","49",515,370,885
"7933","ISIOLO","ALL","45-49",3847,3276,7123
"7934","ISIOLO","ALL","50",1336,1106,2442
"7935","ISIOLO","ALL","51",363,307,670
"7936","ISIOLO","ALL","52",481,414,895
"7937","ISIOLO","ALL","53",379,264,643
"7938","ISIOLO","ALL","54",464,364,828
"7939","ISIOLO","ALL","50-54",3023,2455,5478
"7940","ISIOLO","ALL","55",605,492,1097
"7941","ISIOLO","ALL","56",567,470,1037
"7942","ISIOLO","ALL","57",389,497,886
"7943","ISIOLO","ALL","58",426,450,876
"7944","ISIOLO","ALL","59",448,486,934
"7945","ISIOLO","ALL","55-59",2435,2395,4830
"7946","ISIOLO","ALL","60",1041,843,1884
"7947","ISIOLO","ALL","61",377,396,773
"7948","ISIOLO","ALL","62",376,237,613
"7949","ISIOLO","ALL","63",371,287,658
"7950","ISIOLO","ALL","64",276,197,473
"7951","ISIOLO","ALL","60-64",2441,1960,4401
"7952","ISIOLO","ALL","65",428,424,852
"7953","ISIOLO","ALL","66",211,210,421
"7954","ISIOLO","ALL","67",279,226,505
"7955","ISIOLO","ALL","68",212,145,357
"7956","ISIOLO","ALL","69",269,207,476
"7957","ISIOLO","ALL","65-69",1399,1212,2611
"7958","ISIOLO","ALL","70",619,564,1183
"7959","ISIOLO","ALL","71",172,286,458
"7960","ISIOLO","ALL","72",155,126,281
"7961","ISIOLO","ALL","73",150,103,253
"7962","ISIOLO","ALL","74",141,106,247
"7963","ISIOLO","ALL","70-74",1237,1185,2422
"7964","ISIOLO","ALL","75",167,152,319
"7965","ISIOLO","ALL","76",97,120,217
"7966","ISIOLO","ALL","77",95,59,154
"7967","ISIOLO","ALL","78",107,71,178
"7968","ISIOLO","ALL","79",123,121,244
"7969","ISIOLO","ALL","75-79",589,523,1112
"7970","ISIOLO","ALL","80",218,250,468
"7971","ISIOLO","ALL","81",68,148,216
"7972","ISIOLO","ALL","82",64,46,110
"7973","ISIOLO","ALL","83",58,47,105
"7974","ISIOLO","ALL","84",49,64,113
"7975","ISIOLO","ALL","80-84",457,555,1012
"7976","ISIOLO","ALL","85",63,69,132
"7977","ISIOLO","ALL","86",41,30,71
"7978","ISIOLO","ALL","87",36,34,70
"7979","ISIOLO","ALL","88",30,32,62
"7980","ISIOLO","ALL","89",55,80,135
"7981","ISIOLO","ALL","85-89",225,245,470
"7982","ISIOLO","ALL","90",59,81,140
"7983","ISIOLO","ALL","91",24,44,68
"7984","ISIOLO","ALL","92",19,15,34
"7985","ISIOLO","ALL","93",15,12,27
"7986","ISIOLO","ALL","94",12,13,25
"7987","ISIOLO","ALL","90-94",129,165,294
"7988","ISIOLO","ALL","95",11,25,36
"7989","ISIOLO","ALL","96",8,12,20
"7990","ISIOLO","ALL","97",9,12,21
"7991","ISIOLO","ALL","98",7,10,17
"7992","ISIOLO","ALL","99",12,16,28
"7993","ISIOLO","ALL","95-99",47,75,122
"7994","ISIOLO","ALL","100+",28,42,70
"7995","ISIOLO","ALL","Not Stated",1,NA,1
"7996","ISIOLO","GARBATULLA","Total",54661,45068,99729
"7997","ISIOLO","GARBATULLA","0",853,777,1630
"7998","ISIOLO","GARBATULLA","1",1136,1177,2313
"7999","ISIOLO","GARBATULLA","2",1864,1696,3560
"8000","ISIOLO","GARBATULLA","3",1705,1583,3288
"8001","ISIOLO","GARBATULLA","4",1886,1805,3691
"8002","ISIOLO","GARBATULLA","0 - 4",7444,7038,14482
"8003","ISIOLO","GARBATULLA","5",1811,1731,3542
"8004","ISIOLO","GARBATULLA","6",1948,1780,3728
"8005","ISIOLO","GARBATULLA","7",1436,1417,2853
"8006","ISIOLO","GARBATULLA","8",2012,1760,3772
"8007","ISIOLO","GARBATULLA","9",1344,1243,2587
"8008","ISIOLO","GARBATULLA","5-9",8551,7931,16482
"8009","ISIOLO","GARBATULLA","10",2537,2186,4723
"8010","ISIOLO","GARBATULLA","11",1088,1207,2295
"8011","ISIOLO","GARBATULLA","12",2106,1382,3488
"8012","ISIOLO","GARBATULLA","13",1435,1119,2554
"8013","ISIOLO","GARBATULLA","14",1692,1151,2843
"8014","ISIOLO","GARBATULLA","10 -14",8858,7045,15903
"8015","ISIOLO","GARBATULLA","15",2113,1352,3465
"8016","ISIOLO","GARBATULLA","16",1606,1063,2669
"8017","ISIOLO","GARBATULLA","17",1758,987,2745
"8018","ISIOLO","GARBATULLA","18",1376,953,2329
"8019","ISIOLO","GARBATULLA","19",703,493,1196
"8020","ISIOLO","GARBATULLA","15-19",7556,4848,12404
"8021","ISIOLO","GARBATULLA","20",1722,1335,3057
"8022","ISIOLO","GARBATULLA","21",672,570,1242
"8023","ISIOLO","GARBATULLA","22",750,698,1448
"8024","ISIOLO","GARBATULLA","23",771,663,1434
"8025","ISIOLO","GARBATULLA","24",696,657,1353
"8026","ISIOLO","GARBATULLA","20-24",4611,3923,8534
"8027","ISIOLO","GARBATULLA","25",1320,1110,2430
"8028","ISIOLO","GARBATULLA","26",680,595,1275
"8029","ISIOLO","GARBATULLA","27",632,558,1190
"8030","ISIOLO","GARBATULLA","28",742,687,1429
"8031","ISIOLO","GARBATULLA","29",506,437,943
"8032","ISIOLO","GARBATULLA","25-29",3880,3387,7267
"8033","ISIOLO","GARBATULLA","30",1540,1177,2717
"8034","ISIOLO","GARBATULLA","31",434,396,830
"8035","ISIOLO","GARBATULLA","32",627,593,1220
"8036","ISIOLO","GARBATULLA","33",385,386,771
"8037","ISIOLO","GARBATULLA","34",413,399,812
"8038","ISIOLO","GARBATULLA","30-34",3399,2951,6350
"8039","ISIOLO","GARBATULLA","35",1006,878,1884
"8040","ISIOLO","GARBATULLA","36",520,442,962
"8041","ISIOLO","GARBATULLA","37",367,295,662
"8042","ISIOLO","GARBATULLA","38",434,359,793
"8043","ISIOLO","GARBATULLA","39",250,181,431
"8044","ISIOLO","GARBATULLA","35-39",2577,2155,4732
"8045","ISIOLO","GARBATULLA","40",1096,693,1789
"8046","ISIOLO","GARBATULLA","41",402,356,758
"8047","ISIOLO","GARBATULLA","42",324,204,528
"8048","ISIOLO","GARBATULLA","43",200,137,337
"8049","ISIOLO","GARBATULLA","44",94,68,162
"8050","ISIOLO","GARBATULLA","40-44",2116,1458,3574
"8051","ISIOLO","GARBATULLA","45",553,449,1002
"8052","ISIOLO","GARBATULLA","46",223,193,416
"8053","ISIOLO","GARBATULLA","47",165,153,318
"8054","ISIOLO","GARBATULLA","48",195,146,341
"8055","ISIOLO","GARBATULLA","49",162,86,248
"8056","ISIOLO","GARBATULLA","45-49",1298,1027,2325
"8057","ISIOLO","GARBATULLA","50",592,394,986
"8058","ISIOLO","GARBATULLA","51",90,64,154
"8059","ISIOLO","GARBATULLA","52",168,131,299
"8060","ISIOLO","GARBATULLA","53",123,69,192
"8061","ISIOLO","GARBATULLA","54",173,136,309
"8062","ISIOLO","GARBATULLA","50-54",1146,794,1940
"8063","ISIOLO","GARBATULLA","55",225,149,374
"8064","ISIOLO","GARBATULLA","56",185,138,323
"8065","ISIOLO","GARBATULLA","57",140,143,283
"8066","ISIOLO","GARBATULLA","58",151,156,307
"8067","ISIOLO","GARBATULLA","59",126,144,270
"8068","ISIOLO","GARBATULLA","55-59",827,730,1557
"8069","ISIOLO","GARBATULLA","60",442,277,719
"8070","ISIOLO","GARBATULLA","61",136,139,275
"8071","ISIOLO","GARBATULLA","62",157,77,234
"8072","ISIOLO","GARBATULLA","63",139,102,241
"8073","ISIOLO","GARBATULLA","64",101,58,159
"8074","ISIOLO","GARBATULLA","60-64",975,653,1628
"8075","ISIOLO","GARBATULLA","65",135,123,258
"8076","ISIOLO","GARBATULLA","66",79,57,136
"8077","ISIOLO","GARBATULLA","67",99,72,171
"8078","ISIOLO","GARBATULLA","68",70,45,115
"8079","ISIOLO","GARBATULLA","69",107,62,169
"8080","ISIOLO","GARBATULLA","65-69",490,359,849
"8081","ISIOLO","GARBATULLA","70",231,164,395
"8082","ISIOLO","GARBATULLA","71",54,79,133
"8083","ISIOLO","GARBATULLA","72",56,37,93
"8084","ISIOLO","GARBATULLA","73",50,30,80
"8085","ISIOLO","GARBATULLA","74",51,32,83
"8086","ISIOLO","GARBATULLA","70-74",442,342,784
"8087","ISIOLO","GARBATULLA","75",51,29,80
"8088","ISIOLO","GARBATULLA","76",41,26,67
"8089","ISIOLO","GARBATULLA","77",30,23,53
"8090","ISIOLO","GARBATULLA","78",47,16,63
"8091","ISIOLO","GARBATULLA","79",44,29,73
"8092","ISIOLO","GARBATULLA","75-79",213,123,336
"8093","ISIOLO","GARBATULLA","80",76,64,140
"8094","ISIOLO","GARBATULLA","81",24,53,77
"8095","ISIOLO","GARBATULLA","82",12,11,23
"8096","ISIOLO","GARBATULLA","83",11,14,25
"8097","ISIOLO","GARBATULLA","84",18,12,30
"8098","ISIOLO","GARBATULLA","80-84",141,154,295
"8099","ISIOLO","GARBATULLA","85",14,21,35
"8100","ISIOLO","GARBATULLA","86",9,9,18
"8101","ISIOLO","GARBATULLA","87",14,12,26
"8102","ISIOLO","GARBATULLA","88",10,8,18
"8103","ISIOLO","GARBATULLA","89",22,17,39
"8104","ISIOLO","GARBATULLA","85-89",69,67,136
"8105","ISIOLO","GARBATULLA","90",15,23,38
"8106","ISIOLO","GARBATULLA","91",11,15,26
"8107","ISIOLO","GARBATULLA","92",6,5,11
"8108","ISIOLO","GARBATULLA","93",3,2,5
"8109","ISIOLO","GARBATULLA","94",5,3,8
"8110","ISIOLO","GARBATULLA","90-94",40,48,88
"8111","ISIOLO","GARBATULLA","95",4,5,9
"8112","ISIOLO","GARBATULLA","96",4,6,10
"8113","ISIOLO","GARBATULLA","97",5,3,8
"8114","ISIOLO","GARBATULLA","98",2,3,5
"8115","ISIOLO","GARBATULLA","99",4,8,12
"8116","ISIOLO","GARBATULLA","95-99",19,25,44
"8117","ISIOLO","GARBATULLA","100+",9,10,19
"8118","ISIOLO","GARBATULLA","Not Stated",NA,NA,NA
"8119","ISIOLO","ISIOLO","Total",60414,60647,121061
"8120","ISIOLO","ISIOLO","0",1723,1729,3452
"8121","ISIOLO","ISIOLO","1",1664,1602,3266
"8122","ISIOLO","ISIOLO","2",1879,1833,3712
"8123","ISIOLO","ISIOLO","3",1893,1870,3763
"8124","ISIOLO","ISIOLO","4",1850,1829,3679
"8125","ISIOLO","ISIOLO","0 - 4",9009,8863,17872
"8126","ISIOLO","ISIOLO","5",1861,1755,3616
"8127","ISIOLO","ISIOLO","6",1761,1678,3439
"8128","ISIOLO","ISIOLO","7",1741,1662,3403
"8129","ISIOLO","ISIOLO","8",1580,1643,3223
"8130","ISIOLO","ISIOLO","9",1513,1477,2990
"8131","ISIOLO","ISIOLO","5-9",8456,8215,16671
"8132","ISIOLO","ISIOLO","10",1829,1781,3610
"8133","ISIOLO","ISIOLO","11",1411,1316,2727
"8134","ISIOLO","ISIOLO","12",1741,1688,3429
"8135","ISIOLO","ISIOLO","13",1515,1593,3108
"8136","ISIOLO","ISIOLO","14",1466,1546,3012
"8137","ISIOLO","ISIOLO","10 -14",7962,7924,15886
"8138","ISIOLO","ISIOLO","15",1604,1467,3071
"8139","ISIOLO","ISIOLO","16",1302,1391,2693
"8140","ISIOLO","ISIOLO","17",1376,1340,2716
"8141","ISIOLO","ISIOLO","18",1199,1284,2483
"8142","ISIOLO","ISIOLO","19",1110,1230,2340
"8143","ISIOLO","ISIOLO","15-19",6591,6712,13303
"8144","ISIOLO","ISIOLO","20",1194,1562,2756
"8145","ISIOLO","ISIOLO","21",1056,1188,2244
"8146","ISIOLO","ISIOLO","22",1165,1392,2557
"8147","ISIOLO","ISIOLO","23",1105,1317,2422
"8148","ISIOLO","ISIOLO","24",1128,1083,2211
"8149","ISIOLO","ISIOLO","20-24",5648,6542,12190
"8150","ISIOLO","ISIOLO","25",1331,1394,2725
"8151","ISIOLO","ISIOLO","26",987,1172,2159
"8152","ISIOLO","ISIOLO","27",1015,1014,2029
"8153","ISIOLO","ISIOLO","28",916,897,1813
"8154","ISIOLO","ISIOLO","29",763,811,1574
"8155","ISIOLO","ISIOLO","25-29",5012,5288,10300
"8156","ISIOLO","ISIOLO","30",1282,1328,2610
"8157","ISIOLO","ISIOLO","31",814,813,1627
"8158","ISIOLO","ISIOLO","32",1005,1070,2075
"8159","ISIOLO","ISIOLO","33",750,757,1507
"8160","ISIOLO","ISIOLO","34",690,667,1357
"8161","ISIOLO","ISIOLO","30-34",4541,4635,9176
"8162","ISIOLO","ISIOLO","35",1144,1018,2162
"8163","ISIOLO","ISIOLO","36",625,568,1193
"8164","ISIOLO","ISIOLO","37",599,515,1114
"8165","ISIOLO","ISIOLO","38",514,409,923
"8166","ISIOLO","ISIOLO","39",457,396,853
"8167","ISIOLO","ISIOLO","35-39",3339,2906,6245
"8168","ISIOLO","ISIOLO","40",843,721,1564
"8169","ISIOLO","ISIOLO","41",556,569,1125
"8170","ISIOLO","ISIOLO","42",479,418,897
"8171","ISIOLO","ISIOLO","43",367,297,664
"8172","ISIOLO","ISIOLO","44",258,244,502
"8173","ISIOLO","ISIOLO","40-44",2503,2249,4752
"8174","ISIOLO","ISIOLO","45",652,645,1297
"8175","ISIOLO","ISIOLO","46",410,381,791
"8176","ISIOLO","ISIOLO","47",364,323,687
"8177","ISIOLO","ISIOLO","48",300,219,519
"8178","ISIOLO","ISIOLO","49",311,246,557
"8179","ISIOLO","ISIOLO","45-49",2037,1814,3851
"8180","ISIOLO","ISIOLO","50",496,455,951
"8181","ISIOLO","ISIOLO","51",215,203,418
"8182","ISIOLO","ISIOLO","52",238,202,440
"8183","ISIOLO","ISIOLO","53",196,150,346
"8184","ISIOLO","ISIOLO","54",219,158,377
"8185","ISIOLO","ISIOLO","50-54",1364,1168,2532
"8186","ISIOLO","ISIOLO","55",272,249,521
"8187","ISIOLO","ISIOLO","56",283,257,540
"8188","ISIOLO","ISIOLO","57",192,262,454
"8189","ISIOLO","ISIOLO","58",202,201,403
"8190","ISIOLO","ISIOLO","59",238,275,513
"8191","ISIOLO","ISIOLO","55-59",1187,1244,2431
"8192","ISIOLO","ISIOLO","60",356,405,761
"8193","ISIOLO","ISIOLO","61",167,171,338
"8194","ISIOLO","ISIOLO","62",155,120,275
"8195","ISIOLO","ISIOLO","63",154,153,307
"8196","ISIOLO","ISIOLO","64",87,91,178
"8197","ISIOLO","ISIOLO","60-64",919,940,1859
"8198","ISIOLO","ISIOLO","65",207,219,426
"8199","ISIOLO","ISIOLO","66",98,111,209
"8200","ISIOLO","ISIOLO","67",124,121,245
"8201","ISIOLO","ISIOLO","68",97,69,166
"8202","ISIOLO","ISIOLO","69",125,118,243
"8203","ISIOLO","ISIOLO","65-69",651,638,1289
"8204","ISIOLO","ISIOLO","70",226,285,511
"8205","ISIOLO","ISIOLO","71",85,156,241
"8206","ISIOLO","ISIOLO","72",72,71,143
"8207","ISIOLO","ISIOLO","73",68,57,125
"8208","ISIOLO","ISIOLO","74",73,57,130
"8209","ISIOLO","ISIOLO","70-74",524,626,1150
"8210","ISIOLO","ISIOLO","75",84,88,172
"8211","ISIOLO","ISIOLO","76",44,67,111
"8212","ISIOLO","ISIOLO","77",51,29,80
"8213","ISIOLO","ISIOLO","78",39,41,80
"8214","ISIOLO","ISIOLO","79",61,78,139
"8215","ISIOLO","ISIOLO","75-79",279,303,582
"8216","ISIOLO","ISIOLO","80",79,141,220
"8217","ISIOLO","ISIOLO","81",29,69,98
"8218","ISIOLO","ISIOLO","82",37,25,62
"8219","ISIOLO","ISIOLO","83",30,28,58
"8220","ISIOLO","ISIOLO","84",14,39,53
"8221","ISIOLO","ISIOLO","80-84",189,302,491
"8222","ISIOLO","ISIOLO","85",32,34,66
"8223","ISIOLO","ISIOLO","86",24,18,42
"8224","ISIOLO","ISIOLO","87",13,17,30
"8225","ISIOLO","ISIOLO","88",11,14,25
"8226","ISIOLO","ISIOLO","89",24,48,72
"8227","ISIOLO","ISIOLO","85-89",104,131,235
"8228","ISIOLO","ISIOLO","90",30,43,73
"8229","ISIOLO","ISIOLO","91",8,14,22
"8230","ISIOLO","ISIOLO","92",8,10,18
"8231","ISIOLO","ISIOLO","93",7,8,15
"8232","ISIOLO","ISIOLO","94",6,8,14
"8233","ISIOLO","ISIOLO","90-94",59,83,142
"8234","ISIOLO","ISIOLO","95",5,14,19
"8235","ISIOLO","ISIOLO","96",4,6,10
"8236","ISIOLO","ISIOLO","97",3,8,11
"8237","ISIOLO","ISIOLO","98",4,6,10
"8238","ISIOLO","ISIOLO","99",8,6,14
"8239","ISIOLO","ISIOLO","95-99",24,40,64
"8240","ISIOLO","ISIOLO","100+",15,24,39
"8241","ISIOLO","ISIOLO","Not Stated",1,NA,1
"8242","ISIOLO","MERTI","Total",24435,22768,47203
"8243","ISIOLO","MERTI","0",701,748,1449
"8244","ISIOLO","MERTI","1",601,606,1207
"8245","ISIOLO","MERTI","2",948,998,1946
"8246","ISIOLO","MERTI","3",824,904,1728
"8247","ISIOLO","MERTI","4",918,1015,1933
"8248","ISIOLO","MERTI","0 - 4",3992,4271,8263
"8249","ISIOLO","MERTI","5",843,832,1675
"8250","ISIOLO","MERTI","6",867,881,1748
"8251","ISIOLO","MERTI","7",806,724,1530
"8252","ISIOLO","MERTI","8",867,866,1733
"8253","ISIOLO","MERTI","9",679,627,1306
"8254","ISIOLO","MERTI","5-9",4062,3930,7992
"8255","ISIOLO","MERTI","10",1096,972,2068
"8256","ISIOLO","MERTI","11",571,572,1143
"8257","ISIOLO","MERTI","12",771,711,1482
"8258","ISIOLO","MERTI","13",632,597,1229
"8259","ISIOLO","MERTI","14",599,604,1203
"8260","ISIOLO","MERTI","10 -14",3669,3456,7125
"8261","ISIOLO","MERTI","15",754,679,1433
"8262","ISIOLO","MERTI","16",536,483,1019
"8263","ISIOLO","MERTI","17",650,659,1309
"8264","ISIOLO","MERTI","18",600,483,1083
"8265","ISIOLO","MERTI","19",321,282,603
"8266","ISIOLO","MERTI","15-19",2861,2586,5447
"8267","ISIOLO","MERTI","20",812,676,1488
"8268","ISIOLO","MERTI","21",320,290,610
"8269","ISIOLO","MERTI","22",443,335,778
"8270","ISIOLO","MERTI","23",336,274,610
"8271","ISIOLO","MERTI","24",272,241,513
"8272","ISIOLO","MERTI","20-24",2183,1816,3999
"8273","ISIOLO","MERTI","25",526,438,964
"8274","ISIOLO","MERTI","26",246,251,497
"8275","ISIOLO","MERTI","27",278,236,514
"8276","ISIOLO","MERTI","28",302,263,565
"8277","ISIOLO","MERTI","29",192,177,369
"8278","ISIOLO","MERTI","25-29",1544,1365,2909
"8279","ISIOLO","MERTI","30",685,590,1275
"8280","ISIOLO","MERTI","31",226,262,488
"8281","ISIOLO","MERTI","32",262,219,481
"8282","ISIOLO","MERTI","33",192,184,376
"8283","ISIOLO","MERTI","34",201,203,404
"8284","ISIOLO","MERTI","30-34",1566,1458,3024
"8285","ISIOLO","MERTI","35",350,347,697
"8286","ISIOLO","MERTI","36",142,141,283
"8287","ISIOLO","MERTI","37",167,127,294
"8288","ISIOLO","MERTI","38",136,120,256
"8289","ISIOLO","MERTI","39",92,88,180
"8290","ISIOLO","MERTI","35-39",887,823,1710
"8291","ISIOLO","MERTI","40",423,301,724
"8292","ISIOLO","MERTI","41",171,164,335
"8293","ISIOLO","MERTI","42",121,74,195
"8294","ISIOLO","MERTI","43",66,45,111
"8295","ISIOLO","MERTI","44",54,36,90
"8296","ISIOLO","MERTI","40-44",835,620,1455
"8297","ISIOLO","MERTI","45",245,191,436
"8298","ISIOLO","MERTI","46",87,77,164
"8299","ISIOLO","MERTI","47",66,67,133
"8300","ISIOLO","MERTI","48",72,62,134
"8301","ISIOLO","MERTI","49",42,38,80
"8302","ISIOLO","MERTI","45-49",512,435,947
"8303","ISIOLO","MERTI","50",248,257,505
"8304","ISIOLO","MERTI","51",58,40,98
"8305","ISIOLO","MERTI","52",75,81,156
"8306","ISIOLO","MERTI","53",60,45,105
"8307","ISIOLO","MERTI","54",72,70,142
"8308","ISIOLO","MERTI","50-54",513,493,1006
"8309","ISIOLO","MERTI","55",108,94,202
"8310","ISIOLO","MERTI","56",99,75,174
"8311","ISIOLO","MERTI","57",57,92,149
"8312","ISIOLO","MERTI","58",73,93,166
"8313","ISIOLO","MERTI","59",84,67,151
"8314","ISIOLO","MERTI","55-59",421,421,842
"8315","ISIOLO","MERTI","60",243,161,404
"8316","ISIOLO","MERTI","61",74,86,160
"8317","ISIOLO","MERTI","62",64,40,104
"8318","ISIOLO","MERTI","63",78,32,110
"8319","ISIOLO","MERTI","64",88,48,136
"8320","ISIOLO","MERTI","60-64",547,367,914
"8321","ISIOLO","MERTI","65",86,82,168
"8322","ISIOLO","MERTI","66",34,42,76
"8323","ISIOLO","MERTI","67",56,33,89
"8324","ISIOLO","MERTI","68",45,31,76
"8325","ISIOLO","MERTI","69",37,27,64
"8326","ISIOLO","MERTI","65-69",258,215,473
"8327","ISIOLO","MERTI","70",162,115,277
"8328","ISIOLO","MERTI","71",33,51,84
"8329","ISIOLO","MERTI","72",27,18,45
"8330","ISIOLO","MERTI","73",32,16,48
"8331","ISIOLO","MERTI","74",17,17,34
"8332","ISIOLO","MERTI","70-74",271,217,488
"8333","ISIOLO","MERTI","75",32,35,67
"8334","ISIOLO","MERTI","76",12,27,39
"8335","ISIOLO","MERTI","77",14,7,21
"8336","ISIOLO","MERTI","78",21,14,35
"8337","ISIOLO","MERTI","79",18,14,32
"8338","ISIOLO","MERTI","75-79",97,97,194
"8339","ISIOLO","MERTI","80",63,45,108
"8340","ISIOLO","MERTI","81",15,26,41
"8341","ISIOLO","MERTI","82",15,10,25
"8342","ISIOLO","MERTI","83",17,5,22
"8343","ISIOLO","MERTI","84",17,13,30
"8344","ISIOLO","MERTI","80-84",127,99,226
"8345","ISIOLO","MERTI","85",17,14,31
"8346","ISIOLO","MERTI","86",8,3,11
"8347","ISIOLO","MERTI","87",9,5,14
"8348","ISIOLO","MERTI","88",9,10,19
"8349","ISIOLO","MERTI","89",9,15,24
"8350","ISIOLO","MERTI","85-89",52,47,99
"8351","ISIOLO","MERTI","90",14,15,29
"8352","ISIOLO","MERTI","91",5,15,20
"8353","ISIOLO","MERTI","92",5,NA,5
"8354","ISIOLO","MERTI","93",5,2,7
"8355","ISIOLO","MERTI","94",1,2,3
"8356","ISIOLO","MERTI","90-94",30,34,64
"8357","ISIOLO","MERTI","95",2,6,8
"8358","ISIOLO","MERTI","96",NA,NA,NA
"8359","ISIOLO","MERTI","97",1,1,2
"8360","ISIOLO","MERTI","98",1,1,2
"8361","ISIOLO","MERTI","99",NA,2,2
"8362","ISIOLO","MERTI","95-99",4,10,14
"8363","ISIOLO","MERTI","100+",4,8,12
"8364","ISIOLO","MERTI","Not Stated",NA,NA,NA
"8365","KAJIADO","ALL","Total",557098,560704,1117802
"8366","KAJIADO","ALL","0",14080,13727,27807
"8367","KAJIADO","ALL","1",16314,15934,32248
"8368","KAJIADO","ALL","2",15913,15629,31542
"8369","KAJIADO","ALL","3",16572,16368,32940
"8370","KAJIADO","ALL","4",16064,15727,31791
"8371","KAJIADO","ALL","0 - 4",78943,77385,156328
"8372","KAJIADO","ALL","5",15763,15387,31150
"8373","KAJIADO","ALL","6",15309,15455,30764
"8374","KAJIADO","ALL","7",14310,14419,28729
"8375","KAJIADO","ALL","8",14210,13893,28103
"8376","KAJIADO","ALL","9",13653,13196,26849
"8377","KAJIADO","ALL","5-9",73245,72350,145595
"8378","KAJIADO","ALL","10",15034,14889,29923
"8379","KAJIADO","ALL","11",11437,11906,23343
"8380","KAJIADO","ALL","12",13558,13600,27158
"8381","KAJIADO","ALL","13",12628,13211,25839
"8382","KAJIADO","ALL","14",11316,12053,23369
"8383","KAJIADO","ALL","10 -14",63973,65659,129632
"8384","KAJIADO","ALL","15",11315,11185,22500
"8385","KAJIADO","ALL","16",9949,10219,20168
"8386","KAJIADO","ALL","17",10079,9847,19926
"8387","KAJIADO","ALL","18",8441,9370,17811
"8388","KAJIADO","ALL","19",9863,11100,20963
"8389","KAJIADO","ALL","15-19",49647,51721,101368
"8390","KAJIADO","ALL","20",10432,12966,23398
"8391","KAJIADO","ALL","21",10188,12066,22254
"8392","KAJIADO","ALL","22",10486,12608,23094
"8393","KAJIADO","ALL","23",11563,13956,25519
"8394","KAJIADO","ALL","24",11474,13080,24554
"8395","KAJIADO","ALL","20-24",54143,64676,118819
"8396","KAJIADO","ALL","25",13275,14287,27562
"8397","KAJIADO","ALL","26",10918,11990,22908
"8398","KAJIADO","ALL","27",11443,11928,23371
"8399","KAJIADO","ALL","28",9734,10648,20382
"8400","KAJIADO","ALL","29",10294,10636,20930
"8401","KAJIADO","ALL","25-29",55664,59489,115153
"8402","KAJIADO","ALL","30",13324,13948,27272
"8403","KAJIADO","ALL","31",8549,8861,17410
"8404","KAJIADO","ALL","32",11093,11242,22335
"8405","KAJIADO","ALL","33",8609,8592,17201
"8406","KAJIADO","ALL","34",7974,7641,15615
"8407","KAJIADO","ALL","30-34",49549,50284,99833
"8408","KAJIADO","ALL","35",10999,10090,21089
"8409","KAJIADO","ALL","36",7171,6586,13757
"8410","KAJIADO","ALL","37",7089,6125,13214
"8411","KAJIADO","ALL","38",6095,5300,11395
"8412","KAJIADO","ALL","39",5936,5183,11119
"8413","KAJIADO","ALL","35-39",37290,33284,70574
"8414","KAJIADO","ALL","40",8001,6887,14888
"8415","KAJIADO","ALL","41",6058,5483,11541
"8416","KAJIADO","ALL","42",5868,5466,11334
"8417","KAJIADO","ALL","43",4672,4197,8869
"8418","KAJIADO","ALL","44",3559,3142,6701
"8419","KAJIADO","ALL","40-44",28158,25175,53333
"8420","KAJIADO","ALL","45",6923,5838,12761
"8421","KAJIADO","ALL","46",4400,3889,8289
"8422","KAJIADO","ALL","47",4406,3617,8023
"8423","KAJIADO","ALL","48",3198,2618,5816
"8424","KAJIADO","ALL","49",3378,2772,6150
"8425","KAJIADO","ALL","45-49",22305,18734,41039
"8426","KAJIADO","ALL","50",4618,3954,8572
"8427","KAJIADO","ALL","51",3281,2851,6132
"8428","KAJIADO","ALL","52",2956,2460,5416
"8429","KAJIADO","ALL","53",2088,1725,3813
"8430","KAJIADO","ALL","54",2612,2279,4891
"8431","KAJIADO","ALL","50-54",15555,13269,28824
"8432","KAJIADO","ALL","55",2654,2249,4903
"8433","KAJIADO","ALL","56",2380,2049,4429
"8434","KAJIADO","ALL","57",1859,1770,3629
"8435","KAJIADO","ALL","58",1601,1412,3013
"8436","KAJIADO","ALL","59",1795,1853,3648
"8437","KAJIADO","ALL","55-59",10289,9333,19622
"8438","KAJIADO","ALL","60",2358,2359,4717
"8439","KAJIADO","ALL","61",1362,1419,2781
"8440","KAJIADO","ALL","62",1223,1189,2412
"8441","KAJIADO","ALL","63",1182,1179,2361
"8442","KAJIADO","ALL","64",906,750,1656
"8443","KAJIADO","ALL","60-64",7031,6896,13927
"8444","KAJIADO","ALL","65",1416,1366,2782
"8445","KAJIADO","ALL","66",675,657,1332
"8446","KAJIADO","ALL","67",1044,912,1956
"8447","KAJIADO","ALL","68",582,512,1094
"8448","KAJIADO","ALL","69",724,833,1557
"8449","KAJIADO","ALL","65-69",4441,4280,8721
"8450","KAJIADO","ALL","70",1260,1337,2597
"8451","KAJIADO","ALL","71",607,722,1329
"8452","KAJIADO","ALL","72",561,504,1065
"8453","KAJIADO","ALL","73",430,422,852
"8454","KAJIADO","ALL","74",444,505,949
"8455","KAJIADO","ALL","70-74",3302,3490,6792
"8456","KAJIADO","ALL","75",444,516,960
"8457","KAJIADO","ALL","76",337,354,691
"8458","KAJIADO","ALL","77",296,318,614
"8459","KAJIADO","ALL","78",212,202,414
"8460","KAJIADO","ALL","79",307,412,719
"8461","KAJIADO","ALL","75-79",1596,1802,3398
"8462","KAJIADO","ALL","80",410,602,1012
"8463","KAJIADO","ALL","81",173,231,404
"8464","KAJIADO","ALL","82",141,135,276
"8465","KAJIADO","ALL","83",129,174,303
"8466","KAJIADO","ALL","84",111,198,309
"8467","KAJIADO","ALL","80-84",964,1340,2304
"8468","KAJIADO","ALL","85",169,200,369
"8469","KAJIADO","ALL","86",102,126,228
"8470","KAJIADO","ALL","87",85,116,201
"8471","KAJIADO","ALL","88",48,65,113
"8472","KAJIADO","ALL","89",130,197,327
"8473","KAJIADO","ALL","85-89",534,704,1238
"8474","KAJIADO","ALL","90",114,196,310
"8475","KAJIADO","ALL","91",46,66,112
"8476","KAJIADO","ALL","92",30,59,89
"8477","KAJIADO","ALL","93",26,41,67
"8478","KAJIADO","ALL","94",28,32,60
"8479","KAJIADO","ALL","90-94",244,394,638
"8480","KAJIADO","ALL","95",57,83,140
"8481","KAJIADO","ALL","96",19,44,63
"8482","KAJIADO","ALL","97",20,39,59
"8483","KAJIADO","ALL","98",15,36,51
"8484","KAJIADO","ALL","99",26,43,69
"8485","KAJIADO","ALL","95-99",137,245,382
"8486","KAJIADO","ALL","100+",75,186,261
"8487","KAJIADO","ALL","Not Stated",13,8,21
"8488","KAJIADO","ISINYA","Total",105607,104860,210467
"8489","KAJIADO","ISINYA","0",2338,2341,4679
"8490","KAJIADO","ISINYA","1",3277,3223,6500
"8491","KAJIADO","ISINYA","2",2654,2715,5369
"8492","KAJIADO","ISINYA","3",2650,2662,5312
"8493","KAJIADO","ISINYA","4",2405,2421,4826
"8494","KAJIADO","ISINYA","0 - 4",13324,13362,26686
"8495","KAJIADO","ISINYA","5",2380,2289,4669
"8496","KAJIADO","ISINYA","6",2114,2085,4199
"8497","KAJIADO","ISINYA","7",2207,2173,4380
"8498","KAJIADO","ISINYA","8",2063,1999,4062
"8499","KAJIADO","ISINYA","9",2118,2053,4171
"8500","KAJIADO","ISINYA","5-9",10882,10599,21481
"8501","KAJIADO","ISINYA","10",1898,1950,3848
"8502","KAJIADO","ISINYA","11",1721,1792,3513
"8503","KAJIADO","ISINYA","12",1751,1849,3600
"8504","KAJIADO","ISINYA","13",1678,1857,3535
"8505","KAJIADO","ISINYA","14",1517,1616,3133
"8506","KAJIADO","ISINYA","10 -14",8565,9064,17629
"8507","KAJIADO","ISINYA","15",1366,1501,2867
"8508","KAJIADO","ISINYA","16",1375,1537,2912
"8509","KAJIADO","ISINYA","17",1369,1567,2936
"8510","KAJIADO","ISINYA","18",1203,1554,2757
"8511","KAJIADO","ISINYA","19",1651,2088,3739
"8512","KAJIADO","ISINYA","15-19",6964,8247,15211
"8513","KAJIADO","ISINYA","20",1850,2616,4466
"8514","KAJIADO","ISINYA","21",2206,2931,5137
"8515","KAJIADO","ISINYA","22",2270,2957,5227
"8516","KAJIADO","ISINYA","23",2762,3522,6284
"8517","KAJIADO","ISINYA","24",2792,3466,6258
"8518","KAJIADO","ISINYA","20-24",11880,15492,27372
"8519","KAJIADO","ISINYA","25",3203,3673,6876
"8520","KAJIADO","ISINYA","26",2909,3132,6041
"8521","KAJIADO","ISINYA","27",3051,3048,6099
"8522","KAJIADO","ISINYA","28",2545,2860,5405
"8523","KAJIADO","ISINYA","29",2855,2779,5634
"8524","KAJIADO","ISINYA","25-29",14563,15492,30055
"8525","KAJIADO","ISINYA","30",3341,3432,6773
"8526","KAJIADO","ISINYA","31",2299,2089,4388
"8527","KAJIADO","ISINYA","32",2921,2650,5571
"8528","KAJIADO","ISINYA","33",2207,2020,4227
"8529","KAJIADO","ISINYA","34",2016,1908,3924
"8530","KAJIADO","ISINYA","30-34",12784,12099,24883
"8531","KAJIADO","ISINYA","35",2525,2198,4723
"8532","KAJIADO","ISINYA","36",1848,1612,3460
"8533","KAJIADO","ISINYA","37",1804,1486,3290
"8534","KAJIADO","ISINYA","38",1553,1296,2849
"8535","KAJIADO","ISINYA","39",1611,1303,2914
"8536","KAJIADO","ISINYA","35-39",9341,7895,17236
"8537","KAJIADO","ISINYA","40",1886,1321,3207
"8538","KAJIADO","ISINYA","41",1419,1038,2457
"8539","KAJIADO","ISINYA","42",1339,1039,2378
"8540","KAJIADO","ISINYA","43",1110,835,1945
"8541","KAJIADO","ISINYA","44",810,680,1490
"8542","KAJIADO","ISINYA","40-44",6564,4913,11477
"8543","KAJIADO","ISINYA","45",1287,845,2132
"8544","KAJIADO","ISINYA","46",938,632,1570
"8545","KAJIADO","ISINYA","47",850,573,1423
"8546","KAJIADO","ISINYA","48",613,445,1058
"8547","KAJIADO","ISINYA","49",708,460,1168
"8548","KAJIADO","ISINYA","45-49",4396,2955,7351
"8549","KAJIADO","ISINYA","50",788,502,1290
"8550","KAJIADO","ISINYA","51",565,330,895
"8551","KAJIADO","ISINYA","52",488,337,825
"8552","KAJIADO","ISINYA","53",395,266,661
"8553","KAJIADO","ISINYA","54",447,298,745
"8554","KAJIADO","ISINYA","50-54",2683,1733,4416
"8555","KAJIADO","ISINYA","55",414,273,687
"8556","KAJIADO","ISINYA","56",391,252,643
"8557","KAJIADO","ISINYA","57",332,240,572
"8558","KAJIADO","ISINYA","58",238,187,425
"8559","KAJIADO","ISINYA","59",293,199,492
"8560","KAJIADO","ISINYA","55-59",1668,1151,2819
"8561","KAJIADO","ISINYA","60",285,263,548
"8562","KAJIADO","ISINYA","61",221,166,387
"8563","KAJIADO","ISINYA","62",148,124,272
"8564","KAJIADO","ISINYA","63",161,129,290
"8565","KAJIADO","ISINYA","64",104,77,181
"8566","KAJIADO","ISINYA","60-64",919,759,1678
"8567","KAJIADO","ISINYA","65",160,111,271
"8568","KAJIADO","ISINYA","66",83,80,163
"8569","KAJIADO","ISINYA","67",129,96,225
"8570","KAJIADO","ISINYA","68",70,60,130
"8571","KAJIADO","ISINYA","69",78,84,162
"8572","KAJIADO","ISINYA","65-69",520,431,951
"8573","KAJIADO","ISINYA","70",101,104,205
"8574","KAJIADO","ISINYA","71",50,67,117
"8575","KAJIADO","ISINYA","72",67,50,117
"8576","KAJIADO","ISINYA","73",43,41,84
"8577","KAJIADO","ISINYA","74",44,49,93
"8578","KAJIADO","ISINYA","70-74",305,311,616
"8579","KAJIADO","ISINYA","75",29,37,66
"8580","KAJIADO","ISINYA","76",34,33,67
"8581","KAJIADO","ISINYA","77",27,37,64
"8582","KAJIADO","ISINYA","78",16,13,29
"8583","KAJIADO","ISINYA","79",27,32,59
"8584","KAJIADO","ISINYA","75-79",133,152,285
"8585","KAJIADO","ISINYA","80",24,34,58
"8586","KAJIADO","ISINYA","81",16,16,32
"8587","KAJIADO","ISINYA","82",8,14,22
"8588","KAJIADO","ISINYA","83",10,16,26
"8589","KAJIADO","ISINYA","84",7,11,18
"8590","KAJIADO","ISINYA","80-84",65,91,156
"8591","KAJIADO","ISINYA","85",7,14,21
"8592","KAJIADO","ISINYA","86",8,15,23
"8593","KAJIADO","ISINYA","87",3,9,12
"8594","KAJIADO","ISINYA","88",1,3,4
"8595","KAJIADO","ISINYA","89",7,16,23
"8596","KAJIADO","ISINYA","85-89",26,57,83
"8597","KAJIADO","ISINYA","90",2,8,10
"8598","KAJIADO","ISINYA","91",3,8,11
"8599","KAJIADO","ISINYA","92",3,2,5
"8600","KAJIADO","ISINYA","93",NA,3,3
"8601","KAJIADO","ISINYA","94",2,2,4
"8602","KAJIADO","ISINYA","90-94",10,23,33
"8603","KAJIADO","ISINYA","95",2,8,10
"8604","KAJIADO","ISINYA","96",2,8,10
"8605","KAJIADO","ISINYA","97",1,1,2
"8606","KAJIADO","ISINYA","98",NA,3,3
"8607","KAJIADO","ISINYA","99",1,2,3
"8608","KAJIADO","ISINYA","95-99",6,22,28
"8609","KAJIADO","ISINYA","100+",4,9,13
"8610","KAJIADO","ISINYA","Not Stated",5,3,8
"8611","KAJIADO","KAJIADO CENTRAL","Total",81514,80343,161857
"8612","KAJIADO","KAJIADO CENTRAL","0",2116,2034,4150
"8613","KAJIADO","KAJIADO CENTRAL","1",2518,2421,4939
"8614","KAJIADO","KAJIADO CENTRAL","2",2696,2593,5289
"8615","KAJIADO","KAJIADO CENTRAL","3",2981,2857,5838
"8616","KAJIADO","KAJIADO CENTRAL","4",2883,2818,5701
"8617","KAJIADO","KAJIADO CENTRAL","0 - 4",13194,12723,25917
"8618","KAJIADO","KAJIADO CENTRAL","5",2954,2932,5886
"8619","KAJIADO","KAJIADO CENTRAL","6",2929,2963,5892
"8620","KAJIADO","KAJIADO CENTRAL","7",2480,2621,5101
"8621","KAJIADO","KAJIADO CENTRAL","8",2645,2444,5089
"8622","KAJIADO","KAJIADO CENTRAL","9",2353,2133,4486
"8623","KAJIADO","KAJIADO CENTRAL","5-9",13361,13093,26454
"8624","KAJIADO","KAJIADO CENTRAL","10",2836,2739,5575
"8625","KAJIADO","KAJIADO CENTRAL","11",1926,1925,3851
"8626","KAJIADO","KAJIADO CENTRAL","12",2565,2429,4994
"8627","KAJIADO","KAJIADO CENTRAL","13",2181,2367,4548
"8628","KAJIADO","KAJIADO CENTRAL","14",1975,2007,3982
"8629","KAJIADO","KAJIADO CENTRAL","10 -14",11483,11467,22950
"8630","KAJIADO","KAJIADO CENTRAL","15",2064,1862,3926
"8631","KAJIADO","KAJIADO CENTRAL","16",1595,1540,3135
"8632","KAJIADO","KAJIADO CENTRAL","17",1630,1450,3080
"8633","KAJIADO","KAJIADO CENTRAL","18",1381,1306,2687
"8634","KAJIADO","KAJIADO CENTRAL","19",1418,1395,2813
"8635","KAJIADO","KAJIADO CENTRAL","15-19",8088,7553,15641
"8636","KAJIADO","KAJIADO CENTRAL","20",1540,1766,3306
"8637","KAJIADO","KAJIADO CENTRAL","21",1288,1409,2697
"8638","KAJIADO","KAJIADO CENTRAL","22",1348,1503,2851
"8639","KAJIADO","KAJIADO CENTRAL","23",1351,1550,2901
"8640","KAJIADO","KAJIADO CENTRAL","24",1280,1419,2699
"8641","KAJIADO","KAJIADO CENTRAL","20-24",6807,7647,14454
"8642","KAJIADO","KAJIADO CENTRAL","25",1534,1725,3259
"8643","KAJIADO","KAJIADO CENTRAL","26",1190,1344,2534
"8644","KAJIADO","KAJIADO CENTRAL","27",1324,1407,2731
"8645","KAJIADO","KAJIADO CENTRAL","28",1174,1237,2411
"8646","KAJIADO","KAJIADO CENTRAL","29",1200,1073,2273
"8647","KAJIADO","KAJIADO CENTRAL","25-29",6422,6786,13208
"8648","KAJIADO","KAJIADO CENTRAL","30",1737,1602,3339
"8649","KAJIADO","KAJIADO CENTRAL","31",876,1035,1911
"8650","KAJIADO","KAJIADO CENTRAL","32",1333,1326,2659
"8651","KAJIADO","KAJIADO CENTRAL","33",919,874,1793
"8652","KAJIADO","KAJIADO CENTRAL","34",815,724,1539
"8653","KAJIADO","KAJIADO CENTRAL","30-34",5680,5561,11241
"8654","KAJIADO","KAJIADO CENTRAL","35",1377,1186,2563
"8655","KAJIADO","KAJIADO CENTRAL","36",837,770,1607
"8656","KAJIADO","KAJIADO CENTRAL","37",795,604,1399
"8657","KAJIADO","KAJIADO CENTRAL","38",703,514,1217
"8658","KAJIADO","KAJIADO CENTRAL","39",601,435,1036
"8659","KAJIADO","KAJIADO CENTRAL","35-39",4313,3509,7822
"8660","KAJIADO","KAJIADO CENTRAL","40",937,846,1783
"8661","KAJIADO","KAJIADO CENTRAL","41",651,651,1302
"8662","KAJIADO","KAJIADO CENTRAL","42",731,808,1539
"8663","KAJIADO","KAJIADO CENTRAL","43",451,480,931
"8664","KAJIADO","KAJIADO CENTRAL","44",334,283,617
"8665","KAJIADO","KAJIADO CENTRAL","40-44",3104,3068,6172
"8666","KAJIADO","KAJIADO CENTRAL","45",932,813,1745
"8667","KAJIADO","KAJIADO CENTRAL","46",523,579,1102
"8668","KAJIADO","KAJIADO CENTRAL","47",517,467,984
"8669","KAJIADO","KAJIADO CENTRAL","48",352,289,641
"8670","KAJIADO","KAJIADO CENTRAL","49",356,320,676
"8671","KAJIADO","KAJIADO CENTRAL","45-49",2680,2468,5148
"8672","KAJIADO","KAJIADO CENTRAL","50",704,601,1305
"8673","KAJIADO","KAJIADO CENTRAL","51",485,502,987
"8674","KAJIADO","KAJIADO CENTRAL","52",375,326,701
"8675","KAJIADO","KAJIADO CENTRAL","53",224,158,382
"8676","KAJIADO","KAJIADO CENTRAL","54",298,367,665
"8677","KAJIADO","KAJIADO CENTRAL","50-54",2086,1954,4040
"8678","KAJIADO","KAJIADO CENTRAL","55",331,357,688
"8679","KAJIADO","KAJIADO CENTRAL","56",335,312,647
"8680","KAJIADO","KAJIADO CENTRAL","57",215,229,444
"8681","KAJIADO","KAJIADO CENTRAL","58",190,191,381
"8682","KAJIADO","KAJIADO CENTRAL","59",261,320,581
"8683","KAJIADO","KAJIADO CENTRAL","55-59",1332,1409,2741
"8684","KAJIADO","KAJIADO CENTRAL","60",424,388,812
"8685","KAJIADO","KAJIADO CENTRAL","61",188,242,430
"8686","KAJIADO","KAJIADO CENTRAL","62",163,153,316
"8687","KAJIADO","KAJIADO CENTRAL","63",204,200,404
"8688","KAJIADO","KAJIADO CENTRAL","64",174,99,273
"8689","KAJIADO","KAJIADO CENTRAL","60-64",1153,1082,2235
"8690","KAJIADO","KAJIADO CENTRAL","65",233,211,444
"8691","KAJIADO","KAJIADO CENTRAL","66",83,76,159
"8692","KAJIADO","KAJIADO CENTRAL","67",126,131,257
"8693","KAJIADO","KAJIADO CENTRAL","68",85,92,177
"8694","KAJIADO","KAJIADO CENTRAL","69",120,152,272
"8695","KAJIADO","KAJIADO CENTRAL","65-69",647,662,1309
"8696","KAJIADO","KAJIADO CENTRAL","70",203,236,439
"8697","KAJIADO","KAJIADO CENTRAL","71",83,126,209
"8698","KAJIADO","KAJIADO CENTRAL","72",84,83,167
"8699","KAJIADO","KAJIADO CENTRAL","73",75,49,124
"8700","KAJIADO","KAJIADO CENTRAL","74",67,77,144
"8701","KAJIADO","KAJIADO CENTRAL","70-74",512,571,1083
"8702","KAJIADO","KAJIADO CENTRAL","75",73,82,155
"8703","KAJIADO","KAJIADO CENTRAL","76",48,44,92
"8704","KAJIADO","KAJIADO CENTRAL","77",44,49,93
"8705","KAJIADO","KAJIADO CENTRAL","78",43,41,84
"8706","KAJIADO","KAJIADO CENTRAL","79",58,73,131
"8707","KAJIADO","KAJIADO CENTRAL","75-79",266,289,555
"8708","KAJIADO","KAJIADO CENTRAL","80",90,134,224
"8709","KAJIADO","KAJIADO CENTRAL","81",30,47,77
"8710","KAJIADO","KAJIADO CENTRAL","82",35,22,57
"8711","KAJIADO","KAJIADO CENTRAL","83",22,26,48
"8712","KAJIADO","KAJIADO CENTRAL","84",17,37,54
"8713","KAJIADO","KAJIADO CENTRAL","80-84",194,266,460
"8714","KAJIADO","KAJIADO CENTRAL","85",33,44,77
"8715","KAJIADO","KAJIADO CENTRAL","86",18,11,29
"8716","KAJIADO","KAJIADO CENTRAL","87",15,17,32
"8717","KAJIADO","KAJIADO CENTRAL","88",11,10,21
"8718","KAJIADO","KAJIADO CENTRAL","89",24,31,55
"8719","KAJIADO","KAJIADO CENTRAL","85-89",101,113,214
"8720","KAJIADO","KAJIADO CENTRAL","90",36,35,71
"8721","KAJIADO","KAJIADO CENTRAL","91",13,10,23
"8722","KAJIADO","KAJIADO CENTRAL","92",2,10,12
"8723","KAJIADO","KAJIADO CENTRAL","93",7,6,13
"8724","KAJIADO","KAJIADO CENTRAL","94",6,7,13
"8725","KAJIADO","KAJIADO CENTRAL","90-94",64,68,132
"8726","KAJIADO","KAJIADO CENTRAL","95",5,9,14
"8727","KAJIADO","KAJIADO CENTRAL","96",2,2,4
"8728","KAJIADO","KAJIADO CENTRAL","97",4,6,10
"8729","KAJIADO","KAJIADO CENTRAL","98",2,4,6
"8730","KAJIADO","KAJIADO CENTRAL","99",6,6,12
"8731","KAJIADO","KAJIADO CENTRAL","95-99",19,27,46
"8732","KAJIADO","KAJIADO CENTRAL","100+",8,27,35
"8733","KAJIADO","KAJIADO CENTRAL","Not Stated",NA,NA,NA
"8734","KAJIADO","KAJIADO NORTH","Total",150675,155908,306583
"8735","KAJIADO","KAJIADO NORTH","0",3871,3533,7404
"8736","KAJIADO","KAJIADO NORTH","1",3721,3669,7390
"8737","KAJIADO","KAJIADO NORTH","2",3585,3593,7178
"8738","KAJIADO","KAJIADO NORTH","3",3523,3625,7148
"8739","KAJIADO","KAJIADO NORTH","4",3462,3224,6686
"8740","KAJIADO","KAJIADO NORTH","0 - 4",18162,17644,35806
"8741","KAJIADO","KAJIADO NORTH","5",3103,3236,6339
"8742","KAJIADO","KAJIADO NORTH","6",3166,3240,6406
"8743","KAJIADO","KAJIADO NORTH","7",3093,3075,6168
"8744","KAJIADO","KAJIADO NORTH","8",3012,3054,6066
"8745","KAJIADO","KAJIADO NORTH","9",3148,3157,6305
"8746","KAJIADO","KAJIADO NORTH","5-9",15522,15762,31284
"8747","KAJIADO","KAJIADO NORTH","10",2923,3064,5987
"8748","KAJIADO","KAJIADO NORTH","11",2711,2802,5513
"8749","KAJIADO","KAJIADO NORTH","12",2786,2806,5592
"8750","KAJIADO","KAJIADO NORTH","13",2870,2939,5809
"8751","KAJIADO","KAJIADO NORTH","14",2514,2802,5316
"8752","KAJIADO","KAJIADO NORTH","10 -14",13804,14413,28217
"8753","KAJIADO","KAJIADO NORTH","15",2393,2580,4973
"8754","KAJIADO","KAJIADO NORTH","16",2278,2603,4881
"8755","KAJIADO","KAJIADO NORTH","17",2505,2671,5176
"8756","KAJIADO","KAJIADO NORTH","18",2122,2603,4725
"8757","KAJIADO","KAJIADO NORTH","19",2733,3496,6229
"8758","KAJIADO","KAJIADO NORTH","15-19",12031,13953,25984
"8759","KAJIADO","KAJIADO NORTH","20",2855,3805,6660
"8760","KAJIADO","KAJIADO NORTH","21",3174,4018,7192
"8761","KAJIADO","KAJIADO NORTH","22",3305,4231,7536
"8762","KAJIADO","KAJIADO NORTH","23",3799,4789,8588
"8763","KAJIADO","KAJIADO NORTH","24",3835,4530,8365
"8764","KAJIADO","KAJIADO NORTH","20-24",16968,21373,38341
"8765","KAJIADO","KAJIADO NORTH","25",4195,4443,8638
"8766","KAJIADO","KAJIADO NORTH","26",3620,3966,7586
"8767","KAJIADO","KAJIADO NORTH","27",3712,3931,7643
"8768","KAJIADO","KAJIADO NORTH","28",3120,3514,6634
"8769","KAJIADO","KAJIADO NORTH","29",3405,3684,7089
"8770","KAJIADO","KAJIADO NORTH","25-29",18052,19538,37590
"8771","KAJIADO","KAJIADO NORTH","30",3874,4160,8034
"8772","KAJIADO","KAJIADO NORTH","31",2872,2936,5808
"8773","KAJIADO","KAJIADO NORTH","32",3527,3606,7133
"8774","KAJIADO","KAJIADO NORTH","33",2819,2936,5755
"8775","KAJIADO","KAJIADO NORTH","34",2648,2671,5319
"8776","KAJIADO","KAJIADO NORTH","30-34",15740,16309,32049
"8777","KAJIADO","KAJIADO NORTH","35",3133,2999,6132
"8778","KAJIADO","KAJIADO NORTH","36",2375,2348,4723
"8779","KAJIADO","KAJIADO NORTH","37",2328,2280,4608
"8780","KAJIADO","KAJIADO NORTH","38",2019,1997,4016
"8781","KAJIADO","KAJIADO NORTH","39",2061,1921,3982
"8782","KAJIADO","KAJIADO NORTH","35-39",11916,11545,23461
"8783","KAJIADO","KAJIADO NORTH","40",2459,2250,4709
"8784","KAJIADO","KAJIADO NORTH","41",1944,1769,3713
"8785","KAJIADO","KAJIADO NORTH","42",1827,1649,3476
"8786","KAJIADO","KAJIADO NORTH","43",1624,1495,3119
"8787","KAJIADO","KAJIADO NORTH","44",1290,1191,2481
"8788","KAJIADO","KAJIADO NORTH","40-44",9144,8354,17498
"8789","KAJIADO","KAJIADO NORTH","45",1938,1567,3505
"8790","KAJIADO","KAJIADO NORTH","46",1343,1143,2486
"8791","KAJIADO","KAJIADO NORTH","47",1420,1207,2627
"8792","KAJIADO","KAJIADO NORTH","48",1109,938,2047
"8793","KAJIADO","KAJIADO NORTH","49",1113,960,2073
"8794","KAJIADO","KAJIADO NORTH","45-49",6923,5815,12738
"8795","KAJIADO","KAJIADO NORTH","50",1327,1112,2439
"8796","KAJIADO","KAJIADO NORTH","51",953,747,1700
"8797","KAJIADO","KAJIADO NORTH","52",971,798,1769
"8798","KAJIADO","KAJIADO NORTH","53",702,643,1345
"8799","KAJIADO","KAJIADO NORTH","54",833,619,1452
"8800","KAJIADO","KAJIADO NORTH","50-54",4786,3919,8705
"8801","KAJIADO","KAJIADO NORTH","55",788,608,1396
"8802","KAJIADO","KAJIADO NORTH","56",765,588,1353
"8803","KAJIADO","KAJIADO NORTH","57",614,573,1187
"8804","KAJIADO","KAJIADO NORTH","58",537,442,979
"8805","KAJIADO","KAJIADO NORTH","59",513,463,976
"8806","KAJIADO","KAJIADO NORTH","55-59",3217,2674,5891
"8807","KAJIADO","KAJIADO NORTH","60",532,519,1051
"8808","KAJIADO","KAJIADO NORTH","61",392,377,769
"8809","KAJIADO","KAJIADO NORTH","62",350,328,678
"8810","KAJIADO","KAJIADO NORTH","63",318,272,590
"8811","KAJIADO","KAJIADO NORTH","64",232,242,474
"8812","KAJIADO","KAJIADO NORTH","60-64",1824,1738,3562
"8813","KAJIADO","KAJIADO NORTH","65",340,323,663
"8814","KAJIADO","KAJIADO NORTH","66",197,184,381
"8815","KAJIADO","KAJIADO NORTH","67",300,267,567
"8816","KAJIADO","KAJIADO NORTH","68",160,128,288
"8817","KAJIADO","KAJIADO NORTH","69",201,196,397
"8818","KAJIADO","KAJIADO NORTH","65-69",1198,1098,2296
"8819","KAJIADO","KAJIADO NORTH","70",233,229,462
"8820","KAJIADO","KAJIADO NORTH","71",141,177,318
"8821","KAJIADO","KAJIADO NORTH","72",170,139,309
"8822","KAJIADO","KAJIADO NORTH","73",128,115,243
"8823","KAJIADO","KAJIADO NORTH","74",110,133,243
"8824","KAJIADO","KAJIADO NORTH","70-74",782,793,1575
"8825","KAJIADO","KAJIADO NORTH","75",85,109,194
"8826","KAJIADO","KAJIADO NORTH","76",74,106,180
"8827","KAJIADO","KAJIADO NORTH","77",66,76,142
"8828","KAJIADO","KAJIADO NORTH","78",49,54,103
"8829","KAJIADO","KAJIADO NORTH","79",39,58,97
"8830","KAJIADO","KAJIADO NORTH","75-79",313,403,716
"8831","KAJIADO","KAJIADO NORTH","80",52,92,144
"8832","KAJIADO","KAJIADO NORTH","81",35,52,87
"8833","KAJIADO","KAJIADO NORTH","82",31,36,67
"8834","KAJIADO","KAJIADO NORTH","83",25,45,70
"8835","KAJIADO","KAJIADO NORTH","84",20,39,59
"8836","KAJIADO","KAJIADO NORTH","80-84",163,264,427
"8837","KAJIADO","KAJIADO NORTH","85",25,34,59
"8838","KAJIADO","KAJIADO NORTH","86",19,35,54
"8839","KAJIADO","KAJIADO NORTH","87",13,34,47
"8840","KAJIADO","KAJIADO NORTH","88",9,15,24
"8841","KAJIADO","KAJIADO NORTH","89",17,25,42
"8842","KAJIADO","KAJIADO NORTH","85-89",83,143,226
"8843","KAJIADO","KAJIADO NORTH","90",10,37,47
"8844","KAJIADO","KAJIADO NORTH","91",4,17,21
"8845","KAJIADO","KAJIADO NORTH","92",5,18,23
"8846","KAJIADO","KAJIADO NORTH","93",3,9,12
"8847","KAJIADO","KAJIADO NORTH","94",2,7,9
"8848","KAJIADO","KAJIADO NORTH","90-94",24,88,112
"8849","KAJIADO","KAJIADO NORTH","95",7,13,20
"8850","KAJIADO","KAJIADO NORTH","96",2,9,11
"8851","KAJIADO","KAJIADO NORTH","97",4,13,17
"8852","KAJIADO","KAJIADO NORTH","98",NA,5,5
"8853","KAJIADO","KAJIADO NORTH","99",1,5,6
"8854","KAJIADO","KAJIADO NORTH","95-99",14,45,59
"8855","KAJIADO","KAJIADO NORTH","100+",4,33,37
"8856","KAJIADO","KAJIADO NORTH","Not Stated",5,4,9
"8857","KAJIADO","KAJIADO WEST","Total",91607,91237,182844
"8858","KAJIADO","KAJIADO WEST","0",2369,2426,4795
"8859","KAJIADO","KAJIADO WEST","1",2967,2747,5714
"8860","KAJIADO","KAJIADO WEST","2",3107,2973,6080
"8861","KAJIADO","KAJIADO WEST","3",3282,3166,6448
"8862","KAJIADO","KAJIADO WEST","4",3240,3257,6497
"8863","KAJIADO","KAJIADO WEST","0 - 4",14965,14569,29534
"8864","KAJIADO","KAJIADO WEST","5",3204,3072,6276
"8865","KAJIADO","KAJIADO WEST","6",3114,3207,6321
"8866","KAJIADO","KAJIADO WEST","7",2761,2792,5553
"8867","KAJIADO","KAJIADO WEST","8",2922,2743,5665
"8868","KAJIADO","KAJIADO WEST","9",2454,2291,4745
"8869","KAJIADO","KAJIADO WEST","5-9",14455,14105,28560
"8870","KAJIADO","KAJIADO WEST","10",3220,3068,6288
"8871","KAJIADO","KAJIADO WEST","11",1962,2172,4134
"8872","KAJIADO","KAJIADO WEST","12",2671,2640,5311
"8873","KAJIADO","KAJIADO WEST","13",2278,2355,4633
"8874","KAJIADO","KAJIADO WEST","14",2130,2144,4274
"8875","KAJIADO","KAJIADO WEST","10 -14",12261,12379,24640
"8876","KAJIADO","KAJIADO WEST","15",2245,2068,4313
"8877","KAJIADO","KAJIADO WEST","16",1910,1742,3652
"8878","KAJIADO","KAJIADO WEST","17",1796,1575,3371
"8879","KAJIADO","KAJIADO WEST","18",1579,1771,3350
"8880","KAJIADO","KAJIADO WEST","19",1611,1687,3298
"8881","KAJIADO","KAJIADO WEST","15-19",9141,8843,17984
"8882","KAJIADO","KAJIADO WEST","20",1919,2272,4191
"8883","KAJIADO","KAJIADO WEST","21",1456,1530,2986
"8884","KAJIADO","KAJIADO WEST","22",1597,1726,3323
"8885","KAJIADO","KAJIADO WEST","23",1552,1736,3288
"8886","KAJIADO","KAJIADO WEST","24",1551,1515,3066
"8887","KAJIADO","KAJIADO WEST","20-24",8075,8779,16854
"8888","KAJIADO","KAJIADO WEST","25",1980,1960,3940
"8889","KAJIADO","KAJIADO WEST","26",1298,1479,2777
"8890","KAJIADO","KAJIADO WEST","27",1320,1344,2664
"8891","KAJIADO","KAJIADO WEST","28",1130,1162,2292
"8892","KAJIADO","KAJIADO WEST","29",1128,1182,2310
"8893","KAJIADO","KAJIADO WEST","25-29",6856,7127,13983
"8894","KAJIADO","KAJIADO WEST","30",1925,2055,3980
"8895","KAJIADO","KAJIADO WEST","31",1033,1056,2089
"8896","KAJIADO","KAJIADO WEST","32",1337,1504,2841
"8897","KAJIADO","KAJIADO WEST","33",989,1037,2026
"8898","KAJIADO","KAJIADO WEST","34",907,888,1795
"8899","KAJIADO","KAJIADO WEST","30-34",6191,6540,12731
"8900","KAJIADO","KAJIADO WEST","35",1585,1587,3172
"8901","KAJIADO","KAJIADO WEST","36",868,829,1697
"8902","KAJIADO","KAJIADO WEST","37",867,681,1548
"8903","KAJIADO","KAJIADO WEST","38",795,606,1401
"8904","KAJIADO","KAJIADO WEST","39",695,664,1359
"8905","KAJIADO","KAJIADO WEST","35-39",4810,4367,9177
"8906","KAJIADO","KAJIADO WEST","40",1178,1128,2306
"8907","KAJIADO","KAJIADO WEST","41",752,755,1507
"8908","KAJIADO","KAJIADO WEST","42",790,846,1636
"8909","KAJIADO","KAJIADO WEST","43",564,570,1134
"8910","KAJIADO","KAJIADO WEST","44",457,393,850
"8911","KAJIADO","KAJIADO WEST","40-44",3741,3692,7433
"8912","KAJIADO","KAJIADO WEST","45",1174,1037,2211
"8913","KAJIADO","KAJIADO WEST","46",690,596,1286
"8914","KAJIADO","KAJIADO WEST","47",664,532,1196
"8915","KAJIADO","KAJIADO WEST","48",480,376,856
"8916","KAJIADO","KAJIADO WEST","49",450,388,838
"8917","KAJIADO","KAJIADO WEST","45-49",3458,2929,6387
"8918","KAJIADO","KAJIADO WEST","50",739,740,1479
"8919","KAJIADO","KAJIADO WEST","51",571,590,1161
"8920","KAJIADO","KAJIADO WEST","52",497,449,946
"8921","KAJIADO","KAJIADO WEST","53",286,235,521
"8922","KAJIADO","KAJIADO WEST","54",377,364,741
"8923","KAJIADO","KAJIADO WEST","50-54",2470,2378,4848
"8924","KAJIADO","KAJIADO WEST","55",479,475,954
"8925","KAJIADO","KAJIADO WEST","56",334,331,665
"8926","KAJIADO","KAJIADO WEST","57",281,262,543
"8927","KAJIADO","KAJIADO WEST","58",287,221,508
"8928","KAJIADO","KAJIADO WEST","59",312,338,650
"8929","KAJIADO","KAJIADO WEST","55-59",1693,1627,3320
"8930","KAJIADO","KAJIADO WEST","60",509,496,1005
"8931","KAJIADO","KAJIADO WEST","61",184,227,411
"8932","KAJIADO","KAJIADO WEST","62",226,232,458
"8933","KAJIADO","KAJIADO WEST","63",183,234,417
"8934","KAJIADO","KAJIADO WEST","64",144,148,292
"8935","KAJIADO","KAJIADO WEST","60-64",1246,1337,2583
"8936","KAJIADO","KAJIADO WEST","65",272,285,557
"8937","KAJIADO","KAJIADO WEST","66",117,118,235
"8938","KAJIADO","KAJIADO WEST","67",161,127,288
"8939","KAJIADO","KAJIADO WEST","68",100,109,209
"8940","KAJIADO","KAJIADO WEST","69",111,134,245
"8941","KAJIADO","KAJIADO WEST","65-69",761,773,1534
"8942","KAJIADO","KAJIADO WEST","70",326,315,641
"8943","KAJIADO","KAJIADO WEST","71",125,168,293
"8944","KAJIADO","KAJIADO WEST","72",96,107,203
"8945","KAJIADO","KAJIADO WEST","73",81,91,172
"8946","KAJIADO","KAJIADO WEST","74",90,91,181
"8947","KAJIADO","KAJIADO WEST","70-74",718,772,1490
"8948","KAJIADO","KAJIADO WEST","75",116,123,239
"8949","KAJIADO","KAJIADO WEST","76",52,62,114
"8950","KAJIADO","KAJIADO WEST","77",51,60,111
"8951","KAJIADO","KAJIADO WEST","78",37,37,74
"8952","KAJIADO","KAJIADO WEST","79",80,99,179
"8953","KAJIADO","KAJIADO WEST","75-79",336,381,717
"8954","KAJIADO","KAJIADO WEST","80",100,159,259
"8955","KAJIADO","KAJIADO WEST","81",30,43,73
"8956","KAJIADO","KAJIADO WEST","82",14,16,30
"8957","KAJIADO","KAJIADO WEST","83",24,24,48
"8958","KAJIADO","KAJIADO WEST","84",30,45,75
"8959","KAJIADO","KAJIADO WEST","80-84",198,287,485
"8960","KAJIADO","KAJIADO WEST","85",43,35,78
"8961","KAJIADO","KAJIADO WEST","86",23,30,53
"8962","KAJIADO","KAJIADO WEST","87",12,15,27
"8963","KAJIADO","KAJIADO WEST","88",13,9,22
"8964","KAJIADO","KAJIADO WEST","89",25,55,80
"8965","KAJIADO","KAJIADO WEST","85-89",116,144,260
"8966","KAJIADO","KAJIADO WEST","90",32,55,87
"8967","KAJIADO","KAJIADO WEST","91",8,11,19
"8968","KAJIADO","KAJIADO WEST","92",9,9,18
"8969","KAJIADO","KAJIADO WEST","93",4,8,12
"8970","KAJIADO","KAJIADO WEST","94",5,5,10
"8971","KAJIADO","KAJIADO WEST","90-94",58,88,146
"8972","KAJIADO","KAJIADO WEST","95",19,24,43
"8973","KAJIADO","KAJIADO WEST","96",5,12,17
"8974","KAJIADO","KAJIADO WEST","97",3,5,8
"8975","KAJIADO","KAJIADO WEST","98",3,6,9
"8976","KAJIADO","KAJIADO WEST","99",7,10,17
"8977","KAJIADO","KAJIADO WEST","95-99",37,57,94
"8978","KAJIADO","KAJIADO WEST","100+",21,62,83
"8979","KAJIADO","KAJIADO WEST","Not Stated",NA,1,1
"8980","KAJIADO","LOITOKITOK","Total",94613,97225,191838
"8981","KAJIADO","LOITOKITOK","0",2542,2636,5178
"8982","KAJIADO","LOITOKITOK","1",2912,3011,5923
"8983","KAJIADO","LOITOKITOK","2",3012,2955,5967
"8984","KAJIADO","LOITOKITOK","3",3158,3151,6309
"8985","KAJIADO","LOITOKITOK","4",3202,3124,6326
"8986","KAJIADO","LOITOKITOK","0 - 4",14826,14877,29703
"8987","KAJIADO","LOITOKITOK","5",3221,3010,6231
"8988","KAJIADO","LOITOKITOK","6",3210,3094,6304
"8989","KAJIADO","LOITOKITOK","7",2971,2979,5950
"8990","KAJIADO","LOITOKITOK","8",2787,2913,5700
"8991","KAJIADO","LOITOKITOK","9",2754,2724,5478
"8992","KAJIADO","LOITOKITOK","5-9",14943,14720,29663
"8993","KAJIADO","LOITOKITOK","10",3284,3219,6503
"8994","KAJIADO","LOITOKITOK","11",2371,2457,4828
"8995","KAJIADO","LOITOKITOK","12",2922,3041,5963
"8996","KAJIADO","LOITOKITOK","13",2712,2839,5551
"8997","KAJIADO","LOITOKITOK","14",2375,2677,5052
"8998","KAJIADO","LOITOKITOK","10 -14",13664,14233,27897
"8999","KAJIADO","LOITOKITOK","15",2444,2368,4812
"9000","KAJIADO","LOITOKITOK","16",2070,2064,4134
"9001","KAJIADO","LOITOKITOK","17",2062,1913,3975
"9002","KAJIADO","LOITOKITOK","18",1557,1598,3155
"9003","KAJIADO","LOITOKITOK","19",1702,1781,3483
"9004","KAJIADO","LOITOKITOK","15-19",9835,9724,19559
"9005","KAJIADO","LOITOKITOK","20",1553,1843,3396
"9006","KAJIADO","LOITOKITOK","21",1404,1549,2953
"9007","KAJIADO","LOITOKITOK","22",1342,1566,2908
"9008","KAJIADO","LOITOKITOK","23",1434,1613,3047
"9009","KAJIADO","LOITOKITOK","24",1356,1489,2845
"9010","KAJIADO","LOITOKITOK","20-24",7089,8060,15149
"9011","KAJIADO","LOITOKITOK","25",1603,1794,3397
"9012","KAJIADO","LOITOKITOK","26",1278,1463,2741
"9013","KAJIADO","LOITOKITOK","27",1406,1593,2999
"9014","KAJIADO","LOITOKITOK","28",1276,1385,2661
"9015","KAJIADO","LOITOKITOK","29",1186,1407,2593
"9016","KAJIADO","LOITOKITOK","25-29",6749,7642,14391
"9017","KAJIADO","LOITOKITOK","30",1721,2048,3769
"9018","KAJIADO","LOITOKITOK","31",1083,1372,2455
"9019","KAJIADO","LOITOKITOK","32",1346,1594,2940
"9020","KAJIADO","LOITOKITOK","33",1181,1288,2469
"9021","KAJIADO","LOITOKITOK","34",1190,1126,2316
"9022","KAJIADO","LOITOKITOK","30-34",6521,7428,13949
"9023","KAJIADO","LOITOKITOK","35",1761,1632,3393
"9024","KAJIADO","LOITOKITOK","36",897,733,1630
"9025","KAJIADO","LOITOKITOK","37",901,747,1648
"9026","KAJIADO","LOITOKITOK","38",734,635,1369
"9027","KAJIADO","LOITOKITOK","39",700,616,1316
"9028","KAJIADO","LOITOKITOK","35-39",4993,4363,9356
"9029","KAJIADO","LOITOKITOK","40",1107,1017,2124
"9030","KAJIADO","LOITOKITOK","41",912,949,1861
"9031","KAJIADO","LOITOKITOK","42",868,856,1724
"9032","KAJIADO","LOITOKITOK","43",661,600,1261
"9033","KAJIADO","LOITOKITOK","44",465,429,894
"9034","KAJIADO","LOITOKITOK","40-44",4013,3851,7864
"9035","KAJIADO","LOITOKITOK","45",1024,1138,2162
"9036","KAJIADO","LOITOKITOK","46",689,733,1422
"9037","KAJIADO","LOITOKITOK","47",715,624,1339
"9038","KAJIADO","LOITOKITOK","48",477,414,891
"9039","KAJIADO","LOITOKITOK","49",573,482,1055
"9040","KAJIADO","LOITOKITOK","45-49",3478,3391,6869
"9041","KAJIADO","LOITOKITOK","50",845,794,1639
"9042","KAJIADO","LOITOKITOK","51",493,498,991
"9043","KAJIADO","LOITOKITOK","52",490,460,950
"9044","KAJIADO","LOITOKITOK","53",388,352,740
"9045","KAJIADO","LOITOKITOK","54",481,491,972
"9046","KAJIADO","LOITOKITOK","50-54",2697,2595,5292
"9047","KAJIADO","LOITOKITOK","55",457,390,847
"9048","KAJIADO","LOITOKITOK","56",412,396,808
"9049","KAJIADO","LOITOKITOK","57",306,365,671
"9050","KAJIADO","LOITOKITOK","58",263,297,560
"9051","KAJIADO","LOITOKITOK","59",313,417,730
"9052","KAJIADO","LOITOKITOK","55-59",1751,1865,3616
"9053","KAJIADO","LOITOKITOK","60",456,524,980
"9054","KAJIADO","LOITOKITOK","61",267,302,569
"9055","KAJIADO","LOITOKITOK","62",236,276,512
"9056","KAJIADO","LOITOKITOK","63",224,227,451
"9057","KAJIADO","LOITOKITOK","64",175,136,311
"9058","KAJIADO","LOITOKITOK","60-64",1358,1465,2823
"9059","KAJIADO","LOITOKITOK","65",303,343,646
"9060","KAJIADO","LOITOKITOK","66",147,146,293
"9061","KAJIADO","LOITOKITOK","67",243,202,445
"9062","KAJIADO","LOITOKITOK","68",130,94,224
"9063","KAJIADO","LOITOKITOK","69",178,212,390
"9064","KAJIADO","LOITOKITOK","65-69",1001,997,1998
"9065","KAJIADO","LOITOKITOK","70",298,355,653
"9066","KAJIADO","LOITOKITOK","71",147,142,289
"9067","KAJIADO","LOITOKITOK","72",109,96,205
"9068","KAJIADO","LOITOKITOK","73",74,99,173
"9069","KAJIADO","LOITOKITOK","74",95,114,209
"9070","KAJIADO","LOITOKITOK","70-74",723,806,1529
"9071","KAJIADO","LOITOKITOK","75",106,139,245
"9072","KAJIADO","LOITOKITOK","76",102,87,189
"9073","KAJIADO","LOITOKITOK","77",80,79,159
"9074","KAJIADO","LOITOKITOK","78",52,44,96
"9075","KAJIADO","LOITOKITOK","79",76,117,193
"9076","KAJIADO","LOITOKITOK","75-79",416,466,882
"9077","KAJIADO","LOITOKITOK","80",113,151,264
"9078","KAJIADO","LOITOKITOK","81",47,49,96
"9079","KAJIADO","LOITOKITOK","82",41,43,84
"9080","KAJIADO","LOITOKITOK","83",38,47,85
"9081","KAJIADO","LOITOKITOK","84",26,49,75
"9082","KAJIADO","LOITOKITOK","80-84",265,339,604
"9083","KAJIADO","LOITOKITOK","85",44,59,103
"9084","KAJIADO","LOITOKITOK","86",27,28,55
"9085","KAJIADO","LOITOKITOK","87",31,33,64
"9086","KAJIADO","LOITOKITOK","88",11,26,37
"9087","KAJIADO","LOITOKITOK","89",48,51,99
"9088","KAJIADO","LOITOKITOK","85-89",161,197,358
"9089","KAJIADO","LOITOKITOK","90",25,51,76
"9090","KAJIADO","LOITOKITOK","91",12,16,28
"9091","KAJIADO","LOITOKITOK","92",6,14,20
"9092","KAJIADO","LOITOKITOK","93",9,11,20
"9093","KAJIADO","LOITOKITOK","94",7,11,18
"9094","KAJIADO","LOITOKITOK","90-94",59,103,162
"9095","KAJIADO","LOITOKITOK","95",16,21,37
"9096","KAJIADO","LOITOKITOK","96",5,7,12
"9097","KAJIADO","LOITOKITOK","97",7,11,18
"9098","KAJIADO","LOITOKITOK","98",9,13,22
"9099","KAJIADO","LOITOKITOK","99",9,18,27
"9100","KAJIADO","LOITOKITOK","95-99",46,70,116
"9101","KAJIADO","LOITOKITOK","100+",22,33,55
"9102","KAJIADO","LOITOKITOK","Not Stated",3,NA,3
"9103","KAJIADO","MASHUURU","Total",33082,31131,64213
"9104","KAJIADO","MASHUURU","0",844,757,1601
"9105","KAJIADO","MASHUURU","1",919,863,1782
"9106","KAJIADO","MASHUURU","2",859,800,1659
"9107","KAJIADO","MASHUURU","3",978,907,1885
"9108","KAJIADO","MASHUURU","4",872,883,1755
"9109","KAJIADO","MASHUURU","0 - 4",4472,4210,8682
"9110","KAJIADO","MASHUURU","5",901,848,1749
"9111","KAJIADO","MASHUURU","6",776,866,1642
"9112","KAJIADO","MASHUURU","7",798,779,1577
"9113","KAJIADO","MASHUURU","8",781,740,1521
"9114","KAJIADO","MASHUURU","9",826,838,1664
"9115","KAJIADO","MASHUURU","5-9",4082,4071,8153
"9116","KAJIADO","MASHUURU","10",873,849,1722
"9117","KAJIADO","MASHUURU","11",746,758,1504
"9118","KAJIADO","MASHUURU","12",863,835,1698
"9119","KAJIADO","MASHUURU","13",909,854,1763
"9120","KAJIADO","MASHUURU","14",805,807,1612
"9121","KAJIADO","MASHUURU","10 -14",4196,4103,8299
"9122","KAJIADO","MASHUURU","15",803,806,1609
"9123","KAJIADO","MASHUURU","16",721,733,1454
"9124","KAJIADO","MASHUURU","17",717,671,1388
"9125","KAJIADO","MASHUURU","18",599,538,1137
"9126","KAJIADO","MASHUURU","19",748,653,1401
"9127","KAJIADO","MASHUURU","15-19",3588,3401,6989
"9128","KAJIADO","MASHUURU","20",715,664,1379
"9129","KAJIADO","MASHUURU","21",660,629,1289
"9130","KAJIADO","MASHUURU","22",624,625,1249
"9131","KAJIADO","MASHUURU","23",665,746,1411
"9132","KAJIADO","MASHUURU","24",660,661,1321
"9133","KAJIADO","MASHUURU","20-24",3324,3325,6649
"9134","KAJIADO","MASHUURU","25",760,692,1452
"9135","KAJIADO","MASHUURU","26",623,606,1229
"9136","KAJIADO","MASHUURU","27",630,605,1235
"9137","KAJIADO","MASHUURU","28",489,490,979
"9138","KAJIADO","MASHUURU","29",520,511,1031
"9139","KAJIADO","MASHUURU","25-29",3022,2904,5926
"9140","KAJIADO","MASHUURU","30",726,651,1377
"9141","KAJIADO","MASHUURU","31",386,373,759
"9142","KAJIADO","MASHUURU","32",629,562,1191
"9143","KAJIADO","MASHUURU","33",494,437,931
"9144","KAJIADO","MASHUURU","34",398,324,722
"9145","KAJIADO","MASHUURU","30-34",2633,2347,4980
"9146","KAJIADO","MASHUURU","35",618,488,1106
"9147","KAJIADO","MASHUURU","36",346,294,640
"9148","KAJIADO","MASHUURU","37",394,327,721
"9149","KAJIADO","MASHUURU","38",291,252,543
"9150","KAJIADO","MASHUURU","39",268,244,512
"9151","KAJIADO","MASHUURU","35-39",1917,1605,3522
"9152","KAJIADO","MASHUURU","40",434,325,759
"9153","KAJIADO","MASHUURU","41",380,321,701
"9154","KAJIADO","MASHUURU","42",313,268,581
"9155","KAJIADO","MASHUURU","43",262,217,479
"9156","KAJIADO","MASHUURU","44",203,166,369
"9157","KAJIADO","MASHUURU","40-44",1592,1297,2889
"9158","KAJIADO","MASHUURU","45",568,438,1006
"9159","KAJIADO","MASHUURU","46",217,206,423
"9160","KAJIADO","MASHUURU","47",240,214,454
"9161","KAJIADO","MASHUURU","48",167,156,323
"9162","KAJIADO","MASHUURU","49",178,162,340
"9163","KAJIADO","MASHUURU","45-49",1370,1176,2546
"9164","KAJIADO","MASHUURU","50",215,205,420
"9165","KAJIADO","MASHUURU","51",214,184,398
"9166","KAJIADO","MASHUURU","52",135,90,225
"9167","KAJIADO","MASHUURU","53",93,71,164
"9168","KAJIADO","MASHUURU","54",176,140,316
"9169","KAJIADO","MASHUURU","50-54",833,690,1523
"9170","KAJIADO","MASHUURU","55",185,146,331
"9171","KAJIADO","MASHUURU","56",143,170,313
"9172","KAJIADO","MASHUURU","57",111,101,212
"9173","KAJIADO","MASHUURU","58",86,74,160
"9174","KAJIADO","MASHUURU","59",103,116,219
"9175","KAJIADO","MASHUURU","55-59",628,607,1235
"9176","KAJIADO","MASHUURU","60",152,169,321
"9177","KAJIADO","MASHUURU","61",110,105,215
"9178","KAJIADO","MASHUURU","62",100,76,176
"9179","KAJIADO","MASHUURU","63",92,117,209
"9180","KAJIADO","MASHUURU","64",77,48,125
"9181","KAJIADO","MASHUURU","60-64",531,515,1046
"9182","KAJIADO","MASHUURU","65",108,93,201
"9183","KAJIADO","MASHUURU","66",48,53,101
"9184","KAJIADO","MASHUURU","67",85,89,174
"9185","KAJIADO","MASHUURU","68",37,29,66
"9186","KAJIADO","MASHUURU","69",36,55,91
"9187","KAJIADO","MASHUURU","65-69",314,319,633
"9188","KAJIADO","MASHUURU","70",99,98,197
"9189","KAJIADO","MASHUURU","71",61,42,103
"9190","KAJIADO","MASHUURU","72",35,29,64
"9191","KAJIADO","MASHUURU","73",29,27,56
"9192","KAJIADO","MASHUURU","74",38,41,79
"9193","KAJIADO","MASHUURU","70-74",262,237,499
"9194","KAJIADO","MASHUURU","75",35,26,61
"9195","KAJIADO","MASHUURU","76",27,22,49
"9196","KAJIADO","MASHUURU","77",28,17,45
"9197","KAJIADO","MASHUURU","78",15,13,28
"9198","KAJIADO","MASHUURU","79",27,33,60
"9199","KAJIADO","MASHUURU","75-79",132,111,243
"9200","KAJIADO","MASHUURU","80",31,32,63
"9201","KAJIADO","MASHUURU","81",15,24,39
"9202","KAJIADO","MASHUURU","82",12,4,16
"9203","KAJIADO","MASHUURU","83",10,16,26
"9204","KAJIADO","MASHUURU","84",11,17,28
"9205","KAJIADO","MASHUURU","80-84",79,93,172
"9206","KAJIADO","MASHUURU","85",17,14,31
"9207","KAJIADO","MASHUURU","86",7,7,14
"9208","KAJIADO","MASHUURU","87",11,8,19
"9209","KAJIADO","MASHUURU","88",3,2,5
"9210","KAJIADO","MASHUURU","89",9,19,28
"9211","KAJIADO","MASHUURU","85-89",47,50,97
"9212","KAJIADO","MASHUURU","90",9,10,19
"9213","KAJIADO","MASHUURU","91",6,4,10
"9214","KAJIADO","MASHUURU","92",5,6,11
"9215","KAJIADO","MASHUURU","93",3,4,7
"9216","KAJIADO","MASHUURU","94",6,NA,6
"9217","KAJIADO","MASHUURU","90-94",29,24,53
"9218","KAJIADO","MASHUURU","95",8,8,16
"9219","KAJIADO","MASHUURU","96",3,6,9
"9220","KAJIADO","MASHUURU","97",1,3,4
"9221","KAJIADO","MASHUURU","98",1,5,6
"9222","KAJIADO","MASHUURU","99",2,2,4
"9223","KAJIADO","MASHUURU","95-99",15,24,39
"9224","KAJIADO","MASHUURU","100+",16,22,38
"9225","KAJIADO","MASHUURU","Not Stated",NA,NA,NA
"9226","KAKAMEGA","ALL","Total",897133,970406,1867539
"9227","KAKAMEGA","ALL","0",20947,21181,42128
"9228","KAKAMEGA","ALL","1",21421,21831,43252
"9229","KAKAMEGA","ALL","2",21959,22153,44112
"9230","KAKAMEGA","ALL","3",23353,23920,47273
"9231","KAKAMEGA","ALL","4",24680,24474,49154
"9232","KAKAMEGA","ALL","0 - 4",112360,113559,225919
"9233","KAKAMEGA","ALL","5",25911,25358,51269
"9234","KAKAMEGA","ALL","6",26869,27071,53940
"9235","KAKAMEGA","ALL","7",26916,26673,53589
"9236","KAKAMEGA","ALL","8",25383,26266,51649
"9237","KAKAMEGA","ALL","9",29151,29187,58338
"9238","KAKAMEGA","ALL","5-9",134230,134555,268785
"9239","KAKAMEGA","ALL","10",29721,29391,59112
"9240","KAKAMEGA","ALL","11",27237,28443,55680
"9241","KAKAMEGA","ALL","12",30724,30365,61089
"9242","KAKAMEGA","ALL","13",29559,30716,60275
"9243","KAKAMEGA","ALL","14",27734,28087,55821
"9244","KAKAMEGA","ALL","10 -14",144975,147002,291977
"9245","KAKAMEGA","ALL","15",27134,27642,54776
"9246","KAKAMEGA","ALL","16",25327,25606,50933
"9247","KAKAMEGA","ALL","17",25898,25078,50976
"9248","KAKAMEGA","ALL","18",20938,19504,40442
"9249","KAKAMEGA","ALL","19",20968,20576,41544
"9250","KAKAMEGA","ALL","15-19",120265,118406,238671
"9251","KAKAMEGA","ALL","20",17883,19015,36898
"9252","KAKAMEGA","ALL","21",14916,16061,30977
"9253","KAKAMEGA","ALL","22",13485,14853,28338
"9254","KAKAMEGA","ALL","23",13018,15563,28581
"9255","KAKAMEGA","ALL","24",11138,13652,24790
"9256","KAKAMEGA","ALL","20-24",70440,79144,149584
"9257","KAKAMEGA","ALL","25",12282,14558,26840
"9258","KAKAMEGA","ALL","26",10046,13150,23196
"9259","KAKAMEGA","ALL","27",10527,13419,23946
"9260","KAKAMEGA","ALL","28",8363,10812,19175
"9261","KAKAMEGA","ALL","29",9145,12011,21156
"9262","KAKAMEGA","ALL","25-29",50363,63950,114313
"9263","KAKAMEGA","ALL","30",11453,15639,27092
"9264","KAKAMEGA","ALL","31",9309,11887,21196
"9265","KAKAMEGA","ALL","32",11411,15079,26490
"9266","KAKAMEGA","ALL","33",9608,12784,22392
"9267","KAKAMEGA","ALL","34",8914,10707,19621
"9268","KAKAMEGA","ALL","30-34",50695,66096,116791
"9269","KAKAMEGA","ALL","35",10500,11717,22217
"9270","KAKAMEGA","ALL","36",8186,8623,16809
"9271","KAKAMEGA","ALL","37",8786,8523,17309
"9272","KAKAMEGA","ALL","38",6536,6666,13202
"9273","KAKAMEGA","ALL","39",7400,7534,14934
"9274","KAKAMEGA","ALL","35-39",41408,43063,84471
"9275","KAKAMEGA","ALL","40",8482,9399,17881
"9276","KAKAMEGA","ALL","41",8014,8812,16826
"9277","KAKAMEGA","ALL","42",8109,8964,17073
"9278","KAKAMEGA","ALL","43",7355,8603,15958
"9279","KAKAMEGA","ALL","44",6110,6873,12983
"9280","KAKAMEGA","ALL","40-44",38070,42651,80721
"9281","KAKAMEGA","ALL","45",7990,8986,16976
"9282","KAKAMEGA","ALL","46",6166,6793,12959
"9283","KAKAMEGA","ALL","47",6525,7021,13546
"9284","KAKAMEGA","ALL","48",4653,4912,9565
"9285","KAKAMEGA","ALL","49",5211,5741,10952
"9286","KAKAMEGA","ALL","45-49",30545,33453,63998
"9287","KAKAMEGA","ALL","50",6178,8034,14212
"9288","KAKAMEGA","ALL","51",5431,6677,12108
"9289","KAKAMEGA","ALL","52",4551,5244,9795
"9290","KAKAMEGA","ALL","53",3977,5006,8983
"9291","KAKAMEGA","ALL","54",4278,4836,9114
"9292","KAKAMEGA","ALL","50-54",24415,29797,54212
"9293","KAKAMEGA","ALL","55",4706,5257,9963
"9294","KAKAMEGA","ALL","56",4662,5529,10191
"9295","KAKAMEGA","ALL","57",4849,6916,11765
"9296","KAKAMEGA","ALL","58",3577,4214,7791
"9297","KAKAMEGA","ALL","59",4605,5501,10106
"9298","KAKAMEGA","ALL","55-59",22399,27417,49816
"9299","KAKAMEGA","ALL","60",4769,5948,10717
"9300","KAKAMEGA","ALL","61",4188,4917,9105
"9301","KAKAMEGA","ALL","62",3571,4054,7625
"9302","KAKAMEGA","ALL","63",3785,4654,8439
"9303","KAKAMEGA","ALL","64",3017,3475,6492
"9304","KAKAMEGA","ALL","60-64",19330,23048,42378
"9305","KAKAMEGA","ALL","65",3817,4614,8431
"9306","KAKAMEGA","ALL","66",2602,3071,5673
"9307","KAKAMEGA","ALL","67",3631,4536,8167
"9308","KAKAMEGA","ALL","68",1719,1870,3589
"9309","KAKAMEGA","ALL","69",2618,3176,5794
"9310","KAKAMEGA","ALL","65-69",14387,17267,31654
"9311","KAKAMEGA","ALL","70",3130,3985,7115
"9312","KAKAMEGA","ALL","71",2181,2551,4732
"9313","KAKAMEGA","ALL","72",1926,2000,3926
"9314","KAKAMEGA","ALL","73",1742,1895,3637
"9315","KAKAMEGA","ALL","74",1524,1890,3414
"9316","KAKAMEGA","ALL","70-74",10503,12321,22824
"9317","KAKAMEGA","ALL","75",1410,1930,3340
"9318","KAKAMEGA","ALL","76",1412,2310,3722
"9319","KAKAMEGA","ALL","77",1234,1864,3098
"9320","KAKAMEGA","ALL","78",719,884,1603
"9321","KAKAMEGA","ALL","79",874,1431,2305
"9322","KAKAMEGA","ALL","75-79",5649,8419,14068
"9323","KAKAMEGA","ALL","80",1056,1558,2614
"9324","KAKAMEGA","ALL","81",778,1042,1820
"9325","KAKAMEGA","ALL","82",698,895,1593
"9326","KAKAMEGA","ALL","83",821,1059,1880
"9327","KAKAMEGA","ALL","84",526,724,1250
"9328","KAKAMEGA","ALL","80-84",3879,5278,9157
"9329","KAKAMEGA","ALL","85",571,744,1315
"9330","KAKAMEGA","ALL","86",408,635,1043
"9331","KAKAMEGA","ALL","87",562,902,1464
"9332","KAKAMEGA","ALL","88",232,325,557
"9333","KAKAMEGA","ALL","89",332,670,1002
"9334","KAKAMEGA","ALL","85-89",2105,3276,5381
"9335","KAKAMEGA","ALL","90",220,297,517
"9336","KAKAMEGA","ALL","91",199,230,429
"9337","KAKAMEGA","ALL","92",128,169,297
"9338","KAKAMEGA","ALL","93",136,159,295
"9339","KAKAMEGA","ALL","94",63,124,187
"9340","KAKAMEGA","ALL","90-94",746,979,1725
"9341","KAKAMEGA","ALL","95",113,204,317
"9342","KAKAMEGA","ALL","96",46,85,131
"9343","KAKAMEGA","ALL","97",80,118,198
"9344","KAKAMEGA","ALL","98",36,55,91
"9345","KAKAMEGA","ALL","99",31,92,123
"9346","KAKAMEGA","ALL","95-99",306,554,860
"9347","KAKAMEGA","ALL","100+",47,156,203
"9348","KAKAMEGA","ALL","Not Stated",16,15,31
"9349","KAKAMEGA","BUTERE","Total",73634,80463,154097
"9350","KAKAMEGA","BUTERE","0",1636,1682,3318
"9351","KAKAMEGA","BUTERE","1",1714,1832,3546
"9352","KAKAMEGA","BUTERE","2",1869,1852,3721
"9353","KAKAMEGA","BUTERE","3",1839,2035,3874
"9354","KAKAMEGA","BUTERE","4",2025,2025,4050
"9355","KAKAMEGA","BUTERE","0 - 4",9083,9426,18509
"9356","KAKAMEGA","BUTERE","5",2169,1963,4132
"9357","KAKAMEGA","BUTERE","6",2237,2266,4503
"9358","KAKAMEGA","BUTERE","7",2252,2330,4582
"9359","KAKAMEGA","BUTERE","8",2152,2161,4313
"9360","KAKAMEGA","BUTERE","9",2419,2464,4883
"9361","KAKAMEGA","BUTERE","5-9",11229,11184,22413
"9362","KAKAMEGA","BUTERE","10",2516,2526,5042
"9363","KAKAMEGA","BUTERE","11",2276,2457,4733
"9364","KAKAMEGA","BUTERE","12",2659,2542,5201
"9365","KAKAMEGA","BUTERE","13",2425,2507,4932
"9366","KAKAMEGA","BUTERE","14",2310,2335,4645
"9367","KAKAMEGA","BUTERE","10 -14",12186,12367,24553
"9368","KAKAMEGA","BUTERE","15",2260,2324,4584
"9369","KAKAMEGA","BUTERE","16",2081,2107,4188
"9370","KAKAMEGA","BUTERE","17",2166,2011,4177
"9371","KAKAMEGA","BUTERE","18",1736,1565,3301
"9372","KAKAMEGA","BUTERE","19",1720,1630,3350
"9373","KAKAMEGA","BUTERE","15-19",9963,9637,19600
"9374","KAKAMEGA","BUTERE","20",1379,1457,2836
"9375","KAKAMEGA","BUTERE","21",1087,1182,2269
"9376","KAKAMEGA","BUTERE","22",943,1069,2012
"9377","KAKAMEGA","BUTERE","23",881,1109,1990
"9378","KAKAMEGA","BUTERE","24",741,1029,1770
"9379","KAKAMEGA","BUTERE","20-24",5031,5846,10877
"9380","KAKAMEGA","BUTERE","25",787,1068,1855
"9381","KAKAMEGA","BUTERE","26",699,993,1692
"9382","KAKAMEGA","BUTERE","27",740,1061,1801
"9383","KAKAMEGA","BUTERE","28",644,809,1453
"9384","KAKAMEGA","BUTERE","29",629,852,1481
"9385","KAKAMEGA","BUTERE","25-29",3499,4783,8282
"9386","KAKAMEGA","BUTERE","30",855,1244,2099
"9387","KAKAMEGA","BUTERE","31",714,949,1663
"9388","KAKAMEGA","BUTERE","32",818,1162,1980
"9389","KAKAMEGA","BUTERE","33",687,1015,1702
"9390","KAKAMEGA","BUTERE","34",697,879,1576
"9391","KAKAMEGA","BUTERE","30-34",3771,5249,9020
"9392","KAKAMEGA","BUTERE","35",833,1007,1840
"9393","KAKAMEGA","BUTERE","36",649,757,1406
"9394","KAKAMEGA","BUTERE","37",705,743,1448
"9395","KAKAMEGA","BUTERE","38",496,519,1015
"9396","KAKAMEGA","BUTERE","39",582,629,1211
"9397","KAKAMEGA","BUTERE","35-39",3265,3655,6920
"9398","KAKAMEGA","BUTERE","40",726,795,1521
"9399","KAKAMEGA","BUTERE","41",660,699,1359
"9400","KAKAMEGA","BUTERE","42",600,711,1311
"9401","KAKAMEGA","BUTERE","43",570,645,1215
"9402","KAKAMEGA","BUTERE","44",456,524,980
"9403","KAKAMEGA","BUTERE","40-44",3012,3374,6386
"9404","KAKAMEGA","BUTERE","45",620,725,1345
"9405","KAKAMEGA","BUTERE","46",516,520,1036
"9406","KAKAMEGA","BUTERE","47",529,586,1115
"9407","KAKAMEGA","BUTERE","48",416,446,862
"9408","KAKAMEGA","BUTERE","49",450,485,935
"9409","KAKAMEGA","BUTERE","45-49",2531,2762,5293
"9410","KAKAMEGA","BUTERE","50",563,715,1278
"9411","KAKAMEGA","BUTERE","51",536,678,1214
"9412","KAKAMEGA","BUTERE","52",411,459,870
"9413","KAKAMEGA","BUTERE","53",394,482,876
"9414","KAKAMEGA","BUTERE","54",396,456,852
"9415","KAKAMEGA","BUTERE","50-54",2300,2790,5090
"9416","KAKAMEGA","BUTERE","55",435,493,928
"9417","KAKAMEGA","BUTERE","56",392,481,873
"9418","KAKAMEGA","BUTERE","57",442,658,1100
"9419","KAKAMEGA","BUTERE","58",302,343,645
"9420","KAKAMEGA","BUTERE","59",420,467,887
"9421","KAKAMEGA","BUTERE","55-59",1991,2442,4433
"9422","KAKAMEGA","BUTERE","60",446,614,1060
"9423","KAKAMEGA","BUTERE","61",415,428,843
"9424","KAKAMEGA","BUTERE","62",355,359,714
"9425","KAKAMEGA","BUTERE","63",333,387,720
"9426","KAKAMEGA","BUTERE","64",309,311,620
"9427","KAKAMEGA","BUTERE","60-64",1858,2099,3957
"9428","KAKAMEGA","BUTERE","65",362,414,776
"9429","KAKAMEGA","BUTERE","66",249,303,552
"9430","KAKAMEGA","BUTERE","67",375,446,821
"9431","KAKAMEGA","BUTERE","68",180,176,356
"9432","KAKAMEGA","BUTERE","69",226,304,530
"9433","KAKAMEGA","BUTERE","65-69",1392,1643,3035
"9434","KAKAMEGA","BUTERE","70",357,447,804
"9435","KAKAMEGA","BUTERE","71",207,262,469
"9436","KAKAMEGA","BUTERE","72",195,185,380
"9437","KAKAMEGA","BUTERE","73",178,156,334
"9438","KAKAMEGA","BUTERE","74",159,165,324
"9439","KAKAMEGA","BUTERE","70-74",1096,1215,2311
"9440","KAKAMEGA","BUTERE","75",156,194,350
"9441","KAKAMEGA","BUTERE","76",142,258,400
"9442","KAKAMEGA","BUTERE","77",150,194,344
"9443","KAKAMEGA","BUTERE","78",66,78,144
"9444","KAKAMEGA","BUTERE","79",84,180,264
"9445","KAKAMEGA","BUTERE","75-79",598,904,1502
"9446","KAKAMEGA","BUTERE","80",125,166,291
"9447","KAKAMEGA","BUTERE","81",88,102,190
"9448","KAKAMEGA","BUTERE","82",72,86,158
"9449","KAKAMEGA","BUTERE","83",97,106,203
"9450","KAKAMEGA","BUTERE","84",63,66,129
"9451","KAKAMEGA","BUTERE","80-84",445,526,971
"9452","KAKAMEGA","BUTERE","85",79,82,161
"9453","KAKAMEGA","BUTERE","86",33,62,95
"9454","KAKAMEGA","BUTERE","87",74,124,198
"9455","KAKAMEGA","BUTERE","88",34,31,65
"9456","KAKAMEGA","BUTERE","89",35,81,116
"9457","KAKAMEGA","BUTERE","85-89",255,380,635
"9458","KAKAMEGA","BUTERE","90",27,40,67
"9459","KAKAMEGA","BUTERE","91",20,28,48
"9460","KAKAMEGA","BUTERE","92",13,13,26
"9461","KAKAMEGA","BUTERE","93",24,18,42
"9462","KAKAMEGA","BUTERE","94",7,20,27
"9463","KAKAMEGA","BUTERE","90-94",91,119,210
"9464","KAKAMEGA","BUTERE","95",11,16,27
"9465","KAKAMEGA","BUTERE","96",3,8,11
"9466","KAKAMEGA","BUTERE","97",11,8,19
"9467","KAKAMEGA","BUTERE","98",3,7,10
"9468","KAKAMEGA","BUTERE","99",4,6,10
"9469","KAKAMEGA","BUTERE","95-99",32,45,77
"9470","KAKAMEGA","BUTERE","100+",5,17,22
"9471","KAKAMEGA","BUTERE","Not Stated",1,NA,1
"9472","KAKAMEGA","KAKAMEGA CENTRAL","Total",92774,95432,188206
"9473","KAKAMEGA","KAKAMEGA CENTRAL","0",2236,2195,4431
"9474","KAKAMEGA","KAKAMEGA CENTRAL","1",2061,2106,4167
"9475","KAKAMEGA","KAKAMEGA CENTRAL","2",2044,2053,4097
"9476","KAKAMEGA","KAKAMEGA CENTRAL","3",2175,2124,4299
"9477","KAKAMEGA","KAKAMEGA CENTRAL","4",2099,2164,4263
"9478","KAKAMEGA","KAKAMEGA CENTRAL","0 - 4",10615,10642,21257
"9479","KAKAMEGA","KAKAMEGA CENTRAL","5",2231,2133,4364
"9480","KAKAMEGA","KAKAMEGA CENTRAL","6",2282,2241,4523
"9481","KAKAMEGA","KAKAMEGA CENTRAL","7",2261,2279,4540
"9482","KAKAMEGA","KAKAMEGA CENTRAL","8",2179,2235,4414
"9483","KAKAMEGA","KAKAMEGA CENTRAL","9",2314,2491,4805
"9484","KAKAMEGA","KAKAMEGA CENTRAL","5-9",11267,11379,22646
"9485","KAKAMEGA","KAKAMEGA CENTRAL","10",2421,2489,4910
"9486","KAKAMEGA","KAKAMEGA CENTRAL","11",2159,2297,4456
"9487","KAKAMEGA","KAKAMEGA CENTRAL","12",2407,2526,4933
"9488","KAKAMEGA","KAKAMEGA CENTRAL","13",2418,2661,5079
"9489","KAKAMEGA","KAKAMEGA CENTRAL","14",2251,2312,4563
"9490","KAKAMEGA","KAKAMEGA CENTRAL","10 -14",11656,12285,23941
"9491","KAKAMEGA","KAKAMEGA CENTRAL","15",2246,2274,4520
"9492","KAKAMEGA","KAKAMEGA CENTRAL","16",2074,2211,4285
"9493","KAKAMEGA","KAKAMEGA CENTRAL","17",2211,2302,4513
"9494","KAKAMEGA","KAKAMEGA CENTRAL","18",1909,1880,3789
"9495","KAKAMEGA","KAKAMEGA CENTRAL","19",2066,2113,4179
"9496","KAKAMEGA","KAKAMEGA CENTRAL","15-19",10506,10780,21286
"9497","KAKAMEGA","KAKAMEGA CENTRAL","20",1942,2166,4108
"9498","KAKAMEGA","KAKAMEGA CENTRAL","21",2025,2151,4176
"9499","KAKAMEGA","KAKAMEGA CENTRAL","22",2067,2305,4372
"9500","KAKAMEGA","KAKAMEGA CENTRAL","23",2149,2276,4425
"9501","KAKAMEGA","KAKAMEGA CENTRAL","24",1928,2027,3955
"9502","KAKAMEGA","KAKAMEGA CENTRAL","20-24",10111,10925,21036
"9503","KAKAMEGA","KAKAMEGA CENTRAL","25",2066,1959,4025
"9504","KAKAMEGA","KAKAMEGA CENTRAL","26",1667,1731,3398
"9505","KAKAMEGA","KAKAMEGA CENTRAL","27",1717,1755,3472
"9506","KAKAMEGA","KAKAMEGA CENTRAL","28",1314,1518,2832
"9507","KAKAMEGA","KAKAMEGA CENTRAL","29",1473,1560,3033
"9508","KAKAMEGA","KAKAMEGA CENTRAL","25-29",8237,8523,16760
"9509","KAKAMEGA","KAKAMEGA CENTRAL","30",1790,1935,3725
"9510","KAKAMEGA","KAKAMEGA CENTRAL","31",1333,1312,2645
"9511","KAKAMEGA","KAKAMEGA CENTRAL","32",1676,1767,3443
"9512","KAKAMEGA","KAKAMEGA CENTRAL","33",1261,1391,2652
"9513","KAKAMEGA","KAKAMEGA CENTRAL","34",1243,1271,2514
"9514","KAKAMEGA","KAKAMEGA CENTRAL","30-34",7303,7676,14979
"9515","KAKAMEGA","KAKAMEGA CENTRAL","35",1491,1361,2852
"9516","KAKAMEGA","KAKAMEGA CENTRAL","36",1075,996,2071
"9517","KAKAMEGA","KAKAMEGA CENTRAL","37",1101,996,2097
"9518","KAKAMEGA","KAKAMEGA CENTRAL","38",901,835,1736
"9519","KAKAMEGA","KAKAMEGA CENTRAL","39",919,834,1753
"9520","KAKAMEGA","KAKAMEGA CENTRAL","35-39",5487,5022,10509
"9521","KAKAMEGA","KAKAMEGA CENTRAL","40",1141,1058,2199
"9522","KAKAMEGA","KAKAMEGA CENTRAL","41",949,848,1797
"9523","KAKAMEGA","KAKAMEGA CENTRAL","42",1027,874,1901
"9524","KAKAMEGA","KAKAMEGA CENTRAL","43",870,844,1714
"9525","KAKAMEGA","KAKAMEGA CENTRAL","44",707,661,1368
"9526","KAKAMEGA","KAKAMEGA CENTRAL","40-44",4694,4285,8979
"9527","KAKAMEGA","KAKAMEGA CENTRAL","45",955,848,1803
"9528","KAKAMEGA","KAKAMEGA CENTRAL","46",643,653,1296
"9529","KAKAMEGA","KAKAMEGA CENTRAL","47",700,657,1357
"9530","KAKAMEGA","KAKAMEGA CENTRAL","48",575,516,1091
"9531","KAKAMEGA","KAKAMEGA CENTRAL","49",578,541,1119
"9532","KAKAMEGA","KAKAMEGA CENTRAL","45-49",3451,3215,6666
"9533","KAKAMEGA","KAKAMEGA CENTRAL","50",723,784,1507
"9534","KAKAMEGA","KAKAMEGA CENTRAL","51",524,591,1115
"9535","KAKAMEGA","KAKAMEGA CENTRAL","52",517,511,1028
"9536","KAKAMEGA","KAKAMEGA CENTRAL","53",440,511,951
"9537","KAKAMEGA","KAKAMEGA CENTRAL","54",442,460,902
"9538","KAKAMEGA","KAKAMEGA CENTRAL","50-54",2646,2857,5503
"9539","KAKAMEGA","KAKAMEGA CENTRAL","55",430,467,897
"9540","KAKAMEGA","KAKAMEGA CENTRAL","56",498,564,1062
"9541","KAKAMEGA","KAKAMEGA CENTRAL","57",445,540,985
"9542","KAKAMEGA","KAKAMEGA CENTRAL","58",366,350,716
"9543","KAKAMEGA","KAKAMEGA CENTRAL","59",412,462,874
"9544","KAKAMEGA","KAKAMEGA CENTRAL","55-59",2151,2383,4534
"9545","KAKAMEGA","KAKAMEGA CENTRAL","60",437,477,914
"9546","KAKAMEGA","KAKAMEGA CENTRAL","61",349,397,746
"9547","KAKAMEGA","KAKAMEGA CENTRAL","62",300,346,646
"9548","KAKAMEGA","KAKAMEGA CENTRAL","63",355,373,728
"9549","KAKAMEGA","KAKAMEGA CENTRAL","64",263,266,529
"9550","KAKAMEGA","KAKAMEGA CENTRAL","60-64",1704,1859,3563
"9551","KAKAMEGA","KAKAMEGA CENTRAL","65",321,373,694
"9552","KAKAMEGA","KAKAMEGA CENTRAL","66",237,266,503
"9553","KAKAMEGA","KAKAMEGA CENTRAL","67",293,352,645
"9554","KAKAMEGA","KAKAMEGA CENTRAL","68",139,157,296
"9555","KAKAMEGA","KAKAMEGA CENTRAL","69",189,224,413
"9556","KAKAMEGA","KAKAMEGA CENTRAL","65-69",1179,1372,2551
"9557","KAKAMEGA","KAKAMEGA CENTRAL","70",249,319,568
"9558","KAKAMEGA","KAKAMEGA CENTRAL","71",168,194,362
"9559","KAKAMEGA","KAKAMEGA CENTRAL","72",149,168,317
"9560","KAKAMEGA","KAKAMEGA CENTRAL","73",151,141,292
"9561","KAKAMEGA","KAKAMEGA CENTRAL","74",110,156,266
"9562","KAKAMEGA","KAKAMEGA CENTRAL","70-74",827,978,1805
"9563","KAKAMEGA","KAKAMEGA CENTRAL","75",132,131,263
"9564","KAKAMEGA","KAKAMEGA CENTRAL","76",111,165,276
"9565","KAKAMEGA","KAKAMEGA CENTRAL","77",87,121,208
"9566","KAKAMEGA","KAKAMEGA CENTRAL","78",63,60,123
"9567","KAKAMEGA","KAKAMEGA CENTRAL","79",67,90,157
"9568","KAKAMEGA","KAKAMEGA CENTRAL","75-79",460,567,1027
"9569","KAKAMEGA","KAKAMEGA CENTRAL","80",69,131,200
"9570","KAKAMEGA","KAKAMEGA CENTRAL","81",57,66,123
"9571","KAKAMEGA","KAKAMEGA CENTRAL","82",55,45,100
"9572","KAKAMEGA","KAKAMEGA CENTRAL","83",52,60,112
"9573","KAKAMEGA","KAKAMEGA CENTRAL","84",22,43,65
"9574","KAKAMEGA","KAKAMEGA CENTRAL","80-84",255,345,600
"9575","KAKAMEGA","KAKAMEGA CENTRAL","85",46,50,96
"9576","KAKAMEGA","KAKAMEGA CENTRAL","86",25,36,61
"9577","KAKAMEGA","KAKAMEGA CENTRAL","87",32,59,91
"9578","KAKAMEGA","KAKAMEGA CENTRAL","88",11,22,33
"9579","KAKAMEGA","KAKAMEGA CENTRAL","89",25,47,72
"9580","KAKAMEGA","KAKAMEGA CENTRAL","85-89",139,214,353
"9581","KAKAMEGA","KAKAMEGA CENTRAL","90",14,17,31
"9582","KAKAMEGA","KAKAMEGA CENTRAL","91",10,17,27
"9583","KAKAMEGA","KAKAMEGA CENTRAL","92",6,9,15
"9584","KAKAMEGA","KAKAMEGA CENTRAL","93",15,14,29
"9585","KAKAMEGA","KAKAMEGA CENTRAL","94",5,10,15
"9586","KAKAMEGA","KAKAMEGA CENTRAL","90-94",50,67,117
"9587","KAKAMEGA","KAKAMEGA CENTRAL","95",6,16,22
"9588","KAKAMEGA","KAKAMEGA CENTRAL","96",4,5,9
"9589","KAKAMEGA","KAKAMEGA CENTRAL","97",7,12,19
"9590","KAKAMEGA","KAKAMEGA CENTRAL","98",8,6,14
"9591","KAKAMEGA","KAKAMEGA CENTRAL","99",4,5,9
"9592","KAKAMEGA","KAKAMEGA CENTRAL","95-99",29,44,73
"9593","KAKAMEGA","KAKAMEGA CENTRAL","100+",5,12,17
"9594","KAKAMEGA","KAKAMEGA CENTRAL","Not Stated",2,2,4
"9595","KAKAMEGA","KAKAMEGA EAST","Total",80853,86784,167637
"9596","KAKAMEGA","KAKAMEGA EAST","0",1711,1816,3527
"9597","KAKAMEGA","KAKAMEGA EAST","1",1890,1922,3812
"9598","KAKAMEGA","KAKAMEGA EAST","2",1852,1750,3602
"9599","KAKAMEGA","KAKAMEGA EAST","3",1949,1962,3911
"9600","KAKAMEGA","KAKAMEGA EAST","4",2084,2144,4228
"9601","KAKAMEGA","KAKAMEGA EAST","0 - 4",9486,9594,19080
"9602","KAKAMEGA","KAKAMEGA EAST","5",2198,2015,4213
"9603","KAKAMEGA","KAKAMEGA EAST","6",2316,2263,4579
"9604","KAKAMEGA","KAKAMEGA EAST","7",2412,2313,4725
"9605","KAKAMEGA","KAKAMEGA EAST","8",2141,2277,4418
"9606","KAKAMEGA","KAKAMEGA EAST","9",2474,2541,5015
"9607","KAKAMEGA","KAKAMEGA EAST","5-9",11541,11409,22950
"9608","KAKAMEGA","KAKAMEGA EAST","10",2554,2516,5070
"9609","KAKAMEGA","KAKAMEGA EAST","11",2335,2468,4803
"9610","KAKAMEGA","KAKAMEGA EAST","12",2669,2628,5297
"9611","KAKAMEGA","KAKAMEGA EAST","13",2586,2696,5282
"9612","KAKAMEGA","KAKAMEGA EAST","14",2425,2456,4881
"9613","KAKAMEGA","KAKAMEGA EAST","10 -14",12569,12764,25333
"9614","KAKAMEGA","KAKAMEGA EAST","15",2402,2395,4797
"9615","KAKAMEGA","KAKAMEGA EAST","16",2340,2258,4598
"9616","KAKAMEGA","KAKAMEGA EAST","17",2456,2168,4624
"9617","KAKAMEGA","KAKAMEGA EAST","18",1972,1741,3713
"9618","KAKAMEGA","KAKAMEGA EAST","19",1837,1810,3647
"9619","KAKAMEGA","KAKAMEGA EAST","15-19",11007,10372,21379
"9620","KAKAMEGA","KAKAMEGA EAST","20",1588,1687,3275
"9621","KAKAMEGA","KAKAMEGA EAST","21",1259,1347,2606
"9622","KAKAMEGA","KAKAMEGA EAST","22",1193,1224,2417
"9623","KAKAMEGA","KAKAMEGA EAST","23",1114,1280,2394
"9624","KAKAMEGA","KAKAMEGA EAST","24",937,1088,2025
"9625","KAKAMEGA","KAKAMEGA EAST","20-24",6091,6626,12717
"9626","KAKAMEGA","KAKAMEGA EAST","25",1057,1263,2320
"9627","KAKAMEGA","KAKAMEGA EAST","26",861,1123,1984
"9628","KAKAMEGA","KAKAMEGA EAST","27",964,1123,2087
"9629","KAKAMEGA","KAKAMEGA EAST","28",820,990,1810
"9630","KAKAMEGA","KAKAMEGA EAST","29",835,1074,1909
"9631","KAKAMEGA","KAKAMEGA EAST","25-29",4537,5573,10110
"9632","KAKAMEGA","KAKAMEGA EAST","30",1050,1343,2393
"9633","KAKAMEGA","KAKAMEGA EAST","31",836,1096,1932
"9634","KAKAMEGA","KAKAMEGA EAST","32",991,1332,2323
"9635","KAKAMEGA","KAKAMEGA EAST","33",898,1061,1959
"9636","KAKAMEGA","KAKAMEGA EAST","34",829,896,1725
"9637","KAKAMEGA","KAKAMEGA EAST","30-34",4604,5728,10332
"9638","KAKAMEGA","KAKAMEGA EAST","35",987,1060,2047
"9639","KAKAMEGA","KAKAMEGA EAST","36",757,814,1571
"9640","KAKAMEGA","KAKAMEGA EAST","37",817,753,1570
"9641","KAKAMEGA","KAKAMEGA EAST","38",609,682,1291
"9642","KAKAMEGA","KAKAMEGA EAST","39",734,710,1444
"9643","KAKAMEGA","KAKAMEGA EAST","35-39",3904,4019,7923
"9644","KAKAMEGA","KAKAMEGA EAST","40",722,864,1586
"9645","KAKAMEGA","KAKAMEGA EAST","41",774,820,1594
"9646","KAKAMEGA","KAKAMEGA EAST","42",776,843,1619
"9647","KAKAMEGA","KAKAMEGA EAST","43",674,786,1460
"9648","KAKAMEGA","KAKAMEGA EAST","44",544,630,1174
"9649","KAKAMEGA","KAKAMEGA EAST","40-44",3490,3943,7433
"9650","KAKAMEGA","KAKAMEGA EAST","45",745,868,1613
"9651","KAKAMEGA","KAKAMEGA EAST","46",559,666,1225
"9652","KAKAMEGA","KAKAMEGA EAST","47",587,645,1232
"9653","KAKAMEGA","KAKAMEGA EAST","48",495,473,968
"9654","KAKAMEGA","KAKAMEGA EAST","49",462,576,1038
"9655","KAKAMEGA","KAKAMEGA EAST","45-49",2848,3228,6076
"9656","KAKAMEGA","KAKAMEGA EAST","50",569,783,1352
"9657","KAKAMEGA","KAKAMEGA EAST","51",549,584,1133
"9658","KAKAMEGA","KAKAMEGA EAST","52",471,548,1019
"9659","KAKAMEGA","KAKAMEGA EAST","53",387,484,871
"9660","KAKAMEGA","KAKAMEGA EAST","54",444,549,993
"9661","KAKAMEGA","KAKAMEGA EAST","50-54",2420,2948,5368
"9662","KAKAMEGA","KAKAMEGA EAST","55",444,552,996
"9663","KAKAMEGA","KAKAMEGA EAST","56",512,546,1058
"9664","KAKAMEGA","KAKAMEGA EAST","57",486,641,1127
"9665","KAKAMEGA","KAKAMEGA EAST","58",378,478,856
"9666","KAKAMEGA","KAKAMEGA EAST","59",437,528,965
"9667","KAKAMEGA","KAKAMEGA EAST","55-59",2257,2745,5002
"9668","KAKAMEGA","KAKAMEGA EAST","60",511,651,1162
"9669","KAKAMEGA","KAKAMEGA EAST","61",401,512,913
"9670","KAKAMEGA","KAKAMEGA EAST","62",414,466,880
"9671","KAKAMEGA","KAKAMEGA EAST","63",364,499,863
"9672","KAKAMEGA","KAKAMEGA EAST","64",327,437,764
"9673","KAKAMEGA","KAKAMEGA EAST","60-64",2017,2565,4582
"9674","KAKAMEGA","KAKAMEGA EAST","65",380,500,880
"9675","KAKAMEGA","KAKAMEGA EAST","66",269,353,622
"9676","KAKAMEGA","KAKAMEGA EAST","67",348,443,791
"9677","KAKAMEGA","KAKAMEGA EAST","68",209,214,423
"9678","KAKAMEGA","KAKAMEGA EAST","69",287,348,635
"9679","KAKAMEGA","KAKAMEGA EAST","65-69",1493,1858,3351
"9680","KAKAMEGA","KAKAMEGA EAST","70",342,412,754
"9681","KAKAMEGA","KAKAMEGA EAST","71",263,289,552
"9682","KAKAMEGA","KAKAMEGA EAST","72",227,216,443
"9683","KAKAMEGA","KAKAMEGA EAST","73",186,192,378
"9684","KAKAMEGA","KAKAMEGA EAST","74",174,204,378
"9685","KAKAMEGA","KAKAMEGA EAST","70-74",1192,1313,2505
"9686","KAKAMEGA","KAKAMEGA EAST","75",156,226,382
"9687","KAKAMEGA","KAKAMEGA EAST","76",205,289,494
"9688","KAKAMEGA","KAKAMEGA EAST","77",120,200,320
"9689","KAKAMEGA","KAKAMEGA EAST","78",74,95,169
"9690","KAKAMEGA","KAKAMEGA EAST","79",90,158,248
"9691","KAKAMEGA","KAKAMEGA EAST","75-79",645,968,1613
"9692","KAKAMEGA","KAKAMEGA EAST","80",105,161,266
"9693","KAKAMEGA","KAKAMEGA EAST","81",79,110,189
"9694","KAKAMEGA","KAKAMEGA EAST","82",78,103,181
"9695","KAKAMEGA","KAKAMEGA EAST","83",83,108,191
"9696","KAKAMEGA","KAKAMEGA EAST","84",60,74,134
"9697","KAKAMEGA","KAKAMEGA EAST","80-84",405,556,961
"9698","KAKAMEGA","KAKAMEGA EAST","85",61,82,143
"9699","KAKAMEGA","KAKAMEGA EAST","86",50,82,132
"9700","KAKAMEGA","KAKAMEGA EAST","87",61,78,139
"9701","KAKAMEGA","KAKAMEGA EAST","88",24,34,58
"9702","KAKAMEGA","KAKAMEGA EAST","89",31,75,106
"9703","KAKAMEGA","KAKAMEGA EAST","85-89",227,351,578
"9704","KAKAMEGA","KAKAMEGA EAST","90",31,30,61
"9705","KAKAMEGA","KAKAMEGA EAST","91",18,27,45
"9706","KAKAMEGA","KAKAMEGA EAST","92",17,22,39
"9707","KAKAMEGA","KAKAMEGA EAST","93",4,21,25
"9708","KAKAMEGA","KAKAMEGA EAST","94",8,16,24
"9709","KAKAMEGA","KAKAMEGA EAST","90-94",78,116,194
"9710","KAKAMEGA","KAKAMEGA EAST","95",16,29,45
"9711","KAKAMEGA","KAKAMEGA EAST","96",8,7,15
"9712","KAKAMEGA","KAKAMEGA EAST","97",7,14,21
"9713","KAKAMEGA","KAKAMEGA EAST","98",4,4,8
"9714","KAKAMEGA","KAKAMEGA EAST","99",2,17,19
"9715","KAKAMEGA","KAKAMEGA EAST","95-99",37,71,108
"9716","KAKAMEGA","KAKAMEGA EAST","100+",3,33,36
"9717","KAKAMEGA","KAKAMEGA EAST","Not Stated",2,4,6
"9718","KAKAMEGA","KAKAMEGA NORTH","Total",115511,122814,238325
"9719","KAKAMEGA","KAKAMEGA NORTH","0",2824,2766,5590
"9720","KAKAMEGA","KAKAMEGA NORTH","1",2836,2791,5627
"9721","KAKAMEGA","KAKAMEGA NORTH","2",2891,2946,5837
"9722","KAKAMEGA","KAKAMEGA NORTH","3",3024,3211,6235
"9723","KAKAMEGA","KAKAMEGA NORTH","4",3292,3219,6511
"9724","KAKAMEGA","KAKAMEGA NORTH","0 - 4",14867,14933,29800
"9725","KAKAMEGA","KAKAMEGA NORTH","5",3387,3485,6872
"9726","KAKAMEGA","KAKAMEGA NORTH","6",3465,3532,6997
"9727","KAKAMEGA","KAKAMEGA NORTH","7",3437,3391,6828
"9728","KAKAMEGA","KAKAMEGA NORTH","8",3437,3515,6952
"9729","KAKAMEGA","KAKAMEGA NORTH","9",3975,3870,7845
"9730","KAKAMEGA","KAKAMEGA NORTH","5-9",17701,17793,35494
"9731","KAKAMEGA","KAKAMEGA NORTH","10",3733,3760,7493
"9732","KAKAMEGA","KAKAMEGA NORTH","11",3744,3798,7542
"9733","KAKAMEGA","KAKAMEGA NORTH","12",3937,3875,7812
"9734","KAKAMEGA","KAKAMEGA NORTH","13",3979,4030,8009
"9735","KAKAMEGA","KAKAMEGA NORTH","14",3568,3593,7161
"9736","KAKAMEGA","KAKAMEGA NORTH","10 -14",18961,19056,38017
"9737","KAKAMEGA","KAKAMEGA NORTH","15",3458,3592,7050
"9738","KAKAMEGA","KAKAMEGA NORTH","16",3328,3264,6592
"9739","KAKAMEGA","KAKAMEGA NORTH","17",3208,3148,6356
"9740","KAKAMEGA","KAKAMEGA NORTH","18",2640,2517,5157
"9741","KAKAMEGA","KAKAMEGA NORTH","19",2697,2575,5272
"9742","KAKAMEGA","KAKAMEGA NORTH","15-19",15331,15096,30427
"9743","KAKAMEGA","KAKAMEGA NORTH","20",2468,2550,5018
"9744","KAKAMEGA","KAKAMEGA NORTH","21",2039,2056,4095
"9745","KAKAMEGA","KAKAMEGA NORTH","22",1688,1788,3476
"9746","KAKAMEGA","KAKAMEGA NORTH","23",1615,1985,3600
"9747","KAKAMEGA","KAKAMEGA NORTH","24",1421,1599,3020
"9748","KAKAMEGA","KAKAMEGA NORTH","20-24",9231,9978,19209
"9749","KAKAMEGA","KAKAMEGA NORTH","25",1490,1928,3418
"9750","KAKAMEGA","KAKAMEGA NORTH","26",1297,1615,2912
"9751","KAKAMEGA","KAKAMEGA NORTH","27",1341,1767,3108
"9752","KAKAMEGA","KAKAMEGA NORTH","28",1024,1311,2335
"9753","KAKAMEGA","KAKAMEGA NORTH","29",1165,1570,2735
"9754","KAKAMEGA","KAKAMEGA NORTH","25-29",6317,8191,14508
"9755","KAKAMEGA","KAKAMEGA NORTH","30",1368,1927,3295
"9756","KAKAMEGA","KAKAMEGA NORTH","31",1230,1575,2805
"9757","KAKAMEGA","KAKAMEGA NORTH","32",1523,2036,3559
"9758","KAKAMEGA","KAKAMEGA NORTH","33",1346,1786,3132
"9759","KAKAMEGA","KAKAMEGA NORTH","34",1174,1494,2668
"9760","KAKAMEGA","KAKAMEGA NORTH","30-34",6641,8818,15459
"9761","KAKAMEGA","KAKAMEGA NORTH","35",1393,1514,2907
"9762","KAKAMEGA","KAKAMEGA NORTH","36",1034,1074,2108
"9763","KAKAMEGA","KAKAMEGA NORTH","37",1120,1100,2220
"9764","KAKAMEGA","KAKAMEGA NORTH","38",808,762,1570
"9765","KAKAMEGA","KAKAMEGA NORTH","39",907,875,1782
"9766","KAKAMEGA","KAKAMEGA NORTH","35-39",5262,5325,10587
"9767","KAKAMEGA","KAKAMEGA NORTH","40",996,1067,2063
"9768","KAKAMEGA","KAKAMEGA NORTH","41",1004,1107,2111
"9769","KAKAMEGA","KAKAMEGA NORTH","42",1107,1121,2228
"9770","KAKAMEGA","KAKAMEGA NORTH","43",1037,1095,2132
"9771","KAKAMEGA","KAKAMEGA NORTH","44",901,969,1870
"9772","KAKAMEGA","KAKAMEGA NORTH","40-44",5045,5359,10404
"9773","KAKAMEGA","KAKAMEGA NORTH","45",1089,1144,2233
"9774","KAKAMEGA","KAKAMEGA NORTH","46",859,872,1731
"9775","KAKAMEGA","KAKAMEGA NORTH","47",851,841,1692
"9776","KAKAMEGA","KAKAMEGA NORTH","48",605,575,1180
"9777","KAKAMEGA","KAKAMEGA NORTH","49",627,630,1257
"9778","KAKAMEGA","KAKAMEGA NORTH","45-49",4031,4062,8093
"9779","KAKAMEGA","KAKAMEGA NORTH","50",636,774,1410
"9780","KAKAMEGA","KAKAMEGA NORTH","51",663,712,1375
"9781","KAKAMEGA","KAKAMEGA NORTH","52",511,608,1119
"9782","KAKAMEGA","KAKAMEGA NORTH","53",453,562,1015
"9783","KAKAMEGA","KAKAMEGA NORTH","54",508,564,1072
"9784","KAKAMEGA","KAKAMEGA NORTH","50-54",2771,3220,5991
"9785","KAKAMEGA","KAKAMEGA NORTH","55",610,585,1195
"9786","KAKAMEGA","KAKAMEGA NORTH","56",530,597,1127
"9787","KAKAMEGA","KAKAMEGA NORTH","57",641,841,1482
"9788","KAKAMEGA","KAKAMEGA NORTH","58",468,464,932
"9789","KAKAMEGA","KAKAMEGA NORTH","59",603,638,1241
"9790","KAKAMEGA","KAKAMEGA NORTH","55-59",2852,3125,5977
"9791","KAKAMEGA","KAKAMEGA NORTH","60",567,590,1157
"9792","KAKAMEGA","KAKAMEGA NORTH","61",545,579,1124
"9793","KAKAMEGA","KAKAMEGA NORTH","62",389,461,850
"9794","KAKAMEGA","KAKAMEGA NORTH","63",446,550,996
"9795","KAKAMEGA","KAKAMEGA NORTH","64",337,410,747
"9796","KAKAMEGA","KAKAMEGA NORTH","60-64",2284,2590,4874
"9797","KAKAMEGA","KAKAMEGA NORTH","65",450,564,1014
"9798","KAKAMEGA","KAKAMEGA NORTH","66",276,323,599
"9799","KAKAMEGA","KAKAMEGA NORTH","67",399,464,863
"9800","KAKAMEGA","KAKAMEGA NORTH","68",193,226,419
"9801","KAKAMEGA","KAKAMEGA NORTH","69",292,332,624
"9802","KAKAMEGA","KAKAMEGA NORTH","65-69",1610,1909,3519
"9803","KAKAMEGA","KAKAMEGA NORTH","70",322,387,709
"9804","KAKAMEGA","KAKAMEGA NORTH","71",264,304,568
"9805","KAKAMEGA","KAKAMEGA NORTH","72",245,217,462
"9806","KAKAMEGA","KAKAMEGA NORTH","73",195,198,393
"9807","KAKAMEGA","KAKAMEGA NORTH","74",178,210,388
"9808","KAKAMEGA","KAKAMEGA NORTH","70-74",1204,1316,2520
"9809","KAKAMEGA","KAKAMEGA NORTH","75",161,224,385
"9810","KAKAMEGA","KAKAMEGA NORTH","76",160,308,468
"9811","KAKAMEGA","KAKAMEGA NORTH","77",144,216,360
"9812","KAKAMEGA","KAKAMEGA NORTH","78",78,107,185
"9813","KAKAMEGA","KAKAMEGA NORTH","79",82,159,241
"9814","KAKAMEGA","KAKAMEGA NORTH","75-79",625,1014,1639
"9815","KAKAMEGA","KAKAMEGA NORTH","80",111,140,251
"9816","KAKAMEGA","KAKAMEGA NORTH","81",88,134,222
"9817","KAKAMEGA","KAKAMEGA NORTH","82",91,95,186
"9818","KAKAMEGA","KAKAMEGA NORTH","83",88,116,204
"9819","KAKAMEGA","KAKAMEGA NORTH","84",59,61,120
"9820","KAKAMEGA","KAKAMEGA NORTH","80-84",437,546,983
"9821","KAKAMEGA","KAKAMEGA NORTH","85",58,55,113
"9822","KAKAMEGA","KAKAMEGA NORTH","86",59,69,128
"9823","KAKAMEGA","KAKAMEGA NORTH","87",59,97,156
"9824","KAKAMEGA","KAKAMEGA NORTH","88",14,31,45
"9825","KAKAMEGA","KAKAMEGA NORTH","89",38,58,96
"9826","KAKAMEGA","KAKAMEGA NORTH","85-89",228,310,538
"9827","KAKAMEGA","KAKAMEGA NORTH","90",17,29,46
"9828","KAKAMEGA","KAKAMEGA NORTH","91",23,18,41
"9829","KAKAMEGA","KAKAMEGA NORTH","92",17,22,39
"9830","KAKAMEGA","KAKAMEGA NORTH","93",14,14,28
"9831","KAKAMEGA","KAKAMEGA NORTH","94",2,9,11
"9832","KAKAMEGA","KAKAMEGA NORTH","90-94",73,92,165
"9833","KAKAMEGA","KAKAMEGA NORTH","95",7,25,32
"9834","KAKAMEGA","KAKAMEGA NORTH","96",6,10,16
"9835","KAKAMEGA","KAKAMEGA NORTH","97",11,12,23
"9836","KAKAMEGA","KAKAMEGA NORTH","98",4,10,14
"9837","KAKAMEGA","KAKAMEGA NORTH","99",4,9,13
"9838","KAKAMEGA","KAKAMEGA NORTH","95-99",32,66,98
"9839","KAKAMEGA","KAKAMEGA NORTH","100+",6,15,21
"9840","KAKAMEGA","KAKAMEGA NORTH","Not Stated",2,NA,2
"9841","KAKAMEGA","KAKAMEGA SOUTH","Total",53219,58524,111743
"9842","KAKAMEGA","KAKAMEGA SOUTH","0",1107,1139,2246
"9843","KAKAMEGA","KAKAMEGA SOUTH","1",1284,1310,2594
"9844","KAKAMEGA","KAKAMEGA SOUTH","2",1223,1213,2436
"9845","KAKAMEGA","KAKAMEGA SOUTH","3",1353,1280,2633
"9846","KAKAMEGA","KAKAMEGA SOUTH","4",1351,1318,2669
"9847","KAKAMEGA","KAKAMEGA SOUTH","0 - 4",6318,6260,12578
"9848","KAKAMEGA","KAKAMEGA SOUTH","5",1410,1391,2801
"9849","KAKAMEGA","KAKAMEGA SOUTH","6",1549,1478,3027
"9850","KAKAMEGA","KAKAMEGA SOUTH","7",1606,1545,3151
"9851","KAKAMEGA","KAKAMEGA SOUTH","8",1512,1531,3043
"9852","KAKAMEGA","KAKAMEGA SOUTH","9",1621,1691,3312
"9853","KAKAMEGA","KAKAMEGA SOUTH","5-9",7698,7636,15334
"9854","KAKAMEGA","KAKAMEGA SOUTH","10",1638,1656,3294
"9855","KAKAMEGA","KAKAMEGA SOUTH","11",1541,1638,3179
"9856","KAKAMEGA","KAKAMEGA SOUTH","12",1736,1805,3541
"9857","KAKAMEGA","KAKAMEGA SOUTH","13",1765,1863,3628
"9858","KAKAMEGA","KAKAMEGA SOUTH","14",1544,1633,3177
"9859","KAKAMEGA","KAKAMEGA SOUTH","10 -14",8224,8595,16819
"9860","KAKAMEGA","KAKAMEGA SOUTH","15",1557,1620,3177
"9861","KAKAMEGA","KAKAMEGA SOUTH","16",1398,1602,3000
"9862","KAKAMEGA","KAKAMEGA SOUTH","17",1578,1573,3151
"9863","KAKAMEGA","KAKAMEGA SOUTH","18",1299,1186,2485
"9864","KAKAMEGA","KAKAMEGA SOUTH","19",1296,1241,2537
"9865","KAKAMEGA","KAKAMEGA SOUTH","15-19",7128,7222,14350
"9866","KAKAMEGA","KAKAMEGA SOUTH","20",1093,1079,2172
"9867","KAKAMEGA","KAKAMEGA SOUTH","21",854,860,1714
"9868","KAKAMEGA","KAKAMEGA SOUTH","22",770,854,1624
"9869","KAKAMEGA","KAKAMEGA SOUTH","23",697,875,1572
"9870","KAKAMEGA","KAKAMEGA SOUTH","24",636,776,1412
"9871","KAKAMEGA","KAKAMEGA SOUTH","20-24",4050,4444,8494
"9872","KAKAMEGA","KAKAMEGA SOUTH","25",687,783,1470
"9873","KAKAMEGA","KAKAMEGA SOUTH","26",519,703,1222
"9874","KAKAMEGA","KAKAMEGA SOUTH","27",562,702,1264
"9875","KAKAMEGA","KAKAMEGA SOUTH","28",511,656,1167
"9876","KAKAMEGA","KAKAMEGA SOUTH","29",504,655,1159
"9877","KAKAMEGA","KAKAMEGA SOUTH","25-29",2783,3499,6282
"9878","KAKAMEGA","KAKAMEGA SOUTH","30",646,822,1468
"9879","KAKAMEGA","KAKAMEGA SOUTH","31",505,652,1157
"9880","KAKAMEGA","KAKAMEGA SOUTH","32",648,818,1466
"9881","KAKAMEGA","KAKAMEGA SOUTH","33",556,684,1240
"9882","KAKAMEGA","KAKAMEGA SOUTH","34",507,617,1124
"9883","KAKAMEGA","KAKAMEGA SOUTH","30-34",2862,3593,6455
"9884","KAKAMEGA","KAKAMEGA SOUTH","35",603,649,1252
"9885","KAKAMEGA","KAKAMEGA SOUTH","36",475,516,991
"9886","KAKAMEGA","KAKAMEGA SOUTH","37",514,494,1008
"9887","KAKAMEGA","KAKAMEGA SOUTH","38",379,409,788
"9888","KAKAMEGA","KAKAMEGA SOUTH","39",459,479,938
"9889","KAKAMEGA","KAKAMEGA SOUTH","35-39",2430,2547,4977
"9890","KAKAMEGA","KAKAMEGA SOUTH","40",512,514,1026
"9891","KAKAMEGA","KAKAMEGA SOUTH","41",441,545,986
"9892","KAKAMEGA","KAKAMEGA SOUTH","42",468,512,980
"9893","KAKAMEGA","KAKAMEGA SOUTH","43",406,541,947
"9894","KAKAMEGA","KAKAMEGA SOUTH","44",395,484,879
"9895","KAKAMEGA","KAKAMEGA SOUTH","40-44",2222,2596,4818
"9896","KAKAMEGA","KAKAMEGA SOUTH","45",485,585,1070
"9897","KAKAMEGA","KAKAMEGA SOUTH","46",371,406,777
"9898","KAKAMEGA","KAKAMEGA SOUTH","47",364,433,797
"9899","KAKAMEGA","KAKAMEGA SOUTH","48",285,328,613
"9900","KAKAMEGA","KAKAMEGA SOUTH","49",307,423,730
"9901","KAKAMEGA","KAKAMEGA SOUTH","45-49",1812,2175,3987
"9902","KAKAMEGA","KAKAMEGA SOUTH","50",380,563,943
"9903","KAKAMEGA","KAKAMEGA SOUTH","51",297,389,686
"9904","KAKAMEGA","KAKAMEGA SOUTH","52",313,372,685
"9905","KAKAMEGA","KAKAMEGA SOUTH","53",254,332,586
"9906","KAKAMEGA","KAKAMEGA SOUTH","54",304,349,653
"9907","KAKAMEGA","KAKAMEGA SOUTH","50-54",1548,2005,3553
"9908","KAKAMEGA","KAKAMEGA SOUTH","55",338,394,732
"9909","KAKAMEGA","KAKAMEGA SOUTH","56",334,448,782
"9910","KAKAMEGA","KAKAMEGA SOUTH","57",292,530,822
"9911","KAKAMEGA","KAKAMEGA SOUTH","58",237,333,570
"9912","KAKAMEGA","KAKAMEGA SOUTH","59",328,394,722
"9913","KAKAMEGA","KAKAMEGA SOUTH","55-59",1529,2099,3628
"9914","KAKAMEGA","KAKAMEGA SOUTH","60",360,461,821
"9915","KAKAMEGA","KAKAMEGA SOUTH","61",284,347,631
"9916","KAKAMEGA","KAKAMEGA SOUTH","62",289,353,642
"9917","KAKAMEGA","KAKAMEGA SOUTH","63",263,333,596
"9918","KAKAMEGA","KAKAMEGA SOUTH","64",266,256,522
"9919","KAKAMEGA","KAKAMEGA SOUTH","60-64",1462,1750,3212
"9920","KAKAMEGA","KAKAMEGA SOUTH","65",288,351,639
"9921","KAKAMEGA","KAKAMEGA SOUTH","66",208,269,477
"9922","KAKAMEGA","KAKAMEGA SOUTH","67",279,360,639
"9923","KAKAMEGA","KAKAMEGA SOUTH","68",151,174,325
"9924","KAKAMEGA","KAKAMEGA SOUTH","69",226,237,463
"9925","KAKAMEGA","KAKAMEGA SOUTH","65-69",1152,1391,2543
"9926","KAKAMEGA","KAKAMEGA SOUTH","70",253,283,536
"9927","KAKAMEGA","KAKAMEGA SOUTH","71",187,211,398
"9928","KAKAMEGA","KAKAMEGA SOUTH","72",174,185,359
"9929","KAKAMEGA","KAKAMEGA SOUTH","73",141,179,320
"9930","KAKAMEGA","KAKAMEGA SOUTH","74",126,176,302
"9931","KAKAMEGA","KAKAMEGA SOUTH","70-74",881,1034,1915
"9932","KAKAMEGA","KAKAMEGA SOUTH","75",118,175,293
"9933","KAKAMEGA","KAKAMEGA SOUTH","76",132,259,391
"9934","KAKAMEGA","KAKAMEGA SOUTH","77",107,155,262
"9935","KAKAMEGA","KAKAMEGA SOUTH","78",75,83,158
"9936","KAKAMEGA","KAKAMEGA SOUTH","79",85,131,216
"9937","KAKAMEGA","KAKAMEGA SOUTH","75-79",517,803,1320
"9938","KAKAMEGA","KAKAMEGA SOUTH","80",107,123,230
"9939","KAKAMEGA","KAKAMEGA SOUTH","81",59,98,157
"9940","KAKAMEGA","KAKAMEGA SOUTH","82",68,84,152
"9941","KAKAMEGA","KAKAMEGA SOUTH","83",66,75,141
"9942","KAKAMEGA","KAKAMEGA SOUTH","84",54,80,134
"9943","KAKAMEGA","KAKAMEGA SOUTH","80-84",354,460,814
"9944","KAKAMEGA","KAKAMEGA SOUTH","85",39,55,94
"9945","KAKAMEGA","KAKAMEGA SOUTH","86",25,68,93
"9946","KAKAMEGA","KAKAMEGA SOUTH","87",47,65,112
"9947","KAKAMEGA","KAKAMEGA SOUTH","88",25,28,53
"9948","KAKAMEGA","KAKAMEGA SOUTH","89",27,56,83
"9949","KAKAMEGA","KAKAMEGA SOUTH","85-89",163,272,435
"9950","KAKAMEGA","KAKAMEGA SOUTH","90",15,33,48
"9951","KAKAMEGA","KAKAMEGA SOUTH","91",17,22,39
"9952","KAKAMEGA","KAKAMEGA SOUTH","92",10,11,21
"9953","KAKAMEGA","KAKAMEGA SOUTH","93",8,7,15
"9954","KAKAMEGA","KAKAMEGA SOUTH","94",7,8,15
"9955","KAKAMEGA","KAKAMEGA SOUTH","90-94",57,81,138
"9956","KAKAMEGA","KAKAMEGA SOUTH","95",13,16,29
"9957","KAKAMEGA","KAKAMEGA SOUTH","96",2,4,6
"9958","KAKAMEGA","KAKAMEGA SOUTH","97",4,12,16
"9959","KAKAMEGA","KAKAMEGA SOUTH","98",2,3,5
"9960","KAKAMEGA","KAKAMEGA SOUTH","99",2,14,16
"9961","KAKAMEGA","KAKAMEGA SOUTH","95-99",23,49,72
"9962","KAKAMEGA","KAKAMEGA SOUTH","100+",5,12,17
"9963","KAKAMEGA","KAKAMEGA SOUTH","Not Stated",1,1,2
"9964","KAKAMEGA","KHWISERO","Total",53670,59803,113473
"9965","KAKAMEGA","KHWISERO","0",1177,1216,2393
"9966","KAKAMEGA","KHWISERO","1",1206,1174,2380
"9967","KAKAMEGA","KHWISERO","2",1246,1297,2543
"9968","KAKAMEGA","KHWISERO","3",1385,1394,2779
"9969","KAKAMEGA","KHWISERO","4",1472,1407,2879
"9970","KAKAMEGA","KHWISERO","0 - 4",6486,6488,12974
"9971","KAKAMEGA","KHWISERO","5",1530,1476,3006
"9972","KAKAMEGA","KHWISERO","6",1588,1610,3198
"9973","KAKAMEGA","KHWISERO","7",1608,1738,3346
"9974","KAKAMEGA","KHWISERO","8",1534,1617,3151
"9975","KAKAMEGA","KHWISERO","9",1736,1731,3467
"9976","KAKAMEGA","KHWISERO","5-9",7996,8172,16168
"9977","KAKAMEGA","KHWISERO","10",1817,1771,3588
"9978","KAKAMEGA","KHWISERO","11",1593,1716,3309
"9979","KAKAMEGA","KHWISERO","12",1949,1879,3828
"9980","KAKAMEGA","KHWISERO","13",1735,1849,3584
"9981","KAKAMEGA","KHWISERO","14",1717,1780,3497
"9982","KAKAMEGA","KHWISERO","10 -14",8811,8995,17806
"9983","KAKAMEGA","KHWISERO","15",1737,1658,3395
"9984","KAKAMEGA","KHWISERO","16",1518,1543,3061
"9985","KAKAMEGA","KHWISERO","17",1566,1490,3056
"9986","KAKAMEGA","KHWISERO","18",1253,1168,2421
"9987","KAKAMEGA","KHWISERO","19",1187,1189,2376
"9988","KAKAMEGA","KHWISERO","15-19",7261,7048,14309
"9989","KAKAMEGA","KHWISERO","20",910,992,1902
"9990","KAKAMEGA","KHWISERO","21",713,863,1576
"9991","KAKAMEGA","KHWISERO","22",686,804,1490
"9992","KAKAMEGA","KHWISERO","23",596,746,1342
"9993","KAKAMEGA","KHWISERO","24",510,682,1192
"9994","KAKAMEGA","KHWISERO","20-24",3415,4087,7502
"9995","KAKAMEGA","KHWISERO","25",558,726,1284
"9996","KAKAMEGA","KHWISERO","26",475,706,1181
"9997","KAKAMEGA","KHWISERO","27",503,714,1217
"9998","KAKAMEGA","KHWISERO","28",447,586,1033
"9999","KAKAMEGA","KHWISERO","29",473,658,1131
"10000","KAKAMEGA","KHWISERO","25-29",2456,3390,5846
"10001","KAKAMEGA","KHWISERO","30",612,949,1561
"10002","KAKAMEGA","KHWISERO","31",443,631,1074
"10003","KAKAMEGA","KHWISERO","32",563,808,1371
"10004","KAKAMEGA","KHWISERO","33",458,680,1138
"10005","KAKAMEGA","KHWISERO","34",462,606,1068
"10006","KAKAMEGA","KHWISERO","30-34",2538,3674,6212
"10007","KAKAMEGA","KHWISERO","35",592,747,1339
"10008","KAKAMEGA","KHWISERO","36",474,536,1010
"10009","KAKAMEGA","KHWISERO","37",493,511,1004
"10010","KAKAMEGA","KHWISERO","38",393,408,801
"10011","KAKAMEGA","KHWISERO","39",377,509,886
"10012","KAKAMEGA","KHWISERO","35-39",2329,2711,5040
"10013","KAKAMEGA","KHWISERO","40",508,634,1142
"10014","KAKAMEGA","KHWISERO","41",459,578,1037
"10015","KAKAMEGA","KHWISERO","42",483,534,1017
"10016","KAKAMEGA","KHWISERO","43",408,500,908
"10017","KAKAMEGA","KHWISERO","44",373,391,764
"10018","KAKAMEGA","KHWISERO","40-44",2231,2637,4868
"10019","KAKAMEGA","KHWISERO","45",446,497,943
"10020","KAKAMEGA","KHWISERO","46",335,335,670
"10021","KAKAMEGA","KHWISERO","47",381,408,789
"10022","KAKAMEGA","KHWISERO","48",296,342,638
"10023","KAKAMEGA","KHWISERO","49",340,359,699
"10024","KAKAMEGA","KHWISERO","45-49",1798,1941,3739
"10025","KAKAMEGA","KHWISERO","50",456,621,1077
"10026","KAKAMEGA","KHWISERO","51",320,474,794
"10027","KAKAMEGA","KHWISERO","52",333,409,742
"10028","KAKAMEGA","KHWISERO","53",274,370,644
"10029","KAKAMEGA","KHWISERO","54",295,327,622
"10030","KAKAMEGA","KHWISERO","50-54",1678,2201,3879
"10031","KAKAMEGA","KHWISERO","55",338,382,720
"10032","KAKAMEGA","KHWISERO","56",353,388,741
"10033","KAKAMEGA","KHWISERO","57",344,481,825
"10034","KAKAMEGA","KHWISERO","58",252,310,562
"10035","KAKAMEGA","KHWISERO","59",317,435,752
"10036","KAKAMEGA","KHWISERO","55-59",1604,1996,3600
"10037","KAKAMEGA","KHWISERO","60",372,512,884
"10038","KAKAMEGA","KHWISERO","61",330,377,707
"10039","KAKAMEGA","KHWISERO","62",306,317,623
"10040","KAKAMEGA","KHWISERO","63",319,365,684
"10041","KAKAMEGA","KHWISERO","64",225,309,534
"10042","KAKAMEGA","KHWISERO","60-64",1552,1880,3432
"10043","KAKAMEGA","KHWISERO","65",316,381,697
"10044","KAKAMEGA","KHWISERO","66",267,281,548
"10045","KAKAMEGA","KHWISERO","67",315,409,724
"10046","KAKAMEGA","KHWISERO","68",132,165,297
"10047","KAKAMEGA","KHWISERO","69",235,293,528
"10048","KAKAMEGA","KHWISERO","65-69",1265,1529,2794
"10049","KAKAMEGA","KHWISERO","70",332,482,814
"10050","KAKAMEGA","KHWISERO","71",186,205,391
"10051","KAKAMEGA","KHWISERO","72",202,187,389
"10052","KAKAMEGA","KHWISERO","73",142,181,323
"10053","KAKAMEGA","KHWISERO","74",147,188,335
"10054","KAKAMEGA","KHWISERO","70-74",1009,1243,2252
"10055","KAKAMEGA","KHWISERO","75",126,177,303
"10056","KAKAMEGA","KHWISERO","76",136,243,379
"10057","KAKAMEGA","KHWISERO","77",108,169,277
"10058","KAKAMEGA","KHWISERO","78",75,81,156
"10059","KAKAMEGA","KHWISERO","79",89,122,211
"10060","KAKAMEGA","KHWISERO","75-79",534,792,1326
"10061","KAKAMEGA","KHWISERO","80",115,193,308
"10062","KAKAMEGA","KHWISERO","81",82,87,169
"10063","KAKAMEGA","KHWISERO","82",63,112,175
"10064","KAKAMEGA","KHWISERO","83",80,85,165
"10065","KAKAMEGA","KHWISERO","84",56,78,134
"10066","KAKAMEGA","KHWISERO","80-84",396,555,951
"10067","KAKAMEGA","KHWISERO","85",57,77,134
"10068","KAKAMEGA","KHWISERO","86",41,47,88
"10069","KAKAMEGA","KHWISERO","87",46,86,132
"10070","KAKAMEGA","KHWISERO","88",35,38,73
"10071","KAKAMEGA","KHWISERO","89",28,60,88
"10072","KAKAMEGA","KHWISERO","85-89",207,308,515
"10073","KAKAMEGA","KHWISERO","90",31,29,60
"10074","KAKAMEGA","KHWISERO","91",17,18,35
"10075","KAKAMEGA","KHWISERO","92",8,18,26
"10076","KAKAMEGA","KHWISERO","93",12,18,30
"10077","KAKAMEGA","KHWISERO","94",11,11,22
"10078","KAKAMEGA","KHWISERO","90-94",79,94,173
"10079","KAKAMEGA","KHWISERO","95",9,19,28
"10080","KAKAMEGA","KHWISERO","96",2,10,12
"10081","KAKAMEGA","KHWISERO","97",6,4,10
"10082","KAKAMEGA","KHWISERO","98",1,4,5
"10083","KAKAMEGA","KHWISERO","99",2,11,13
"10084","KAKAMEGA","KHWISERO","95-99",20,48,68
"10085","KAKAMEGA","KHWISERO","100+",4,14,18
"10086","KAKAMEGA","KHWISERO","Not Stated",1,NA,1
"10087","KAKAMEGA","LIKUYANI","Total",73710,78341,152051
"10088","KAKAMEGA","LIKUYANI","0",1698,1663,3361
"10089","KAKAMEGA","LIKUYANI","1",1765,1762,3527
"10090","KAKAMEGA","LIKUYANI","2",1758,1795,3553
"10091","KAKAMEGA","LIKUYANI","3",1931,1937,3868
"10092","KAKAMEGA","LIKUYANI","4",2025,1952,3977
"10093","KAKAMEGA","LIKUYANI","0 - 4",9177,9109,18286
"10094","KAKAMEGA","LIKUYANI","5",2048,1968,4016
"10095","KAKAMEGA","LIKUYANI","6",2182,2177,4359
"10096","KAKAMEGA","LIKUYANI","7",2200,2034,4234
"10097","KAKAMEGA","LIKUYANI","8",2030,2128,4158
"10098","KAKAMEGA","LIKUYANI","9",2379,2327,4706
"10099","KAKAMEGA","LIKUYANI","5-9",10839,10634,21473
"10100","KAKAMEGA","LIKUYANI","10",2509,2337,4846
"10101","KAKAMEGA","LIKUYANI","11",2206,2306,4512
"10102","KAKAMEGA","LIKUYANI","12",2536,2407,4943
"10103","KAKAMEGA","LIKUYANI","13",2400,2436,4836
"10104","KAKAMEGA","LIKUYANI","14",2380,2361,4741
"10105","KAKAMEGA","LIKUYANI","10 -14",12031,11847,23878
"10106","KAKAMEGA","LIKUYANI","15",2120,2214,4334
"10107","KAKAMEGA","LIKUYANI","16",2202,2113,4315
"10108","KAKAMEGA","LIKUYANI","17",2155,2070,4225
"10109","KAKAMEGA","LIKUYANI","18",1800,1572,3372
"10110","KAKAMEGA","LIKUYANI","19",1773,1646,3419
"10111","KAKAMEGA","LIKUYANI","15-19",10050,9615,19665
"10112","KAKAMEGA","LIKUYANI","20",1572,1566,3138
"10113","KAKAMEGA","LIKUYANI","21",1297,1317,2614
"10114","KAKAMEGA","LIKUYANI","22",1154,1252,2406
"10115","KAKAMEGA","LIKUYANI","23",1078,1238,2316
"10116","KAKAMEGA","LIKUYANI","24",920,1088,2008
"10117","KAKAMEGA","LIKUYANI","20-24",6021,6461,12482
"10118","KAKAMEGA","LIKUYANI","25",1024,1139,2163
"10119","KAKAMEGA","LIKUYANI","26",840,1005,1845
"10120","KAKAMEGA","LIKUYANI","27",797,989,1786
"10121","KAKAMEGA","LIKUYANI","28",632,778,1410
"10122","KAKAMEGA","LIKUYANI","29",762,927,1689
"10123","KAKAMEGA","LIKUYANI","25-29",4055,4838,8893
"10124","KAKAMEGA","LIKUYANI","30",912,1188,2100
"10125","KAKAMEGA","LIKUYANI","31",738,898,1636
"10126","KAKAMEGA","LIKUYANI","32",901,1173,2074
"10127","KAKAMEGA","LIKUYANI","33",787,976,1763
"10128","KAKAMEGA","LIKUYANI","34",660,802,1462
"10129","KAKAMEGA","LIKUYANI","30-34",3998,5037,9035
"10130","KAKAMEGA","LIKUYANI","35",814,963,1777
"10131","KAKAMEGA","LIKUYANI","36",635,705,1340
"10132","KAKAMEGA","LIKUYANI","37",676,687,1363
"10133","KAKAMEGA","LIKUYANI","38",558,580,1138
"10134","KAKAMEGA","LIKUYANI","39",599,711,1310
"10135","KAKAMEGA","LIKUYANI","35-39",3282,3646,6928
"10136","KAKAMEGA","LIKUYANI","40",690,886,1576
"10137","KAKAMEGA","LIKUYANI","41",694,814,1508
"10138","KAKAMEGA","LIKUYANI","42",726,826,1552
"10139","KAKAMEGA","LIKUYANI","43",612,789,1401
"10140","KAKAMEGA","LIKUYANI","44",506,565,1071
"10141","KAKAMEGA","LIKUYANI","40-44",3228,3880,7108
"10142","KAKAMEGA","LIKUYANI","45",671,763,1434
"10143","KAKAMEGA","LIKUYANI","46",549,577,1126
"10144","KAKAMEGA","LIKUYANI","47",575,670,1245
"10145","KAKAMEGA","LIKUYANI","48",401,481,882
"10146","KAKAMEGA","LIKUYANI","49",528,558,1086
"10147","KAKAMEGA","LIKUYANI","45-49",2724,3049,5773
"10148","KAKAMEGA","LIKUYANI","50",527,718,1245
"10149","KAKAMEGA","LIKUYANI","51",482,533,1015
"10150","KAKAMEGA","LIKUYANI","52",420,487,907
"10151","KAKAMEGA","LIKUYANI","53",352,417,769
"10152","KAKAMEGA","LIKUYANI","54",357,406,763
"10153","KAKAMEGA","LIKUYANI","50-54",2138,2561,4699
"10154","KAKAMEGA","LIKUYANI","55",374,435,809
"10155","KAKAMEGA","LIKUYANI","56",341,463,804
"10156","KAKAMEGA","LIKUYANI","57",416,573,989
"10157","KAKAMEGA","LIKUYANI","58",312,394,706
"10158","KAKAMEGA","LIKUYANI","59",373,444,817
"10159","KAKAMEGA","LIKUYANI","55-59",1816,2309,4125
"10160","KAKAMEGA","LIKUYANI","60",399,437,836
"10161","KAKAMEGA","LIKUYANI","61",321,372,693
"10162","KAKAMEGA","LIKUYANI","62",298,335,633
"10163","KAKAMEGA","LIKUYANI","63",303,422,725
"10164","KAKAMEGA","LIKUYANI","64",212,251,463
"10165","KAKAMEGA","LIKUYANI","60-64",1533,1817,3350
"10166","KAKAMEGA","LIKUYANI","65",304,354,658
"10167","KAKAMEGA","LIKUYANI","66",197,223,420
"10168","KAKAMEGA","LIKUYANI","67",292,347,639
"10169","KAKAMEGA","LIKUYANI","68",136,157,293
"10170","KAKAMEGA","LIKUYANI","69",225,286,511
"10171","KAKAMEGA","LIKUYANI","65-69",1154,1367,2521
"10172","KAKAMEGA","LIKUYANI","70",220,252,472
"10173","KAKAMEGA","LIKUYANI","71",153,192,345
"10174","KAKAMEGA","LIKUYANI","72",132,160,292
"10175","KAKAMEGA","LIKUYANI","73",135,147,282
"10176","KAKAMEGA","LIKUYANI","74",114,158,272
"10177","KAKAMEGA","LIKUYANI","70-74",754,909,1663
"10178","KAKAMEGA","LIKUYANI","75",83,140,223
"10179","KAKAMEGA","LIKUYANI","76",107,143,250
"10180","KAKAMEGA","LIKUYANI","77",86,118,204
"10181","KAKAMEGA","LIKUYANI","78",58,79,137
"10182","KAKAMEGA","LIKUYANI","79",68,78,146
"10183","KAKAMEGA","LIKUYANI","75-79",402,558,960
"10184","KAKAMEGA","LIKUYANI","80",82,100,182
"10185","KAKAMEGA","LIKUYANI","81",46,57,103
"10186","KAKAMEGA","LIKUYANI","82",56,77,133
"10187","KAKAMEGA","LIKUYANI","83",53,86,139
"10188","KAKAMEGA","LIKUYANI","84",33,62,95
"10189","KAKAMEGA","LIKUYANI","80-84",270,382,652
"10190","KAKAMEGA","LIKUYANI","85",38,44,82
"10191","KAKAMEGA","LIKUYANI","86",26,50,76
"10192","KAKAMEGA","LIKUYANI","87",44,46,90
"10193","KAKAMEGA","LIKUYANI","88",19,26,45
"10194","KAKAMEGA","LIKUYANI","89",21,45,66
"10195","KAKAMEGA","LIKUYANI","85-89",148,211,359
"10196","KAKAMEGA","LIKUYANI","90",17,15,32
"10197","KAKAMEGA","LIKUYANI","91",18,16,34
"10198","KAKAMEGA","LIKUYANI","92",7,17,24
"10199","KAKAMEGA","LIKUYANI","93",3,8,11
"10200","KAKAMEGA","LIKUYANI","94",7,4,11
"10201","KAKAMEGA","LIKUYANI","90-94",52,60,112
"10202","KAKAMEGA","LIKUYANI","95",10,13,23
"10203","KAKAMEGA","LIKUYANI","96",6,7,13
"10204","KAKAMEGA","LIKUYANI","97",9,9,18
"10205","KAKAMEGA","LIKUYANI","98",2,4,6
"10206","KAKAMEGA","LIKUYANI","99",6,3,9
"10207","KAKAMEGA","LIKUYANI","95-99",33,36,69
"10208","KAKAMEGA","LIKUYANI","100+",3,14,17
"10209","KAKAMEGA","LIKUYANI","Not Stated",2,1,3
"10210","KAKAMEGA","LUGARI","Total",59135,63593,122728
"10211","KAKAMEGA","LUGARI","0",1379,1400,2779
"10212","KAKAMEGA","LUGARI","1",1408,1447,2855
"10213","KAKAMEGA","LUGARI","2",1448,1484,2932
"10214","KAKAMEGA","LUGARI","3",1537,1594,3131
"10215","KAKAMEGA","LUGARI","4",1599,1596,3195
"10216","KAKAMEGA","LUGARI","0 - 4",7371,7521,14892
"10217","KAKAMEGA","LUGARI","5",1625,1588,3213
"10218","KAKAMEGA","LUGARI","6",1622,1758,3380
"10219","KAKAMEGA","LUGARI","7",1791,1686,3477
"10220","KAKAMEGA","LUGARI","8",1580,1672,3252
"10221","KAKAMEGA","LUGARI","9",2027,1979,4006
"10222","KAKAMEGA","LUGARI","5-9",8645,8683,17328
"10223","KAKAMEGA","LUGARI","10",2014,1948,3962
"10224","KAKAMEGA","LUGARI","11",1791,1871,3662
"10225","KAKAMEGA","LUGARI","12",1959,2019,3978
"10226","KAKAMEGA","LUGARI","13",1903,1902,3805
"10227","KAKAMEGA","LUGARI","14",1844,1794,3638
"10228","KAKAMEGA","LUGARI","10 -14",9511,9534,19045
"10229","KAKAMEGA","LUGARI","15",1772,1782,3554
"10230","KAKAMEGA","LUGARI","16",1745,1689,3434
"10231","KAKAMEGA","LUGARI","17",1780,1687,3467
"10232","KAKAMEGA","LUGARI","18",1461,1289,2750
"10233","KAKAMEGA","LUGARI","19",1470,1333,2803
"10234","KAKAMEGA","LUGARI","15-19",8228,7780,16008
"10235","KAKAMEGA","LUGARI","20",1135,1159,2294
"10236","KAKAMEGA","LUGARI","21",990,1016,2006
"10237","KAKAMEGA","LUGARI","22",883,893,1776
"10238","KAKAMEGA","LUGARI","23",854,928,1782
"10239","KAKAMEGA","LUGARI","24",726,839,1565
"10240","KAKAMEGA","LUGARI","20-24",4588,4835,9423
"10241","KAKAMEGA","LUGARI","25",795,901,1696
"10242","KAKAMEGA","LUGARI","26",582,822,1404
"10243","KAKAMEGA","LUGARI","27",677,821,1498
"10244","KAKAMEGA","LUGARI","28",490,656,1146
"10245","KAKAMEGA","LUGARI","29",554,731,1285
"10246","KAKAMEGA","LUGARI","25-29",3098,3931,7029
"10247","KAKAMEGA","LUGARI","30",714,946,1660
"10248","KAKAMEGA","LUGARI","31",562,772,1334
"10249","KAKAMEGA","LUGARI","32",789,956,1745
"10250","KAKAMEGA","LUGARI","33",574,765,1339
"10251","KAKAMEGA","LUGARI","34",577,664,1241
"10252","KAKAMEGA","LUGARI","30-34",3216,4103,7319
"10253","KAKAMEGA","LUGARI","35",643,736,1379
"10254","KAKAMEGA","LUGARI","36",543,549,1092
"10255","KAKAMEGA","LUGARI","37",584,603,1187
"10256","KAKAMEGA","LUGARI","38",414,471,885
"10257","KAKAMEGA","LUGARI","39",469,507,976
"10258","KAKAMEGA","LUGARI","35-39",2653,2866,5519
"10259","KAKAMEGA","LUGARI","40",525,607,1132
"10260","KAKAMEGA","LUGARI","41",522,616,1138
"10261","KAKAMEGA","LUGARI","42",499,692,1191
"10262","KAKAMEGA","LUGARI","43",490,591,1081
"10263","KAKAMEGA","LUGARI","44",381,477,858
"10264","KAKAMEGA","LUGARI","40-44",2417,2983,5400
"10265","KAKAMEGA","LUGARI","45",515,672,1187
"10266","KAKAMEGA","LUGARI","46",448,578,1026
"10267","KAKAMEGA","LUGARI","47",431,494,925
"10268","KAKAMEGA","LUGARI","48",337,352,689
"10269","KAKAMEGA","LUGARI","49",355,459,814
"10270","KAKAMEGA","LUGARI","45-49",2086,2555,4641
"10271","KAKAMEGA","LUGARI","50",414,537,951
"10272","KAKAMEGA","LUGARI","51",367,493,860
"10273","KAKAMEGA","LUGARI","52",324,410,734
"10274","KAKAMEGA","LUGARI","53",276,388,664
"10275","KAKAMEGA","LUGARI","54",355,392,747
"10276","KAKAMEGA","LUGARI","50-54",1736,2220,3956
"10277","KAKAMEGA","LUGARI","55",375,422,797
"10278","KAKAMEGA","LUGARI","56",361,450,811
"10279","KAKAMEGA","LUGARI","57",328,500,828
"10280","KAKAMEGA","LUGARI","58",276,335,611
"10281","KAKAMEGA","LUGARI","59",324,403,727
"10282","KAKAMEGA","LUGARI","55-59",1664,2110,3774
"10283","KAKAMEGA","LUGARI","60",365,443,808
"10284","KAKAMEGA","LUGARI","61",318,336,654
"10285","KAKAMEGA","LUGARI","62",289,292,581
"10286","KAKAMEGA","LUGARI","63",261,328,589
"10287","KAKAMEGA","LUGARI","64",242,244,486
"10288","KAKAMEGA","LUGARI","60-64",1475,1643,3118
"10289","KAKAMEGA","LUGARI","65",279,313,592
"10290","KAKAMEGA","LUGARI","66",198,210,408
"10291","KAKAMEGA","LUGARI","67",256,259,515
"10292","KAKAMEGA","LUGARI","68",137,120,257
"10293","KAKAMEGA","LUGARI","69",196,168,364
"10294","KAKAMEGA","LUGARI","65-69",1066,1070,2136
"10295","KAKAMEGA","LUGARI","70",184,197,381
"10296","KAKAMEGA","LUGARI","71",140,151,291
"10297","KAKAMEGA","LUGARI","72",127,122,249
"10298","KAKAMEGA","LUGARI","73",108,106,214
"10299","KAKAMEGA","LUGARI","74",80,97,177
"10300","KAKAMEGA","LUGARI","70-74",639,673,1312
"10301","KAKAMEGA","LUGARI","75",82,107,189
"10302","KAKAMEGA","LUGARI","76",70,132,202
"10303","KAKAMEGA","LUGARI","77",56,107,163
"10304","KAKAMEGA","LUGARI","78",48,44,92
"10305","KAKAMEGA","LUGARI","79",44,66,110
"10306","KAKAMEGA","LUGARI","75-79",300,456,756
"10307","KAKAMEGA","LUGARI","80",57,96,153
"10308","KAKAMEGA","LUGARI","81",43,74,117
"10309","KAKAMEGA","LUGARI","82",43,59,102
"10310","KAKAMEGA","LUGARI","83",48,73,121
"10311","KAKAMEGA","LUGARI","84",35,45,80
"10312","KAKAMEGA","LUGARI","80-84",226,347,573
"10313","KAKAMEGA","LUGARI","85",37,42,79
"10314","KAKAMEGA","LUGARI","86",33,42,75
"10315","KAKAMEGA","LUGARI","87",32,39,71
"10316","KAKAMEGA","LUGARI","88",12,27,39
"10317","KAKAMEGA","LUGARI","89",30,26,56
"10318","KAKAMEGA","LUGARI","85-89",144,176,320
"10319","KAKAMEGA","LUGARI","90",10,20,30
"10320","KAKAMEGA","LUGARI","91",12,21,33
"10321","KAKAMEGA","LUGARI","92",14,7,21
"10322","KAKAMEGA","LUGARI","93",11,11,22
"10323","KAKAMEGA","LUGARI","94",6,3,9
"10324","KAKAMEGA","LUGARI","90-94",53,62,115
"10325","KAKAMEGA","LUGARI","95",8,15,23
"10326","KAKAMEGA","LUGARI","96",3,4,7
"10327","KAKAMEGA","LUGARI","97",2,10,12
"10328","KAKAMEGA","LUGARI","98",2,4,6
"10329","KAKAMEGA","LUGARI","99",2,3,5
"10330","KAKAMEGA","LUGARI","95-99",17,36,53
"10331","KAKAMEGA","LUGARI","100+",2,7,9
"10332","KAKAMEGA","LUGARI","Not Stated",NA,2,2
"10333","KAKAMEGA","MATETE","Total",31749,34423,66172
"10334","KAKAMEGA","MATETE","0",744,752,1496
"10335","KAKAMEGA","MATETE","1",793,833,1626
"10336","KAKAMEGA","MATETE","2",800,851,1651
"10337","KAKAMEGA","MATETE","3",900,904,1804
"10338","KAKAMEGA","MATETE","4",922,913,1835
"10339","KAKAMEGA","MATETE","0 - 4",4159,4253,8412
"10340","KAKAMEGA","MATETE","5",987,1000,1987
"10341","KAKAMEGA","MATETE","6",1007,1055,2062
"10342","KAKAMEGA","MATETE","7",1009,1018,2027
"10343","KAKAMEGA","MATETE","8",902,948,1850
"10344","KAKAMEGA","MATETE","9",1182,1142,2324
"10345","KAKAMEGA","MATETE","5-9",5087,5163,10250
"10346","KAKAMEGA","MATETE","10",1176,1062,2238
"10347","KAKAMEGA","MATETE","11",998,1132,2130
"10348","KAKAMEGA","MATETE","12",1082,1085,2167
"10349","KAKAMEGA","MATETE","13",1074,1160,2234
"10350","KAKAMEGA","MATETE","14",1028,989,2017
"10351","KAKAMEGA","MATETE","10 -14",5358,5428,10786
"10352","KAKAMEGA","MATETE","15",1107,1030,2137
"10353","KAKAMEGA","MATETE","16",985,937,1922
"10354","KAKAMEGA","MATETE","17",986,955,1941
"10355","KAKAMEGA","MATETE","18",704,664,1368
"10356","KAKAMEGA","MATETE","19",754,778,1532
"10357","KAKAMEGA","MATETE","15-19",4536,4364,8900
"10358","KAKAMEGA","MATETE","20",622,668,1290
"10359","KAKAMEGA","MATETE","21",550,578,1128
"10360","KAKAMEGA","MATETE","22",448,488,936
"10361","KAKAMEGA","MATETE","23",416,566,982
"10362","KAKAMEGA","MATETE","24",314,483,797
"10363","KAKAMEGA","MATETE","20-24",2350,2783,5133
"10364","KAKAMEGA","MATETE","25",388,533,921
"10365","KAKAMEGA","MATETE","26",364,442,806
"10366","KAKAMEGA","MATETE","27",338,470,808
"10367","KAKAMEGA","MATETE","28",218,353,571
"10368","KAKAMEGA","MATETE","29",322,412,734
"10369","KAKAMEGA","MATETE","25-29",1630,2210,3840
"10370","KAKAMEGA","MATETE","30",361,526,887
"10371","KAKAMEGA","MATETE","31",314,433,747
"10372","KAKAMEGA","MATETE","32",411,541,952
"10373","KAKAMEGA","MATETE","33",336,462,798
"10374","KAKAMEGA","MATETE","34",301,332,633
"10375","KAKAMEGA","MATETE","30-34",1723,2294,4017
"10376","KAKAMEGA","MATETE","35",348,391,739
"10377","KAKAMEGA","MATETE","36",230,274,504
"10378","KAKAMEGA","MATETE","37",277,252,529
"10379","KAKAMEGA","MATETE","38",194,189,383
"10380","KAKAMEGA","MATETE","39",255,264,519
"10381","KAKAMEGA","MATETE","35-39",1304,1370,2674
"10382","KAKAMEGA","MATETE","40",255,309,564
"10383","KAKAMEGA","MATETE","41",275,263,538
"10384","KAKAMEGA","MATETE","42",273,317,590
"10385","KAKAMEGA","MATETE","43",268,312,580
"10386","KAKAMEGA","MATETE","44",215,241,456
"10387","KAKAMEGA","MATETE","40-44",1286,1442,2728
"10388","KAKAMEGA","MATETE","45",272,304,576
"10389","KAKAMEGA","MATETE","46",228,240,468
"10390","KAKAMEGA","MATETE","47",243,263,506
"10391","KAKAMEGA","MATETE","48",134,142,276
"10392","KAKAMEGA","MATETE","49",161,177,338
"10393","KAKAMEGA","MATETE","45-49",1038,1126,2164
"10394","KAKAMEGA","MATETE","50",174,196,370
"10395","KAKAMEGA","MATETE","51",187,211,398
"10396","KAKAMEGA","MATETE","52",153,166,319
"10397","KAKAMEGA","MATETE","53",112,163,275
"10398","KAKAMEGA","MATETE","54",120,132,252
"10399","KAKAMEGA","MATETE","50-54",746,868,1614
"10400","KAKAMEGA","MATETE","55",139,160,299
"10401","KAKAMEGA","MATETE","56",121,157,278
"10402","KAKAMEGA","MATETE","57",161,226,387
"10403","KAKAMEGA","MATETE","58",147,159,306
"10404","KAKAMEGA","MATETE","59",182,200,382
"10405","KAKAMEGA","MATETE","55-59",750,902,1652
"10406","KAKAMEGA","MATETE","60",168,158,326
"10407","KAKAMEGA","MATETE","61",120,193,313
"10408","KAKAMEGA","MATETE","62",107,126,233
"10409","KAKAMEGA","MATETE","63",152,152,304
"10410","KAKAMEGA","MATETE","64",106,92,198
"10411","KAKAMEGA","MATETE","60-64",653,721,1374
"10412","KAKAMEGA","MATETE","65",131,135,266
"10413","KAKAMEGA","MATETE","66",73,88,161
"10414","KAKAMEGA","MATETE","67",110,119,229
"10415","KAKAMEGA","MATETE","68",51,51,102
"10416","KAKAMEGA","MATETE","69",80,98,178
"10417","KAKAMEGA","MATETE","65-69",445,491,936
"10418","KAKAMEGA","MATETE","70",81,107,188
"10419","KAKAMEGA","MATETE","71",78,68,146
"10420","KAKAMEGA","MATETE","72",55,71,126
"10421","KAKAMEGA","MATETE","73",56,71,127
"10422","KAKAMEGA","MATETE","74",56,57,113
"10423","KAKAMEGA","MATETE","70-74",326,374,700
"10424","KAKAMEGA","MATETE","75",51,71,122
"10425","KAKAMEGA","MATETE","76",42,65,107
"10426","KAKAMEGA","MATETE","77",30,52,82
"10427","KAKAMEGA","MATETE","78",23,30,53
"10428","KAKAMEGA","MATETE","79",27,53,80
"10429","KAKAMEGA","MATETE","75-79",173,271,444
"10430","KAKAMEGA","MATETE","80",22,32,54
"10431","KAKAMEGA","MATETE","81",31,29,60
"10432","KAKAMEGA","MATETE","82",11,23,34
"10433","KAKAMEGA","MATETE","83",20,59,79
"10434","KAKAMEGA","MATETE","84",15,28,43
"10435","KAKAMEGA","MATETE","80-84",99,171,270
"10436","KAKAMEGA","MATETE","85",13,34,47
"10437","KAKAMEGA","MATETE","86",6,25,31
"10438","KAKAMEGA","MATETE","87",16,39,55
"10439","KAKAMEGA","MATETE","88",3,11,14
"10440","KAKAMEGA","MATETE","89",11,20,31
"10441","KAKAMEGA","MATETE","85-89",49,129,178
"10442","KAKAMEGA","MATETE","90",11,12,23
"10443","KAKAMEGA","MATETE","91",8,6,14
"10444","KAKAMEGA","MATETE","92",2,10,12
"10445","KAKAMEGA","MATETE","93",6,8,14
"10446","KAKAMEGA","MATETE","94",1,2,3
"10447","KAKAMEGA","MATETE","90-94",28,38,66
"10448","KAKAMEGA","MATETE","95",4,5,9
"10449","KAKAMEGA","MATETE","96",1,7,8
"10450","KAKAMEGA","MATETE","97",2,3,5
"10451","KAKAMEGA","MATETE","98",NA,2,2
"10452","KAKAMEGA","MATETE","99",1,3,4
"10453","KAKAMEGA","MATETE","95-99",8,20,28
"10454","KAKAMEGA","MATETE","100+",1,5,6
"10455","KAKAMEGA","MATETE","Not Stated",NA,NA,NA
"10456","KAKAMEGA","MATUNGU","Total",78793,88143,166936
"10457","KAKAMEGA","MATUNGU","0",1939,2008,3947
"10458","KAKAMEGA","MATUNGU","1",1974,2052,4026
"10459","KAKAMEGA","MATUNGU","2",2082,2255,4337
"10460","KAKAMEGA","MATUNGU","3",2257,2372,4629
"10461","KAKAMEGA","MATUNGU","4",2342,2416,4758
"10462","KAKAMEGA","MATUNGU","0 - 4",10594,11103,21697
"10463","KAKAMEGA","MATUNGU","5",2561,2579,5140
"10464","KAKAMEGA","MATUNGU","6",2704,2680,5384
"10465","KAKAMEGA","MATUNGU","7",2528,2599,5127
"10466","KAKAMEGA","MATUNGU","8",2444,2480,4924
"10467","KAKAMEGA","MATUNGU","9",2763,2709,5472
"10468","KAKAMEGA","MATUNGU","5-9",13000,13047,26047
"10469","KAKAMEGA","MATUNGU","10",2905,2929,5834
"10470","KAKAMEGA","MATUNGU","11",2638,2662,5300
"10471","KAKAMEGA","MATUNGU","12",3083,2946,6029
"10472","KAKAMEGA","MATUNGU","13",2821,2909,5730
"10473","KAKAMEGA","MATUNGU","14",2655,2789,5444
"10474","KAKAMEGA","MATUNGU","10 -14",14102,14235,28337
"10475","KAKAMEGA","MATUNGU","15",2589,2698,5287
"10476","KAKAMEGA","MATUNGU","16",2276,2395,4671
"10477","KAKAMEGA","MATUNGU","17",2415,2351,4766
"10478","KAKAMEGA","MATUNGU","18",1884,1792,3676
"10479","KAKAMEGA","MATUNGU","19",1806,1869,3675
"10480","KAKAMEGA","MATUNGU","15-19",10970,11105,22075
"10481","KAKAMEGA","MATUNGU","20",1556,1692,3248
"10482","KAKAMEGA","MATUNGU","21",1173,1379,2552
"10483","KAKAMEGA","MATUNGU","22",1027,1281,2308
"10484","KAKAMEGA","MATUNGU","23",1018,1340,2358
"10485","KAKAMEGA","MATUNGU","24",841,1195,2036
"10486","KAKAMEGA","MATUNGU","20-24",5615,6887,12502
"10487","KAKAMEGA","MATUNGU","25",980,1271,2251
"10488","KAKAMEGA","MATUNGU","26",820,1172,1992
"10489","KAKAMEGA","MATUNGU","27",838,1169,2007
"10490","KAKAMEGA","MATUNGU","28",638,866,1504
"10491","KAKAMEGA","MATUNGU","29",667,990,1657
"10492","KAKAMEGA","MATUNGU","25-29",3943,5468,9411
"10493","KAKAMEGA","MATUNGU","30",913,1359,2272
"10494","KAKAMEGA","MATUNGU","31",780,1036,1816
"10495","KAKAMEGA","MATUNGU","32",906,1367,2273
"10496","KAKAMEGA","MATUNGU","33",777,1118,1895
"10497","KAKAMEGA","MATUNGU","34",728,904,1632
"10498","KAKAMEGA","MATUNGU","30-34",4104,5784,9888
"10499","KAKAMEGA","MATUNGU","35",762,899,1661
"10500","KAKAMEGA","MATUNGU","36",634,646,1280
"10501","KAKAMEGA","MATUNGU","37",720,676,1396
"10502","KAKAMEGA","MATUNGU","38",488,530,1018
"10503","KAKAMEGA","MATUNGU","39",563,573,1136
"10504","KAKAMEGA","MATUNGU","35-39",3167,3324,6491
"10505","KAKAMEGA","MATUNGU","40",729,892,1621
"10506","KAKAMEGA","MATUNGU","41",682,830,1512
"10507","KAKAMEGA","MATUNGU","42",629,872,1501
"10508","KAKAMEGA","MATUNGU","43",580,812,1392
"10509","KAKAMEGA","MATUNGU","44",468,596,1064
"10510","KAKAMEGA","MATUNGU","40-44",3088,4002,7090
"10511","KAKAMEGA","MATUNGU","45",625,771,1396
"10512","KAKAMEGA","MATUNGU","46",489,562,1051
"10513","KAKAMEGA","MATUNGU","47",548,639,1187
"10514","KAKAMEGA","MATUNGU","48",280,355,635
"10515","KAKAMEGA","MATUNGU","49",393,466,859
"10516","KAKAMEGA","MATUNGU","45-49",2335,2793,5128
"10517","KAKAMEGA","MATUNGU","50",558,791,1349
"10518","KAKAMEGA","MATUNGU","51",450,634,1084
"10519","KAKAMEGA","MATUNGU","52",325,384,709
"10520","KAKAMEGA","MATUNGU","53",308,394,702
"10521","KAKAMEGA","MATUNGU","54",296,333,629
"10522","KAKAMEGA","MATUNGU","50-54",1937,2536,4473
"10523","KAKAMEGA","MATUNGU","55",379,418,797
"10524","KAKAMEGA","MATUNGU","56",349,411,760
"10525","KAKAMEGA","MATUNGU","57",377,602,979
"10526","KAKAMEGA","MATUNGU","58",266,333,599
"10527","KAKAMEGA","MATUNGU","59",366,480,846
"10528","KAKAMEGA","MATUNGU","55-59",1737,2244,3981
"10529","KAKAMEGA","MATUNGU","60",366,525,891
"10530","KAKAMEGA","MATUNGU","61",316,398,714
"10531","KAKAMEGA","MATUNGU","62",220,286,506
"10532","KAKAMEGA","MATUNGU","63",307,369,676
"10533","KAKAMEGA","MATUNGU","64",187,243,430
"10534","KAKAMEGA","MATUNGU","60-64",1396,1821,3217
"10535","KAKAMEGA","MATUNGU","65",288,358,646
"10536","KAKAMEGA","MATUNGU","66",189,195,384
"10537","KAKAMEGA","MATUNGU","67",293,402,695
"10538","KAKAMEGA","MATUNGU","68",111,109,220
"10539","KAKAMEGA","MATUNGU","69",186,266,452
"10540","KAKAMEGA","MATUNGU","65-69",1067,1330,2397
"10541","KAKAMEGA","MATUNGU","70",253,364,617
"10542","KAKAMEGA","MATUNGU","71",152,186,338
"10543","KAKAMEGA","MATUNGU","72",132,147,279
"10544","KAKAMEGA","MATUNGU","73",129,170,299
"10545","KAKAMEGA","MATUNGU","74",111,148,259
"10546","KAKAMEGA","MATUNGU","70-74",777,1015,1792
"10547","KAKAMEGA","MATUNGU","75",109,155,264
"10548","KAKAMEGA","MATUNGU","76",86,96,182
"10549","KAKAMEGA","MATUNGU","77",114,153,267
"10550","KAKAMEGA","MATUNGU","78",58,65,123
"10551","KAKAMEGA","MATUNGU","79",67,134,201
"10552","KAKAMEGA","MATUNGU","75-79",434,603,1037
"10553","KAKAMEGA","MATUNGU","80",88,148,236
"10554","KAKAMEGA","MATUNGU","81",61,75,136
"10555","KAKAMEGA","MATUNGU","82",49,65,114
"10556","KAKAMEGA","MATUNGU","83",70,83,153
"10557","KAKAMEGA","MATUNGU","84",33,62,95
"10558","KAKAMEGA","MATUNGU","80-84",301,433,734
"10559","KAKAMEGA","MATUNGU","85",34,72,106
"10560","KAKAMEGA","MATUNGU","86",38,49,87
"10561","KAKAMEGA","MATUNGU","87",40,81,121
"10562","KAKAMEGA","MATUNGU","88",13,21,34
"10563","KAKAMEGA","MATUNGU","89",21,66,87
"10564","KAKAMEGA","MATUNGU","85-89",146,289,435
"10565","KAKAMEGA","MATUNGU","90",18,26,44
"10566","KAKAMEGA","MATUNGU","91",12,18,30
"10567","KAKAMEGA","MATUNGU","92",9,7,16
"10568","KAKAMEGA","MATUNGU","93",14,15,29
"10569","KAKAMEGA","MATUNGU","94",2,9,11
"10570","KAKAMEGA","MATUNGU","90-94",55,75,130
"10571","KAKAMEGA","MATUNGU","95",10,16,26
"10572","KAKAMEGA","MATUNGU","96",3,4,7
"10573","KAKAMEGA","MATUNGU","97",6,13,19
"10574","KAKAMEGA","MATUNGU","98",2,2,4
"10575","KAKAMEGA","MATUNGU","99",1,4,5
"10576","KAKAMEGA","MATUNGU","95-99",22,39,61
"10577","KAKAMEGA","MATUNGU","100+",1,9,10
"10578","KAKAMEGA","MATUNGU","Not Stated",2,1,3
"10579","KAKAMEGA","MUMIAS EAST","Total",55895,60953,116848
"10580","KAKAMEGA","MUMIAS EAST","0",1314,1372,2686
"10581","KAKAMEGA","MUMIAS EAST","1",1346,1402,2748
"10582","KAKAMEGA","MUMIAS EAST","2",1422,1388,2810
"10583","KAKAMEGA","MUMIAS EAST","3",1465,1490,2955
"10584","KAKAMEGA","MUMIAS EAST","4",1663,1607,3270
"10585","KAKAMEGA","MUMIAS EAST","0 - 4",7210,7259,14469
"10586","KAKAMEGA","MUMIAS EAST","5",1698,1710,3408
"10587","KAKAMEGA","MUMIAS EAST","6",1783,1738,3521
"10588","KAKAMEGA","MUMIAS EAST","7",1728,1723,3451
"10589","KAKAMEGA","MUMIAS EAST","8",1621,1692,3313
"10590","KAKAMEGA","MUMIAS EAST","9",1893,1832,3725
"10591","KAKAMEGA","MUMIAS EAST","5-9",8723,8695,17418
"10592","KAKAMEGA","MUMIAS EAST","10",1967,1957,3924
"10593","KAKAMEGA","MUMIAS EAST","11",1783,1848,3631
"10594","KAKAMEGA","MUMIAS EAST","12",2075,1999,4074
"10595","KAKAMEGA","MUMIAS EAST","13",1913,1954,3867
"10596","KAKAMEGA","MUMIAS EAST","14",1830,1862,3692
"10597","KAKAMEGA","MUMIAS EAST","10 -14",9568,9620,19188
"10598","KAKAMEGA","MUMIAS EAST","15",1776,1856,3632
"10599","KAKAMEGA","MUMIAS EAST","16",1629,1598,3227
"10600","KAKAMEGA","MUMIAS EAST","17",1644,1602,3246
"10601","KAKAMEGA","MUMIAS EAST","18",1272,1239,2511
"10602","KAKAMEGA","MUMIAS EAST","19",1331,1345,2676
"10603","KAKAMEGA","MUMIAS EAST","15-19",7652,7640,15292
"10604","KAKAMEGA","MUMIAS EAST","20",1113,1222,2335
"10605","KAKAMEGA","MUMIAS EAST","21",941,1085,2026
"10606","KAKAMEGA","MUMIAS EAST","22",818,908,1726
"10607","KAKAMEGA","MUMIAS EAST","23",841,941,1782
"10608","KAKAMEGA","MUMIAS EAST","24",684,856,1540
"10609","KAKAMEGA","MUMIAS EAST","20-24",4397,5012,9409
"10610","KAKAMEGA","MUMIAS EAST","25",801,896,1697
"10611","KAKAMEGA","MUMIAS EAST","26",596,904,1500
"10612","KAKAMEGA","MUMIAS EAST","27",633,875,1508
"10613","KAKAMEGA","MUMIAS EAST","28",565,716,1281
"10614","KAKAMEGA","MUMIAS EAST","29",583,804,1387
"10615","KAKAMEGA","MUMIAS EAST","25-29",3178,4195,7373
"10616","KAKAMEGA","MUMIAS EAST","30",708,1079,1787
"10617","KAKAMEGA","MUMIAS EAST","31",565,780,1345
"10618","KAKAMEGA","MUMIAS EAST","32",675,1000,1675
"10619","KAKAMEGA","MUMIAS EAST","33",617,902,1519
"10620","KAKAMEGA","MUMIAS EAST","34",540,752,1292
"10621","KAKAMEGA","MUMIAS EAST","30-34",3105,4513,7618
"10622","KAKAMEGA","MUMIAS EAST","35",685,726,1411
"10623","KAKAMEGA","MUMIAS EAST","36",551,547,1098
"10624","KAKAMEGA","MUMIAS EAST","37",539,541,1080
"10625","KAKAMEGA","MUMIAS EAST","38",418,401,819
"10626","KAKAMEGA","MUMIAS EAST","39",528,400,928
"10627","KAKAMEGA","MUMIAS EAST","35-39",2721,2615,5336
"10628","KAKAMEGA","MUMIAS EAST","40",521,509,1030
"10629","KAKAMEGA","MUMIAS EAST","41",525,511,1036
"10630","KAKAMEGA","MUMIAS EAST","42",457,471,928
"10631","KAKAMEGA","MUMIAS EAST","43",430,470,900
"10632","KAKAMEGA","MUMIAS EAST","44",364,384,748
"10633","KAKAMEGA","MUMIAS EAST","40-44",2297,2345,4642
"10634","KAKAMEGA","MUMIAS EAST","45",440,463,903
"10635","KAKAMEGA","MUMIAS EAST","46",351,421,772
"10636","KAKAMEGA","MUMIAS EAST","47",421,375,796
"10637","KAKAMEGA","MUMIAS EAST","48",241,273,514
"10638","KAKAMEGA","MUMIAS EAST","49",319,326,645
"10639","KAKAMEGA","MUMIAS EAST","45-49",1772,1858,3630
"10640","KAKAMEGA","MUMIAS EAST","50",339,526,865
"10641","KAKAMEGA","MUMIAS EAST","51",321,422,743
"10642","KAKAMEGA","MUMIAS EAST","52",235,261,496
"10643","KAKAMEGA","MUMIAS EAST","53",224,266,490
"10644","KAKAMEGA","MUMIAS EAST","54",204,267,471
"10645","KAKAMEGA","MUMIAS EAST","50-54",1323,1742,3065
"10646","KAKAMEGA","MUMIAS EAST","55",248,297,545
"10647","KAKAMEGA","MUMIAS EAST","56",252,316,568
"10648","KAKAMEGA","MUMIAS EAST","57",279,401,680
"10649","KAKAMEGA","MUMIAS EAST","58",154,234,388
"10650","KAKAMEGA","MUMIAS EAST","59",220,295,515
"10651","KAKAMEGA","MUMIAS EAST","55-59",1153,1543,2696
"10652","KAKAMEGA","MUMIAS EAST","60",232,326,558
"10653","KAKAMEGA","MUMIAS EAST","61",198,341,539
"10654","KAKAMEGA","MUMIAS EAST","62",161,214,375
"10655","KAKAMEGA","MUMIAS EAST","63",185,266,451
"10656","KAKAMEGA","MUMIAS EAST","64",152,199,351
"10657","KAKAMEGA","MUMIAS EAST","60-64",928,1346,2274
"10658","KAKAMEGA","MUMIAS EAST","65",174,243,417
"10659","KAKAMEGA","MUMIAS EAST","66",143,171,314
"10660","KAKAMEGA","MUMIAS EAST","67",199,269,468
"10661","KAKAMEGA","MUMIAS EAST","68",86,92,178
"10662","KAKAMEGA","MUMIAS EAST","69",148,170,318
"10663","KAKAMEGA","MUMIAS EAST","65-69",750,945,1695
"10664","KAKAMEGA","MUMIAS EAST","70",170,226,396
"10665","KAKAMEGA","MUMIAS EAST","71",106,143,249
"10666","KAKAMEGA","MUMIAS EAST","72",77,103,180
"10667","KAKAMEGA","MUMIAS EAST","73",81,107,188
"10668","KAKAMEGA","MUMIAS EAST","74",58,88,146
"10669","KAKAMEGA","MUMIAS EAST","70-74",492,667,1159
"10670","KAKAMEGA","MUMIAS EAST","75",66,100,166
"10671","KAKAMEGA","MUMIAS EAST","76",43,103,146
"10672","KAKAMEGA","MUMIAS EAST","77",60,90,150
"10673","KAKAMEGA","MUMIAS EAST","78",27,52,79
"10674","KAKAMEGA","MUMIAS EAST","79",40,64,104
"10675","KAKAMEGA","MUMIAS EAST","75-79",236,409,645
"10676","KAKAMEGA","MUMIAS EAST","80",46,71,117
"10677","KAKAMEGA","MUMIAS EAST","81",42,64,106
"10678","KAKAMEGA","MUMIAS EAST","82",43,45,88
"10679","KAKAMEGA","MUMIAS EAST","83",38,57,95
"10680","KAKAMEGA","MUMIAS EAST","84",37,28,65
"10681","KAKAMEGA","MUMIAS EAST","80-84",206,265,471
"10682","KAKAMEGA","MUMIAS EAST","85",34,41,75
"10683","KAKAMEGA","MUMIAS EAST","86",14,41,55
"10684","KAKAMEGA","MUMIAS EAST","87",28,64,92
"10685","KAKAMEGA","MUMIAS EAST","88",13,15,28
"10686","KAKAMEGA","MUMIAS EAST","89",25,47,72
"10687","KAKAMEGA","MUMIAS EAST","85-89",114,208,322
"10688","KAKAMEGA","MUMIAS EAST","90",12,13,25
"10689","KAKAMEGA","MUMIAS EAST","91",19,10,29
"10690","KAKAMEGA","MUMIAS EAST","92",7,6,13
"10691","KAKAMEGA","MUMIAS EAST","93",6,6,12
"10692","KAKAMEGA","MUMIAS EAST","94",2,10,12
"10693","KAKAMEGA","MUMIAS EAST","90-94",46,45,91
"10694","KAKAMEGA","MUMIAS EAST","95",6,7,13
"10695","KAKAMEGA","MUMIAS EAST","96",4,2,6
"10696","KAKAMEGA","MUMIAS EAST","97",4,11,15
"10697","KAKAMEGA","MUMIAS EAST","98",4,3,7
"10698","KAKAMEGA","MUMIAS EAST","99",NA,5,5
"10699","KAKAMEGA","MUMIAS EAST","95-99",18,28,46
"10700","KAKAMEGA","MUMIAS EAST","100+",6,3,9
"10701","KAKAMEGA","MUMIAS EAST","Not Stated",NA,NA,NA
"10702","KAKAMEGA","MUMIAS WEST","Total",54915,60438,115353
"10703","KAKAMEGA","MUMIAS WEST","0",1340,1385,2725
"10704","KAKAMEGA","MUMIAS WEST","1",1320,1383,2703
"10705","KAKAMEGA","MUMIAS WEST","2",1383,1348,2731
"10706","KAKAMEGA","MUMIAS WEST","3",1516,1508,3024
"10707","KAKAMEGA","MUMIAS WEST","4",1567,1502,3069
"10708","KAKAMEGA","MUMIAS WEST","0 - 4",7126,7126,14252
"10709","KAKAMEGA","MUMIAS WEST","5",1640,1576,3216
"10710","KAKAMEGA","MUMIAS WEST","6",1659,1707,3366
"10711","KAKAMEGA","MUMIAS WEST","7",1679,1659,3338
"10712","KAKAMEGA","MUMIAS WEST","8",1550,1627,3177
"10713","KAKAMEGA","MUMIAS WEST","9",1792,1724,3516
"10714","KAKAMEGA","MUMIAS WEST","5-9",8320,8293,16613
"10715","KAKAMEGA","MUMIAS WEST","10",1807,1849,3656
"10716","KAKAMEGA","MUMIAS WEST","11",1733,1745,3478
"10717","KAKAMEGA","MUMIAS WEST","12",1917,1953,3870
"10718","KAKAMEGA","MUMIAS WEST","13",1892,1999,3891
"10719","KAKAMEGA","MUMIAS WEST","14",1657,1742,3399
"10720","KAKAMEGA","MUMIAS WEST","10 -14",9006,9288,18294
"10721","KAKAMEGA","MUMIAS WEST","15",1731,1705,3436
"10722","KAKAMEGA","MUMIAS WEST","16",1548,1648,3196
"10723","KAKAMEGA","MUMIAS WEST","17",1571,1569,3140
"10724","KAKAMEGA","MUMIAS WEST","18",1326,1301,2627
"10725","KAKAMEGA","MUMIAS WEST","19",1311,1336,2647
"10726","KAKAMEGA","MUMIAS WEST","15-19",7487,7559,15046
"10727","KAKAMEGA","MUMIAS WEST","20",1069,1163,2232
"10728","KAKAMEGA","MUMIAS WEST","21",837,947,1784
"10729","KAKAMEGA","MUMIAS WEST","22",821,843,1664
"10730","KAKAMEGA","MUMIAS WEST","23",791,1023,1814
"10731","KAKAMEGA","MUMIAS WEST","24",657,883,1540
"10732","KAKAMEGA","MUMIAS WEST","20-24",4175,4859,9034
"10733","KAKAMEGA","MUMIAS WEST","25",773,933,1706
"10734","KAKAMEGA","MUMIAS WEST","26",581,839,1420
"10735","KAKAMEGA","MUMIAS WEST","27",607,870,1477
"10736","KAKAMEGA","MUMIAS WEST","28",517,709,1226
"10737","KAKAMEGA","MUMIAS WEST","29",525,799,1324
"10738","KAKAMEGA","MUMIAS WEST","25-29",3003,4150,7153
"10739","KAKAMEGA","MUMIAS WEST","30",710,1043,1753
"10740","KAKAMEGA","MUMIAS WEST","31",591,719,1310
"10741","KAKAMEGA","MUMIAS WEST","32",692,930,1622
"10742","KAKAMEGA","MUMIAS WEST","33",580,885,1465
"10743","KAKAMEGA","MUMIAS WEST","34",553,685,1238
"10744","KAKAMEGA","MUMIAS WEST","30-34",3126,4262,7388
"10745","KAKAMEGA","MUMIAS WEST","35",636,785,1421
"10746","KAKAMEGA","MUMIAS WEST","36",512,594,1106
"10747","KAKAMEGA","MUMIAS WEST","37",581,543,1124
"10748","KAKAMEGA","MUMIAS WEST","38",409,438,847
"10749","KAKAMEGA","MUMIAS WEST","39",468,501,969
"10750","KAKAMEGA","MUMIAS WEST","35-39",2606,2861,5467
"10751","KAKAMEGA","MUMIAS WEST","40",526,603,1129
"10752","KAKAMEGA","MUMIAS WEST","41",466,506,972
"10753","KAKAMEGA","MUMIAS WEST","42",472,518,990
"10754","KAKAMEGA","MUMIAS WEST","43",445,500,945
"10755","KAKAMEGA","MUMIAS WEST","44",361,371,732
"10756","KAKAMEGA","MUMIAS WEST","40-44",2270,2498,4768
"10757","KAKAMEGA","MUMIAS WEST","45",511,578,1089
"10758","KAKAMEGA","MUMIAS WEST","46",388,449,837
"10759","KAKAMEGA","MUMIAS WEST","47",393,473,866
"10760","KAKAMEGA","MUMIAS WEST","48",287,312,599
"10761","KAKAMEGA","MUMIAS WEST","49",333,318,651
"10762","KAKAMEGA","MUMIAS WEST","45-49",1912,2130,4042
"10763","KAKAMEGA","MUMIAS WEST","50",405,527,932
"10764","KAKAMEGA","MUMIAS WEST","51",358,422,780
"10765","KAKAMEGA","MUMIAS WEST","52",244,294,538
"10766","KAKAMEGA","MUMIAS WEST","53",237,274,511
"10767","KAKAMEGA","MUMIAS WEST","54",242,290,532
"10768","KAKAMEGA","MUMIAS WEST","50-54",1486,1807,3293
"10769","KAKAMEGA","MUMIAS WEST","55",289,284,573
"10770","KAKAMEGA","MUMIAS WEST","56",267,289,556
"10771","KAKAMEGA","MUMIAS WEST","57",277,403,680
"10772","KAKAMEGA","MUMIAS WEST","58",188,209,397
"10773","KAKAMEGA","MUMIAS WEST","59",270,336,606
"10774","KAKAMEGA","MUMIAS WEST","55-59",1291,1521,2812
"10775","KAKAMEGA","MUMIAS WEST","60",223,326,549
"10776","KAKAMEGA","MUMIAS WEST","61",248,285,533
"10777","KAKAMEGA","MUMIAS WEST","62",178,212,390
"10778","KAKAMEGA","MUMIAS WEST","63",209,269,478
"10779","KAKAMEGA","MUMIAS WEST","64",168,190,358
"10780","KAKAMEGA","MUMIAS WEST","60-64",1026,1282,2308
"10781","KAKAMEGA","MUMIAS WEST","65",217,262,479
"10782","KAKAMEGA","MUMIAS WEST","66",149,181,330
"10783","KAKAMEGA","MUMIAS WEST","67",234,317,551
"10784","KAKAMEGA","MUMIAS WEST","68",95,92,187
"10785","KAKAMEGA","MUMIAS WEST","69",137,212,349
"10786","KAKAMEGA","MUMIAS WEST","65-69",832,1064,1896
"10787","KAKAMEGA","MUMIAS WEST","70",167,245,412
"10788","KAKAMEGA","MUMIAS WEST","71",113,152,265
"10789","KAKAMEGA","MUMIAS WEST","72",74,113,187
"10790","KAKAMEGA","MUMIAS WEST","73",109,109,218
"10791","KAKAMEGA","MUMIAS WEST","74",88,93,181
"10792","KAKAMEGA","MUMIAS WEST","70-74",551,712,1263
"10793","KAKAMEGA","MUMIAS WEST","75",77,83,160
"10794","KAKAMEGA","MUMIAS WEST","76",65,89,154
"10795","KAKAMEGA","MUMIAS WEST","77",79,126,205
"10796","KAKAMEGA","MUMIAS WEST","78",29,51,80
"10797","KAKAMEGA","MUMIAS WEST","79",59,89,148
"10798","KAKAMEGA","MUMIAS WEST","75-79",309,438,747
"10799","KAKAMEGA","MUMIAS WEST","80",66,98,164
"10800","KAKAMEGA","MUMIAS WEST","81",50,66,116
"10801","KAKAMEGA","MUMIAS WEST","82",30,51,81
"10802","KAKAMEGA","MUMIAS WEST","83",41,58,99
"10803","KAKAMEGA","MUMIAS WEST","84",23,42,65
"10804","KAKAMEGA","MUMIAS WEST","80-84",210,315,525
"10805","KAKAMEGA","MUMIAS WEST","85",37,53,90
"10806","KAKAMEGA","MUMIAS WEST","86",19,30,49
"10807","KAKAMEGA","MUMIAS WEST","87",42,42,84
"10808","KAKAMEGA","MUMIAS WEST","88",16,17,33
"10809","KAKAMEGA","MUMIAS WEST","89",15,37,52
"10810","KAKAMEGA","MUMIAS WEST","85-89",129,179,308
"10811","KAKAMEGA","MUMIAS WEST","90",7,16,23
"10812","KAKAMEGA","MUMIAS WEST","91",11,13,24
"10813","KAKAMEGA","MUMIAS WEST","92",10,11,21
"10814","KAKAMEGA","MUMIAS WEST","93",6,5,11
"10815","KAKAMEGA","MUMIAS WEST","94",NA,9,9
"10816","KAKAMEGA","MUMIAS WEST","90-94",34,54,88
"10817","KAKAMEGA","MUMIAS WEST","95",3,16,19
"10818","KAKAMEGA","MUMIAS WEST","96",2,8,10
"10819","KAKAMEGA","MUMIAS WEST","97",5,2,7
"10820","KAKAMEGA","MUMIAS WEST","98",1,2,3
"10821","KAKAMEGA","MUMIAS WEST","99",1,6,7
"10822","KAKAMEGA","MUMIAS WEST","95-99",12,34,46
"10823","KAKAMEGA","MUMIAS WEST","100+",1,4,5
"10824","KAKAMEGA","MUMIAS WEST","Not Stated",3,2,5
"10825","KAKAMEGA","NAVAKHOLO","Total",73275,80695,153970
"10826","KAKAMEGA","NAVAKHOLO","0",1842,1787,3629
"10827","KAKAMEGA","NAVAKHOLO","1",1824,1817,3641
"10828","KAKAMEGA","NAVAKHOLO","2",1941,1921,3862
"10829","KAKAMEGA","NAVAKHOLO","3",2022,2109,4131
"10830","KAKAMEGA","NAVAKHOLO","4",2239,2211,4450
"10831","KAKAMEGA","NAVAKHOLO","0 - 4",9868,9845,19713
"10832","KAKAMEGA","NAVAKHOLO","5",2427,2474,4901
"10833","KAKAMEGA","NAVAKHOLO","6",2475,2566,5041
"10834","KAKAMEGA","NAVAKHOLO","7",2405,2358,4763
"10835","KAKAMEGA","NAVAKHOLO","8",2301,2383,4684
"10836","KAKAMEGA","NAVAKHOLO","9",2576,2686,5262
"10837","KAKAMEGA","NAVAKHOLO","5-9",12184,12467,24651
"10838","KAKAMEGA","NAVAKHOLO","10",2664,2591,5255
"10839","KAKAMEGA","NAVAKHOLO","11",2440,2505,4945
"10840","KAKAMEGA","NAVAKHOLO","12",2715,2701,5416
"10841","KAKAMEGA","NAVAKHOLO","13",2648,2750,5398
"10842","KAKAMEGA","NAVAKHOLO","14",2525,2441,4966
"10843","KAKAMEGA","NAVAKHOLO","10 -14",12992,12988,25980
"10844","KAKAMEGA","NAVAKHOLO","15",2379,2494,4873
"10845","KAKAMEGA","NAVAKHOLO","16",2203,2241,4444
"10846","KAKAMEGA","NAVAKHOLO","17",2162,2152,4314
"10847","KAKAMEGA","NAVAKHOLO","18",1682,1590,3272
"10848","KAKAMEGA","NAVAKHOLO","19",1720,1711,3431
"10849","KAKAMEGA","NAVAKHOLO","15-19",10146,10188,20334
"10850","KAKAMEGA","NAVAKHOLO","20",1436,1614,3050
"10851","KAKAMEGA","NAVAKHOLO","21",1151,1280,2431
"10852","KAKAMEGA","NAVAKHOLO","22",987,1144,2131
"10853","KAKAMEGA","NAVAKHOLO","23",968,1256,2224
"10854","KAKAMEGA","NAVAKHOLO","24",823,1107,1930
"10855","KAKAMEGA","NAVAKHOLO","20-24",5365,6401,11766
"10856","KAKAMEGA","NAVAKHOLO","25",876,1158,2034
"10857","KAKAMEGA","NAVAKHOLO","26",745,1095,1840
"10858","KAKAMEGA","NAVAKHOLO","27",810,1103,1913
"10859","KAKAMEGA","NAVAKHOLO","28",543,864,1407
"10860","KAKAMEGA","NAVAKHOLO","29",653,979,1632
"10861","KAKAMEGA","NAVAKHOLO","25-29",3627,5199,8826
"10862","KAKAMEGA","NAVAKHOLO","30",814,1278,2092
"10863","KAKAMEGA","NAVAKHOLO","31",698,1034,1732
"10864","KAKAMEGA","NAVAKHOLO","32",818,1189,2007
"10865","KAKAMEGA","NAVAKHOLO","33",731,1059,1790
"10866","KAKAMEGA","NAVAKHOLO","34",643,805,1448
"10867","KAKAMEGA","NAVAKHOLO","30-34",3704,5365,9069
"10868","KAKAMEGA","NAVAKHOLO","35",713,879,1592
"10869","KAKAMEGA","NAVAKHOLO","36",617,615,1232
"10870","KAKAMEGA","NAVAKHOLO","37",659,624,1283
"10871","KAKAMEGA","NAVAKHOLO","38",469,442,911
"10872","KAKAMEGA","NAVAKHOLO","39",540,542,1082
"10873","KAKAMEGA","NAVAKHOLO","35-39",2998,3102,6100
"10874","KAKAMEGA","NAVAKHOLO","40",631,661,1292
"10875","KAKAMEGA","NAVAKHOLO","41",563,675,1238
"10876","KAKAMEGA","NAVAKHOLO","42",592,673,1265
"10877","KAKAMEGA","NAVAKHOLO","43",565,718,1283
"10878","KAKAMEGA","NAVAKHOLO","44",439,580,1019
"10879","KAKAMEGA","NAVAKHOLO","40-44",2790,3307,6097
"10880","KAKAMEGA","NAVAKHOLO","45",616,768,1384
"10881","KAKAMEGA","NAVAKHOLO","46",430,514,944
"10882","KAKAMEGA","NAVAKHOLO","47",502,537,1039
"10883","KAKAMEGA","NAVAKHOLO","48",301,317,618
"10884","KAKAMEGA","NAVAKHOLO","49",358,423,781
"10885","KAKAMEGA","NAVAKHOLO","45-49",2207,2559,4766
"10886","KAKAMEGA","NAVAKHOLO","50",434,499,933
"10887","KAKAMEGA","NAVAKHOLO","51",377,534,911
"10888","KAKAMEGA","NAVAKHOLO","52",294,335,629
"10889","KAKAMEGA","NAVAKHOLO","53",266,363,629
"10890","KAKAMEGA","NAVAKHOLO","54",315,311,626
"10891","KAKAMEGA","NAVAKHOLO","50-54",1686,2042,3728
"10892","KAKAMEGA","NAVAKHOLO","55",307,368,675
"10893","KAKAMEGA","NAVAKHOLO","56",352,419,771
"10894","KAKAMEGA","NAVAKHOLO","57",361,520,881
"10895","KAKAMEGA","NAVAKHOLO","58",231,272,503
"10896","KAKAMEGA","NAVAKHOLO","59",353,419,772
"10897","KAKAMEGA","NAVAKHOLO","55-59",1604,1998,3602
"10898","KAKAMEGA","NAVAKHOLO","60",323,428,751
"10899","KAKAMEGA","NAVAKHOLO","61",343,352,695
"10900","KAKAMEGA","NAVAKHOLO","62",265,287,552
"10901","KAKAMEGA","NAVAKHOLO","63",288,341,629
"10902","KAKAMEGA","NAVAKHOLO","64",223,267,490
"10903","KAKAMEGA","NAVAKHOLO","60-64",1442,1675,3117
"10904","KAKAMEGA","NAVAKHOLO","65",307,366,673
"10905","KAKAMEGA","NAVAKHOLO","66",147,208,355
"10906","KAKAMEGA","NAVAKHOLO","67",238,349,587
"10907","KAKAMEGA","NAVAKHOLO","68",99,137,236
"10908","KAKAMEGA","NAVAKHOLO","69",191,238,429
"10909","KAKAMEGA","NAVAKHOLO","65-69",982,1298,2280
"10910","KAKAMEGA","NAVAKHOLO","70",200,264,464
"10911","KAKAMEGA","NAVAKHOLO","71",164,194,358
"10912","KAKAMEGA","NAVAKHOLO","72",137,126,263
"10913","KAKAMEGA","NAVAKHOLO","73",131,138,269
"10914","KAKAMEGA","NAVAKHOLO","74",123,150,273
"10915","KAKAMEGA","NAVAKHOLO","70-74",755,872,1627
"10916","KAKAMEGA","NAVAKHOLO","75",93,147,240
"10917","KAKAMEGA","NAVAKHOLO","76",113,160,273
"10918","KAKAMEGA","NAVAKHOLO","77",93,163,256
"10919","KAKAMEGA","NAVAKHOLO","78",45,59,104
"10920","KAKAMEGA","NAVAKHOLO","79",72,107,179
"10921","KAKAMEGA","NAVAKHOLO","75-79",416,636,1052
"10922","KAKAMEGA","NAVAKHOLO","80",63,99,162
"10923","KAKAMEGA","NAVAKHOLO","81",52,80,132
"10924","KAKAMEGA","NAVAKHOLO","82",39,50,89
"10925","KAKAMEGA","NAVAKHOLO","83",85,93,178
"10926","KAKAMEGA","NAVAKHOLO","84",36,55,91
"10927","KAKAMEGA","NAVAKHOLO","80-84",275,377,652
"10928","KAKAMEGA","NAVAKHOLO","85",38,57,95
"10929","KAKAMEGA","NAVAKHOLO","86",39,34,73
"10930","KAKAMEGA","NAVAKHOLO","87",41,82,123
"10931","KAKAMEGA","NAVAKHOLO","88",13,24,37
"10932","KAKAMEGA","NAVAKHOLO","89",25,52,77
"10933","KAKAMEGA","NAVAKHOLO","85-89",156,249,405
"10934","KAKAMEGA","NAVAKHOLO","90",10,17,27
"10935","KAKAMEGA","NAVAKHOLO","91",14,16,30
"10936","KAKAMEGA","NAVAKHOLO","92",8,16,24
"10937","KAKAMEGA","NAVAKHOLO","93",13,14,27
"10938","KAKAMEGA","NAVAKHOLO","94",5,13,18
"10939","KAKAMEGA","NAVAKHOLO","90-94",50,76,126
"10940","KAKAMEGA","NAVAKHOLO","95",10,11,21
"10941","KAKAMEGA","NAVAKHOLO","96",2,9,11
"10942","KAKAMEGA","NAVAKHOLO","97",6,8,14
"10943","KAKAMEGA","NAVAKHOLO","98",3,4,7
"10944","KAKAMEGA","NAVAKHOLO","99",2,6,8
"10945","KAKAMEGA","NAVAKHOLO","95-99",23,38,61
"10946","KAKAMEGA","NAVAKHOLO","100+",5,11,16
"10947","KAKAMEGA","NAVAKHOLO","Not Stated",NA,2,2
"10948","KERICHO","ALL","Total",450741,451008,901749
"10949","KERICHO","ALL","0",10058,9876,19934
"10950","KERICHO","ALL","1",10667,10527,21194
"10951","KERICHO","ALL","2",11093,10753,21846
"10952","KERICHO","ALL","3",11667,11610,23277
"10953","KERICHO","ALL","4",11852,11455,23307
"10954","KERICHO","ALL","0 - 4",55337,54221,109558
"10955","KERICHO","ALL","5",11696,11512,23208
"10956","KERICHO","ALL","6",11742,11562,23304
"10957","KERICHO","ALL","7",12075,11718,23793
"10958","KERICHO","ALL","8",11223,10990,22213
"10959","KERICHO","ALL","9",12965,12742,25707
"10960","KERICHO","ALL","5-9",59701,58524,118225
"10961","KERICHO","ALL","10",12579,12315,24894
"10962","KERICHO","ALL","11",12047,11999,24046
"10963","KERICHO","ALL","12",13808,13224,27032
"10964","KERICHO","ALL","13",12694,13213,25907
"10965","KERICHO","ALL","14",12562,12576,25138
"10966","KERICHO","ALL","10 -14",63690,63327,127017
"10967","KERICHO","ALL","15",12405,12128,24533
"10968","KERICHO","ALL","16",11191,10992,22183
"10969","KERICHO","ALL","17",11150,10678,21828
"10970","KERICHO","ALL","18",8930,8694,17624
"10971","KERICHO","ALL","19",10680,10342,21022
"10972","KERICHO","ALL","15-19",54356,52834,107190
"10973","KERICHO","ALL","20",8505,9269,17774
"10974","KERICHO","ALL","21",8726,9366,18092
"10975","KERICHO","ALL","22",7874,8623,16497
"10976","KERICHO","ALL","23",8277,9422,17699
"10977","KERICHO","ALL","24",7477,8038,15515
"10978","KERICHO","ALL","20-24",40859,44718,85577
"10979","KERICHO","ALL","25",8351,8891,17242
"10980","KERICHO","ALL","26",6954,7699,14653
"10981","KERICHO","ALL","27",7608,8184,15792
"10982","KERICHO","ALL","28",5671,6185,11856
"10983","KERICHO","ALL","29",6616,7206,13822
"10984","KERICHO","ALL","25-29",35200,38165,73365
"10985","KERICHO","ALL","30",7781,8831,16612
"10986","KERICHO","ALL","31",6156,6812,12968
"10987","KERICHO","ALL","32",7315,8212,15527
"10988","KERICHO","ALL","33",6341,7086,13427
"10989","KERICHO","ALL","34",5621,5955,11576
"10990","KERICHO","ALL","30-34",33214,36896,70110
"10991","KERICHO","ALL","35",7243,6405,13648
"10992","KERICHO","ALL","36",4752,3661,8413
"10993","KERICHO","ALL","37",5138,3903,9041
"10994","KERICHO","ALL","38",3243,2561,5804
"10995","KERICHO","ALL","39",4476,3543,8019
"10996","KERICHO","ALL","35-39",24852,20073,44925
"10997","KERICHO","ALL","40",4918,4089,9007
"10998","KERICHO","ALL","41",5814,4869,10683
"10999","KERICHO","ALL","42",4351,3746,8097
"11000","KERICHO","ALL","43",3548,3605,7153
"11001","KERICHO","ALL","44",2796,2761,5557
"11002","KERICHO","ALL","40-44",21427,19070,40497
"11003","KERICHO","ALL","45",6068,4946,11014
"11004","KERICHO","ALL","46",3351,3301,6652
"11005","KERICHO","ALL","47",3746,3749,7495
"11006","KERICHO","ALL","48",2082,1949,4031
"11007","KERICHO","ALL","49",2770,2709,5479
"11008","KERICHO","ALL","45-49",18017,16654,34671
"11009","KERICHO","ALL","50",3022,3169,6191
"11010","KERICHO","ALL","51",2744,2674,5418
"11011","KERICHO","ALL","52",1889,1746,3635
"11012","KERICHO","ALL","53",1462,1276,2738
"11013","KERICHO","ALL","54",1602,1487,3089
"11014","KERICHO","ALL","50-54",10719,10352,21071
"11015","KERICHO","ALL","55",1663,1536,3199
"11016","KERICHO","ALL","56",1644,1744,3388
"11017","KERICHO","ALL","57",1953,2238,4191
"11018","KERICHO","ALL","58",2629,3185,5814
"11019","KERICHO","ALL","59",2111,2008,4119
"11020","KERICHO","ALL","55-59",10000,10711,20711
"11021","KERICHO","ALL","60",2193,2373,4566
"11022","KERICHO","ALL","61",1770,1764,3534
"11023","KERICHO","ALL","62",1373,1364,2737
"11024","KERICHO","ALL","63",1395,1438,2833
"11025","KERICHO","ALL","64",963,1104,2067
"11026","KERICHO","ALL","60-64",7694,8043,15737
"11027","KERICHO","ALL","65",1733,1774,3507
"11028","KERICHO","ALL","66",999,821,1820
"11029","KERICHO","ALL","67",1610,1562,3172
"11030","KERICHO","ALL","68",659,663,1322
"11031","KERICHO","ALL","69",1077,1065,2142
"11032","KERICHO","ALL","65-69",6078,5885,11963
"11033","KERICHO","ALL","70",1369,1618,2987
"11034","KERICHO","ALL","71",1264,929,2193
"11035","KERICHO","ALL","72",832,561,1393
"11036","KERICHO","ALL","73",649,607,1256
"11037","KERICHO","ALL","74",642,686,1328
"11038","KERICHO","ALL","70-74",4756,4401,9157
"11039","KERICHO","ALL","75",478,633,1111
"11040","KERICHO","ALL","76",367,397,764
"11041","KERICHO","ALL","77",538,498,1036
"11042","KERICHO","ALL","78",266,285,551
"11043","KERICHO","ALL","79",394,704,1098
"11044","KERICHO","ALL","75-79",2043,2517,4560
"11045","KERICHO","ALL","80",406,785,1191
"11046","KERICHO","ALL","81",246,423,669
"11047","KERICHO","ALL","82",233,243,476
"11048","KERICHO","ALL","83",243,310,553
"11049","KERICHO","ALL","84",235,404,639
"11050","KERICHO","ALL","80-84",1363,2165,3528
"11051","KERICHO","ALL","85",212,311,523
"11052","KERICHO","ALL","86",151,154,305
"11053","KERICHO","ALL","87",178,206,384
"11054","KERICHO","ALL","88",109,135,244
"11055","KERICHO","ALL","89",184,499,683
"11056","KERICHO","ALL","85-89",834,1305,2139
"11057","KERICHO","ALL","90",119,239,358
"11058","KERICHO","ALL","91",54,118,172
"11059","KERICHO","ALL","92",45,70,115
"11060","KERICHO","ALL","93",47,66,113
"11061","KERICHO","ALL","94",50,120,170
"11062","KERICHO","ALL","90-94",315,613,928
"11063","KERICHO","ALL","95",94,133,227
"11064","KERICHO","ALL","96",30,50,80
"11065","KERICHO","ALL","97",36,53,89
"11066","KERICHO","ALL","98",18,45,63
"11067","KERICHO","ALL","99",34,98,132
"11068","KERICHO","ALL","95-99",212,379,591
"11069","KERICHO","ALL","100+",64,152,216
"11070","KERICHO","ALL","Not Stated",10,3,13
"11071","KERICHO","BELGUT","Total",72508,72564,145072
"11072","KERICHO","BELGUT","0",1376,1414,2790
"11073","KERICHO","BELGUT","1",1519,1531,3050
"11074","KERICHO","BELGUT","2",1570,1533,3103
"11075","KERICHO","BELGUT","3",1736,1653,3389
"11076","KERICHO","BELGUT","4",1729,1640,3369
"11077","KERICHO","BELGUT","0 - 4",7930,7771,15701
"11078","KERICHO","BELGUT","5",1674,1682,3356
"11079","KERICHO","BELGUT","6",1705,1702,3407
"11080","KERICHO","BELGUT","7",1759,1742,3501
"11081","KERICHO","BELGUT","8",1622,1725,3347
"11082","KERICHO","BELGUT","9",1975,1871,3846
"11083","KERICHO","BELGUT","5-9",8735,8722,17457
"11084","KERICHO","BELGUT","10",1976,1935,3911
"11085","KERICHO","BELGUT","11",1859,1905,3764
"11086","KERICHO","BELGUT","12",2194,2050,4244
"11087","KERICHO","BELGUT","13",1957,2100,4057
"11088","KERICHO","BELGUT","14",2043,2064,4107
"11089","KERICHO","BELGUT","10 -14",10029,10054,20083
"11090","KERICHO","BELGUT","15",2017,1964,3981
"11091","KERICHO","BELGUT","16",1811,1784,3595
"11092","KERICHO","BELGUT","17",1780,1796,3576
"11093","KERICHO","BELGUT","18",1370,1432,2802
"11094","KERICHO","BELGUT","19",1649,1582,3231
"11095","KERICHO","BELGUT","15-19",8627,8558,17185
"11096","KERICHO","BELGUT","20",1329,1435,2764
"11097","KERICHO","BELGUT","21",1343,1473,2816
"11098","KERICHO","BELGUT","22",1253,1352,2605
"11099","KERICHO","BELGUT","23",1291,1470,2761
"11100","KERICHO","BELGUT","24",1162,1274,2436
"11101","KERICHO","BELGUT","20-24",6378,7004,13382
"11102","KERICHO","BELGUT","25",1349,1432,2781
"11103","KERICHO","BELGUT","26",1108,1208,2316
"11104","KERICHO","BELGUT","27",1163,1261,2424
"11105","KERICHO","BELGUT","28",887,1044,1931
"11106","KERICHO","BELGUT","29",1154,1169,2323
"11107","KERICHO","BELGUT","25-29",5661,6114,11775
"11108","KERICHO","BELGUT","30",1295,1544,2839
"11109","KERICHO","BELGUT","31",1117,1198,2315
"11110","KERICHO","BELGUT","32",1275,1481,2756
"11111","KERICHO","BELGUT","33",1088,1237,2325
"11112","KERICHO","BELGUT","34",956,1077,2033
"11113","KERICHO","BELGUT","30-34",5731,6537,12268
"11114","KERICHO","BELGUT","35",1281,1198,2479
"11115","KERICHO","BELGUT","36",898,692,1590
"11116","KERICHO","BELGUT","37",893,728,1621
"11117","KERICHO","BELGUT","38",582,457,1039
"11118","KERICHO","BELGUT","39",828,653,1481
"11119","KERICHO","BELGUT","35-39",4482,3728,8210
"11120","KERICHO","BELGUT","40",968,871,1839
"11121","KERICHO","BELGUT","41",1199,979,2178
"11122","KERICHO","BELGUT","42",819,723,1542
"11123","KERICHO","BELGUT","43",674,662,1336
"11124","KERICHO","BELGUT","44",551,496,1047
"11125","KERICHO","BELGUT","40-44",4211,3731,7942
"11126","KERICHO","BELGUT","45",1079,850,1929
"11127","KERICHO","BELGUT","46",575,587,1162
"11128","KERICHO","BELGUT","47",700,668,1368
"11129","KERICHO","BELGUT","48",353,317,670
"11130","KERICHO","BELGUT","49",497,450,947
"11131","KERICHO","BELGUT","45-49",3204,2872,6076
"11132","KERICHO","BELGUT","50",541,567,1108
"11133","KERICHO","BELGUT","51",467,449,916
"11134","KERICHO","BELGUT","52",361,317,678
"11135","KERICHO","BELGUT","53",266,221,487
"11136","KERICHO","BELGUT","54",254,252,506
"11137","KERICHO","BELGUT","50-54",1889,1806,3695
"11138","KERICHO","BELGUT","55",285,250,535
"11139","KERICHO","BELGUT","56",285,267,552
"11140","KERICHO","BELGUT","57",337,351,688
"11141","KERICHO","BELGUT","58",470,511,981
"11142","KERICHO","BELGUT","59",351,285,636
"11143","KERICHO","BELGUT","55-59",1728,1664,3392
"11144","KERICHO","BELGUT","60",419,392,811
"11145","KERICHO","BELGUT","61",284,254,538
"11146","KERICHO","BELGUT","62",228,216,444
"11147","KERICHO","BELGUT","63",235,213,448
"11148","KERICHO","BELGUT","64",158,161,319
"11149","KERICHO","BELGUT","60-64",1324,1236,2560
"11150","KERICHO","BELGUT","65",293,292,585
"11151","KERICHO","BELGUT","66",171,119,290
"11152","KERICHO","BELGUT","67",227,283,510
"11153","KERICHO","BELGUT","68",96,96,192
"11154","KERICHO","BELGUT","69",166,185,351
"11155","KERICHO","BELGUT","65-69",953,975,1928
"11156","KERICHO","BELGUT","70",206,240,446
"11157","KERICHO","BELGUT","71",223,154,377
"11158","KERICHO","BELGUT","72",164,81,245
"11159","KERICHO","BELGUT","73",117,104,221
"11160","KERICHO","BELGUT","74",111,113,224
"11161","KERICHO","BELGUT","70-74",821,692,1513
"11162","KERICHO","BELGUT","75",77,84,161
"11163","KERICHO","BELGUT","76",64,55,119
"11164","KERICHO","BELGUT","77",98,73,171
"11165","KERICHO","BELGUT","78",39,35,74
"11166","KERICHO","BELGUT","79",69,111,180
"11167","KERICHO","BELGUT","75-79",347,358,705
"11168","KERICHO","BELGUT","80",63,135,198
"11169","KERICHO","BELGUT","81",37,77,114
"11170","KERICHO","BELGUT","82",39,39,78
"11171","KERICHO","BELGUT","83",43,44,87
"11172","KERICHO","BELGUT","84",44,62,106
"11173","KERICHO","BELGUT","80-84",226,357,583
"11174","KERICHO","BELGUT","85",38,42,80
"11175","KERICHO","BELGUT","86",27,23,50
"11176","KERICHO","BELGUT","87",30,34,64
"11177","KERICHO","BELGUT","88",18,19,37
"11178","KERICHO","BELGUT","89",26,90,116
"11179","KERICHO","BELGUT","85-89",139,208,347
"11180","KERICHO","BELGUT","90",15,45,60
"11181","KERICHO","BELGUT","91",8,15,23
"11182","KERICHO","BELGUT","92",12,18,30
"11183","KERICHO","BELGUT","93",4,4,8
"11184","KERICHO","BELGUT","94",9,25,34
"11185","KERICHO","BELGUT","90-94",48,107,155
"11186","KERICHO","BELGUT","95",20,16,36
"11187","KERICHO","BELGUT","96",10,7,17
"11188","KERICHO","BELGUT","97",3,5,8
"11189","KERICHO","BELGUT","98",2,4,6
"11190","KERICHO","BELGUT","99",3,17,20
"11191","KERICHO","BELGUT","95-99",38,49,87
"11192","KERICHO","BELGUT","100+",7,21,28
"11193","KERICHO","BELGUT","Not Stated",NA,NA,NA
"11194","KERICHO","BURETI","Total",98823,100642,199465
"11195","KERICHO","BURETI","0",2157,2179,4336
"11196","KERICHO","BURETI","1",2341,2228,4569
"11197","KERICHO","BURETI","2",2441,2335,4776
"11198","KERICHO","BURETI","3",2480,2560,5040
"11199","KERICHO","BURETI","4",2533,2492,5025
"11200","KERICHO","BURETI","0 - 4",11952,11794,23746
"11201","KERICHO","BURETI","5",2539,2534,5073
"11202","KERICHO","BURETI","6",2572,2547,5119
"11203","KERICHO","BURETI","7",2660,2622,5282
"11204","KERICHO","BURETI","8",2433,2424,4857
"11205","KERICHO","BURETI","9",2822,2815,5637
"11206","KERICHO","BURETI","5-9",13026,12942,25968
"11207","KERICHO","BURETI","10",2722,2672,5394
"11208","KERICHO","BURETI","11",2606,2592,5198
"11209","KERICHO","BURETI","12",3025,2974,5999
"11210","KERICHO","BURETI","13",2810,2959,5769
"11211","KERICHO","BURETI","14",2859,2898,5757
"11212","KERICHO","BURETI","10 -14",14022,14095,28117
"11213","KERICHO","BURETI","15",2791,2816,5607
"11214","KERICHO","BURETI","16",2565,2560,5125
"11215","KERICHO","BURETI","17",2524,2509,5033
"11216","KERICHO","BURETI","18",2026,1973,3999
"11217","KERICHO","BURETI","19",2365,2448,4813
"11218","KERICHO","BURETI","15-19",12271,12306,24577
"11219","KERICHO","BURETI","20",1958,2082,4040
"11220","KERICHO","BURETI","21",1987,2042,4029
"11221","KERICHO","BURETI","22",1773,2032,3805
"11222","KERICHO","BURETI","23",1876,2132,4008
"11223","KERICHO","BURETI","24",1638,1831,3469
"11224","KERICHO","BURETI","20-24",9232,10119,19351
"11225","KERICHO","BURETI","25",1936,2066,4002
"11226","KERICHO","BURETI","26",1533,1761,3294
"11227","KERICHO","BURETI","27",1697,1813,3510
"11228","KERICHO","BURETI","28",1243,1350,2593
"11229","KERICHO","BURETI","29",1328,1554,2882
"11230","KERICHO","BURETI","25-29",7737,8544,16281
"11231","KERICHO","BURETI","30",1653,2083,3736
"11232","KERICHO","BURETI","31",1308,1500,2808
"11233","KERICHO","BURETI","32",1502,1766,3268
"11234","KERICHO","BURETI","33",1325,1527,2852
"11235","KERICHO","BURETI","34",1209,1332,2541
"11236","KERICHO","BURETI","30-34",6997,8208,15205
"11237","KERICHO","BURETI","35",1578,1289,2867
"11238","KERICHO","BURETI","36",1060,785,1845
"11239","KERICHO","BURETI","37",1193,853,2046
"11240","KERICHO","BURETI","38",660,532,1192
"11241","KERICHO","BURETI","39",1002,795,1797
"11242","KERICHO","BURETI","35-39",5493,4254,9747
"11243","KERICHO","BURETI","40",1016,892,1908
"11244","KERICHO","BURETI","41",1116,974,2090
"11245","KERICHO","BURETI","42",894,780,1674
"11246","KERICHO","BURETI","43",737,796,1533
"11247","KERICHO","BURETI","44",558,620,1178
"11248","KERICHO","BURETI","40-44",4321,4062,8383
"11249","KERICHO","BURETI","45",1366,1198,2564
"11250","KERICHO","BURETI","46",724,757,1481
"11251","KERICHO","BURETI","47",834,916,1750
"11252","KERICHO","BURETI","48",429,425,854
"11253","KERICHO","BURETI","49",618,600,1218
"11254","KERICHO","BURETI","45-49",3971,3896,7867
"11255","KERICHO","BURETI","50",655,722,1377
"11256","KERICHO","BURETI","51",622,593,1215
"11257","KERICHO","BURETI","52",365,358,723
"11258","KERICHO","BURETI","53",280,247,527
"11259","KERICHO","BURETI","54",313,301,614
"11260","KERICHO","BURETI","50-54",2235,2221,4456
"11261","KERICHO","BURETI","55",304,302,606
"11262","KERICHO","BURETI","56",281,351,632
"11263","KERICHO","BURETI","57",438,520,958
"11264","KERICHO","BURETI","58",595,742,1337
"11265","KERICHO","BURETI","59",476,454,930
"11266","KERICHO","BURETI","55-59",2094,2369,4463
"11267","KERICHO","BURETI","60",512,546,1058
"11268","KERICHO","BURETI","61",464,378,842
"11269","KERICHO","BURETI","62",329,302,631
"11270","KERICHO","BURETI","63",317,341,658
"11271","KERICHO","BURETI","64",239,252,491
"11272","KERICHO","BURETI","60-64",1861,1819,3680
"11273","KERICHO","BURETI","65",441,421,862
"11274","KERICHO","BURETI","66",213,233,446
"11275","KERICHO","BURETI","67",418,339,757
"11276","KERICHO","BURETI","68",136,144,280
"11277","KERICHO","BURETI","69",246,229,475
"11278","KERICHO","BURETI","65-69",1454,1366,2820
"11279","KERICHO","BURETI","70",344,333,677
"11280","KERICHO","BURETI","71",299,249,548
"11281","KERICHO","BURETI","72",175,123,298
"11282","KERICHO","BURETI","73",172,139,311
"11283","KERICHO","BURETI","74",148,148,296
"11284","KERICHO","BURETI","70-74",1138,992,2130
"11285","KERICHO","BURETI","75",103,142,245
"11286","KERICHO","BURETI","76",71,84,155
"11287","KERICHO","BURETI","77",116,121,237
"11288","KERICHO","BURETI","78",59,59,118
"11289","KERICHO","BURETI","79",81,162,243
"11290","KERICHO","BURETI","75-79",430,568,998
"11291","KERICHO","BURETI","80",111,144,255
"11292","KERICHO","BURETI","81",62,103,165
"11293","KERICHO","BURETI","82",50,52,102
"11294","KERICHO","BURETI","83",51,78,129
"11295","KERICHO","BURETI","84",42,99,141
"11296","KERICHO","BURETI","80-84",316,476,792
"11297","KERICHO","BURETI","85",38,73,111
"11298","KERICHO","BURETI","86",36,38,74
"11299","KERICHO","BURETI","87",24,59,83
"11300","KERICHO","BURETI","88",22,41,63
"11301","KERICHO","BURETI","89",31,114,145
"11302","KERICHO","BURETI","85-89",151,325,476
"11303","KERICHO","BURETI","90",30,62,92
"11304","KERICHO","BURETI","91",11,34,45
"11305","KERICHO","BURETI","92",9,17,26
"11306","KERICHO","BURETI","93",9,16,25
"11307","KERICHO","BURETI","94",9,30,39
"11308","KERICHO","BURETI","90-94",68,159,227
"11309","KERICHO","BURETI","95",20,38,58
"11310","KERICHO","BURETI","96",4,9,13
"11311","KERICHO","BURETI","97",5,13,18
"11312","KERICHO","BURETI","98",5,14,19
"11313","KERICHO","BURETI","99",5,30,35
"11314","KERICHO","BURETI","95-99",39,104,143
"11315","KERICHO","BURETI","100+",15,23,38
"11316","KERICHO","BURETI","Not Stated",NA,NA,NA
"11317","KERICHO","KERICHO EAST","Total",86671,83947,170618
"11318","KERICHO","KERICHO EAST","0",1960,1735,3695
"11319","KERICHO","KERICHO EAST","1",1806,1909,3715
"11320","KERICHO","KERICHO EAST","2",1954,1873,3827
"11321","KERICHO","KERICHO EAST","3",2077,2030,4107
"11322","KERICHO","KERICHO EAST","4",2081,2010,4091
"11323","KERICHO","KERICHO EAST","0 - 4",9878,9557,19435
"11324","KERICHO","KERICHO EAST","5",1952,1909,3861
"11325","KERICHO","KERICHO EAST","6",2003,2014,4017
"11326","KERICHO","KERICHO EAST","7",2103,1960,4063
"11327","KERICHO","KERICHO EAST","8",1887,1930,3817
"11328","KERICHO","KERICHO EAST","9",2205,2267,4472
"11329","KERICHO","KERICHO EAST","5-9",10150,10080,20230
"11330","KERICHO","KERICHO EAST","10",2049,2082,4131
"11331","KERICHO","KERICHO EAST","11",1983,2037,4020
"11332","KERICHO","KERICHO EAST","12",2322,2240,4562
"11333","KERICHO","KERICHO EAST","13",2148,2166,4314
"11334","KERICHO","KERICHO EAST","14",2129,2101,4230
"11335","KERICHO","KERICHO EAST","10 -14",10631,10626,21257
"11336","KERICHO","KERICHO EAST","15",2080,2023,4103
"11337","KERICHO","KERICHO EAST","16",1868,1882,3750
"11338","KERICHO","KERICHO EAST","17",1868,1875,3743
"11339","KERICHO","KERICHO EAST","18",1591,1632,3223
"11340","KERICHO","KERICHO EAST","19",1843,1889,3732
"11341","KERICHO","KERICHO EAST","15-19",9250,9301,18551
"11342","KERICHO","KERICHO EAST","20",1644,1909,3553
"11343","KERICHO","KERICHO EAST","21",1845,1954,3799
"11344","KERICHO","KERICHO EAST","22",1714,1878,3592
"11345","KERICHO","KERICHO EAST","23",1881,2115,3996
"11346","KERICHO","KERICHO EAST","24",1823,1808,3631
"11347","KERICHO","KERICHO EAST","20-24",8907,9664,18571
"11348","KERICHO","KERICHO EAST","25",1962,1945,3907
"11349","KERICHO","KERICHO EAST","26",1718,1687,3405
"11350","KERICHO","KERICHO EAST","27",1906,1798,3704
"11351","KERICHO","KERICHO EAST","28",1393,1336,2729
"11352","KERICHO","KERICHO EAST","29",1621,1581,3202
"11353","KERICHO","KERICHO EAST","25-29",8600,8347,16947
"11354","KERICHO","KERICHO EAST","30",1877,1788,3665
"11355","KERICHO","KERICHO EAST","31",1394,1357,2751
"11356","KERICHO","KERICHO EAST","32",1684,1683,3367
"11357","KERICHO","KERICHO EAST","33",1381,1389,2770
"11358","KERICHO","KERICHO EAST","34",1245,1192,2437
"11359","KERICHO","KERICHO EAST","30-34",7581,7409,14990
"11360","KERICHO","KERICHO EAST","35",1544,1343,2887
"11361","KERICHO","KERICHO EAST","36",1007,848,1855
"11362","KERICHO","KERICHO EAST","37",1122,818,1940
"11363","KERICHO","KERICHO EAST","38",798,603,1401
"11364","KERICHO","KERICHO EAST","39",965,677,1642
"11365","KERICHO","KERICHO EAST","35-39",5436,4289,9725
"11366","KERICHO","KERICHO EAST","40",1106,811,1917
"11367","KERICHO","KERICHO EAST","41",1160,852,2012
"11368","KERICHO","KERICHO EAST","42",944,695,1639
"11369","KERICHO","KERICHO EAST","43",783,666,1449
"11370","KERICHO","KERICHO EAST","44",547,494,1041
"11371","KERICHO","KERICHO EAST","40-44",4540,3518,8058
"11372","KERICHO","KERICHO EAST","45",1162,892,2054
"11373","KERICHO","KERICHO EAST","46",653,627,1280
"11374","KERICHO","KERICHO EAST","47",713,654,1367
"11375","KERICHO","KERICHO EAST","48",438,384,822
"11376","KERICHO","KERICHO EAST","49",522,495,1017
"11377","KERICHO","KERICHO EAST","45-49",3488,3052,6540
"11378","KERICHO","KERICHO EAST","50",581,582,1163
"11379","KERICHO","KERICHO EAST","51",497,505,1002
"11380","KERICHO","KERICHO EAST","52",398,293,691
"11381","KERICHO","KERICHO EAST","53",315,241,556
"11382","KERICHO","KERICHO EAST","54",365,314,679
"11383","KERICHO","KERICHO EAST","50-54",2156,1935,4091
"11384","KERICHO","KERICHO EAST","55",359,263,622
"11385","KERICHO","KERICHO EAST","56",338,343,681
"11386","KERICHO","KERICHO EAST","57",372,411,783
"11387","KERICHO","KERICHO EAST","58",461,467,928
"11388","KERICHO","KERICHO EAST","59",444,348,792
"11389","KERICHO","KERICHO EAST","55-59",1974,1832,3806
"11390","KERICHO","KERICHO EAST","60",389,407,796
"11391","KERICHO","KERICHO EAST","61",306,333,639
"11392","KERICHO","KERICHO EAST","62",235,243,478
"11393","KERICHO","KERICHO EAST","63",250,244,494
"11394","KERICHO","KERICHO EAST","64",158,193,351
"11395","KERICHO","KERICHO EAST","60-64",1338,1420,2758
"11396","KERICHO","KERICHO EAST","65",302,273,575
"11397","KERICHO","KERICHO EAST","66",204,131,335
"11398","KERICHO","KERICHO EAST","67",273,252,525
"11399","KERICHO","KERICHO EAST","68",104,105,209
"11400","KERICHO","KERICHO EAST","69",194,177,371
"11401","KERICHO","KERICHO EAST","65-69",1077,938,2015
"11402","KERICHO","KERICHO EAST","70",244,287,531
"11403","KERICHO","KERICHO EAST","71",224,133,357
"11404","KERICHO","KERICHO EAST","72",146,95,241
"11405","KERICHO","KERICHO EAST","73",112,101,213
"11406","KERICHO","KERICHO EAST","74",105,143,248
"11407","KERICHO","KERICHO EAST","70-74",831,759,1590
"11408","KERICHO","KERICHO EAST","75",82,101,183
"11409","KERICHO","KERICHO EAST","76",53,64,117
"11410","KERICHO","KERICHO EAST","77",96,85,181
"11411","KERICHO","KERICHO EAST","78",48,55,103
"11412","KERICHO","KERICHO EAST","79",60,136,196
"11413","KERICHO","KERICHO EAST","75-79",339,441,780
"11414","KERICHO","KERICHO EAST","80",73,131,204
"11415","KERICHO","KERICHO EAST","81",43,62,105
"11416","KERICHO","KERICHO EAST","82",27,39,66
"11417","KERICHO","KERICHO EAST","83",48,57,105
"11418","KERICHO","KERICHO EAST","84",33,56,89
"11419","KERICHO","KERICHO EAST","80-84",224,345,569
"11420","KERICHO","KERICHO EAST","85",33,66,99
"11421","KERICHO","KERICHO EAST","86",32,37,69
"11422","KERICHO","KERICHO EAST","87",38,25,63
"11423","KERICHO","KERICHO EAST","88",22,22,44
"11424","KERICHO","KERICHO EAST","89",38,85,123
"11425","KERICHO","KERICHO EAST","85-89",163,235,398
"11426","KERICHO","KERICHO EAST","90",15,42,57
"11427","KERICHO","KERICHO EAST","91",15,21,36
"11428","KERICHO","KERICHO EAST","92",7,10,17
"11429","KERICHO","KERICHO EAST","93",8,10,18
"11430","KERICHO","KERICHO EAST","94",9,17,26
"11431","KERICHO","KERICHO EAST","90-94",54,100,154
"11432","KERICHO","KERICHO EAST","95",16,17,33
"11433","KERICHO","KERICHO EAST","96",5,7,12
"11434","KERICHO","KERICHO EAST","97",5,8,13
"11435","KERICHO","KERICHO EAST","98",3,15,18
"11436","KERICHO","KERICHO EAST","99",8,10,18
"11437","KERICHO","KERICHO EAST","95-99",37,57,94
"11438","KERICHO","KERICHO EAST","100+",11,40,51
"11439","KERICHO","KERICHO EAST","Not Stated",6,2,8
"11440","KERICHO","KIPKELION","Total",61066,61460,122526
"11441","KERICHO","KIPKELION","0",1539,1658,3197
"11442","KERICHO","KIPKELION","1",1772,1654,3426
"11443","KERICHO","KIPKELION","2",1720,1762,3482
"11444","KERICHO","KIPKELION","3",1828,1838,3666
"11445","KERICHO","KIPKELION","4",1902,1843,3745
"11446","KERICHO","KIPKELION","0 - 4",8761,8755,17516
"11447","KERICHO","KIPKELION","5",1920,1859,3779
"11448","KERICHO","KIPKELION","6",1846,1873,3719
"11449","KERICHO","KIPKELION","7",1880,1826,3706
"11450","KERICHO","KIPKELION","8",1801,1619,3420
"11451","KERICHO","KIPKELION","9",1950,1909,3859
"11452","KERICHO","KIPKELION","5-9",9397,9086,18483
"11453","KERICHO","KIPKELION","10",1889,1863,3752
"11454","KERICHO","KIPKELION","11",1888,1744,3632
"11455","KERICHO","KIPKELION","12",1999,1945,3944
"11456","KERICHO","KIPKELION","13",1814,1841,3655
"11457","KERICHO","KIPKELION","14",1729,1732,3461
"11458","KERICHO","KIPKELION","10 -14",9319,9125,18444
"11459","KERICHO","KIPKELION","15",1762,1634,3396
"11460","KERICHO","KIPKELION","16",1490,1604,3094
"11461","KERICHO","KIPKELION","17",1567,1342,2909
"11462","KERICHO","KIPKELION","18",1290,1151,2441
"11463","KERICHO","KIPKELION","19",1508,1358,2866
"11464","KERICHO","KIPKELION","15-19",7617,7089,14706
"11465","KERICHO","KIPKELION","20",1186,1238,2424
"11466","KERICHO","KIPKELION","21",1112,1275,2387
"11467","KERICHO","KIPKELION","22",1022,1067,2089
"11468","KERICHO","KIPKELION","23",1011,1176,2187
"11469","KERICHO","KIPKELION","24",913,932,1845
"11470","KERICHO","KIPKELION","20-24",5244,5688,10932
"11471","KERICHO","KIPKELION","25",975,1050,2025
"11472","KERICHO","KIPKELION","26",801,926,1727
"11473","KERICHO","KIPKELION","27",871,986,1857
"11474","KERICHO","KIPKELION","28",579,698,1277
"11475","KERICHO","KIPKELION","29",749,855,1604
"11476","KERICHO","KIPKELION","25-29",3975,4515,8490
"11477","KERICHO","KIPKELION","30",833,991,1824
"11478","KERICHO","KIPKELION","31",710,826,1536
"11479","KERICHO","KIPKELION","32",835,956,1791
"11480","KERICHO","KIPKELION","33",762,829,1591
"11481","KERICHO","KIPKELION","34",633,649,1282
"11482","KERICHO","KIPKELION","30-34",3773,4251,8024
"11483","KERICHO","KIPKELION","35",849,746,1595
"11484","KERICHO","KIPKELION","36",543,362,905
"11485","KERICHO","KIPKELION","37",561,432,993
"11486","KERICHO","KIPKELION","38",318,277,595
"11487","KERICHO","KIPKELION","39",462,399,861
"11488","KERICHO","KIPKELION","35-39",2733,2216,4949
"11489","KERICHO","KIPKELION","40",472,417,889
"11490","KERICHO","KIPKELION","41",649,569,1218
"11491","KERICHO","KIPKELION","42",524,466,990
"11492","KERICHO","KIPKELION","43",422,475,897
"11493","KERICHO","KIPKELION","44",346,356,702
"11494","KERICHO","KIPKELION","40-44",2413,2283,4696
"11495","KERICHO","KIPKELION","45",661,601,1262
"11496","KERICHO","KIPKELION","46",394,420,814
"11497","KERICHO","KIPKELION","47",450,441,891
"11498","KERICHO","KIPKELION","48",249,235,484
"11499","KERICHO","KIPKELION","49",324,312,636
"11500","KERICHO","KIPKELION","45-49",2078,2009,4087
"11501","KERICHO","KIPKELION","50",356,406,762
"11502","KERICHO","KIPKELION","51",343,315,658
"11503","KERICHO","KIPKELION","52",232,236,468
"11504","KERICHO","KIPKELION","53",197,192,389
"11505","KERICHO","KIPKELION","54",217,190,407
"11506","KERICHO","KIPKELION","50-54",1345,1339,2684
"11507","KERICHO","KIPKELION","55",216,224,440
"11508","KERICHO","KIPKELION","56",218,241,459
"11509","KERICHO","KIPKELION","57",241,330,571
"11510","KERICHO","KIPKELION","58",346,500,846
"11511","KERICHO","KIPKELION","59",264,301,565
"11512","KERICHO","KIPKELION","55-59",1285,1596,2881
"11513","KERICHO","KIPKELION","60",255,308,563
"11514","KERICHO","KIPKELION","61",225,267,492
"11515","KERICHO","KIPKELION","62",188,206,394
"11516","KERICHO","KIPKELION","63",211,208,419
"11517","KERICHO","KIPKELION","64",128,146,274
"11518","KERICHO","KIPKELION","60-64",1007,1135,2142
"11519","KERICHO","KIPKELION","65",239,238,477
"11520","KERICHO","KIPKELION","66",131,94,225
"11521","KERICHO","KIPKELION","67",210,224,434
"11522","KERICHO","KIPKELION","68",109,95,204
"11523","KERICHO","KIPKELION","69",160,151,311
"11524","KERICHO","KIPKELION","65-69",849,802,1651
"11525","KERICHO","KIPKELION","70",176,254,430
"11526","KERICHO","KIPKELION","71",161,113,274
"11527","KERICHO","KIPKELION","72",106,70,176
"11528","KERICHO","KIPKELION","73",75,66,141
"11529","KERICHO","KIPKELION","74",78,103,181
"11530","KERICHO","KIPKELION","70-74",596,606,1202
"11531","KERICHO","KIPKELION","75",58,93,151
"11532","KERICHO","KIPKELION","76",57,59,116
"11533","KERICHO","KIPKELION","77",69,61,130
"11534","KERICHO","KIPKELION","78",34,44,78
"11535","KERICHO","KIPKELION","79",50,98,148
"11536","KERICHO","KIPKELION","75-79",268,355,623
"11537","KERICHO","KIPKELION","80",60,116,176
"11538","KERICHO","KIPKELION","81",38,62,100
"11539","KERICHO","KIPKELION","82",31,40,71
"11540","KERICHO","KIPKELION","83",35,36,71
"11541","KERICHO","KIPKELION","84",40,47,87
"11542","KERICHO","KIPKELION","80-84",204,301,505
"11543","KERICHO","KIPKELION","85",32,43,75
"11544","KERICHO","KIPKELION","86",17,19,36
"11545","KERICHO","KIPKELION","87",29,29,58
"11546","KERICHO","KIPKELION","88",9,14,23
"11547","KERICHO","KIPKELION","89",31,69,100
"11548","KERICHO","KIPKELION","85-89",118,174,292
"11549","KERICHO","KIPKELION","90",21,33,54
"11550","KERICHO","KIPKELION","91",7,9,16
"11551","KERICHO","KIPKELION","92",5,10,15
"11552","KERICHO","KIPKELION","93",8,15,23
"11553","KERICHO","KIPKELION","94",8,14,22
"11554","KERICHO","KIPKELION","90-94",49,81,130
"11555","KERICHO","KIPKELION","95",8,13,21
"11556","KERICHO","KIPKELION","96",4,6,10
"11557","KERICHO","KIPKELION","97",4,8,12
"11558","KERICHO","KIPKELION","98",2,2,4
"11559","KERICHO","KIPKELION","99",8,8,16
"11560","KERICHO","KIPKELION","95-99",26,37,63
"11561","KERICHO","KIPKELION","100+",7,17,24
"11562","KERICHO","KIPKELION","Not Stated",2,NA,2
"11563","KERICHO","LONDIANI","Total",68570,69000,137570
"11564","KERICHO","LONDIANI","0",1649,1585,3234
"11565","KERICHO","LONDIANI","1",1720,1733,3453
"11566","KERICHO","LONDIANI","2",1853,1707,3560
"11567","KERICHO","LONDIANI","3",1932,1883,3815
"11568","KERICHO","LONDIANI","4",1921,1859,3780
"11569","KERICHO","LONDIANI","0 - 4",9075,8767,17842
"11570","KERICHO","LONDIANI","5",1919,1857,3776
"11571","KERICHO","LONDIANI","6",1872,1800,3672
"11572","KERICHO","LONDIANI","7",1864,1824,3688
"11573","KERICHO","LONDIANI","8",1798,1732,3530
"11574","KERICHO","LONDIANI","9",2028,2056,4084
"11575","KERICHO","LONDIANI","5-9",9481,9269,18750
"11576","KERICHO","LONDIANI","10",1931,1880,3811
"11577","KERICHO","LONDIANI","11",1881,1849,3730
"11578","KERICHO","LONDIANI","12",2150,2010,4160
"11579","KERICHO","LONDIANI","13",2041,2083,4124
"11580","KERICHO","LONDIANI","14",1920,1907,3827
"11581","KERICHO","LONDIANI","10 -14",9923,9729,19652
"11582","KERICHO","LONDIANI","15",1886,1895,3781
"11583","KERICHO","LONDIANI","16",1796,1668,3464
"11584","KERICHO","LONDIANI","17",1807,1638,3445
"11585","KERICHO","LONDIANI","18",1420,1303,2723
"11586","KERICHO","LONDIANI","19",1728,1553,3281
"11587","KERICHO","LONDIANI","15-19",8637,8057,16694
"11588","KERICHO","LONDIANI","20",1254,1289,2543
"11589","KERICHO","LONDIANI","21",1293,1397,2690
"11590","KERICHO","LONDIANI","22",1126,1184,2310
"11591","KERICHO","LONDIANI","23",1084,1307,2391
"11592","KERICHO","LONDIANI","24",1018,1142,2160
"11593","KERICHO","LONDIANI","20-24",5775,6319,12094
"11594","KERICHO","LONDIANI","25",1080,1179,2259
"11595","KERICHO","LONDIANI","26",982,1108,2090
"11596","KERICHO","LONDIANI","27",987,1182,2169
"11597","KERICHO","LONDIANI","28",801,885,1686
"11598","KERICHO","LONDIANI","29",906,1011,1917
"11599","KERICHO","LONDIANI","25-29",4756,5365,10121
"11600","KERICHO","LONDIANI","30",1047,1213,2260
"11601","KERICHO","LONDIANI","31",788,1030,1818
"11602","KERICHO","LONDIANI","32",1024,1214,2238
"11603","KERICHO","LONDIANI","33",872,1094,1966
"11604","KERICHO","LONDIANI","34",791,876,1667
"11605","KERICHO","LONDIANI","30-34",4522,5427,9949
"11606","KERICHO","LONDIANI","35",987,992,1979
"11607","KERICHO","LONDIANI","36",680,567,1247
"11608","KERICHO","LONDIANI","37",715,611,1326
"11609","KERICHO","LONDIANI","38",521,402,923
"11610","KERICHO","LONDIANI","39",662,569,1231
"11611","KERICHO","LONDIANI","35-39",3565,3141,6706
"11612","KERICHO","LONDIANI","40",700,595,1295
"11613","KERICHO","LONDIANI","41",915,819,1734
"11614","KERICHO","LONDIANI","42",654,581,1235
"11615","KERICHO","LONDIANI","43",492,566,1058
"11616","KERICHO","LONDIANI","44",445,405,850
"11617","KERICHO","LONDIANI","40-44",3206,2966,6172
"11618","KERICHO","LONDIANI","45",910,722,1632
"11619","KERICHO","LONDIANI","46",533,513,1046
"11620","KERICHO","LONDIANI","47",549,520,1069
"11621","KERICHO","LONDIANI","48",340,342,682
"11622","KERICHO","LONDIANI","49",453,410,863
"11623","KERICHO","LONDIANI","45-49",2785,2507,5292
"11624","KERICHO","LONDIANI","50",476,453,929
"11625","KERICHO","LONDIANI","51",416,435,851
"11626","KERICHO","LONDIANI","52",288,287,575
"11627","KERICHO","LONDIANI","53",211,199,410
"11628","KERICHO","LONDIANI","54",257,248,505
"11629","KERICHO","LONDIANI","50-54",1648,1622,3270
"11630","KERICHO","LONDIANI","55",272,293,565
"11631","KERICHO","LONDIANI","56",317,290,607
"11632","KERICHO","LONDIANI","57",311,349,660
"11633","KERICHO","LONDIANI","58",370,505,875
"11634","KERICHO","LONDIANI","59",282,338,620
"11635","KERICHO","LONDIANI","55-59",1552,1775,3327
"11636","KERICHO","LONDIANI","60",308,370,678
"11637","KERICHO","LONDIANI","61",256,284,540
"11638","KERICHO","LONDIANI","62",217,212,429
"11639","KERICHO","LONDIANI","63",193,220,413
"11640","KERICHO","LONDIANI","64",153,178,331
"11641","KERICHO","LONDIANI","60-64",1127,1264,2391
"11642","KERICHO","LONDIANI","65",229,276,505
"11643","KERICHO","LONDIANI","66",148,133,281
"11644","KERICHO","LONDIANI","67",260,252,512
"11645","KERICHO","LONDIANI","68",120,120,240
"11646","KERICHO","LONDIANI","69",163,150,313
"11647","KERICHO","LONDIANI","65-69",920,931,1851
"11648","KERICHO","LONDIANI","70",216,261,477
"11649","KERICHO","LONDIANI","71",200,133,333
"11650","KERICHO","LONDIANI","72",141,115,256
"11651","KERICHO","LONDIANI","73",112,115,227
"11652","KERICHO","LONDIANI","74",100,99,199
"11653","KERICHO","LONDIANI","70-74",769,723,1492
"11654","KERICHO","LONDIANI","75",78,124,202
"11655","KERICHO","LONDIANI","76",77,89,166
"11656","KERICHO","LONDIANI","77",85,84,169
"11657","KERICHO","LONDIANI","78",55,58,113
"11658","KERICHO","LONDIANI","79",69,93,162
"11659","KERICHO","LONDIANI","75-79",364,448,812
"11660","KERICHO","LONDIANI","80",50,121,171
"11661","KERICHO","LONDIANI","81",42,57,99
"11662","KERICHO","LONDIANI","82",56,46,102
"11663","KERICHO","LONDIANI","83",38,47,85
"11664","KERICHO","LONDIANI","84",40,57,97
"11665","KERICHO","LONDIANI","80-84",226,328,554
"11666","KERICHO","LONDIANI","85",36,44,80
"11667","KERICHO","LONDIANI","86",21,13,34
"11668","KERICHO","LONDIANI","87",37,25,62
"11669","KERICHO","LONDIANI","88",22,16,38
"11670","KERICHO","LONDIANI","89",24,70,94
"11671","KERICHO","LONDIANI","85-89",140,168,308
"11672","KERICHO","LONDIANI","90",22,38,60
"11673","KERICHO","LONDIANI","91",9,21,30
"11674","KERICHO","LONDIANI","92",5,7,12
"11675","KERICHO","LONDIANI","93",8,13,21
"11676","KERICHO","LONDIANI","94",4,18,22
"11677","KERICHO","LONDIANI","90-94",48,97,145
"11678","KERICHO","LONDIANI","95",16,27,43
"11679","KERICHO","LONDIANI","96",6,11,17
"11680","KERICHO","LONDIANI","97",9,10,19
"11681","KERICHO","LONDIANI","98",4,8,12
"11682","KERICHO","LONDIANI","99",4,15,19
"11683","KERICHO","LONDIANI","95-99",39,71,110
"11684","KERICHO","LONDIANI","100+",12,25,37
"11685","KERICHO","LONDIANI","Not Stated",NA,1,1
"11686","KERICHO","SOIN SIGOWET","Total",63103,63395,126498
"11687","KERICHO","SOIN SIGOWET","0",1377,1305,2682
"11688","KERICHO","SOIN SIGOWET","1",1509,1472,2981
"11689","KERICHO","SOIN SIGOWET","2",1555,1543,3098
"11690","KERICHO","SOIN SIGOWET","3",1614,1646,3260
"11691","KERICHO","SOIN SIGOWET","4",1686,1611,3297
"11692","KERICHO","SOIN SIGOWET","0 - 4",7741,7577,15318
"11693","KERICHO","SOIN SIGOWET","5",1692,1671,3363
"11694","KERICHO","SOIN SIGOWET","6",1744,1626,3370
"11695","KERICHO","SOIN SIGOWET","7",1809,1744,3553
"11696","KERICHO","SOIN SIGOWET","8",1682,1560,3242
"11697","KERICHO","SOIN SIGOWET","9",1985,1824,3809
"11698","KERICHO","SOIN SIGOWET","5-9",8912,8425,17337
"11699","KERICHO","SOIN SIGOWET","10",2012,1883,3895
"11700","KERICHO","SOIN SIGOWET","11",1830,1872,3702
"11701","KERICHO","SOIN SIGOWET","12",2118,2005,4123
"11702","KERICHO","SOIN SIGOWET","13",1924,2064,3988
"11703","KERICHO","SOIN SIGOWET","14",1882,1874,3756
"11704","KERICHO","SOIN SIGOWET","10 -14",9766,9698,19464
"11705","KERICHO","SOIN SIGOWET","15",1869,1796,3665
"11706","KERICHO","SOIN SIGOWET","16",1661,1494,3155
"11707","KERICHO","SOIN SIGOWET","17",1604,1518,3122
"11708","KERICHO","SOIN SIGOWET","18",1233,1203,2436
"11709","KERICHO","SOIN SIGOWET","19",1587,1512,3099
"11710","KERICHO","SOIN SIGOWET","15-19",7954,7523,15477
"11711","KERICHO","SOIN SIGOWET","20",1134,1316,2450
"11712","KERICHO","SOIN SIGOWET","21",1146,1225,2371
"11713","KERICHO","SOIN SIGOWET","22",986,1110,2096
"11714","KERICHO","SOIN SIGOWET","23",1134,1222,2356
"11715","KERICHO","SOIN SIGOWET","24",923,1051,1974
"11716","KERICHO","SOIN SIGOWET","20-24",5323,5924,11247
"11717","KERICHO","SOIN SIGOWET","25",1049,1219,2268
"11718","KERICHO","SOIN SIGOWET","26",812,1009,1821
"11719","KERICHO","SOIN SIGOWET","27",984,1144,2128
"11720","KERICHO","SOIN SIGOWET","28",768,872,1640
"11721","KERICHO","SOIN SIGOWET","29",858,1036,1894
"11722","KERICHO","SOIN SIGOWET","25-29",4471,5280,9751
"11723","KERICHO","SOIN SIGOWET","30",1076,1212,2288
"11724","KERICHO","SOIN SIGOWET","31",839,901,1740
"11725","KERICHO","SOIN SIGOWET","32",995,1112,2107
"11726","KERICHO","SOIN SIGOWET","33",913,1010,1923
"11727","KERICHO","SOIN SIGOWET","34",787,829,1616
"11728","KERICHO","SOIN SIGOWET","30-34",4610,5064,9674
"11729","KERICHO","SOIN SIGOWET","35",1004,837,1841
"11730","KERICHO","SOIN SIGOWET","36",564,407,971
"11731","KERICHO","SOIN SIGOWET","37",654,461,1115
"11732","KERICHO","SOIN SIGOWET","38",364,290,654
"11733","KERICHO","SOIN SIGOWET","39",557,450,1007
"11734","KERICHO","SOIN SIGOWET","35-39",3143,2445,5588
"11735","KERICHO","SOIN SIGOWET","40",656,503,1159
"11736","KERICHO","SOIN SIGOWET","41",775,676,1451
"11737","KERICHO","SOIN SIGOWET","42",516,501,1017
"11738","KERICHO","SOIN SIGOWET","43",440,440,880
"11739","KERICHO","SOIN SIGOWET","44",349,390,739
"11740","KERICHO","SOIN SIGOWET","40-44",2736,2510,5246
"11741","KERICHO","SOIN SIGOWET","45",890,683,1573
"11742","KERICHO","SOIN SIGOWET","46",472,397,869
"11743","KERICHO","SOIN SIGOWET","47",500,550,1050
"11744","KERICHO","SOIN SIGOWET","48",273,246,519
"11745","KERICHO","SOIN SIGOWET","49",356,442,798
"11746","KERICHO","SOIN SIGOWET","45-49",2491,2318,4809
"11747","KERICHO","SOIN SIGOWET","50",413,439,852
"11748","KERICHO","SOIN SIGOWET","51",399,377,776
"11749","KERICHO","SOIN SIGOWET","52",245,255,500
"11750","KERICHO","SOIN SIGOWET","53",193,176,369
"11751","KERICHO","SOIN SIGOWET","54",196,182,378
"11752","KERICHO","SOIN SIGOWET","50-54",1446,1429,2875
"11753","KERICHO","SOIN SIGOWET","55",227,204,431
"11754","KERICHO","SOIN SIGOWET","56",205,252,457
"11755","KERICHO","SOIN SIGOWET","57",254,277,531
"11756","KERICHO","SOIN SIGOWET","58",387,460,847
"11757","KERICHO","SOIN SIGOWET","59",294,282,576
"11758","KERICHO","SOIN SIGOWET","55-59",1367,1475,2842
"11759","KERICHO","SOIN SIGOWET","60",310,350,660
"11760","KERICHO","SOIN SIGOWET","61",235,248,483
"11761","KERICHO","SOIN SIGOWET","62",176,185,361
"11762","KERICHO","SOIN SIGOWET","63",189,212,401
"11763","KERICHO","SOIN SIGOWET","64",127,174,301
"11764","KERICHO","SOIN SIGOWET","60-64",1037,1169,2206
"11765","KERICHO","SOIN SIGOWET","65",229,274,503
"11766","KERICHO","SOIN SIGOWET","66",132,111,243
"11767","KERICHO","SOIN SIGOWET","67",222,212,434
"11768","KERICHO","SOIN SIGOWET","68",94,103,197
"11769","KERICHO","SOIN SIGOWET","69",148,173,321
"11770","KERICHO","SOIN SIGOWET","65-69",825,873,1698
"11771","KERICHO","SOIN SIGOWET","70",183,243,426
"11772","KERICHO","SOIN SIGOWET","71",157,147,304
"11773","KERICHO","SOIN SIGOWET","72",100,77,177
"11774","KERICHO","SOIN SIGOWET","73",61,82,143
"11775","KERICHO","SOIN SIGOWET","74",100,80,180
"11776","KERICHO","SOIN SIGOWET","70-74",601,629,1230
"11777","KERICHO","SOIN SIGOWET","75",80,89,169
"11778","KERICHO","SOIN SIGOWET","76",45,46,91
"11779","KERICHO","SOIN SIGOWET","77",74,74,148
"11780","KERICHO","SOIN SIGOWET","78",31,34,65
"11781","KERICHO","SOIN SIGOWET","79",65,104,169
"11782","KERICHO","SOIN SIGOWET","75-79",295,347,642
"11783","KERICHO","SOIN SIGOWET","80",49,138,187
"11784","KERICHO","SOIN SIGOWET","81",24,62,86
"11785","KERICHO","SOIN SIGOWET","82",30,27,57
"11786","KERICHO","SOIN SIGOWET","83",28,48,76
"11787","KERICHO","SOIN SIGOWET","84",36,83,119
"11788","KERICHO","SOIN SIGOWET","80-84",167,358,525
"11789","KERICHO","SOIN SIGOWET","85",35,43,78
"11790","KERICHO","SOIN SIGOWET","86",18,24,42
"11791","KERICHO","SOIN SIGOWET","87",20,34,54
"11792","KERICHO","SOIN SIGOWET","88",16,23,39
"11793","KERICHO","SOIN SIGOWET","89",34,71,105
"11794","KERICHO","SOIN SIGOWET","85-89",123,195,318
"11795","KERICHO","SOIN SIGOWET","90",16,19,35
"11796","KERICHO","SOIN SIGOWET","91",4,18,22
"11797","KERICHO","SOIN SIGOWET","92",7,8,15
"11798","KERICHO","SOIN SIGOWET","93",10,8,18
"11799","KERICHO","SOIN SIGOWET","94",11,16,27
"11800","KERICHO","SOIN SIGOWET","90-94",48,69,117
"11801","KERICHO","SOIN SIGOWET","95",14,22,36
"11802","KERICHO","SOIN SIGOWET","96",1,10,11
"11803","KERICHO","SOIN SIGOWET","97",10,9,19
"11804","KERICHO","SOIN SIGOWET","98",2,2,4
"11805","KERICHO","SOIN SIGOWET","99",6,18,24
"11806","KERICHO","SOIN SIGOWET","95-99",33,61,94
"11807","KERICHO","SOIN SIGOWET","100+",12,26,38
"11808","KERICHO","SOIN SIGOWET","Not Stated",2,NA,2
"11809","KIAMBU","ALL","Total",1187146,1230454,2417600
"11810","KIAMBU","ALL","0",29608,29445,59053
"11811","KIAMBU","ALL","1",29092,28394,57486
"11812","KIAMBU","ALL","2",27832,27383,55215
"11813","KIAMBU","ALL","3",27477,27311,54788
"11814","KIAMBU","ALL","4",26120,25479,51599
"11815","KIAMBU","ALL","0 - 4",140129,138012,278141
"11816","KIAMBU","ALL","5",24814,24226,49040
"11817","KIAMBU","ALL","6",24023,24057,48080
"11818","KIAMBU","ALL","7",24337,24214,48551
"11819","KIAMBU","ALL","8",22817,23190,46007
"11820","KIAMBU","ALL","9",24994,25128,50122
"11821","KIAMBU","ALL","5-9",120985,120815,241800
"11822","KIAMBU","ALL","10",23830,23625,47455
"11823","KIAMBU","ALL","11",21337,21947,43284
"11824","KIAMBU","ALL","12",23207,23303,46510
"11825","KIAMBU","ALL","13",23198,23336,46534
"11826","KIAMBU","ALL","14",21644,21903,43547
"11827","KIAMBU","ALL","10 -14",113216,114114,227330
"11828","KIAMBU","ALL","15",20776,21335,42111
"11829","KIAMBU","ALL","16",20083,21412,41495
"11830","KIAMBU","ALL","17",21420,22041,43461
"11831","KIAMBU","ALL","18",18209,20478,38687
"11832","KIAMBU","ALL","19",21311,24856,46167
"11833","KIAMBU","ALL","15-19",101799,110122,211921
"11834","KIAMBU","ALL","20",21452,27039,48491
"11835","KIAMBU","ALL","21",23451,27587,51038
"11836","KIAMBU","ALL","22",24229,29090,53319
"11837","KIAMBU","ALL","23",27337,31887,59224
"11838","KIAMBU","ALL","24",26505,29516,56021
"11839","KIAMBU","ALL","20-24",122974,145119,268093
"11840","KIAMBU","ALL","25",26922,28956,55878
"11841","KIAMBU","ALL","26",24378,26745,51123
"11842","KIAMBU","ALL","27",25227,26172,51399
"11843","KIAMBU","ALL","28",22122,23883,46005
"11844","KIAMBU","ALL","29",24169,25387,49556
"11845","KIAMBU","ALL","25-29",122818,131143,253961
"11846","KIAMBU","ALL","30",27508,29535,57043
"11847","KIAMBU","ALL","31",20308,20718,41026
"11848","KIAMBU","ALL","32",24707,25615,50322
"11849","KIAMBU","ALL","33",20182,21540,41722
"11850","KIAMBU","ALL","34",19413,20070,39483
"11851","KIAMBU","ALL","30-34",112118,117478,229596
"11852","KIAMBU","ALL","35",23309,23140,46449
"11853","KIAMBU","ALL","36",17392,18311,35703
"11854","KIAMBU","ALL","37",17437,17292,34729
"11855","KIAMBU","ALL","38",15647,16043,31690
"11856","KIAMBU","ALL","39",16447,16310,32757
"11857","KIAMBU","ALL","35-39",90232,91096,181328
"11858","KIAMBU","ALL","40",18378,17650,36028
"11859","KIAMBU","ALL","41",15437,14881,30318
"11860","KIAMBU","ALL","42",15087,14168,29255
"11861","KIAMBU","ALL","43",13082,12638,25720
"11862","KIAMBU","ALL","44",11129,10603,21732
"11863","KIAMBU","ALL","40-44",73113,69940,143053
"11864","KIAMBU","ALL","45",15508,13966,29474
"11865","KIAMBU","ALL","46",11751,11043,22794
"11866","KIAMBU","ALL","47",12084,10955,23039
"11867","KIAMBU","ALL","48",9168,8699,17867
"11868","KIAMBU","ALL","49",10071,9355,19426
"11869","KIAMBU","ALL","45-49",58582,54018,112600
"11870","KIAMBU","ALL","50",10942,10700,21642
"11871","KIAMBU","ALL","51",8423,7630,16053
"11872","KIAMBU","ALL","52",9289,8541,17830
"11873","KIAMBU","ALL","53",6414,6241,12655
"11874","KIAMBU","ALL","54",7544,6992,14536
"11875","KIAMBU","ALL","50-54",42612,40104,82716
"11876","KIAMBU","ALL","55",7675,6646,14321
"11877","KIAMBU","ALL","56",7677,7027,14704
"11878","KIAMBU","ALL","57",6067,6410,12477
"11879","KIAMBU","ALL","58",5008,4929,9937
"11880","KIAMBU","ALL","59",5332,5220,10552
"11881","KIAMBU","ALL","55-59",31759,30232,61991
"11882","KIAMBU","ALL","60",5606,5638,11244
"11883","KIAMBU","ALL","61",4358,4300,8658
"11884","KIAMBU","ALL","62",3912,3687,7599
"11885","KIAMBU","ALL","63",3285,3160,6445
"11886","KIAMBU","ALL","64",2469,2570,5039
"11887","KIAMBU","ALL","60-64",19630,19355,38985
"11888","KIAMBU","ALL","65",3631,3737,7368
"11889","KIAMBU","ALL","66",2479,2654,5133
"11890","KIAMBU","ALL","67",4016,4304,8320
"11891","KIAMBU","ALL","68",1830,1866,3696
"11892","KIAMBU","ALL","69",2587,2871,5458
"11893","KIAMBU","ALL","65-69",14543,15432,29975
"11894","KIAMBU","ALL","70",3142,3922,7064
"11895","KIAMBU","ALL","71",2282,2475,4757
"11896","KIAMBU","ALL","72",2344,2227,4571
"11897","KIAMBU","ALL","73",1800,1915,3715
"11898","KIAMBU","ALL","74",1608,1881,3489
"11899","KIAMBU","ALL","70-74",11176,12420,23596
"11900","KIAMBU","ALL","75",1288,1919,3207
"11901","KIAMBU","ALL","76",1379,2512,3891
"11902","KIAMBU","ALL","77",1083,1514,2597
"11903","KIAMBU","ALL","78",674,946,1620
"11904","KIAMBU","ALL","79",759,1446,2205
"11905","KIAMBU","ALL","75-79",5183,8337,13520
"11906","KIAMBU","ALL","80",991,1995,2986
"11907","KIAMBU","ALL","81",568,1006,1574
"11908","KIAMBU","ALL","82",585,779,1364
"11909","KIAMBU","ALL","83",622,876,1498
"11910","KIAMBU","ALL","84",557,1010,1567
"11911","KIAMBU","ALL","80-84",3323,5666,8989
"11912","KIAMBU","ALL","85",456,1068,1524
"11913","KIAMBU","ALL","86",380,722,1102
"11914","KIAMBU","ALL","87",386,607,993
"11915","KIAMBU","ALL","88",212,372,584
"11916","KIAMBU","ALL","89",357,851,1208
"11917","KIAMBU","ALL","85-89",1791,3620,5411
"11918","KIAMBU","ALL","90",189,583,772
"11919","KIAMBU","ALL","91",196,384,580
"11920","KIAMBU","ALL","92",129,273,402
"11921","KIAMBU","ALL","93",101,256,357
"11922","KIAMBU","ALL","94",62,237,299
"11923","KIAMBU","ALL","90-94",677,1733,2410
"11924","KIAMBU","ALL","95",103,313,416
"11925","KIAMBU","ALL","96",71,222,293
"11926","KIAMBU","ALL","97",102,220,322
"11927","KIAMBU","ALL","98",35,125,160
"11928","KIAMBU","ALL","99",53,234,287
"11929","KIAMBU","ALL","95-99",364,1114,1478
"11930","KIAMBU","ALL","100+",92,566,658
"11931","KIAMBU","ALL","Not Stated",30,18,48
"11932","KIAMBU","GATUNDU NORTH","Total",54189,55678,109867
"11933","KIAMBU","GATUNDU NORTH","0",1139,1133,2272
"11934","KIAMBU","GATUNDU NORTH","1",1173,1082,2255
"11935","KIAMBU","GATUNDU NORTH","2",1135,1098,2233
"11936","KIAMBU","GATUNDU NORTH","3",1145,1167,2312
"11937","KIAMBU","GATUNDU NORTH","4",1213,1165,2378
"11938","KIAMBU","GATUNDU NORTH","0 - 4",5805,5645,11450
"11939","KIAMBU","GATUNDU NORTH","5",1150,1044,2194
"11940","KIAMBU","GATUNDU NORTH","6",1098,1187,2285
"11941","KIAMBU","GATUNDU NORTH","7",1194,1203,2397
"11942","KIAMBU","GATUNDU NORTH","8",1090,1085,2175
"11943","KIAMBU","GATUNDU NORTH","9",1286,1268,2554
"11944","KIAMBU","GATUNDU NORTH","5-9",5818,5787,11605
"11945","KIAMBU","GATUNDU NORTH","10",1226,1180,2406
"11946","KIAMBU","GATUNDU NORTH","11",1147,1178,2325
"11947","KIAMBU","GATUNDU NORTH","12",1244,1222,2466
"11948","KIAMBU","GATUNDU NORTH","13",1304,1314,2618
"11949","KIAMBU","GATUNDU NORTH","14",1234,1182,2416
"11950","KIAMBU","GATUNDU NORTH","10 -14",6155,6076,12231
"11951","KIAMBU","GATUNDU NORTH","15",1228,1204,2432
"11952","KIAMBU","GATUNDU NORTH","16",1236,1270,2506
"11953","KIAMBU","GATUNDU NORTH","17",1404,1174,2578
"11954","KIAMBU","GATUNDU NORTH","18",1038,955,1993
"11955","KIAMBU","GATUNDU NORTH","19",1079,922,2001
"11956","KIAMBU","GATUNDU NORTH","15-19",5985,5525,11510
"11957","KIAMBU","GATUNDU NORTH","20",936,825,1761
"11958","KIAMBU","GATUNDU NORTH","21",857,770,1627
"11959","KIAMBU","GATUNDU NORTH","22",799,802,1601
"11960","KIAMBU","GATUNDU NORTH","23",801,781,1582
"11961","KIAMBU","GATUNDU NORTH","24",698,704,1402
"11962","KIAMBU","GATUNDU NORTH","20-24",4091,3882,7973
"11963","KIAMBU","GATUNDU NORTH","25",659,723,1382
"11964","KIAMBU","GATUNDU NORTH","26",616,615,1231
"11965","KIAMBU","GATUNDU NORTH","27",683,664,1347
"11966","KIAMBU","GATUNDU NORTH","28",641,651,1292
"11967","KIAMBU","GATUNDU NORTH","29",702,761,1463
"11968","KIAMBU","GATUNDU NORTH","25-29",3301,3414,6715
"11969","KIAMBU","GATUNDU NORTH","30",816,906,1722
"11970","KIAMBU","GATUNDU NORTH","31",595,622,1217
"11971","KIAMBU","GATUNDU NORTH","32",796,859,1655
"11972","KIAMBU","GATUNDU NORTH","33",699,763,1462
"11973","KIAMBU","GATUNDU NORTH","34",662,706,1368
"11974","KIAMBU","GATUNDU NORTH","30-34",3568,3856,7424
"11975","KIAMBU","GATUNDU NORTH","35",850,897,1747
"11976","KIAMBU","GATUNDU NORTH","36",689,716,1405
"11977","KIAMBU","GATUNDU NORTH","37",745,719,1464
"11978","KIAMBU","GATUNDU NORTH","38",595,667,1262
"11979","KIAMBU","GATUNDU NORTH","39",693,711,1404
"11980","KIAMBU","GATUNDU NORTH","35-39",3572,3710,7282
"11981","KIAMBU","GATUNDU NORTH","40",748,849,1597
"11982","KIAMBU","GATUNDU NORTH","41",699,669,1368
"11983","KIAMBU","GATUNDU NORTH","42",654,715,1369
"11984","KIAMBU","GATUNDU NORTH","43",674,636,1310
"11985","KIAMBU","GATUNDU NORTH","44",547,554,1101
"11986","KIAMBU","GATUNDU NORTH","40-44",3322,3423,6745
"11987","KIAMBU","GATUNDU NORTH","45",762,776,1538
"11988","KIAMBU","GATUNDU NORTH","46",613,628,1241
"11989","KIAMBU","GATUNDU NORTH","47",642,627,1269
"11990","KIAMBU","GATUNDU NORTH","48",447,434,881
"11991","KIAMBU","GATUNDU NORTH","49",533,540,1073
"11992","KIAMBU","GATUNDU NORTH","45-49",2997,3005,6002
"11993","KIAMBU","GATUNDU NORTH","50",580,684,1264
"11994","KIAMBU","GATUNDU NORTH","51",481,517,998
"11995","KIAMBU","GATUNDU NORTH","52",564,590,1154
"11996","KIAMBU","GATUNDU NORTH","53",367,354,721
"11997","KIAMBU","GATUNDU NORTH","54",412,447,859
"11998","KIAMBU","GATUNDU NORTH","50-54",2404,2592,4996
"11999","KIAMBU","GATUNDU NORTH","55",490,437,927
"12000","KIAMBU","GATUNDU NORTH","56",508,496,1004
"12001","KIAMBU","GATUNDU NORTH","57",409,511,920
"12002","KIAMBU","GATUNDU NORTH","58",319,371,690
"12003","KIAMBU","GATUNDU NORTH","59",362,391,753
"12004","KIAMBU","GATUNDU NORTH","55-59",2088,2206,4294
"12005","KIAMBU","GATUNDU NORTH","60",403,445,848
"12006","KIAMBU","GATUNDU NORTH","61",304,363,667
"12007","KIAMBU","GATUNDU NORTH","62",284,311,595
"12008","KIAMBU","GATUNDU NORTH","63",276,257,533
"12009","KIAMBU","GATUNDU NORTH","64",201,234,435
"12010","KIAMBU","GATUNDU NORTH","60-64",1468,1610,3078
"12011","KIAMBU","GATUNDU NORTH","65",330,314,644
"12012","KIAMBU","GATUNDU NORTH","66",229,223,452
"12013","KIAMBU","GATUNDU NORTH","67",367,403,770
"12014","KIAMBU","GATUNDU NORTH","68",152,178,330
"12015","KIAMBU","GATUNDU NORTH","69",214,290,504
"12016","KIAMBU","GATUNDU NORTH","65-69",1292,1408,2700
"12017","KIAMBU","GATUNDU NORTH","70",315,388,703
"12018","KIAMBU","GATUNDU NORTH","71",233,238,471
"12019","KIAMBU","GATUNDU NORTH","72",202,176,378
"12020","KIAMBU","GATUNDU NORTH","73",167,190,357
"12021","KIAMBU","GATUNDU NORTH","74",166,188,354
"12022","KIAMBU","GATUNDU NORTH","70-74",1083,1180,2263
"12023","KIAMBU","GATUNDU NORTH","75",141,195,336
"12024","KIAMBU","GATUNDU NORTH","76",145,261,406
"12025","KIAMBU","GATUNDU NORTH","77",106,160,266
"12026","KIAMBU","GATUNDU NORTH","78",76,104,180
"12027","KIAMBU","GATUNDU NORTH","79",85,153,238
"12028","KIAMBU","GATUNDU NORTH","75-79",553,873,1426
"12029","KIAMBU","GATUNDU NORTH","80",95,229,324
"12030","KIAMBU","GATUNDU NORTH","81",57,107,164
"12031","KIAMBU","GATUNDU NORTH","82",53,93,146
"12032","KIAMBU","GATUNDU NORTH","83",78,121,199
"12033","KIAMBU","GATUNDU NORTH","84",72,119,191
"12034","KIAMBU","GATUNDU NORTH","80-84",355,669,1024
"12035","KIAMBU","GATUNDU NORTH","85",50,128,178
"12036","KIAMBU","GATUNDU NORTH","86",41,94,135
"12037","KIAMBU","GATUNDU NORTH","87",56,44,100
"12038","KIAMBU","GATUNDU NORTH","88",24,51,75
"12039","KIAMBU","GATUNDU NORTH","89",42,112,154
"12040","KIAMBU","GATUNDU NORTH","85-89",213,429,642
"12041","KIAMBU","GATUNDU NORTH","90",28,61,89
"12042","KIAMBU","GATUNDU NORTH","91",14,33,47
"12043","KIAMBU","GATUNDU NORTH","92",15,30,45
"12044","KIAMBU","GATUNDU NORTH","93",12,43,55
"12045","KIAMBU","GATUNDU NORTH","94",4,30,34
"12046","KIAMBU","GATUNDU NORTH","90-94",73,197,270
"12047","KIAMBU","GATUNDU NORTH","95",13,28,41
"12048","KIAMBU","GATUNDU NORTH","96",4,27,31
"12049","KIAMBU","GATUNDU NORTH","97",11,21,32
"12050","KIAMBU","GATUNDU NORTH","98",3,15,18
"12051","KIAMBU","GATUNDU NORTH","99",2,34,36
"12052","KIAMBU","GATUNDU NORTH","95-99",33,125,158
"12053","KIAMBU","GATUNDU NORTH","100+",12,66,78
"12054","KIAMBU","GATUNDU NORTH","Not Stated",1,NA,1
"12055","KIAMBU","GATUNDU SOUTH","Total",60384,61714,122098
"12056","KIAMBU","GATUNDU SOUTH","0",1170,1218,2388
"12057","KIAMBU","GATUNDU SOUTH","1",1192,1192,2384
"12058","KIAMBU","GATUNDU SOUTH","2",1184,1176,2360
"12059","KIAMBU","GATUNDU SOUTH","3",1197,1237,2434
"12060","KIAMBU","GATUNDU SOUTH","4",1338,1246,2584
"12061","KIAMBU","GATUNDU SOUTH","0 - 4",6081,6069,12150
"12062","KIAMBU","GATUNDU SOUTH","5",1199,1175,2374
"12063","KIAMBU","GATUNDU SOUTH","6",1213,1180,2393
"12064","KIAMBU","GATUNDU SOUTH","7",1315,1276,2591
"12065","KIAMBU","GATUNDU SOUTH","8",1247,1194,2441
"12066","KIAMBU","GATUNDU SOUTH","9",1356,1307,2663
"12067","KIAMBU","GATUNDU SOUTH","5-9",6330,6132,12462
"12068","KIAMBU","GATUNDU SOUTH","10",1352,1304,2656
"12069","KIAMBU","GATUNDU SOUTH","11",1207,1206,2413
"12070","KIAMBU","GATUNDU SOUTH","12",1381,1362,2743
"12071","KIAMBU","GATUNDU SOUTH","13",1428,1347,2775
"12072","KIAMBU","GATUNDU SOUTH","14",1372,1324,2696
"12073","KIAMBU","GATUNDU SOUTH","10 -14",6740,6543,13283
"12074","KIAMBU","GATUNDU SOUTH","15",1385,1328,2713
"12075","KIAMBU","GATUNDU SOUTH","16",1370,1343,2713
"12076","KIAMBU","GATUNDU SOUTH","17",1490,1313,2803
"12077","KIAMBU","GATUNDU SOUTH","18",1227,1044,2271
"12078","KIAMBU","GATUNDU SOUTH","19",1182,1101,2283
"12079","KIAMBU","GATUNDU SOUTH","15-19",6654,6129,12783
"12080","KIAMBU","GATUNDU SOUTH","20",1095,982,2077
"12081","KIAMBU","GATUNDU SOUTH","21",1013,882,1895
"12082","KIAMBU","GATUNDU SOUTH","22",944,867,1811
"12083","KIAMBU","GATUNDU SOUTH","23",951,908,1859
"12084","KIAMBU","GATUNDU SOUTH","24",858,797,1655
"12085","KIAMBU","GATUNDU SOUTH","20-24",4861,4436,9297
"12086","KIAMBU","GATUNDU SOUTH","25",857,756,1613
"12087","KIAMBU","GATUNDU SOUTH","26",726,701,1427
"12088","KIAMBU","GATUNDU SOUTH","27",745,686,1431
"12089","KIAMBU","GATUNDU SOUTH","28",655,706,1361
"12090","KIAMBU","GATUNDU SOUTH","29",709,793,1502
"12091","KIAMBU","GATUNDU SOUTH","25-29",3692,3642,7334
"12092","KIAMBU","GATUNDU SOUTH","30",889,945,1834
"12093","KIAMBU","GATUNDU SOUTH","31",675,787,1462
"12094","KIAMBU","GATUNDU SOUTH","32",854,862,1716
"12095","KIAMBU","GATUNDU SOUTH","33",769,821,1590
"12096","KIAMBU","GATUNDU SOUTH","34",785,766,1551
"12097","KIAMBU","GATUNDU SOUTH","30-34",3972,4181,8153
"12098","KIAMBU","GATUNDU SOUTH","35",956,992,1948
"12099","KIAMBU","GATUNDU SOUTH","36",720,858,1578
"12100","KIAMBU","GATUNDU SOUTH","37",814,768,1582
"12101","KIAMBU","GATUNDU SOUTH","38",731,710,1441
"12102","KIAMBU","GATUNDU SOUTH","39",783,795,1578
"12103","KIAMBU","GATUNDU SOUTH","35-39",4004,4123,8127
"12104","KIAMBU","GATUNDU SOUTH","40",853,973,1826
"12105","KIAMBU","GATUNDU SOUTH","41",831,809,1640
"12106","KIAMBU","GATUNDU SOUTH","42",735,783,1518
"12107","KIAMBU","GATUNDU SOUTH","43",717,736,1453
"12108","KIAMBU","GATUNDU SOUTH","44",591,593,1184
"12109","KIAMBU","GATUNDU SOUTH","40-44",3727,3894,7621
"12110","KIAMBU","GATUNDU SOUTH","45",847,798,1645
"12111","KIAMBU","GATUNDU SOUTH","46",717,743,1460
"12112","KIAMBU","GATUNDU SOUTH","47",715,713,1428
"12113","KIAMBU","GATUNDU SOUTH","48",512,560,1072
"12114","KIAMBU","GATUNDU SOUTH","49",567,610,1177
"12115","KIAMBU","GATUNDU SOUTH","45-49",3358,3424,6782
"12116","KIAMBU","GATUNDU SOUTH","50",607,755,1362
"12117","KIAMBU","GATUNDU SOUTH","51",525,561,1086
"12118","KIAMBU","GATUNDU SOUTH","52",559,607,1166
"12119","KIAMBU","GATUNDU SOUTH","53",389,425,814
"12120","KIAMBU","GATUNDU SOUTH","54",524,555,1079
"12121","KIAMBU","GATUNDU SOUTH","50-54",2604,2903,5507
"12122","KIAMBU","GATUNDU SOUTH","55",541,503,1044
"12123","KIAMBU","GATUNDU SOUTH","56",613,585,1198
"12124","KIAMBU","GATUNDU SOUTH","57",454,537,991
"12125","KIAMBU","GATUNDU SOUTH","58",377,439,816
"12126","KIAMBU","GATUNDU SOUTH","59",406,488,894
"12127","KIAMBU","GATUNDU SOUTH","55-59",2391,2552,4943
"12128","KIAMBU","GATUNDU SOUTH","60",468,507,975
"12129","KIAMBU","GATUNDU SOUTH","61",381,475,856
"12130","KIAMBU","GATUNDU SOUTH","62",353,338,691
"12131","KIAMBU","GATUNDU SOUTH","63",331,321,652
"12132","KIAMBU","GATUNDU SOUTH","64",234,283,517
"12133","KIAMBU","GATUNDU SOUTH","60-64",1767,1924,3691
"12134","KIAMBU","GATUNDU SOUTH","65",367,386,753
"12135","KIAMBU","GATUNDU SOUTH","66",267,273,540
"12136","KIAMBU","GATUNDU SOUTH","67",413,503,916
"12137","KIAMBU","GATUNDU SOUTH","68",173,197,370
"12138","KIAMBU","GATUNDU SOUTH","69",263,275,538
"12139","KIAMBU","GATUNDU SOUTH","65-69",1483,1634,3117
"12140","KIAMBU","GATUNDU SOUTH","70",334,474,808
"12141","KIAMBU","GATUNDU SOUTH","71",272,284,556
"12142","KIAMBU","GATUNDU SOUTH","72",244,232,476
"12143","KIAMBU","GATUNDU SOUTH","73",224,225,449
"12144","KIAMBU","GATUNDU SOUTH","74",183,210,393
"12145","KIAMBU","GATUNDU SOUTH","70-74",1257,1425,2682
"12146","KIAMBU","GATUNDU SOUTH","75",152,238,390
"12147","KIAMBU","GATUNDU SOUTH","76",169,363,532
"12148","KIAMBU","GATUNDU SOUTH","77",147,197,344
"12149","KIAMBU","GATUNDU SOUTH","78",75,133,208
"12150","KIAMBU","GATUNDU SOUTH","79",99,187,286
"12151","KIAMBU","GATUNDU SOUTH","75-79",642,1118,1760
"12152","KIAMBU","GATUNDU SOUTH","80",133,290,423
"12153","KIAMBU","GATUNDU SOUTH","81",76,127,203
"12154","KIAMBU","GATUNDU SOUTH","82",61,80,141
"12155","KIAMBU","GATUNDU SOUTH","83",103,96,199
"12156","KIAMBU","GATUNDU SOUTH","84",56,120,176
"12157","KIAMBU","GATUNDU SOUTH","80-84",429,713,1142
"12158","KIAMBU","GATUNDU SOUTH","85",62,128,190
"12159","KIAMBU","GATUNDU SOUTH","86",49,95,144
"12160","KIAMBU","GATUNDU SOUTH","87",49,60,109
"12161","KIAMBU","GATUNDU SOUTH","88",24,52,76
"12162","KIAMBU","GATUNDU SOUTH","89",54,119,173
"12163","KIAMBU","GATUNDU SOUTH","85-89",238,454,692
"12164","KIAMBU","GATUNDU SOUTH","90",24,70,94
"12165","KIAMBU","GATUNDU SOUTH","91",23,45,68
"12166","KIAMBU","GATUNDU SOUTH","92",16,35,51
"12167","KIAMBU","GATUNDU SOUTH","93",11,31,42
"12168","KIAMBU","GATUNDU SOUTH","94",5,29,34
"12169","KIAMBU","GATUNDU SOUTH","90-94",79,210,289
"12170","KIAMBU","GATUNDU SOUTH","95",10,31,41
"12171","KIAMBU","GATUNDU SOUTH","96",11,23,34
"12172","KIAMBU","GATUNDU SOUTH","97",20,22,42
"12173","KIAMBU","GATUNDU SOUTH","98",6,13,19
"12174","KIAMBU","GATUNDU SOUTH","99",8,44,52
"12175","KIAMBU","GATUNDU SOUTH","95-99",55,133,188
"12176","KIAMBU","GATUNDU SOUTH","100+",16,72,88
"12177","KIAMBU","GATUNDU SOUTH","Not Stated",4,3,7
"12178","KIAMBU","GITHUNGURI","Total",82037,83187,165224
"12179","KIAMBU","GITHUNGURI","0",1629,1647,3276
"12180","KIAMBU","GITHUNGURI","1",1622,1605,3227
"12181","KIAMBU","GITHUNGURI","2",1723,1670,3393
"12182","KIAMBU","GITHUNGURI","3",1739,1715,3454
"12183","KIAMBU","GITHUNGURI","4",1703,1693,3396
"12184","KIAMBU","GITHUNGURI","0 - 4",8416,8330,16746
"12185","KIAMBU","GITHUNGURI","5",1557,1546,3103
"12186","KIAMBU","GITHUNGURI","6",1597,1607,3204
"12187","KIAMBU","GITHUNGURI","7",1708,1634,3342
"12188","KIAMBU","GITHUNGURI","8",1634,1582,3216
"12189","KIAMBU","GITHUNGURI","9",1812,1881,3693
"12190","KIAMBU","GITHUNGURI","5-9",8308,8250,16558
"12191","KIAMBU","GITHUNGURI","10",1798,1788,3586
"12192","KIAMBU","GITHUNGURI","11",1640,1598,3238
"12193","KIAMBU","GITHUNGURI","12",1850,1812,3662
"12194","KIAMBU","GITHUNGURI","13",1861,1804,3665
"12195","KIAMBU","GITHUNGURI","14",1709,1712,3421
"12196","KIAMBU","GITHUNGURI","10 -14",8858,8714,17572
"12197","KIAMBU","GITHUNGURI","15",1785,1674,3459
"12198","KIAMBU","GITHUNGURI","16",1684,1655,3339
"12199","KIAMBU","GITHUNGURI","17",1833,1629,3462
"12200","KIAMBU","GITHUNGURI","18",1526,1412,2938
"12201","KIAMBU","GITHUNGURI","19",1573,1448,3021
"12202","KIAMBU","GITHUNGURI","15-19",8401,7818,16219
"12203","KIAMBU","GITHUNGURI","20",1356,1343,2699
"12204","KIAMBU","GITHUNGURI","21",1427,1360,2787
"12205","KIAMBU","GITHUNGURI","22",1348,1288,2636
"12206","KIAMBU","GITHUNGURI","23",1448,1305,2753
"12207","KIAMBU","GITHUNGURI","24",1308,1211,2519
"12208","KIAMBU","GITHUNGURI","20-24",6887,6507,13394
"12209","KIAMBU","GITHUNGURI","25",1287,1210,2497
"12210","KIAMBU","GITHUNGURI","26",1095,1069,2164
"12211","KIAMBU","GITHUNGURI","27",1211,1053,2264
"12212","KIAMBU","GITHUNGURI","28",1045,1021,2066
"12213","KIAMBU","GITHUNGURI","29",1151,1152,2303
"12214","KIAMBU","GITHUNGURI","25-29",5789,5505,11294
"12215","KIAMBU","GITHUNGURI","30",1332,1369,2701
"12216","KIAMBU","GITHUNGURI","31",1043,1048,2091
"12217","KIAMBU","GITHUNGURI","32",1297,1337,2634
"12218","KIAMBU","GITHUNGURI","33",1035,1187,2222
"12219","KIAMBU","GITHUNGURI","34",1054,1180,2234
"12220","KIAMBU","GITHUNGURI","30-34",5761,6121,11882
"12221","KIAMBU","GITHUNGURI","35",1320,1423,2743
"12222","KIAMBU","GITHUNGURI","36",1052,1078,2130
"12223","KIAMBU","GITHUNGURI","37",1162,1159,2321
"12224","KIAMBU","GITHUNGURI","38",1027,1116,2143
"12225","KIAMBU","GITHUNGURI","39",1131,1211,2342
"12226","KIAMBU","GITHUNGURI","35-39",5692,5987,11679
"12227","KIAMBU","GITHUNGURI","40",1282,1269,2551
"12228","KIAMBU","GITHUNGURI","41",1051,1054,2105
"12229","KIAMBU","GITHUNGURI","42",1104,1056,2160
"12230","KIAMBU","GITHUNGURI","43",958,1014,1972
"12231","KIAMBU","GITHUNGURI","44",832,807,1639
"12232","KIAMBU","GITHUNGURI","40-44",5227,5200,10427
"12233","KIAMBU","GITHUNGURI","45",1174,1120,2294
"12234","KIAMBU","GITHUNGURI","46",963,898,1861
"12235","KIAMBU","GITHUNGURI","47",883,964,1847
"12236","KIAMBU","GITHUNGURI","48",753,775,1528
"12237","KIAMBU","GITHUNGURI","49",826,812,1638
"12238","KIAMBU","GITHUNGURI","45-49",4599,4569,9168
"12239","KIAMBU","GITHUNGURI","50",920,984,1904
"12240","KIAMBU","GITHUNGURI","51",718,694,1412
"12241","KIAMBU","GITHUNGURI","52",828,813,1641
"12242","KIAMBU","GITHUNGURI","53",547,538,1085
"12243","KIAMBU","GITHUNGURI","54",715,698,1413
"12244","KIAMBU","GITHUNGURI","50-54",3728,3727,7455
"12245","KIAMBU","GITHUNGURI","55",712,758,1470
"12246","KIAMBU","GITHUNGURI","56",708,719,1427
"12247","KIAMBU","GITHUNGURI","57",614,699,1313
"12248","KIAMBU","GITHUNGURI","58",518,487,1005
"12249","KIAMBU","GITHUNGURI","59",500,574,1074
"12250","KIAMBU","GITHUNGURI","55-59",3052,3237,6289
"12251","KIAMBU","GITHUNGURI","60",621,619,1240
"12252","KIAMBU","GITHUNGURI","61",507,521,1028
"12253","KIAMBU","GITHUNGURI","62",459,434,893
"12254","KIAMBU","GITHUNGURI","63",376,409,785
"12255","KIAMBU","GITHUNGURI","64",273,315,588
"12256","KIAMBU","GITHUNGURI","60-64",2236,2298,4534
"12257","KIAMBU","GITHUNGURI","65",440,457,897
"12258","KIAMBU","GITHUNGURI","66",312,343,655
"12259","KIAMBU","GITHUNGURI","67",502,564,1066
"12260","KIAMBU","GITHUNGURI","68",204,258,462
"12261","KIAMBU","GITHUNGURI","69",363,369,732
"12262","KIAMBU","GITHUNGURI","65-69",1821,1991,3812
"12263","KIAMBU","GITHUNGURI","70",402,507,909
"12264","KIAMBU","GITHUNGURI","71",272,350,622
"12265","KIAMBU","GITHUNGURI","72",314,296,610
"12266","KIAMBU","GITHUNGURI","73",250,278,528
"12267","KIAMBU","GITHUNGURI","74",225,270,495
"12268","KIAMBU","GITHUNGURI","70-74",1463,1701,3164
"12269","KIAMBU","GITHUNGURI","75",176,293,469
"12270","KIAMBU","GITHUNGURI","76",216,357,573
"12271","KIAMBU","GITHUNGURI","77",167,243,410
"12272","KIAMBU","GITHUNGURI","78",107,149,256
"12273","KIAMBU","GITHUNGURI","79",113,201,314
"12274","KIAMBU","GITHUNGURI","75-79",779,1243,2022
"12275","KIAMBU","GITHUNGURI","80",148,320,468
"12276","KIAMBU","GITHUNGURI","81",89,130,219
"12277","KIAMBU","GITHUNGURI","82",95,114,209
"12278","KIAMBU","GITHUNGURI","83",101,148,249
"12279","KIAMBU","GITHUNGURI","84",122,156,278
"12280","KIAMBU","GITHUNGURI","80-84",555,868,1423
"12281","KIAMBU","GITHUNGURI","85",61,163,224
"12282","KIAMBU","GITHUNGURI","86",59,105,164
"12283","KIAMBU","GITHUNGURI","87",61,102,163
"12284","KIAMBU","GITHUNGURI","88",38,56,94
"12285","KIAMBU","GITHUNGURI","89",51,130,181
"12286","KIAMBU","GITHUNGURI","85-89",270,556,826
"12287","KIAMBU","GITHUNGURI","90",30,92,122
"12288","KIAMBU","GITHUNGURI","91",43,58,101
"12289","KIAMBU","GITHUNGURI","92",23,43,66
"12290","KIAMBU","GITHUNGURI","93",20,29,49
"12291","KIAMBU","GITHUNGURI","94",9,41,50
"12292","KIAMBU","GITHUNGURI","90-94",125,263,388
"12293","KIAMBU","GITHUNGURI","95",17,55,72
"12294","KIAMBU","GITHUNGURI","96",11,40,51
"12295","KIAMBU","GITHUNGURI","97",15,45,60
"12296","KIAMBU","GITHUNGURI","98",6,21,27
"12297","KIAMBU","GITHUNGURI","99",9,35,44
"12298","KIAMBU","GITHUNGURI","95-99",58,196,254
"12299","KIAMBU","GITHUNGURI","100+",9,104,113
"12300","KIAMBU","GITHUNGURI","Not Stated",3,2,5
"12301","KIAMBU","JUJA","Total",148446,152480,300926
"12302","KIAMBU","JUJA","0",3923,3880,7803
"12303","KIAMBU","JUJA","1",3767,3780,7547
"12304","KIAMBU","JUJA","2",3574,3606,7180
"12305","KIAMBU","JUJA","3",3554,3491,7045
"12306","KIAMBU","JUJA","4",3322,3295,6617
"12307","KIAMBU","JUJA","0 - 4",18140,18052,36192
"12308","KIAMBU","JUJA","5",3205,3096,6301
"12309","KIAMBU","JUJA","6",3103,3069,6172
"12310","KIAMBU","JUJA","7",3138,3030,6168
"12311","KIAMBU","JUJA","8",2850,2996,5846
"12312","KIAMBU","JUJA","9",3086,3092,6178
"12313","KIAMBU","JUJA","5-9",15382,15283,30665
"12314","KIAMBU","JUJA","10",2902,2828,5730
"12315","KIAMBU","JUJA","11",2659,2697,5356
"12316","KIAMBU","JUJA","12",2686,2758,5444
"12317","KIAMBU","JUJA","13",2746,2781,5527
"12318","KIAMBU","JUJA","14",2515,2563,5078
"12319","KIAMBU","JUJA","10 -14",13508,13627,27135
"12320","KIAMBU","JUJA","15",2388,2533,4921
"12321","KIAMBU","JUJA","16",2342,2542,4884
"12322","KIAMBU","JUJA","17",2362,2634,4996
"12323","KIAMBU","JUJA","18",2102,2600,4702
"12324","KIAMBU","JUJA","19",2553,3466,6019
"12325","KIAMBU","JUJA","15-19",11747,13775,25522
"12326","KIAMBU","JUJA","20",3000,4020,7020
"12327","KIAMBU","JUJA","21",3392,4227,7619
"12328","KIAMBU","JUJA","22",3765,4562,8327
"12329","KIAMBU","JUJA","23",4366,4815,9181
"12330","KIAMBU","JUJA","24",4141,4283,8424
"12331","KIAMBU","JUJA","20-24",18664,21907,40571
"12332","KIAMBU","JUJA","25",4117,4215,8332
"12333","KIAMBU","JUJA","26",3741,3635,7376
"12334","KIAMBU","JUJA","27",3573,3505,7078
"12335","KIAMBU","JUJA","28",3139,3171,6310
"12336","KIAMBU","JUJA","29",3310,3245,6555
"12337","KIAMBU","JUJA","25-29",17880,17771,35651
"12338","KIAMBU","JUJA","30",3544,3677,7221
"12339","KIAMBU","JUJA","31",2525,2558,5083
"12340","KIAMBU","JUJA","32",3171,3204,6375
"12341","KIAMBU","JUJA","33",2563,2673,5236
"12342","KIAMBU","JUJA","34",2409,2522,4931
"12343","KIAMBU","JUJA","30-34",14212,14634,28846
"12344","KIAMBU","JUJA","35",2937,2880,5817
"12345","KIAMBU","JUJA","36",2111,2312,4423
"12346","KIAMBU","JUJA","37",2113,2173,4286
"12347","KIAMBU","JUJA","38",1941,2026,3967
"12348","KIAMBU","JUJA","39",2034,2014,4048
"12349","KIAMBU","JUJA","35-39",11136,11405,22541
"12350","KIAMBU","JUJA","40",2411,2171,4582
"12351","KIAMBU","JUJA","41",1950,1863,3813
"12352","KIAMBU","JUJA","42",1913,1652,3565
"12353","KIAMBU","JUJA","43",1617,1557,3174
"12354","KIAMBU","JUJA","44",1317,1271,2588
"12355","KIAMBU","JUJA","40-44",9208,8514,17722
"12356","KIAMBU","JUJA","45",1890,1670,3560
"12357","KIAMBU","JUJA","46",1381,1290,2671
"12358","KIAMBU","JUJA","47",1475,1215,2690
"12359","KIAMBU","JUJA","48",1151,1020,2171
"12360","KIAMBU","JUJA","49",1139,1057,2196
"12361","KIAMBU","JUJA","45-49",7036,6252,13288
"12362","KIAMBU","JUJA","50",1322,1162,2484
"12363","KIAMBU","JUJA","51",902,865,1767
"12364","KIAMBU","JUJA","52",1012,822,1834
"12365","KIAMBU","JUJA","53",736,653,1389
"12366","KIAMBU","JUJA","54",782,725,1507
"12367","KIAMBU","JUJA","50-54",4754,4227,8981
"12368","KIAMBU","JUJA","55",818,607,1425
"12369","KIAMBU","JUJA","56",783,664,1447
"12370","KIAMBU","JUJA","57",596,592,1188
"12371","KIAMBU","JUJA","58",469,415,884
"12372","KIAMBU","JUJA","59",463,441,904
"12373","KIAMBU","JUJA","55-59",3129,2719,5848
"12374","KIAMBU","JUJA","60",506,491,997
"12375","KIAMBU","JUJA","61",337,327,664
"12376","KIAMBU","JUJA","62",299,286,585
"12377","KIAMBU","JUJA","63",280,224,504
"12378","KIAMBU","JUJA","64",191,188,379
"12379","KIAMBU","JUJA","60-64",1613,1516,3129
"12380","KIAMBU","JUJA","65",237,283,520
"12381","KIAMBU","JUJA","66",152,194,346
"12382","KIAMBU","JUJA","67",241,294,535
"12383","KIAMBU","JUJA","68",139,146,285
"12384","KIAMBU","JUJA","69",170,169,339
"12385","KIAMBU","JUJA","65-69",939,1086,2025
"12386","KIAMBU","JUJA","70",172,237,409
"12387","KIAMBU","JUJA","71",113,139,252
"12388","KIAMBU","JUJA","72",135,131,266
"12389","KIAMBU","JUJA","73",100,99,199
"12390","KIAMBU","JUJA","74",72,92,164
"12391","KIAMBU","JUJA","70-74",592,698,1290
"12392","KIAMBU","JUJA","75",67,95,162
"12393","KIAMBU","JUJA","76",49,117,166
"12394","KIAMBU","JUJA","77",54,83,137
"12395","KIAMBU","JUJA","78",41,54,95
"12396","KIAMBU","JUJA","79",34,65,99
"12397","KIAMBU","JUJA","75-79",245,414,659
"12398","KIAMBU","JUJA","80",46,76,122
"12399","KIAMBU","JUJA","81",19,45,64
"12400","KIAMBU","JUJA","82",30,38,68
"12401","KIAMBU","JUJA","83",21,35,56
"12402","KIAMBU","JUJA","84",25,47,72
"12403","KIAMBU","JUJA","80-84",141,241,382
"12404","KIAMBU","JUJA","85",18,52,70
"12405","KIAMBU","JUJA","86",24,30,54
"12406","KIAMBU","JUJA","87",16,29,45
"12407","KIAMBU","JUJA","88",6,14,20
"12408","KIAMBU","JUJA","89",9,48,57
"12409","KIAMBU","JUJA","85-89",73,173,246
"12410","KIAMBU","JUJA","90",8,40,48
"12411","KIAMBU","JUJA","91",9,18,27
"12412","KIAMBU","JUJA","92",NA,24,24
"12413","KIAMBU","JUJA","93",5,10,15
"12414","KIAMBU","JUJA","94",4,16,20
"12415","KIAMBU","JUJA","90-94",26,108,134
"12416","KIAMBU","JUJA","95",NA,13,13
"12417","KIAMBU","JUJA","96",3,8,11
"12418","KIAMBU","JUJA","97",6,9,15
"12419","KIAMBU","JUJA","98",1,7,8
"12420","KIAMBU","JUJA","99",1,11,12
"12421","KIAMBU","JUJA","95-99",11,48,59
"12422","KIAMBU","JUJA","100+",7,29,36
"12423","KIAMBU","JUJA","Not Stated",3,1,4
"12424","KIAMBU","KABETE","Total",97794,101845,199639
"12425","KIAMBU","KABETE","0",2509,2492,5001
"12426","KIAMBU","KABETE","1",2459,2431,4890
"12427","KIAMBU","KABETE","2",2354,2202,4556
"12428","KIAMBU","KABETE","3",2269,2138,4407
"12429","KIAMBU","KABETE","4",2080,2020,4100
"12430","KIAMBU","KABETE","0 - 4",11671,11283,22954
"12431","KIAMBU","KABETE","5",1932,1962,3894
"12432","KIAMBU","KABETE","6",1919,1941,3860
"12433","KIAMBU","KABETE","7",1920,1854,3774
"12434","KIAMBU","KABETE","8",1786,1907,3693
"12435","KIAMBU","KABETE","9",1977,1992,3969
"12436","KIAMBU","KABETE","5-9",9534,9656,19190
"12437","KIAMBU","KABETE","10",1858,1797,3655
"12438","KIAMBU","KABETE","11",1645,1760,3405
"12439","KIAMBU","KABETE","12",1859,1796,3655
"12440","KIAMBU","KABETE","13",1844,1831,3675
"12441","KIAMBU","KABETE","14",1747,1742,3489
"12442","KIAMBU","KABETE","10 -14",8953,8926,17879
"12443","KIAMBU","KABETE","15",1621,1614,3235
"12444","KIAMBU","KABETE","16",1585,1674,3259
"12445","KIAMBU","KABETE","17",1583,1792,3375
"12446","KIAMBU","KABETE","18",1388,1612,3000
"12447","KIAMBU","KABETE","19",1692,1979,3671
"12448","KIAMBU","KABETE","15-19",7869,8671,16540
"12449","KIAMBU","KABETE","20",1628,2124,3752
"12450","KIAMBU","KABETE","21",1883,2219,4102
"12451","KIAMBU","KABETE","22",1860,2313,4173
"12452","KIAMBU","KABETE","23",2197,2682,4879
"12453","KIAMBU","KABETE","24",2292,2472,4764
"12454","KIAMBU","KABETE","20-24",9860,11810,21670
"12455","KIAMBU","KABETE","25",2331,2548,4879
"12456","KIAMBU","KABETE","26",2097,2482,4579
"12457","KIAMBU","KABETE","27",2323,2330,4653
"12458","KIAMBU","KABETE","28",1976,2087,4063
"12459","KIAMBU","KABETE","29",2191,2298,4489
"12460","KIAMBU","KABETE","25-29",10918,11745,22663
"12461","KIAMBU","KABETE","30",2380,2578,4958
"12462","KIAMBU","KABETE","31",1832,1811,3643
"12463","KIAMBU","KABETE","32",2063,2252,4315
"12464","KIAMBU","KABETE","33",1711,1851,3562
"12465","KIAMBU","KABETE","34",1682,1752,3434
"12466","KIAMBU","KABETE","30-34",9668,10244,19912
"12467","KIAMBU","KABETE","35",1943,1927,3870
"12468","KIAMBU","KABETE","36",1442,1567,3009
"12469","KIAMBU","KABETE","37",1485,1500,2985
"12470","KIAMBU","KABETE","38",1274,1315,2589
"12471","KIAMBU","KABETE","39",1424,1403,2827
"12472","KIAMBU","KABETE","35-39",7568,7712,15280
"12473","KIAMBU","KABETE","40",1553,1498,3051
"12474","KIAMBU","KABETE","41",1267,1221,2488
"12475","KIAMBU","KABETE","42",1258,1234,2492
"12476","KIAMBU","KABETE","43",1067,1064,2131
"12477","KIAMBU","KABETE","44",879,883,1762
"12478","KIAMBU","KABETE","40-44",6024,5900,11924
"12479","KIAMBU","KABETE","45",1342,1158,2500
"12480","KIAMBU","KABETE","46",957,946,1903
"12481","KIAMBU","KABETE","47",980,923,1903
"12482","KIAMBU","KABETE","48",820,735,1555
"12483","KIAMBU","KABETE","49",859,834,1693
"12484","KIAMBU","KABETE","45-49",4958,4596,9554
"12485","KIAMBU","KABETE","50",928,941,1869
"12486","KIAMBU","KABETE","51",720,626,1346
"12487","KIAMBU","KABETE","52",781,778,1559
"12488","KIAMBU","KABETE","53",531,565,1096
"12489","KIAMBU","KABETE","54",651,555,1206
"12490","KIAMBU","KABETE","50-54",3611,3465,7076
"12491","KIAMBU","KABETE","55",608,524,1132
"12492","KIAMBU","KABETE","56",614,578,1192
"12493","KIAMBU","KABETE","57",473,452,925
"12494","KIAMBU","KABETE","58",411,398,809
"12495","KIAMBU","KABETE","59",454,408,862
"12496","KIAMBU","KABETE","55-59",2560,2360,4920
"12497","KIAMBU","KABETE","60",455,454,909
"12498","KIAMBU","KABETE","61",347,364,711
"12499","KIAMBU","KABETE","62",303,308,611
"12500","KIAMBU","KABETE","63",265,256,521
"12501","KIAMBU","KABETE","64",191,189,380
"12502","KIAMBU","KABETE","60-64",1561,1571,3132
"12503","KIAMBU","KABETE","65",284,306,590
"12504","KIAMBU","KABETE","66",193,210,403
"12505","KIAMBU","KABETE","67",321,372,693
"12506","KIAMBU","KABETE","68",161,151,312
"12507","KIAMBU","KABETE","69",215,221,436
"12508","KIAMBU","KABETE","65-69",1174,1260,2434
"12509","KIAMBU","KABETE","70",261,325,586
"12510","KIAMBU","KABETE","71",181,210,391
"12511","KIAMBU","KABETE","72",183,204,387
"12512","KIAMBU","KABETE","73",161,169,330
"12513","KIAMBU","KABETE","74",137,157,294
"12514","KIAMBU","KABETE","70-74",923,1065,1988
"12515","KIAMBU","KABETE","75",111,141,252
"12516","KIAMBU","KABETE","76",129,186,315
"12517","KIAMBU","KABETE","77",83,114,197
"12518","KIAMBU","KABETE","78",56,64,120
"12519","KIAMBU","KABETE","79",64,115,179
"12520","KIAMBU","KABETE","75-79",443,620,1063
"12521","KIAMBU","KABETE","80",93,174,267
"12522","KIAMBU","KABETE","81",44,76,120
"12523","KIAMBU","KABETE","82",45,66,111
"12524","KIAMBU","KABETE","83",51,69,120
"12525","KIAMBU","KABETE","84",37,67,104
"12526","KIAMBU","KABETE","80-84",270,452,722
"12527","KIAMBU","KABETE","85",39,90,129
"12528","KIAMBU","KABETE","86",30,44,74
"12529","KIAMBU","KABETE","87",37,59,96
"12530","KIAMBU","KABETE","88",10,27,37
"12531","KIAMBU","KABETE","89",27,56,83
"12532","KIAMBU","KABETE","85-89",143,276,419
"12533","KIAMBU","KABETE","90",13,44,57
"12534","KIAMBU","KABETE","91",11,23,34
"12535","KIAMBU","KABETE","92",10,25,35
"12536","KIAMBU","KABETE","93",9,20,29
"12537","KIAMBU","KABETE","94",7,10,17
"12538","KIAMBU","KABETE","90-94",50,122,172
"12539","KIAMBU","KABETE","95",10,25,35
"12540","KIAMBU","KABETE","96",7,16,23
"12541","KIAMBU","KABETE","97",6,19,25
"12542","KIAMBU","KABETE","98",2,5,7
"12543","KIAMBU","KABETE","99",4,12,16
"12544","KIAMBU","KABETE","95-99",29,77,106
"12545","KIAMBU","KABETE","100+",5,33,38
"12546","KIAMBU","KABETE","Not Stated",2,1,3
"12547","KIAMBU","KIAMBAA","Total",115690,120695,236385
"12548","KIAMBU","KIAMBAA","0",3001,2955,5956
"12549","KIAMBU","KIAMBAA","1",3035,3042,6077
"12550","KIAMBU","KIAMBAA","2",2826,2838,5664
"12551","KIAMBU","KIAMBAA","3",2759,2820,5579
"12552","KIAMBU","KIAMBAA","4",2682,2485,5167
"12553","KIAMBU","KIAMBAA","0 - 4",14303,14140,28443
"12554","KIAMBU","KIAMBAA","5",2347,2432,4779
"12555","KIAMBU","KIAMBAA","6",2395,2341,4736
"12556","KIAMBU","KIAMBAA","7",2253,2285,4538
"12557","KIAMBU","KIAMBAA","8",2156,2249,4405
"12558","KIAMBU","KIAMBAA","9",2226,2392,4618
"12559","KIAMBU","KIAMBAA","5-9",11377,11699,23076
"12560","KIAMBU","KIAMBAA","10",2192,2241,4433
"12561","KIAMBU","KIAMBAA","11",1974,1983,3957
"12562","KIAMBU","KIAMBAA","12",2139,2124,4263
"12563","KIAMBU","KIAMBAA","13",2056,2088,4144
"12564","KIAMBU","KIAMBAA","14",1866,2014,3880
"12565","KIAMBU","KIAMBAA","10 -14",10227,10450,20677
"12566","KIAMBU","KIAMBAA","15",1758,1912,3670
"12567","KIAMBU","KIAMBAA","16",1714,1868,3582
"12568","KIAMBU","KIAMBAA","17",1804,1948,3752
"12569","KIAMBU","KIAMBAA","18",1606,1901,3507
"12570","KIAMBU","KIAMBAA","19",1919,2279,4198
"12571","KIAMBU","KIAMBAA","15-19",8801,9908,18709
"12572","KIAMBU","KIAMBAA","20",1826,2520,4346
"12573","KIAMBU","KIAMBAA","21",2073,2643,4716
"12574","KIAMBU","KIAMBAA","22",2108,2922,5030
"12575","KIAMBU","KIAMBAA","23",2502,3236,5738
"12576","KIAMBU","KIAMBAA","24",2585,3163,5748
"12577","KIAMBU","KIAMBAA","20-24",11094,14484,25578
"12578","KIAMBU","KIAMBAA","25",2760,3220,5980
"12579","KIAMBU","KIAMBAA","26",2568,3032,5600
"12580","KIAMBU","KIAMBAA","27",2636,2977,5613
"12581","KIAMBU","KIAMBAA","28",2406,2660,5066
"12582","KIAMBU","KIAMBAA","29",2654,2799,5453
"12583","KIAMBU","KIAMBAA","25-29",13024,14688,27712
"12584","KIAMBU","KIAMBAA","30",3066,3259,6325
"12585","KIAMBU","KIAMBAA","31",2316,2364,4680
"12586","KIAMBU","KIAMBAA","32",2827,2816,5643
"12587","KIAMBU","KIAMBAA","33",2225,2305,4530
"12588","KIAMBU","KIAMBAA","34",2282,2182,4464
"12589","KIAMBU","KIAMBAA","30-34",12716,12926,25642
"12590","KIAMBU","KIAMBAA","35",2588,2408,4996
"12591","KIAMBU","KIAMBAA","36",1876,1903,3779
"12592","KIAMBU","KIAMBAA","37",1864,1667,3531
"12593","KIAMBU","KIAMBAA","38",1679,1616,3295
"12594","KIAMBU","KIAMBAA","39",1714,1607,3321
"12595","KIAMBU","KIAMBAA","35-39",9721,9201,18922
"12596","KIAMBU","KIAMBAA","40",1787,1692,3479
"12597","KIAMBU","KIAMBAA","41",1553,1440,2993
"12598","KIAMBU","KIAMBAA","42",1559,1393,2952
"12599","KIAMBU","KIAMBAA","43",1361,1228,2589
"12600","KIAMBU","KIAMBAA","44",1110,1006,2116
"12601","KIAMBU","KIAMBAA","40-44",7370,6759,14129
"12602","KIAMBU","KIAMBAA","45",1516,1252,2768
"12603","KIAMBU","KIAMBAA","46",1163,998,2161
"12604","KIAMBU","KIAMBAA","47",1182,1023,2205
"12605","KIAMBU","KIAMBAA","48",909,793,1702
"12606","KIAMBU","KIAMBAA","49",980,872,1852
"12607","KIAMBU","KIAMBAA","45-49",5750,4938,10688
"12608","KIAMBU","KIAMBAA","50",1055,921,1976
"12609","KIAMBU","KIAMBAA","51",827,641,1468
"12610","KIAMBU","KIAMBAA","52",880,709,1589
"12611","KIAMBU","KIAMBAA","53",594,554,1148
"12612","KIAMBU","KIAMBAA","54",711,570,1281
"12613","KIAMBU","KIAMBAA","50-54",4067,3395,7462
"12614","KIAMBU","KIAMBAA","55",706,557,1263
"12615","KIAMBU","KIAMBAA","56",665,584,1249
"12616","KIAMBU","KIAMBAA","57",488,525,1013
"12617","KIAMBU","KIAMBAA","58",423,385,808
"12618","KIAMBU","KIAMBAA","59",438,415,853
"12619","KIAMBU","KIAMBAA","55-59",2720,2466,5186
"12620","KIAMBU","KIAMBAA","60",421,450,871
"12621","KIAMBU","KIAMBAA","61",358,321,679
"12622","KIAMBU","KIAMBAA","62",344,329,673
"12623","KIAMBU","KIAMBAA","63",224,245,469
"12624","KIAMBU","KIAMBAA","64",189,206,395
"12625","KIAMBU","KIAMBAA","60-64",1536,1551,3087
"12626","KIAMBU","KIAMBAA","65",298,293,591
"12627","KIAMBU","KIAMBAA","66",202,237,439
"12628","KIAMBU","KIAMBAA","67",317,373,690
"12629","KIAMBU","KIAMBAA","68",133,147,280
"12630","KIAMBU","KIAMBAA","69",182,263,445
"12631","KIAMBU","KIAMBAA","65-69",1132,1313,2445
"12632","KIAMBU","KIAMBAA","70",260,355,615
"12633","KIAMBU","KIAMBAA","71",199,206,405
"12634","KIAMBU","KIAMBAA","72",187,172,359
"12635","KIAMBU","KIAMBAA","73",158,164,322
"12636","KIAMBU","KIAMBAA","74",114,151,265
"12637","KIAMBU","KIAMBAA","70-74",918,1048,1966
"12638","KIAMBU","KIAMBAA","75",119,171,290
"12639","KIAMBU","KIAMBAA","76",109,216,325
"12640","KIAMBU","KIAMBAA","77",92,142,234
"12641","KIAMBU","KIAMBAA","78",53,81,134
"12642","KIAMBU","KIAMBAA","79",47,131,178
"12643","KIAMBU","KIAMBAA","75-79",420,741,1161
"12644","KIAMBU","KIAMBAA","80",87,159,246
"12645","KIAMBU","KIAMBAA","81",42,102,144
"12646","KIAMBU","KIAMBAA","82",49,71,120
"12647","KIAMBU","KIAMBAA","83",50,53,103
"12648","KIAMBU","KIAMBAA","84",46,76,122
"12649","KIAMBU","KIAMBAA","80-84",274,461,735
"12650","KIAMBU","KIAMBAA","85",39,76,115
"12651","KIAMBU","KIAMBAA","86",37,63,100
"12652","KIAMBU","KIAMBAA","87",24,46,70
"12653","KIAMBU","KIAMBAA","88",22,30,52
"12654","KIAMBU","KIAMBAA","89",28,52,80
"12655","KIAMBU","KIAMBAA","85-89",150,267,417
"12656","KIAMBU","KIAMBAA","90",12,36,48
"12657","KIAMBU","KIAMBAA","91",13,40,53
"12658","KIAMBU","KIAMBAA","92",19,21,40
"12659","KIAMBU","KIAMBAA","93",4,18,22
"12660","KIAMBU","KIAMBAA","94",5,14,19
"12661","KIAMBU","KIAMBAA","90-94",53,129,182
"12662","KIAMBU","KIAMBAA","95",9,26,35
"12663","KIAMBU","KIAMBAA","96",7,17,24
"12664","KIAMBU","KIAMBAA","97",6,13,19
"12665","KIAMBU","KIAMBAA","98",2,9,11
"12666","KIAMBU","KIAMBAA","99",4,22,26
"12667","KIAMBU","KIAMBAA","95-99",28,87,115
"12668","KIAMBU","KIAMBAA","100+",6,43,49
"12669","KIAMBU","KIAMBAA","Not Stated",3,1,4
"12670","KIAMBU","KIAMBU","Total",69661,76225,145886
"12671","KIAMBU","KIAMBU","0",1799,1799,3598
"12672","KIAMBU","KIAMBU","1",1729,1727,3456
"12673","KIAMBU","KIAMBU","2",1711,1607,3318
"12674","KIAMBU","KIAMBU","3",1599,1647,3246
"12675","KIAMBU","KIAMBU","4",1501,1524,3025
"12676","KIAMBU","KIAMBU","0 - 4",8339,8304,16643
"12677","KIAMBU","KIAMBU","5",1555,1468,3023
"12678","KIAMBU","KIAMBU","6",1360,1465,2825
"12679","KIAMBU","KIAMBU","7",1426,1441,2867
"12680","KIAMBU","KIAMBU","8",1329,1341,2670
"12681","KIAMBU","KIAMBU","9",1403,1440,2843
"12682","KIAMBU","KIAMBU","5-9",7073,7155,14228
"12683","KIAMBU","KIAMBU","10",1327,1388,2715
"12684","KIAMBU","KIAMBU","11",1133,1245,2378
"12685","KIAMBU","KIAMBU","12",1292,1398,2690
"12686","KIAMBU","KIAMBU","13",1252,1294,2546
"12687","KIAMBU","KIAMBU","14",1180,1197,2377
"12688","KIAMBU","KIAMBU","10 -14",6184,6522,12706
"12689","KIAMBU","KIAMBU","15",1084,1167,2251
"12690","KIAMBU","KIAMBU","16",1095,1195,2290
"12691","KIAMBU","KIAMBU","17",1080,1245,2325
"12692","KIAMBU","KIAMBU","18",924,1119,2043
"12693","KIAMBU","KIAMBU","19",1164,1444,2608
"12694","KIAMBU","KIAMBU","15-19",5347,6170,11517
"12695","KIAMBU","KIAMBU","20",1190,1654,2844
"12696","KIAMBU","KIAMBU","21",1305,1743,3048
"12697","KIAMBU","KIAMBU","22",1334,1870,3204
"12698","KIAMBU","KIAMBU","23",1527,1997,3524
"12699","KIAMBU","KIAMBU","24",1496,1867,3363
"12700","KIAMBU","KIAMBU","20-24",6852,9131,15983
"12701","KIAMBU","KIAMBU","25",1463,1783,3246
"12702","KIAMBU","KIAMBU","26",1447,1752,3199
"12703","KIAMBU","KIAMBU","27",1475,1694,3169
"12704","KIAMBU","KIAMBU","28",1348,1609,2957
"12705","KIAMBU","KIAMBU","29",1405,1716,3121
"12706","KIAMBU","KIAMBU","25-29",7138,8554,15692
"12707","KIAMBU","KIAMBU","30",1780,2036,3816
"12708","KIAMBU","KIAMBU","31",1313,1452,2765
"12709","KIAMBU","KIAMBU","32",1528,1757,3285
"12710","KIAMBU","KIAMBU","33",1279,1417,2696
"12711","KIAMBU","KIAMBU","34",1281,1385,2666
"12712","KIAMBU","KIAMBU","30-34",7181,8047,15228
"12713","KIAMBU","KIAMBU","35",1490,1618,3108
"12714","KIAMBU","KIAMBU","36",1159,1237,2396
"12715","KIAMBU","KIAMBU","37",1175,1231,2406
"12716","KIAMBU","KIAMBU","38",969,1135,2104
"12717","KIAMBU","KIAMBU","39",1037,1058,2095
"12718","KIAMBU","KIAMBU","35-39",5830,6279,12109
"12719","KIAMBU","KIAMBU","40",1166,1209,2375
"12720","KIAMBU","KIAMBU","41",936,932,1868
"12721","KIAMBU","KIAMBU","42",952,943,1895
"12722","KIAMBU","KIAMBU","43",785,788,1573
"12723","KIAMBU","KIAMBU","44",743,709,1452
"12724","KIAMBU","KIAMBU","40-44",4582,4581,9163
"12725","KIAMBU","KIAMBU","45",911,906,1817
"12726","KIAMBU","KIAMBU","46",705,671,1376
"12727","KIAMBU","KIAMBU","47",681,711,1392
"12728","KIAMBU","KIAMBU","48",554,563,1117
"12729","KIAMBU","KIAMBU","49",632,544,1176
"12730","KIAMBU","KIAMBU","45-49",3483,3395,6878
"12731","KIAMBU","KIAMBU","50",633,651,1284
"12732","KIAMBU","KIAMBU","51",524,468,992
"12733","KIAMBU","KIAMBU","52",535,548,1083
"12734","KIAMBU","KIAMBU","53",399,413,812
"12735","KIAMBU","KIAMBU","54",472,469,941
"12736","KIAMBU","KIAMBU","50-54",2563,2549,5112
"12737","KIAMBU","KIAMBU","55",496,424,920
"12738","KIAMBU","KIAMBU","56",455,433,888
"12739","KIAMBU","KIAMBU","57",339,337,676
"12740","KIAMBU","KIAMBU","58",322,319,641
"12741","KIAMBU","KIAMBU","59",357,307,664
"12742","KIAMBU","KIAMBU","55-59",1969,1820,3789
"12743","KIAMBU","KIAMBU","60",317,304,621
"12744","KIAMBU","KIAMBU","61",254,215,469
"12745","KIAMBU","KIAMBU","62",224,216,440
"12746","KIAMBU","KIAMBU","63",179,191,370
"12747","KIAMBU","KIAMBU","64",161,145,306
"12748","KIAMBU","KIAMBU","60-64",1135,1071,2206
"12749","KIAMBU","KIAMBU","65",215,226,441
"12750","KIAMBU","KIAMBU","66",153,143,296
"12751","KIAMBU","KIAMBU","67",234,232,466
"12752","KIAMBU","KIAMBU","68",98,101,199
"12753","KIAMBU","KIAMBU","69",144,156,300
"12754","KIAMBU","KIAMBU","65-69",844,858,1702
"12755","KIAMBU","KIAMBU","70",169,194,363
"12756","KIAMBU","KIAMBU","71",116,129,245
"12757","KIAMBU","KIAMBU","72",139,129,268
"12758","KIAMBU","KIAMBU","73",114,87,201
"12759","KIAMBU","KIAMBU","74",91,111,202
"12760","KIAMBU","KIAMBU","70-74",629,650,1279
"12761","KIAMBU","KIAMBU","75",70,84,154
"12762","KIAMBU","KIAMBU","76",58,128,186
"12763","KIAMBU","KIAMBU","77",47,65,112
"12764","KIAMBU","KIAMBU","78",31,36,67
"12765","KIAMBU","KIAMBU","79",35,72,107
"12766","KIAMBU","KIAMBU","75-79",241,385,626
"12767","KIAMBU","KIAMBU","80",44,101,145
"12768","KIAMBU","KIAMBU","81",25,45,70
"12769","KIAMBU","KIAMBU","82",35,54,89
"12770","KIAMBU","KIAMBU","83",21,45,66
"12771","KIAMBU","KIAMBU","84",27,51,78
"12772","KIAMBU","KIAMBU","80-84",152,296,448
"12773","KIAMBU","KIAMBU","85",24,51,75
"12774","KIAMBU","KIAMBU","86",13,45,58
"12775","KIAMBU","KIAMBU","87",14,48,62
"12776","KIAMBU","KIAMBU","88",11,18,29
"12777","KIAMBU","KIAMBU","89",9,53,62
"12778","KIAMBU","KIAMBU","85-89",71,215,286
"12779","KIAMBU","KIAMBU","90",7,40,47
"12780","KIAMBU","KIAMBU","91",10,27,37
"12781","KIAMBU","KIAMBU","92",8,18,26
"12782","KIAMBU","KIAMBU","93",NA,23,23
"12783","KIAMBU","KIAMBU","94",2,14,16
"12784","KIAMBU","KIAMBU","90-94",27,122,149
"12785","KIAMBU","KIAMBU","95",5,25,30
"12786","KIAMBU","KIAMBU","96",5,16,21
"12787","KIAMBU","KIAMBU","97",2,14,16
"12788","KIAMBU","KIAMBU","98",2,10,12
"12789","KIAMBU","KIAMBU","99",3,17,20
"12790","KIAMBU","KIAMBU","95-99",17,82,99
"12791","KIAMBU","KIAMBU","100+",2,37,39
"12792","KIAMBU","KIAMBU","Not Stated",2,2,4
"12793","KIAMBU","KIKUYU","Total",90919,96198,187117
"12794","KIAMBU","KIKUYU","0",2362,2205,4567
"12795","KIAMBU","KIKUYU","1",2204,2160,4364
"12796","KIAMBU","KIKUYU","2",2178,2169,4347
"12797","KIAMBU","KIKUYU","3",2181,2066,4247
"12798","KIAMBU","KIKUYU","4",1968,1894,3862
"12799","KIAMBU","KIKUYU","0 - 4",10893,10494,21387
"12800","KIAMBU","KIKUYU","5",1878,1918,3796
"12801","KIAMBU","KIKUYU","6",1864,1810,3674
"12802","KIAMBU","KIKUYU","7",1866,1862,3728
"12803","KIAMBU","KIKUYU","8",1774,1752,3526
"12804","KIAMBU","KIKUYU","9",1950,1969,3919
"12805","KIAMBU","KIKUYU","5-9",9332,9311,18643
"12806","KIAMBU","KIKUYU","10",1806,1844,3650
"12807","KIAMBU","KIKUYU","11",1537,1642,3179
"12808","KIAMBU","KIKUYU","12",1721,1746,3467
"12809","KIAMBU","KIKUYU","13",1793,1760,3553
"12810","KIAMBU","KIKUYU","14",1619,1637,3256
"12811","KIAMBU","KIKUYU","10 -14",8476,8629,17105
"12812","KIAMBU","KIKUYU","15",1534,1603,3137
"12813","KIAMBU","KIKUYU","16",1467,1570,3037
"12814","KIAMBU","KIKUYU","17",1586,1690,3276
"12815","KIAMBU","KIKUYU","18",1397,1553,2950
"12816","KIAMBU","KIKUYU","19",1536,1825,3361
"12817","KIAMBU","KIKUYU","15-19",7520,8241,15761
"12818","KIAMBU","KIKUYU","20",1426,1931,3357
"12819","KIAMBU","KIKUYU","21",1635,2023,3658
"12820","KIAMBU","KIKUYU","22",1714,2081,3795
"12821","KIAMBU","KIKUYU","23",1915,2508,4423
"12822","KIAMBU","KIKUYU","24",1858,2273,4131
"12823","KIAMBU","KIKUYU","20-24",8548,10816,19364
"12824","KIAMBU","KIKUYU","25",1917,2261,4178
"12825","KIAMBU","KIKUYU","26",1898,2253,4151
"12826","KIAMBU","KIKUYU","27",1935,2248,4183
"12827","KIAMBU","KIKUYU","28",1777,1995,3772
"12828","KIAMBU","KIKUYU","29",1916,2205,4121
"12829","KIAMBU","KIKUYU","25-29",9443,10962,20405
"12830","KIAMBU","KIKUYU","30",2134,2420,4554
"12831","KIAMBU","KIKUYU","31",1682,1808,3490
"12832","KIAMBU","KIKUYU","32",1941,2144,4085
"12833","KIAMBU","KIKUYU","33",1712,1817,3529
"12834","KIAMBU","KIKUYU","34",1559,1724,3283
"12835","KIAMBU","KIKUYU","30-34",9028,9913,18941
"12836","KIAMBU","KIKUYU","35",1847,1944,3791
"12837","KIAMBU","KIKUYU","36",1477,1470,2947
"12838","KIAMBU","KIKUYU","37",1424,1411,2835
"12839","KIAMBU","KIKUYU","38",1306,1300,2606
"12840","KIAMBU","KIKUYU","39",1391,1298,2689
"12841","KIAMBU","KIKUYU","35-39",7445,7423,14868
"12842","KIAMBU","KIKUYU","40",1441,1419,2860
"12843","KIAMBU","KIKUYU","41",1155,1139,2294
"12844","KIAMBU","KIKUYU","42",1139,1073,2212
"12845","KIAMBU","KIKUYU","43",995,996,1991
"12846","KIAMBU","KIKUYU","44",894,845,1739
"12847","KIAMBU","KIKUYU","40-44",5624,5472,11096
"12848","KIAMBU","KIKUYU","45",1162,1030,2192
"12849","KIAMBU","KIKUYU","46",886,832,1718
"12850","KIAMBU","KIKUYU","47",889,841,1730
"12851","KIAMBU","KIKUYU","48",737,725,1462
"12852","KIAMBU","KIKUYU","49",760,765,1525
"12853","KIAMBU","KIKUYU","45-49",4434,4193,8627
"12854","KIAMBU","KIKUYU","50",836,796,1632
"12855","KIAMBU","KIKUYU","51",625,613,1238
"12856","KIAMBU","KIKUYU","52",715,673,1388
"12857","KIAMBU","KIKUYU","53",531,552,1083
"12858","KIAMBU","KIKUYU","54",575,547,1122
"12859","KIAMBU","KIKUYU","50-54",3282,3181,6463
"12860","KIAMBU","KIKUYU","55",591,531,1122
"12861","KIAMBU","KIKUYU","56",569,514,1083
"12862","KIAMBU","KIKUYU","57",512,552,1064
"12863","KIAMBU","KIKUYU","58",398,407,805
"12864","KIAMBU","KIKUYU","59",412,381,793
"12865","KIAMBU","KIKUYU","55-59",2482,2385,4867
"12866","KIAMBU","KIKUYU","60",406,417,823
"12867","KIAMBU","KIKUYU","61",374,308,682
"12868","KIAMBU","KIKUYU","62",283,286,569
"12869","KIAMBU","KIKUYU","63",237,265,502
"12870","KIAMBU","KIKUYU","64",180,196,376
"12871","KIAMBU","KIKUYU","60-64",1480,1472,2952
"12872","KIAMBU","KIKUYU","65",281,298,579
"12873","KIAMBU","KIKUYU","66",171,209,380
"12874","KIAMBU","KIKUYU","67",298,302,600
"12875","KIAMBU","KIKUYU","68",143,150,293
"12876","KIAMBU","KIKUYU","69",219,235,454
"12877","KIAMBU","KIKUYU","65-69",1112,1194,2306
"12878","KIAMBU","KIKUYU","70",265,288,553
"12879","KIAMBU","KIKUYU","71",182,202,384
"12880","KIAMBU","KIKUYU","72",204,181,385
"12881","KIAMBU","KIKUYU","73",123,155,278
"12882","KIAMBU","KIKUYU","74",129,158,287
"12883","KIAMBU","KIKUYU","70-74",903,984,1887
"12884","KIAMBU","KIKUYU","75",97,152,249
"12885","KIAMBU","KIKUYU","76",127,171,298
"12886","KIAMBU","KIKUYU","77",89,116,205
"12887","KIAMBU","KIKUYU","78",44,62,106
"12888","KIAMBU","KIKUYU","79",67,115,182
"12889","KIAMBU","KIKUYU","75-79",424,616,1040
"12890","KIAMBU","KIKUYU","80",86,135,221
"12891","KIAMBU","KIKUYU","81",47,74,121
"12892","KIAMBU","KIKUYU","82",48,70,118
"12893","KIAMBU","KIKUYU","83",43,55,98
"12894","KIAMBU","KIKUYU","84",41,79,120
"12895","KIAMBU","KIKUYU","80-84",265,413,678
"12896","KIAMBU","KIKUYU","85",38,88,126
"12897","KIAMBU","KIKUYU","86",29,49,78
"12898","KIAMBU","KIKUYU","87",25,39,64
"12899","KIAMBU","KIKUYU","88",20,25,45
"12900","KIAMBU","KIKUYU","89",32,64,96
"12901","KIAMBU","KIKUYU","85-89",144,265,409
"12902","KIAMBU","KIKUYU","90",17,32,49
"12903","KIAMBU","KIKUYU","91",10,26,36
"12904","KIAMBU","KIKUYU","92",9,18,27
"12905","KIAMBU","KIKUYU","93",7,20,27
"12906","KIAMBU","KIKUYU","94",1,15,16
"12907","KIAMBU","KIKUYU","90-94",44,111,155
"12908","KIAMBU","KIKUYU","95",11,26,37
"12909","KIAMBU","KIKUYU","96",5,18,23
"12910","KIAMBU","KIKUYU","97",8,17,25
"12911","KIAMBU","KIKUYU","98",2,12,14
"12912","KIAMBU","KIKUYU","99",6,13,19
"12913","KIAMBU","KIKUYU","95-99",32,86,118
"12914","KIAMBU","KIKUYU","100+",8,35,43
"12915","KIAMBU","KIKUYU","Not Stated",NA,2,2
"12916","KIAMBU","LARI","Total",67061,68238,135299
"12917","KIAMBU","LARI","0",1476,1523,2999
"12918","KIAMBU","LARI","1",1463,1428,2891
"12919","KIAMBU","LARI","2",1413,1507,2920
"12920","KIAMBU","LARI","3",1555,1500,3055
"12921","KIAMBU","LARI","4",1508,1496,3004
"12922","KIAMBU","LARI","0 - 4",7415,7454,14869
"12923","KIAMBU","LARI","5",1437,1330,2767
"12924","KIAMBU","LARI","6",1424,1469,2893
"12925","KIAMBU","LARI","7",1496,1451,2947
"12926","KIAMBU","LARI","8",1422,1410,2832
"12927","KIAMBU","LARI","9",1686,1616,3302
"12928","KIAMBU","LARI","5-9",7465,7276,14741
"12929","KIAMBU","LARI","10",1604,1530,3134
"12930","KIAMBU","LARI","11",1454,1499,2953
"12931","KIAMBU","LARI","12",1590,1610,3200
"12932","KIAMBU","LARI","13",1645,1623,3268
"12933","KIAMBU","LARI","14",1632,1585,3217
"12934","KIAMBU","LARI","10 -14",7925,7847,15772
"12935","KIAMBU","LARI","15",1627,1561,3188
"12936","KIAMBU","LARI","16",1556,1497,3053
"12937","KIAMBU","LARI","17",1760,1431,3191
"12938","KIAMBU","LARI","18",1296,1231,2527
"12939","KIAMBU","LARI","19",1397,1235,2632
"12940","KIAMBU","LARI","15-19",7636,6955,14591
"12941","KIAMBU","LARI","20",1239,1218,2457
"12942","KIAMBU","LARI","21",1114,1049,2163
"12943","KIAMBU","LARI","22",1139,1035,2174
"12944","KIAMBU","LARI","23",1192,1137,2329
"12945","KIAMBU","LARI","24",1029,1053,2082
"12946","KIAMBU","LARI","20-24",5713,5492,11205
"12947","KIAMBU","LARI","25",981,990,1971
"12948","KIAMBU","LARI","26",894,918,1812
"12949","KIAMBU","LARI","27",987,908,1895
"12950","KIAMBU","LARI","28",819,853,1672
"12951","KIAMBU","LARI","29",888,968,1856
"12952","KIAMBU","LARI","25-29",4569,4637,9206
"12953","KIAMBU","LARI","30",1087,1141,2228
"12954","KIAMBU","LARI","31",891,825,1716
"12955","KIAMBU","LARI","32",978,1046,2024
"12956","KIAMBU","LARI","33",848,990,1838
"12957","KIAMBU","LARI","34",829,920,1749
"12958","KIAMBU","LARI","30-34",4633,4922,9555
"12959","KIAMBU","LARI","35",1077,1116,2193
"12960","KIAMBU","LARI","36",845,888,1733
"12961","KIAMBU","LARI","37",903,880,1783
"12962","KIAMBU","LARI","38",708,732,1440
"12963","KIAMBU","LARI","39",804,878,1682
"12964","KIAMBU","LARI","35-39",4337,4494,8831
"12965","KIAMBU","LARI","40",838,890,1728
"12966","KIAMBU","LARI","41",918,904,1822
"12967","KIAMBU","LARI","42",813,804,1617
"12968","KIAMBU","LARI","43",687,730,1417
"12969","KIAMBU","LARI","44",636,692,1328
"12970","KIAMBU","LARI","40-44",3892,4020,7912
"12971","KIAMBU","LARI","45",858,1034,1892
"12972","KIAMBU","LARI","46",666,725,1391
"12973","KIAMBU","LARI","47",791,745,1536
"12974","KIAMBU","LARI","48",535,566,1101
"12975","KIAMBU","LARI","49",590,559,1149
"12976","KIAMBU","LARI","45-49",3440,3629,7069
"12977","KIAMBU","LARI","50",632,758,1390
"12978","KIAMBU","LARI","51",534,548,1082
"12979","KIAMBU","LARI","52",597,635,1232
"12980","KIAMBU","LARI","53",459,481,940
"12981","KIAMBU","LARI","54",516,520,1036
"12982","KIAMBU","LARI","50-54",2738,2942,5680
"12983","KIAMBU","LARI","55",529,511,1040
"12984","KIAMBU","LARI","56",543,563,1106
"12985","KIAMBU","LARI","57",413,489,902
"12986","KIAMBU","LARI","58",338,413,751
"12987","KIAMBU","LARI","59",401,411,812
"12988","KIAMBU","LARI","55-59",2224,2387,4611
"12989","KIAMBU","LARI","60",409,432,841
"12990","KIAMBU","LARI","61",326,379,705
"12991","KIAMBU","LARI","62",301,301,602
"12992","KIAMBU","LARI","63",240,244,484
"12993","KIAMBU","LARI","64",203,217,420
"12994","KIAMBU","LARI","60-64",1479,1573,3052
"12995","KIAMBU","LARI","65",306,327,633
"12996","KIAMBU","LARI","66",221,250,471
"12997","KIAMBU","LARI","67",396,371,767
"12998","KIAMBU","LARI","68",159,170,329
"12999","KIAMBU","LARI","69",223,307,530
"13000","KIAMBU","LARI","65-69",1305,1425,2730
"13001","KIAMBU","LARI","70",278,355,633
"13002","KIAMBU","LARI","71",251,253,504
"13003","KIAMBU","LARI","72",238,241,479
"13004","KIAMBU","LARI","73",193,182,375
"13005","KIAMBU","LARI","74",152,181,333
"13006","KIAMBU","LARI","70-74",1112,1212,2324
"13007","KIAMBU","LARI","75",109,197,306
"13008","KIAMBU","LARI","76",144,250,394
"13009","KIAMBU","LARI","77",124,144,268
"13010","KIAMBU","LARI","78",57,86,143
"13011","KIAMBU","LARI","79",89,138,227
"13012","KIAMBU","LARI","75-79",523,815,1338
"13013","KIAMBU","LARI","80",93,187,280
"13014","KIAMBU","LARI","81",60,87,147
"13015","KIAMBU","LARI","82",59,68,127
"13016","KIAMBU","LARI","83",62,96,158
"13017","KIAMBU","LARI","84",63,108,171
"13018","KIAMBU","LARI","80-84",337,546,883
"13019","KIAMBU","LARI","85",47,107,154
"13020","KIAMBU","LARI","86",44,56,100
"13021","KIAMBU","LARI","87",31,55,86
"13022","KIAMBU","LARI","88",31,27,58
"13023","KIAMBU","LARI","89",48,79,127
"13024","KIAMBU","LARI","85-89",201,324,525
"13025","KIAMBU","LARI","90",13,48,61
"13026","KIAMBU","LARI","91",21,42,63
"13027","KIAMBU","LARI","92",16,20,36
"13028","KIAMBU","LARI","93",11,26,37
"13029","KIAMBU","LARI","94",11,22,33
"13030","KIAMBU","LARI","90-94",72,158,230
"13031","KIAMBU","LARI","95",9,24,33
"13032","KIAMBU","LARI","96",6,17,23
"13033","KIAMBU","LARI","97",13,22,35
"13034","KIAMBU","LARI","98",6,7,13
"13035","KIAMBU","LARI","99",5,11,16
"13036","KIAMBU","LARI","95-99",39,81,120
"13037","KIAMBU","LARI","100+",6,49,55
"13038","KIAMBU","LARI","Not Stated",NA,NA,NA
"13039","KIAMBU","LIMURU","Total",79632,79682,159314
"13040","KIAMBU","LIMURU","0",1874,1925,3799
"13041","KIAMBU","LIMURU","1",1878,1754,3632
"13042","KIAMBU","LIMURU","2",1784,1733,3517
"13043","KIAMBU","LIMURU","3",1751,1763,3514
"13044","KIAMBU","LIMURU","4",1628,1742,3370
"13045","KIAMBU","LIMURU","0 - 4",8915,8917,17832
"13046","KIAMBU","LIMURU","5",1744,1623,3367
"13047","KIAMBU","LIMURU","6",1652,1577,3229
"13048","KIAMBU","LIMURU","7",1669,1683,3352
"13049","KIAMBU","LIMURU","8",1626,1570,3196
"13050","KIAMBU","LIMURU","9",1803,1809,3612
"13051","KIAMBU","LIMURU","5-9",8494,8262,16756
"13052","KIAMBU","LIMURU","10",1776,1670,3446
"13053","KIAMBU","LIMURU","11",1620,1573,3193
"13054","KIAMBU","LIMURU","12",1804,1721,3525
"13055","KIAMBU","LIMURU","13",1843,1747,3590
"13056","KIAMBU","LIMURU","14",1611,1704,3315
"13057","KIAMBU","LIMURU","10 -14",8654,8415,17069
"13058","KIAMBU","LIMURU","15",1593,1601,3194
"13059","KIAMBU","LIMURU","16",1546,1589,3135
"13060","KIAMBU","LIMURU","17",1685,1580,3265
"13061","KIAMBU","LIMURU","18",1332,1435,2767
"13062","KIAMBU","LIMURU","19",1530,1522,3052
"13063","KIAMBU","LIMURU","15-19",7686,7727,15413
"13064","KIAMBU","LIMURU","20",1446,1532,2978
"13065","KIAMBU","LIMURU","21",1540,1487,3027
"13066","KIAMBU","LIMURU","22",1516,1604,3120
"13067","KIAMBU","LIMURU","23",1605,1680,3285
"13068","KIAMBU","LIMURU","24",1412,1505,2917
"13069","KIAMBU","LIMURU","20-24",7519,7808,15327
"13070","KIAMBU","LIMURU","25",1480,1422,2902
"13071","KIAMBU","LIMURU","26",1312,1440,2752
"13072","KIAMBU","LIMURU","27",1459,1428,2887
"13073","KIAMBU","LIMURU","28",1191,1241,2432
"13074","KIAMBU","LIMURU","29",1319,1334,2653
"13075","KIAMBU","LIMURU","25-29",6761,6865,13626
"13076","KIAMBU","LIMURU","30",1441,1606,3047
"13077","KIAMBU","LIMURU","31",1174,1204,2378
"13078","KIAMBU","LIMURU","32",1452,1434,2886
"13079","KIAMBU","LIMURU","33",1231,1246,2477
"13080","KIAMBU","LIMURU","34",1163,1188,2351
"13081","KIAMBU","LIMURU","30-34",6461,6678,13139
"13082","KIAMBU","LIMURU","35",1457,1397,2854
"13083","KIAMBU","LIMURU","36",1055,1114,2169
"13084","KIAMBU","LIMURU","37",1096,1031,2127
"13085","KIAMBU","LIMURU","38",995,997,1992
"13086","KIAMBU","LIMURU","39",1082,1099,2181
"13087","KIAMBU","LIMURU","35-39",5685,5638,11323
"13088","KIAMBU","LIMURU","40",1187,1097,2284
"13089","KIAMBU","LIMURU","41",1082,1066,2148
"13090","KIAMBU","LIMURU","42",1020,993,2013
"13091","KIAMBU","LIMURU","43",881,850,1731
"13092","KIAMBU","LIMURU","44",762,703,1465
"13093","KIAMBU","LIMURU","40-44",4932,4709,9641
"13094","KIAMBU","LIMURU","45",1075,924,1999
"13095","KIAMBU","LIMURU","46",924,826,1750
"13096","KIAMBU","LIMURU","47",911,719,1630
"13097","KIAMBU","LIMURU","48",650,570,1220
"13098","KIAMBU","LIMURU","49",744,692,1436
"13099","KIAMBU","LIMURU","45-49",4304,3731,8035
"13100","KIAMBU","LIMURU","50",821,758,1579
"13101","KIAMBU","LIMURU","51",615,542,1157
"13102","KIAMBU","LIMURU","52",703,587,1290
"13103","KIAMBU","LIMURU","53",466,448,914
"13104","KIAMBU","LIMURU","54",580,513,1093
"13105","KIAMBU","LIMURU","50-54",3185,2848,6033
"13106","KIAMBU","LIMURU","55",530,495,1025
"13107","KIAMBU","LIMURU","56",558,560,1118
"13108","KIAMBU","LIMURU","57",468,492,960
"13109","KIAMBU","LIMURU","58",365,365,730
"13110","KIAMBU","LIMURU","59",411,425,836
"13111","KIAMBU","LIMURU","55-59",2332,2337,4669
"13112","KIAMBU","LIMURU","60",435,453,888
"13113","KIAMBU","LIMURU","61",349,338,687
"13114","KIAMBU","LIMURU","62",305,267,572
"13115","KIAMBU","LIMURU","63",259,206,465
"13116","KIAMBU","LIMURU","64",208,211,419
"13117","KIAMBU","LIMURU","60-64",1556,1475,3031
"13118","KIAMBU","LIMURU","65",265,302,567
"13119","KIAMBU","LIMURU","66",193,204,397
"13120","KIAMBU","LIMURU","67",328,335,663
"13121","KIAMBU","LIMURU","68",164,144,308
"13122","KIAMBU","LIMURU","69",248,248,496
"13123","KIAMBU","LIMURU","65-69",1198,1233,2431
"13124","KIAMBU","LIMURU","70",283,350,633
"13125","KIAMBU","LIMURU","71",185,191,376
"13126","KIAMBU","LIMURU","72",232,257,489
"13127","KIAMBU","LIMURU","73",126,170,296
"13128","KIAMBU","LIMURU","74",123,181,304
"13129","KIAMBU","LIMURU","70-74",949,1149,2098
"13130","KIAMBU","LIMURU","75",102,164,266
"13131","KIAMBU","LIMURU","76",118,234,352
"13132","KIAMBU","LIMURU","77",83,120,203
"13133","KIAMBU","LIMURU","78",62,91,153
"13134","KIAMBU","LIMURU","79",60,137,197
"13135","KIAMBU","LIMURU","75-79",425,746,1171
"13136","KIAMBU","LIMURU","80",87,173,260
"13137","KIAMBU","LIMURU","81",67,104,171
"13138","KIAMBU","LIMURU","82",64,65,129
"13139","KIAMBU","LIMURU","83",56,79,135
"13140","KIAMBU","LIMURU","84",25,117,142
"13141","KIAMBU","LIMURU","80-84",299,538,837
"13142","KIAMBU","LIMURU","85",50,98,148
"13143","KIAMBU","LIMURU","86",31,67,98
"13144","KIAMBU","LIMURU","87",37,62,99
"13145","KIAMBU","LIMURU","88",16,42,58
"13146","KIAMBU","LIMURU","89",27,65,92
"13147","KIAMBU","LIMURU","85-89",161,334,495
"13148","KIAMBU","LIMURU","90",21,50,71
"13149","KIAMBU","LIMURU","91",19,39,58
"13150","KIAMBU","LIMURU","92",10,23,33
"13151","KIAMBU","LIMURU","93",9,20,29
"13152","KIAMBU","LIMURU","94",10,20,30
"13153","KIAMBU","LIMURU","90-94",69,152,221
"13154","KIAMBU","LIMURU","95",11,30,41
"13155","KIAMBU","LIMURU","96",9,16,25
"13156","KIAMBU","LIMURU","97",9,17,26
"13157","KIAMBU","LIMURU","98",2,7,9
"13158","KIAMBU","LIMURU","99",6,13,19
"13159","KIAMBU","LIMURU","95-99",37,83,120
"13160","KIAMBU","LIMURU","100+",6,37,43
"13161","KIAMBU","LIMURU","Not Stated",4,NA,4
"13162","KIAMBU","RUIRU","Total",180947,190144,371091
"13163","KIAMBU","RUIRU","0",5102,5008,10110
"13164","KIAMBU","RUIRU","1",4971,4803,9774
"13165","KIAMBU","RUIRU","2",4619,4498,9117
"13166","KIAMBU","RUIRU","3",4362,4451,8813
"13167","KIAMBU","RUIRU","4",4078,3933,8011
"13168","KIAMBU","RUIRU","0 - 4",23132,22693,45825
"13169","KIAMBU","RUIRU","5",3916,3820,7736
"13170","KIAMBU","RUIRU","6",3655,3670,7325
"13171","KIAMBU","RUIRU","7",3663,3708,7371
"13172","KIAMBU","RUIRU","8",3312,3547,6859
"13173","KIAMBU","RUIRU","9",3617,3614,7231
"13174","KIAMBU","RUIRU","5-9",18163,18359,36522
"13175","KIAMBU","RUIRU","10",3405,3367,6772
"13176","KIAMBU","RUIRU","11",2948,3107,6055
"13177","KIAMBU","RUIRU","12",3123,3270,6393
"13178","KIAMBU","RUIRU","13",3070,3247,6317
"13179","KIAMBU","RUIRU","14",2902,2910,5812
"13180","KIAMBU","RUIRU","10 -14",15448,15901,31349
"13181","KIAMBU","RUIRU","15",2635,2852,5487
"13182","KIAMBU","RUIRU","16",2441,2880,5321
"13183","KIAMBU","RUIRU","17",2674,3135,5809
"13184","KIAMBU","RUIRU","18",2305,2972,5277
"13185","KIAMBU","RUIRU","19",2886,4128,7014
"13186","KIAMBU","RUIRU","15-19",12941,15967,28908
"13187","KIAMBU","RUIRU","20",3163,4799,7962
"13188","KIAMBU","RUIRU","21",3652,5091,8743
"13189","KIAMBU","RUIRU","22",4028,5528,9556
"13190","KIAMBU","RUIRU","23",5020,6391,11411
"13191","KIAMBU","RUIRU","24",5088,6119,11207
"13192","KIAMBU","RUIRU","20-24",20951,27928,48879
"13193","KIAMBU","RUIRU","25",5412,5989,11401
"13194","KIAMBU","RUIRU","26",4698,5306,10004
"13195","KIAMBU","RUIRU","27",4846,5188,10034
"13196","KIAMBU","RUIRU","28",4254,4756,9010
"13197","KIAMBU","RUIRU","29",4617,4777,9394
"13198","KIAMBU","RUIRU","25-29",23827,26016,49843
"13199","KIAMBU","RUIRU","30",5335,5739,11074
"13200","KIAMBU","RUIRU","31",3718,3584,7302
"13201","KIAMBU","RUIRU","32",4535,4617,9152
"13202","KIAMBU","RUIRU","33",3544,3789,7333
"13203","KIAMBU","RUIRU","34",3310,3336,6646
"13204","KIAMBU","RUIRU","30-34",20442,21065,41507
"13205","KIAMBU","RUIRU","35",3911,3788,7699
"13206","KIAMBU","RUIRU","36",2897,2982,5879
"13207","KIAMBU","RUIRU","37",2648,2684,5332
"13208","KIAMBU","RUIRU","38",2516,2554,5070
"13209","KIAMBU","RUIRU","39",2462,2470,4932
"13210","KIAMBU","RUIRU","35-39",14434,14478,28912
"13211","KIAMBU","RUIRU","40",2883,2592,5475
"13212","KIAMBU","RUIRU","41",2299,2116,4415
"13213","KIAMBU","RUIRU","42",2232,1975,4207
"13214","KIAMBU","RUIRU","43",1826,1681,3507
"13215","KIAMBU","RUIRU","44",1580,1401,2981
"13216","KIAMBU","RUIRU","40-44",10820,9765,20585
"13217","KIAMBU","RUIRU","45",2234,1817,4051
"13218","KIAMBU","RUIRU","46",1534,1357,2891
"13219","KIAMBU","RUIRU","47",1632,1382,3014
"13220","KIAMBU","RUIRU","48",1168,1093,2261
"13221","KIAMBU","RUIRU","49",1384,1099,2483
"13222","KIAMBU","RUIRU","45-49",7952,6748,14700
"13223","KIAMBU","RUIRU","50",1488,1213,2701
"13224","KIAMBU","RUIRU","51",1030,817,1847
"13225","KIAMBU","RUIRU","52",1146,911,2057
"13226","KIAMBU","RUIRU","53",732,643,1375
"13227","KIAMBU","RUIRU","54",865,724,1589
"13228","KIAMBU","RUIRU","50-54",5261,4308,9569
"13229","KIAMBU","RUIRU","55",857,670,1527
"13230","KIAMBU","RUIRU","56",835,670,1505
"13231","KIAMBU","RUIRU","57",697,618,1315
"13232","KIAMBU","RUIRU","58",553,463,1016
"13233","KIAMBU","RUIRU","59",573,481,1054
"13234","KIAMBU","RUIRU","55-59",3515,2902,6417
"13235","KIAMBU","RUIRU","60",601,524,1125
"13236","KIAMBU","RUIRU","61",418,338,756
"13237","KIAMBU","RUIRU","62",378,287,665
"13238","KIAMBU","RUIRU","63",303,250,553
"13239","KIAMBU","RUIRU","64",223,185,408
"13240","KIAMBU","RUIRU","60-64",1923,1584,3507
"13241","KIAMBU","RUIRU","65",302,264,566
"13242","KIAMBU","RUIRU","66",203,183,386
"13243","KIAMBU","RUIRU","67",287,276,563
"13244","KIAMBU","RUIRU","68",145,119,264
"13245","KIAMBU","RUIRU","69",163,160,323
"13246","KIAMBU","RUIRU","65-69",1100,1002,2102
"13247","KIAMBU","RUIRU","70",194,211,405
"13248","KIAMBU","RUIRU","71",124,128,252
"13249","KIAMBU","RUIRU","72",119,113,232
"13250","KIAMBU","RUIRU","73",89,78,167
"13251","KIAMBU","RUIRU","74",97,74,171
"13252","KIAMBU","RUIRU","70-74",623,604,1227
"13253","KIAMBU","RUIRU","75",68,91,159
"13254","KIAMBU","RUIRU","76",45,96,141
"13255","KIAMBU","RUIRU","77",35,59,94
"13256","KIAMBU","RUIRU","78",34,36,70
"13257","KIAMBU","RUIRU","79",31,59,90
"13258","KIAMBU","RUIRU","75-79",213,341,554
"13259","KIAMBU","RUIRU","80",31,64,95
"13260","KIAMBU","RUIRU","81",14,45,59
"13261","KIAMBU","RUIRU","82",16,21,37
"13262","KIAMBU","RUIRU","83",18,38,56
"13263","KIAMBU","RUIRU","84",22,29,51
"13264","KIAMBU","RUIRU","80-84",101,197,298
"13265","KIAMBU","RUIRU","85",10,43,53
"13266","KIAMBU","RUIRU","86",10,30,40
"13267","KIAMBU","RUIRU","87",17,29,46
"13268","KIAMBU","RUIRU","88",5,11,16
"13269","KIAMBU","RUIRU","89",17,28,45
"13270","KIAMBU","RUIRU","85-89",59,141,200
"13271","KIAMBU","RUIRU","90",5,24,29
"13272","KIAMBU","RUIRU","91",6,15,21
"13273","KIAMBU","RUIRU","92",NA,8,8
"13274","KIAMBU","RUIRU","93",7,8,15
"13275","KIAMBU","RUIRU","94",2,11,13
"13276","KIAMBU","RUIRU","90-94",20,66,86
"13277","KIAMBU","RUIRU","95",3,15,18
"13278","KIAMBU","RUIRU","96",2,11,13
"13279","KIAMBU","RUIRU","97",4,11,15
"13280","KIAMBU","RUIRU","98",1,8,9
"13281","KIAMBU","RUIRU","99",1,9,10
"13282","KIAMBU","RUIRU","95-99",11,54,65
"13283","KIAMBU","RUIRU","100+",6,24,30
"13284","KIAMBU","RUIRU","Not Stated",5,1,6
"13285","KIAMBU","THIKA EAST","Total",19688,19264,38952
"13286","KIAMBU","THIKA EAST","0",428,443,871
"13287","KIAMBU","THIKA EAST","1",481,439,920
"13288","KIAMBU","THIKA EAST","2",432,390,822
"13289","KIAMBU","THIKA EAST","3",421,450,871
"13290","KIAMBU","THIKA EAST","4",424,447,871
"13291","KIAMBU","THIKA EAST","0 - 4",2186,2169,4355
"13292","KIAMBU","THIKA EAST","5",425,402,827
"13293","KIAMBU","THIKA EAST","6",392,403,795
"13294","KIAMBU","THIKA EAST","7",409,422,831
"13295","KIAMBU","THIKA EAST","8",380,408,788
"13296","KIAMBU","THIKA EAST","9",449,455,904
"13297","KIAMBU","THIKA EAST","5-9",2055,2090,4145
"13298","KIAMBU","THIKA EAST","10",402,449,851
"13299","KIAMBU","THIKA EAST","11",386,412,798
"13300","KIAMBU","THIKA EAST","12",482,412,894
"13301","KIAMBU","THIKA EAST","13",430,451,881
"13302","KIAMBU","THIKA EAST","14",429,409,838
"13303","KIAMBU","THIKA EAST","10 -14",2129,2133,4262
"13304","KIAMBU","THIKA EAST","15",422,431,853
"13305","KIAMBU","THIKA EAST","16",399,415,814
"13306","KIAMBU","THIKA EAST","17",414,404,818
"13307","KIAMBU","THIKA EAST","18",313,341,654
"13308","KIAMBU","THIKA EAST","19",350,339,689
"13309","KIAMBU","THIKA EAST","15-19",1898,1930,3828
"13310","KIAMBU","THIKA EAST","20",324,382,706
"13311","KIAMBU","THIKA EAST","21",359,325,684
"13312","KIAMBU","THIKA EAST","22",373,355,728
"13313","KIAMBU","THIKA EAST","23",433,420,853
"13314","KIAMBU","THIKA EAST","24",413,359,772
"13315","KIAMBU","THIKA EAST","20-24",1902,1841,3743
"13316","KIAMBU","THIKA EAST","25",362,336,698
"13317","KIAMBU","THIKA EAST","26",352,308,660
"13318","KIAMBU","THIKA EAST","27",343,320,663
"13319","KIAMBU","THIKA EAST","28",272,287,559
"13320","KIAMBU","THIKA EAST","29",375,332,707
"13321","KIAMBU","THIKA EAST","25-29",1704,1583,3287
"13322","KIAMBU","THIKA EAST","30",405,371,776
"13323","KIAMBU","THIKA EAST","31",279,280,559
"13324","KIAMBU","THIKA EAST","32",386,349,735
"13325","KIAMBU","THIKA EAST","33",296,297,593
"13326","KIAMBU","THIKA EAST","34",288,266,554
"13327","KIAMBU","THIKA EAST","30-34",1654,1563,3217
"13328","KIAMBU","THIKA EAST","35",314,323,637
"13329","KIAMBU","THIKA EAST","36",261,279,540
"13330","KIAMBU","THIKA EAST","37",275,266,541
"13331","KIAMBU","THIKA EAST","38",225,216,441
"13332","KIAMBU","THIKA EAST","39",239,223,462
"13333","KIAMBU","THIKA EAST","35-39",1314,1307,2621
"13334","KIAMBU","THIKA EAST","40",322,280,602
"13335","KIAMBU","THIKA EAST","41",264,248,512
"13336","KIAMBU","THIKA EAST","42",257,204,461
"13337","KIAMBU","THIKA EAST","43",244,205,449
"13338","KIAMBU","THIKA EAST","44",207,171,378
"13339","KIAMBU","THIKA EAST","40-44",1294,1108,2402
"13340","KIAMBU","THIKA EAST","45",277,239,516
"13341","KIAMBU","THIKA EAST","46",205,193,398
"13342","KIAMBU","THIKA EAST","47",212,174,386
"13343","KIAMBU","THIKA EAST","48",160,115,275
"13344","KIAMBU","THIKA EAST","49",179,189,368
"13345","KIAMBU","THIKA EAST","45-49",1033,910,1943
"13346","KIAMBU","THIKA EAST","50",167,188,355
"13347","KIAMBU","THIKA EAST","51",174,158,332
"13348","KIAMBU","THIKA EAST","52",164,156,320
"13349","KIAMBU","THIKA EAST","53",120,116,236
"13350","KIAMBU","THIKA EAST","54",138,138,276
"13351","KIAMBU","THIKA EAST","50-54",763,756,1519
"13352","KIAMBU","THIKA EAST","55",145,107,252
"13353","KIAMBU","THIKA EAST","56",182,138,320
"13354","KIAMBU","THIKA EAST","57",113,125,238
"13355","KIAMBU","THIKA EAST","58",98,91,189
"13356","KIAMBU","THIKA EAST","59",110,103,213
"13357","KIAMBU","THIKA EAST","55-59",648,564,1212
"13358","KIAMBU","THIKA EAST","60",119,113,232
"13359","KIAMBU","THIKA EAST","61",67,78,145
"13360","KIAMBU","THIKA EAST","62",71,71,142
"13361","KIAMBU","THIKA EAST","63",81,76,157
"13362","KIAMBU","THIKA EAST","64",44,53,97
"13363","KIAMBU","THIKA EAST","60-64",382,391,773
"13364","KIAMBU","THIKA EAST","65",71,72,143
"13365","KIAMBU","THIKA EAST","66",42,51,93
"13366","KIAMBU","THIKA EAST","67",83,90,173
"13367","KIAMBU","THIKA EAST","68",42,24,66
"13368","KIAMBU","THIKA EAST","69",42,51,93
"13369","KIAMBU","THIKA EAST","65-69",280,288,568
"13370","KIAMBU","THIKA EAST","70",55,57,112
"13371","KIAMBU","THIKA EAST","71",48,50,98
"13372","KIAMBU","THIKA EAST","72",48,30,78
"13373","KIAMBU","THIKA EAST","73",29,42,71
"13374","KIAMBU","THIKA EAST","74",42,40,82
"13375","KIAMBU","THIKA EAST","70-74",222,219,441
"13376","KIAMBU","THIKA EAST","75",26,32,58
"13377","KIAMBU","THIKA EAST","76",22,64,86
"13378","KIAMBU","THIKA EAST","77",23,27,50
"13379","KIAMBU","THIKA EAST","78",14,13,27
"13380","KIAMBU","THIKA EAST","79",14,32,46
"13381","KIAMBU","THIKA EAST","75-79",99,168,267
"13382","KIAMBU","THIKA EAST","80",23,28,51
"13383","KIAMBU","THIKA EAST","81",11,24,35
"13384","KIAMBU","THIKA EAST","82",8,15,23
"13385","KIAMBU","THIKA EAST","83",5,16,21
"13386","KIAMBU","THIKA EAST","84",10,17,27
"13387","KIAMBU","THIKA EAST","80-84",57,100,157
"13388","KIAMBU","THIKA EAST","85",8,10,18
"13389","KIAMBU","THIKA EAST","86",7,21,28
"13390","KIAMBU","THIKA EAST","87",8,14,22
"13391","KIAMBU","THIKA EAST","88",3,8,11
"13392","KIAMBU","THIKA EAST","89",4,14,18
"13393","KIAMBU","THIKA EAST","85-89",30,67,97
"13394","KIAMBU","THIKA EAST","90",3,21,24
"13395","KIAMBU","THIKA EAST","91",10,8,18
"13396","KIAMBU","THIKA EAST","92",1,4,5
"13397","KIAMBU","THIKA EAST","93",5,4,9
"13398","KIAMBU","THIKA EAST","94",2,2,4
"13399","KIAMBU","THIKA EAST","90-94",21,39,60
"13400","KIAMBU","THIKA EAST","95",5,3,8
"13401","KIAMBU","THIKA EAST","96",1,7,8
"13402","KIAMBU","THIKA EAST","97",1,5,6
"13403","KIAMBU","THIKA EAST","98",1,5,6
"13404","KIAMBU","THIKA EAST","99",3,4,7
"13405","KIAMBU","THIKA EAST","95-99",11,24,35
"13406","KIAMBU","THIKA EAST","100+",6,13,19
"13407","KIAMBU","THIKA EAST","Not Stated",NA,1,1
"13408","KIAMBU","THIKA WEST","Total",120698,125104,245802
"13409","KIAMBU","THIKA WEST","0",3196,3217,6413
"13410","KIAMBU","THIKA WEST","1",3118,2951,6069
"13411","KIAMBU","THIKA WEST","2",2899,2889,5788
"13412","KIAMBU","THIKA WEST","3",2945,2866,5811
"13413","KIAMBU","THIKA WEST","4",2675,2539,5214
"13414","KIAMBU","THIKA WEST","0 - 4",14833,14462,29295
"13415","KIAMBU","THIKA WEST","5",2469,2410,4879
"13416","KIAMBU","THIKA WEST","6",2351,2338,4689
"13417","KIAMBU","THIKA WEST","7",2280,2365,4645
"13418","KIAMBU","THIKA WEST","8",2211,2149,4360
"13419","KIAMBU","THIKA WEST","9",2343,2293,4636
"13420","KIAMBU","THIKA WEST","5-9",11654,11555,23209
"13421","KIAMBU","THIKA WEST","10",2182,2239,4421
"13422","KIAMBU","THIKA WEST","11",1987,2047,4034
"13423","KIAMBU","THIKA WEST","12",2036,2072,4108
"13424","KIAMBU","THIKA WEST","13",1926,2049,3975
"13425","KIAMBU","THIKA WEST","14",1828,1924,3752
"13426","KIAMBU","THIKA WEST","10 -14",9959,10331,20290
"13427","KIAMBU","THIKA WEST","15",1716,1855,3571
"13428","KIAMBU","THIKA WEST","16",1648,1914,3562
"13429","KIAMBU","THIKA WEST","17",1745,2066,3811
"13430","KIAMBU","THIKA WEST","18",1755,2303,4058
"13431","KIAMBU","THIKA WEST","19",2450,3168,5618
"13432","KIAMBU","THIKA WEST","15-19",9314,11306,20620
"13433","KIAMBU","THIKA WEST","20",2823,3709,6532
"13434","KIAMBU","THIKA WEST","21",3201,3768,6969
"13435","KIAMBU","THIKA WEST","22",3301,3863,7164
"13436","KIAMBU","THIKA WEST","23",3380,4027,7407
"13437","KIAMBU","THIKA WEST","24",3327,3710,7037
"13438","KIAMBU","THIKA WEST","20-24",16032,19077,35109
"13439","KIAMBU","THIKA WEST","25",3296,3503,6799
"13440","KIAMBU","THIKA WEST","26",2934,3234,6168
"13441","KIAMBU","THIKA WEST","27",3011,3171,6182
"13442","KIAMBU","THIKA WEST","28",2599,2846,5445
"13443","KIAMBU","THIKA WEST","29",2932,3007,5939
"13444","KIAMBU","THIKA WEST","25-29",14772,15761,30533
"13445","KIAMBU","THIKA WEST","30",3299,3488,6787
"13446","KIAMBU","THIKA WEST","31",2265,2375,4640
"13447","KIAMBU","THIKA WEST","32",2879,2938,5817
"13448","KIAMBU","THIKA WEST","33",2270,2384,4654
"13449","KIAMBU","THIKA WEST","34",2109,2143,4252
"13450","KIAMBU","THIKA WEST","30-34",12822,13328,26150
"13451","KIAMBU","THIKA WEST","35",2619,2427,5046
"13452","KIAMBU","THIKA WEST","36",1808,1907,3715
"13453","KIAMBU","THIKA WEST","37",1733,1803,3536
"13454","KIAMBU","THIKA WEST","38",1681,1659,3340
"13455","KIAMBU","THIKA WEST","39",1653,1543,3196
"13456","KIAMBU","THIKA WEST","35-39",9494,9339,18833
"13457","KIAMBU","THIKA WEST","40",1907,1711,3618
"13458","KIAMBU","THIKA WEST","41",1432,1420,2852
"13459","KIAMBU","THIKA WEST","42",1451,1343,2794
"13460","KIAMBU","THIKA WEST","43",1270,1153,2423
"13461","KIAMBU","THIKA WEST","44",1031,968,1999
"13462","KIAMBU","THIKA WEST","40-44",7091,6595,13686
"13463","KIAMBU","THIKA WEST","45",1460,1242,2702
"13464","KIAMBU","THIKA WEST","46",1037,936,1973
"13465","KIAMBU","THIKA WEST","47",1091,918,2009
"13466","KIAMBU","THIKA WEST","48",772,750,1522
"13467","KIAMBU","THIKA WEST","49",878,782,1660
"13468","KIAMBU","THIKA WEST","45-49",5238,4628,9866
"13469","KIAMBU","THIKA WEST","50",953,889,1842
"13470","KIAMBU","THIKA WEST","51",748,580,1328
"13471","KIAMBU","THIKA WEST","52",805,712,1517
"13472","KIAMBU","THIKA WEST","53",543,499,1042
"13473","KIAMBU","THIKA WEST","54",603,531,1134
"13474","KIAMBU","THIKA WEST","50-54",3652,3211,6863
"13475","KIAMBU","THIKA WEST","55",652,522,1174
"13476","KIAMBU","THIKA WEST","56",644,523,1167
"13477","KIAMBU","THIKA WEST","57",491,481,972
"13478","KIAMBU","THIKA WEST","58",417,376,793
"13479","KIAMBU","THIKA WEST","59",445,395,840
"13480","KIAMBU","THIKA WEST","55-59",2649,2297,4946
"13481","KIAMBU","THIKA WEST","60",445,429,874
"13482","KIAMBU","THIKA WEST","61",336,273,609
"13483","KIAMBU","THIKA WEST","62",308,253,561
"13484","KIAMBU","THIKA WEST","63",234,216,450
"13485","KIAMBU","THIKA WEST","64",171,148,319
"13486","KIAMBU","THIKA WEST","60-64",1494,1319,2813
"13487","KIAMBU","THIKA WEST","65",235,209,444
"13488","KIAMBU","THIKA WEST","66",141,134,275
"13489","KIAMBU","THIKA WEST","67",229,189,418
"13490","KIAMBU","THIKA WEST","68",117,81,198
"13491","KIAMBU","THIKA WEST","69",141,127,268
"13492","KIAMBU","THIKA WEST","65-69",863,740,1603
"13493","KIAMBU","THIKA WEST","70",154,181,335
"13494","KIAMBU","THIKA WEST","71",106,95,201
"13495","KIAMBU","THIKA WEST","72",99,65,164
"13496","KIAMBU","THIKA WEST","73",66,76,142
"13497","KIAMBU","THIKA WEST","74",77,68,145
"13498","KIAMBU","THIKA WEST","70-74",502,485,987
"13499","KIAMBU","THIKA WEST","75",50,66,116
"13500","KIAMBU","THIKA WEST","76",48,69,117
"13501","KIAMBU","THIKA WEST","77",33,44,77
"13502","KIAMBU","THIKA WEST","78",24,37,61
"13503","KIAMBU","THIKA WEST","79",21,41,62
"13504","KIAMBU","THIKA WEST","75-79",176,257,433
"13505","KIAMBU","THIKA WEST","80",25,59,84
"13506","KIAMBU","THIKA WEST","81",17,40,57
"13507","KIAMBU","THIKA WEST","82",22,24,46
"13508","KIAMBU","THIKA WEST","83",13,25,38
"13509","KIAMBU","THIKA WEST","84",11,24,35
"13510","KIAMBU","THIKA WEST","80-84",88,172,260
"13511","KIAMBU","THIKA WEST","85",10,34,44
"13512","KIAMBU","THIKA WEST","86",6,23,29
"13513","KIAMBU","THIKA WEST","87",11,20,31
"13514","KIAMBU","THIKA WEST","88",2,11,13
"13515","KIAMBU","THIKA WEST","89",9,31,40
"13516","KIAMBU","THIKA WEST","85-89",38,119,157
"13517","KIAMBU","THIKA WEST","90",8,25,33
"13518","KIAMBU","THIKA WEST","91",7,10,17
"13519","KIAMBU","THIKA WEST","92",2,4,6
"13520","KIAMBU","THIKA WEST","93",1,4,5
"13521","KIAMBU","THIKA WEST","94",NA,13,13
"13522","KIAMBU","THIKA WEST","90-94",18,56,74
"13523","KIAMBU","THIKA WEST","95",NA,12,12
"13524","KIAMBU","THIKA WEST","96",NA,6,6
"13525","KIAMBU","THIKA WEST","97",1,5,6
"13526","KIAMBU","THIKA WEST","98",1,6,7
"13527","KIAMBU","THIKA WEST","99",1,9,10
"13528","KIAMBU","THIKA WEST","95-99",3,38,41
"13529","KIAMBU","THIKA WEST","100+",3,24,27
"13530","KIAMBU","THIKA WEST","Not Stated",3,4,7
"13531","KILIFI","ALL","Total",704089,749673,1453762
"13532","KILIFI","ALL","0",18963,18919,37882
"13533","KILIFI","ALL","1",19960,19550,39510
"13534","KILIFI","ALL","2",20266,20012,40278
"13535","KILIFI","ALL","3",20444,20564,41008
"13536","KILIFI","ALL","4",21286,20867,42153
"13537","KILIFI","ALL","0 - 4",100919,99912,200831
"13538","KILIFI","ALL","5",21905,21615,43520
"13539","KILIFI","ALL","6",20986,20916,41902
"13540","KILIFI","ALL","7",20268,19563,39831
"13541","KILIFI","ALL","8",19994,19962,39956
"13542","KILIFI","ALL","9",20574,20402,40976
"13543","KILIFI","ALL","5-9",103727,102458,206185
"13544","KILIFI","ALL","10",21539,21194,42733
"13545","KILIFI","ALL","11",20129,20468,40597
"13546","KILIFI","ALL","12",21370,20847,42217
"13547","KILIFI","ALL","13",21119,21465,42584
"13548","KILIFI","ALL","14",19422,19219,38641
"13549","KILIFI","ALL","10 -14",103579,103193,206772
"13550","KILIFI","ALL","15",18877,18499,37376
"13551","KILIFI","ALL","16",17635,17708,35343
"13552","KILIFI","ALL","17",18177,17238,35415
"13553","KILIFI","ALL","18",15946,15246,31192
"13554","KILIFI","ALL","19",16630,16394,33024
"13555","KILIFI","ALL","15-19",87265,85085,172350
"13556","KILIFI","ALL","20",15251,16538,31789
"13557","KILIFI","ALL","21",12345,13391,25736
"13558","KILIFI","ALL","22",12528,14313,26841
"13559","KILIFI","ALL","23",12458,14519,26977
"13560","KILIFI","ALL","24",11105,12943,24048
"13561","KILIFI","ALL","20-24",63687,71704,135391
"13562","KILIFI","ALL","25",12505,13929,26434
"13563","KILIFI","ALL","26",10755,12754,23509
"13564","KILIFI","ALL","27",10502,12142,22644
"13565","KILIFI","ALL","28",8783,10932,19715
"13566","KILIFI","ALL","29",8790,10768,19558
"13567","KILIFI","ALL","25-29",51335,60525,111860
"13568","KILIFI","ALL","30",10807,13585,24392
"13569","KILIFI","ALL","31",7432,9691,17123
"13570","KILIFI","ALL","32",8964,11785,20749
"13571","KILIFI","ALL","33",7285,9771,17056
"13572","KILIFI","ALL","34",7089,9553,16642
"13573","KILIFI","ALL","30-34",41577,54385,95962
"13574","KILIFI","ALL","35",8945,9939,18884
"13575","KILIFI","ALL","36",6098,6647,12745
"13576","KILIFI","ALL","37",6239,6002,12241
"13577","KILIFI","ALL","38",4594,4711,9305
"13578","KILIFI","ALL","39",5150,4888,10038
"13579","KILIFI","ALL","35-39",31026,32187,63213
"13580","KILIFI","ALL","40",6678,6386,13064
"13581","KILIFI","ALL","41",6921,8336,15257
"13582","KILIFI","ALL","42",6150,7849,13999
"13583","KILIFI","ALL","43",4953,6421,11374
"13584","KILIFI","ALL","44",4544,4868,9412
"13585","KILIFI","ALL","40-44",29246,33860,63106
"13586","KILIFI","ALL","45",7011,6815,13826
"13587","KILIFI","ALL","46",4423,4432,8855
"13588","KILIFI","ALL","47",4951,4506,9457
"13589","KILIFI","ALL","48",3595,3245,6840
"13590","KILIFI","ALL","49",3928,3600,7528
"13591","KILIFI","ALL","45-49",23908,22598,46506
"13592","KILIFI","ALL","50",5451,6602,12053
"13593","KILIFI","ALL","51",3829,4140,7969
"13594","KILIFI","ALL","52",3266,3366,6632
"13595","KILIFI","ALL","53",2482,2027,4509
"13596","KILIFI","ALL","54",2781,2097,4878
"13597","KILIFI","ALL","50-54",17809,18232,36041
"13598","KILIFI","ALL","55",2705,1969,4674
"13599","KILIFI","ALL","56",3326,3046,6372
"13600","KILIFI","ALL","57",3048,3320,6368
"13601","KILIFI","ALL","58",2504,2772,5276
"13602","KILIFI","ALL","59",2747,4609,7356
"13603","KILIFI","ALL","55-59",14330,15716,30046
"13604","KILIFI","ALL","60",3207,5481,8688
"13605","KILIFI","ALL","61",2270,3754,6024
"13606","KILIFI","ALL","62",2161,2954,5115
"13607","KILIFI","ALL","63",2215,3455,5670
"13608","KILIFI","ALL","64",1859,2238,4097
"13609","KILIFI","ALL","60-64",11712,17882,29594
"13610","KILIFI","ALL","65",2701,3381,6082
"13611","KILIFI","ALL","66",1800,1567,3367
"13612","KILIFI","ALL","67",2334,2261,4595
"13613","KILIFI","ALL","68",1258,1224,2482
"13614","KILIFI","ALL","69",1807,3002,4809
"13615","KILIFI","ALL","65-69",9900,11435,21335
"13616","KILIFI","ALL","70",1985,3464,5449
"13617","KILIFI","ALL","71",1392,1791,3183
"13618","KILIFI","ALL","72",1052,1128,2180
"13619","KILIFI","ALL","73",950,1099,2049
"13620","KILIFI","ALL","74",1062,1378,2440
"13621","KILIFI","ALL","70-74",6441,8860,15301
"13622","KILIFI","ALL","75",1102,1631,2733
"13623","KILIFI","ALL","76",639,754,1393
"13624","KILIFI","ALL","77",737,821,1558
"13625","KILIFI","ALL","78",478,451,929
"13626","KILIFI","ALL","79",770,1343,2113
"13627","KILIFI","ALL","75-79",3726,5000,8726
"13628","KILIFI","ALL","80",693,1414,2107
"13629","KILIFI","ALL","81",377,604,981
"13630","KILIFI","ALL","82",291,374,665
"13631","KILIFI","ALL","83",317,450,767
"13632","KILIFI","ALL","84",321,495,816
"13633","KILIFI","ALL","80-84",1999,3337,5336
"13634","KILIFI","ALL","85",291,528,819
"13635","KILIFI","ALL","86",147,191,338
"13636","KILIFI","ALL","87",245,403,648
"13637","KILIFI","ALL","88",116,139,255
"13638","KILIFI","ALL","89",325,617,942
"13639","KILIFI","ALL","85-89",1124,1878,3002
"13640","KILIFI","ALL","90",149,338,487
"13641","KILIFI","ALL","91",100,148,248
"13642","KILIFI","ALL","92",49,91,140
"13643","KILIFI","ALL","93",50,86,136
"13644","KILIFI","ALL","94",58,89,147
"13645","KILIFI","ALL","90-94",406,752,1158
"13646","KILIFI","ALL","95",68,139,207
"13647","KILIFI","ALL","96",32,49,81
"13648","KILIFI","ALL","97",44,39,83
"13649","KILIFI","ALL","98",35,49,84
"13650","KILIFI","ALL","99",70,142,212
"13651","KILIFI","ALL","95-99",249,418,667
"13652","KILIFI","ALL","100+",118,245,363
"13653","KILIFI","ALL","Not Stated",6,11,17
"13654","KILIFI","CHONYI","Total",29527,32807,62334
"13655","KILIFI","CHONYI","0",847,851,1698
"13656","KILIFI","CHONYI","1",816,795,1611
"13657","KILIFI","CHONYI","2",937,826,1763
"13658","KILIFI","CHONYI","3",900,918,1818
"13659","KILIFI","CHONYI","4",929,883,1812
"13660","KILIFI","CHONYI","0 - 4",4429,4273,8702
"13661","KILIFI","CHONYI","5",1030,999,2029
"13662","KILIFI","CHONYI","6",999,962,1961
"13663","KILIFI","CHONYI","7",993,891,1884
"13664","KILIFI","CHONYI","8",971,996,1967
"13665","KILIFI","CHONYI","9",972,970,1942
"13666","KILIFI","CHONYI","5-9",4965,4818,9783
"13667","KILIFI","CHONYI","10",1078,1018,2096
"13668","KILIFI","CHONYI","11",967,958,1925
"13669","KILIFI","CHONYI","12",1025,990,2015
"13670","KILIFI","CHONYI","13",1007,1001,2008
"13671","KILIFI","CHONYI","14",943,933,1876
"13672","KILIFI","CHONYI","10 -14",5020,4900,9920
"13673","KILIFI","CHONYI","15",886,909,1795
"13674","KILIFI","CHONYI","16",887,864,1751
"13675","KILIFI","CHONYI","17",900,818,1718
"13676","KILIFI","CHONYI","18",779,689,1468
"13677","KILIFI","CHONYI","19",750,744,1494
"13678","KILIFI","CHONYI","15-19",4202,4024,8226
"13679","KILIFI","CHONYI","20",673,686,1359
"13680","KILIFI","CHONYI","21",515,506,1021
"13681","KILIFI","CHONYI","22",443,468,911
"13682","KILIFI","CHONYI","23",412,514,926
"13683","KILIFI","CHONYI","24",372,429,801
"13684","KILIFI","CHONYI","20-24",2415,2603,5018
"13685","KILIFI","CHONYI","25",399,422,821
"13686","KILIFI","CHONYI","26",310,423,733
"13687","KILIFI","CHONYI","27",273,375,648
"13688","KILIFI","CHONYI","28",245,354,599
"13689","KILIFI","CHONYI","29",211,305,516
"13690","KILIFI","CHONYI","25-29",1438,1879,3317
"13691","KILIFI","CHONYI","30",276,458,734
"13692","KILIFI","CHONYI","31",196,330,526
"13693","KILIFI","CHONYI","32",248,459,707
"13694","KILIFI","CHONYI","33",186,379,565
"13695","KILIFI","CHONYI","34",195,353,548
"13696","KILIFI","CHONYI","30-34",1101,1979,3080
"13697","KILIFI","CHONYI","35",243,358,601
"13698","KILIFI","CHONYI","36",171,209,380
"13699","KILIFI","CHONYI","37",165,203,368
"13700","KILIFI","CHONYI","38",112,148,260
"13701","KILIFI","CHONYI","39",141,132,273
"13702","KILIFI","CHONYI","35-39",832,1050,1882
"13703","KILIFI","CHONYI","40",186,260,446
"13704","KILIFI","CHONYI","41",220,323,543
"13705","KILIFI","CHONYI","42",202,361,563
"13706","KILIFI","CHONYI","43",150,280,430
"13707","KILIFI","CHONYI","44",145,212,357
"13708","KILIFI","CHONYI","40-44",903,1436,2339
"13709","KILIFI","CHONYI","45",240,261,501
"13710","KILIFI","CHONYI","46",145,180,325
"13711","KILIFI","CHONYI","47",169,193,362
"13712","KILIFI","CHONYI","48",127,126,253
"13713","KILIFI","CHONYI","49",138,147,285
"13714","KILIFI","CHONYI","45-49",819,907,1726
"13715","KILIFI","CHONYI","50",207,395,602
"13716","KILIFI","CHONYI","51",180,261,441
"13717","KILIFI","CHONYI","52",147,197,344
"13718","KILIFI","CHONYI","53",100,86,186
"13719","KILIFI","CHONYI","54",103,75,178
"13720","KILIFI","CHONYI","50-54",737,1014,1751
"13721","KILIFI","CHONYI","55",145,93,238
"13722","KILIFI","CHONYI","56",172,180,352
"13723","KILIFI","CHONYI","57",132,151,283
"13724","KILIFI","CHONYI","58",109,137,246
"13725","KILIFI","CHONYI","59",124,236,360
"13726","KILIFI","CHONYI","55-59",682,797,1479
"13727","KILIFI","CHONYI","60",169,387,556
"13728","KILIFI","CHONYI","61",86,195,281
"13729","KILIFI","CHONYI","62",99,155,254
"13730","KILIFI","CHONYI","63",141,189,330
"13731","KILIFI","CHONYI","64",124,133,257
"13732","KILIFI","CHONYI","60-64",619,1059,1678
"13733","KILIFI","CHONYI","65",143,215,358
"13734","KILIFI","CHONYI","66",115,96,211
"13735","KILIFI","CHONYI","67",130,121,251
"13736","KILIFI","CHONYI","68",68,79,147
"13737","KILIFI","CHONYI","69",93,183,276
"13738","KILIFI","CHONYI","65-69",549,694,1243
"13739","KILIFI","CHONYI","70",118,243,361
"13740","KILIFI","CHONYI","71",63,96,159
"13741","KILIFI","CHONYI","72",78,74,152
"13742","KILIFI","CHONYI","73",59,66,125
"13743","KILIFI","CHONYI","74",71,101,172
"13744","KILIFI","CHONYI","70-74",389,580,969
"13745","KILIFI","CHONYI","75",72,138,210
"13746","KILIFI","CHONYI","76",29,59,88
"13747","KILIFI","CHONYI","77",61,51,112
"13748","KILIFI","CHONYI","78",23,31,54
"13749","KILIFI","CHONYI","79",35,86,121
"13750","KILIFI","CHONYI","75-79",220,365,585
"13751","KILIFI","CHONYI","80",42,116,158
"13752","KILIFI","CHONYI","81",22,49,71
"13753","KILIFI","CHONYI","82",15,23,38
"13754","KILIFI","CHONYI","83",20,21,41
"13755","KILIFI","CHONYI","84",19,37,56
"13756","KILIFI","CHONYI","80-84",118,246,364
"13757","KILIFI","CHONYI","85",15,34,49
"13758","KILIFI","CHONYI","86",8,14,22
"13759","KILIFI","CHONYI","87",14,15,29
"13760","KILIFI","CHONYI","88",6,5,11
"13761","KILIFI","CHONYI","89",13,34,47
"13762","KILIFI","CHONYI","85-89",56,102,158
"13763","KILIFI","CHONYI","90",10,24,34
"13764","KILIFI","CHONYI","91",3,6,9
"13765","KILIFI","CHONYI","92",1,3,4
"13766","KILIFI","CHONYI","93",2,6,8
"13767","KILIFI","CHONYI","94",2,8,10
"13768","KILIFI","CHONYI","90-94",18,47,65
"13769","KILIFI","CHONYI","95",2,8,10
"13770","KILIFI","CHONYI","96",3,7,10
"13771","KILIFI","CHONYI","97",2,3,5
"13772","KILIFI","CHONYI","98",2,NA,2
"13773","KILIFI","CHONYI","99",1,9,10
"13774","KILIFI","CHONYI","95-99",10,27,37
"13775","KILIFI","CHONYI","100+",5,7,12
"13776","KILIFI","CHONYI","Not Stated",NA,NA,NA
"13777","KILIFI","GANZE","Total",66921,76981,143902
"13778","KILIFI","GANZE","0",2003,1971,3974
"13779","KILIFI","GANZE","1",2043,2063,4106
"13780","KILIFI","GANZE","2",2151,2272,4423
"13781","KILIFI","GANZE","3",2306,2249,4555
"13782","KILIFI","GANZE","4",2442,2343,4785
"13783","KILIFI","GANZE","0 - 4",10945,10898,21843
"13784","KILIFI","GANZE","5",2461,2550,5011
"13785","KILIFI","GANZE","6",2425,2334,4759
"13786","KILIFI","GANZE","7",2216,2074,4290
"13787","KILIFI","GANZE","8",2377,2314,4691
"13788","KILIFI","GANZE","9",2293,2415,4708
"13789","KILIFI","GANZE","5-9",11772,11687,23459
"13790","KILIFI","GANZE","10",2379,2285,4664
"13791","KILIFI","GANZE","11",2449,2451,4900
"13792","KILIFI","GANZE","12",2502,2471,4973
"13793","KILIFI","GANZE","13",2490,2432,4922
"13794","KILIFI","GANZE","14",2255,2119,4374
"13795","KILIFI","GANZE","10 -14",12075,11758,23833
"13796","KILIFI","GANZE","15",2276,2259,4535
"13797","KILIFI","GANZE","16",2012,2027,4039
"13798","KILIFI","GANZE","17",2050,1944,3994
"13799","KILIFI","GANZE","18",1732,1679,3411
"13800","KILIFI","GANZE","19",1624,1631,3255
"13801","KILIFI","GANZE","15-19",9694,9540,19234
"13802","KILIFI","GANZE","20",1445,1497,2942
"13803","KILIFI","GANZE","21",1112,1107,2219
"13804","KILIFI","GANZE","22",819,1049,1868
"13805","KILIFI","GANZE","23",790,1053,1843
"13806","KILIFI","GANZE","24",678,913,1591
"13807","KILIFI","GANZE","20-24",4844,5619,10463
"13808","KILIFI","GANZE","25",769,956,1725
"13809","KILIFI","GANZE","26",581,783,1364
"13810","KILIFI","GANZE","27",563,853,1416
"13811","KILIFI","GANZE","28",460,721,1181
"13812","KILIFI","GANZE","29",507,839,1346
"13813","KILIFI","GANZE","25-29",2880,4152,7032
"13814","KILIFI","GANZE","30",564,985,1549
"13815","KILIFI","GANZE","31",472,943,1415
"13816","KILIFI","GANZE","32",530,1117,1647
"13817","KILIFI","GANZE","33",481,1024,1505
"13818","KILIFI","GANZE","34",440,1009,1449
"13819","KILIFI","GANZE","30-34",2487,5078,7565
"13820","KILIFI","GANZE","35",571,964,1535
"13821","KILIFI","GANZE","36",395,648,1043
"13822","KILIFI","GANZE","37",360,523,883
"13823","KILIFI","GANZE","38",230,343,573
"13824","KILIFI","GANZE","39",299,348,647
"13825","KILIFI","GANZE","35-39",1855,2826,4681
"13826","KILIFI","GANZE","40",339,389,728
"13827","KILIFI","GANZE","41",558,854,1412
"13828","KILIFI","GANZE","42",420,724,1144
"13829","KILIFI","GANZE","43",354,682,1036
"13830","KILIFI","GANZE","44",304,456,760
"13831","KILIFI","GANZE","40-44",1975,3105,5080
"13832","KILIFI","GANZE","45",427,604,1031
"13833","KILIFI","GANZE","46",309,395,704
"13834","KILIFI","GANZE","47",323,365,688
"13835","KILIFI","GANZE","48",229,291,520
"13836","KILIFI","GANZE","49",272,348,620
"13837","KILIFI","GANZE","45-49",1560,2003,3563
"13838","KILIFI","GANZE","50",406,809,1215
"13839","KILIFI","GANZE","51",305,510,815
"13840","KILIFI","GANZE","52",240,401,641
"13841","KILIFI","GANZE","53",224,195,419
"13842","KILIFI","GANZE","54",202,170,372
"13843","KILIFI","GANZE","50-54",1377,2085,3462
"13844","KILIFI","GANZE","55",197,118,315
"13845","KILIFI","GANZE","56",246,228,474
"13846","KILIFI","GANZE","57",298,410,708
"13847","KILIFI","GANZE","58",216,405,621
"13848","KILIFI","GANZE","59",261,750,1011
"13849","KILIFI","GANZE","55-59",1218,1911,3129
"13850","KILIFI","GANZE","60",294,599,893
"13851","KILIFI","GANZE","61",263,516,779
"13852","KILIFI","GANZE","62",244,405,649
"13853","KILIFI","GANZE","63",251,492,743
"13854","KILIFI","GANZE","64",222,267,489
"13855","KILIFI","GANZE","60-64",1274,2279,3553
"13856","KILIFI","GANZE","65",255,442,697
"13857","KILIFI","GANZE","66",222,188,410
"13858","KILIFI","GANZE","67",275,236,511
"13859","KILIFI","GANZE","68",135,124,259
"13860","KILIFI","GANZE","69",222,493,715
"13861","KILIFI","GANZE","65-69",1109,1483,2592
"13862","KILIFI","GANZE","70",218,341,559
"13863","KILIFI","GANZE","71",156,220,376
"13864","KILIFI","GANZE","72",113,103,216
"13865","KILIFI","GANZE","73",102,118,220
"13866","KILIFI","GANZE","74",139,160,299
"13867","KILIFI","GANZE","70-74",728,942,1670
"13868","KILIFI","GANZE","75",207,309,516
"13869","KILIFI","GANZE","76",76,96,172
"13870","KILIFI","GANZE","77",100,94,194
"13871","KILIFI","GANZE","78",49,39,88
"13872","KILIFI","GANZE","79",124,204,328
"13873","KILIFI","GANZE","75-79",556,742,1298
"13874","KILIFI","GANZE","80",78,159,237
"13875","KILIFI","GANZE","81",61,70,131
"13876","KILIFI","GANZE","82",36,37,73
"13877","KILIFI","GANZE","83",45,81,126
"13878","KILIFI","GANZE","84",48,60,108
"13879","KILIFI","GANZE","80-84",268,407,675
"13880","KILIFI","GANZE","85",30,58,88
"13881","KILIFI","GANZE","86",27,25,52
"13882","KILIFI","GANZE","87",59,87,146
"13883","KILIFI","GANZE","88",10,26,36
"13884","KILIFI","GANZE","89",68,83,151
"13885","KILIFI","GANZE","85-89",194,279,473
"13886","KILIFI","GANZE","90",15,38,53
"13887","KILIFI","GANZE","91",21,29,50
"13888","KILIFI","GANZE","92",11,15,26
"13889","KILIFI","GANZE","93",6,9,15
"13890","KILIFI","GANZE","94",12,12,24
"13891","KILIFI","GANZE","90-94",65,103,168
"13892","KILIFI","GANZE","95",6,16,22
"13893","KILIFI","GANZE","96",4,4,8
"13894","KILIFI","GANZE","97",6,5,11
"13895","KILIFI","GANZE","98",3,8,11
"13896","KILIFI","GANZE","99",10,21,31
"13897","KILIFI","GANZE","95-99",29,54,83
"13898","KILIFI","GANZE","100+",15,27,42
"13899","KILIFI","GANZE","Not Stated",1,3,4
"13900","KILIFI","KALOLENI","Total",92614,101063,193677
"13901","KILIFI","KALOLENI","0",2512,2525,5037
"13902","KILIFI","KALOLENI","1",2628,2809,5437
"13903","KILIFI","KALOLENI","2",2874,2846,5720
"13904","KILIFI","KALOLENI","3",2863,2849,5712
"13905","KILIFI","KALOLENI","4",2903,2856,5759
"13906","KILIFI","KALOLENI","0 - 4",13780,13885,27665
"13907","KILIFI","KALOLENI","5",3048,3036,6084
"13908","KILIFI","KALOLENI","6",2885,2938,5823
"13909","KILIFI","KALOLENI","7",2781,2703,5484
"13910","KILIFI","KALOLENI","8",2833,2789,5622
"13911","KILIFI","KALOLENI","9",2913,2865,5778
"13912","KILIFI","KALOLENI","5-9",14460,14331,28791
"13913","KILIFI","KALOLENI","10",2967,3016,5983
"13914","KILIFI","KALOLENI","11",2833,2934,5767
"13915","KILIFI","KALOLENI","12",3064,2926,5990
"13916","KILIFI","KALOLENI","13",3000,3035,6035
"13917","KILIFI","KALOLENI","14",2723,2716,5439
"13918","KILIFI","KALOLENI","10 -14",14587,14627,29214
"13919","KILIFI","KALOLENI","15",2637,2523,5160
"13920","KILIFI","KALOLENI","16",2468,2424,4892
"13921","KILIFI","KALOLENI","17",2435,2281,4716
"13922","KILIFI","KALOLENI","18",2215,1968,4183
"13923","KILIFI","KALOLENI","19",2091,2069,4160
"13924","KILIFI","KALOLENI","15-19",11846,11265,23111
"13925","KILIFI","KALOLENI","20",1854,2026,3880
"13926","KILIFI","KALOLENI","21",1417,1583,3000
"13927","KILIFI","KALOLENI","22",1431,1635,3066
"13928","KILIFI","KALOLENI","23",1409,1765,3174
"13929","KILIFI","KALOLENI","24",1277,1530,2807
"13930","KILIFI","KALOLENI","20-24",7388,8539,15927
"13931","KILIFI","KALOLENI","25",1377,1569,2946
"13932","KILIFI","KALOLENI","26",1208,1587,2795
"13933","KILIFI","KALOLENI","27",1218,1557,2775
"13934","KILIFI","KALOLENI","28",1053,1468,2521
"13935","KILIFI","KALOLENI","29",1008,1492,2500
"13936","KILIFI","KALOLENI","25-29",5864,7673,13537
"13937","KILIFI","KALOLENI","30",1303,1802,3105
"13938","KILIFI","KALOLENI","31",892,1300,2192
"13939","KILIFI","KALOLENI","32",1059,1412,2471
"13940","KILIFI","KALOLENI","33",834,1297,2131
"13941","KILIFI","KALOLENI","34",822,1164,1986
"13942","KILIFI","KALOLENI","30-34",4910,6975,11885
"13943","KILIFI","KALOLENI","35",1015,1241,2256
"13944","KILIFI","KALOLENI","36",704,799,1503
"13945","KILIFI","KALOLENI","37",773,767,1540
"13946","KILIFI","KALOLENI","38",554,603,1157
"13947","KILIFI","KALOLENI","39",618,603,1221
"13948","KILIFI","KALOLENI","35-39",3664,4013,7677
"13949","KILIFI","KALOLENI","40",802,758,1560
"13950","KILIFI","KALOLENI","41",915,932,1847
"13951","KILIFI","KALOLENI","42",725,896,1621
"13952","KILIFI","KALOLENI","43",636,725,1361
"13953","KILIFI","KALOLENI","44",530,570,1100
"13954","KILIFI","KALOLENI","40-44",3608,3881,7489
"13955","KILIFI","KALOLENI","45",856,935,1791
"13956","KILIFI","KALOLENI","46",580,661,1241
"13957","KILIFI","KALOLENI","47",609,669,1278
"13958","KILIFI","KALOLENI","48",433,433,866
"13959","KILIFI","KALOLENI","49",488,492,980
"13960","KILIFI","KALOLENI","45-49",2966,3190,6156
"13961","KILIFI","KALOLENI","50",724,907,1631
"13962","KILIFI","KALOLENI","51",540,563,1103
"13963","KILIFI","KALOLENI","52",426,469,895
"13964","KILIFI","KALOLENI","53",331,300,631
"13965","KILIFI","KALOLENI","54",322,276,598
"13966","KILIFI","KALOLENI","50-54",2343,2515,4858
"13967","KILIFI","KALOLENI","55",339,249,588
"13968","KILIFI","KALOLENI","56",520,540,1060
"13969","KILIFI","KALOLENI","57",415,521,936
"13970","KILIFI","KALOLENI","58",317,357,674
"13971","KILIFI","KALOLENI","59",373,676,1049
"13972","KILIFI","KALOLENI","55-59",1964,2343,4307
"13973","KILIFI","KALOLENI","60",473,807,1280
"13974","KILIFI","KALOLENI","61",326,578,904
"13975","KILIFI","KALOLENI","62",350,383,733
"13976","KILIFI","KALOLENI","63",303,485,788
"13977","KILIFI","KALOLENI","64",273,350,623
"13978","KILIFI","KALOLENI","60-64",1725,2603,4328
"13979","KILIFI","KALOLENI","65",396,477,873
"13980","KILIFI","KALOLENI","66",246,218,464
"13981","KILIFI","KALOLENI","67",325,307,632
"13982","KILIFI","KALOLENI","68",183,184,367
"13983","KILIFI","KALOLENI","69",273,486,759
"13984","KILIFI","KALOLENI","65-69",1423,1672,3095
"13985","KILIFI","KALOLENI","70",298,574,872
"13986","KILIFI","KALOLENI","71",196,306,502
"13987","KILIFI","KALOLENI","72",147,210,357
"13988","KILIFI","KALOLENI","73",136,205,341
"13989","KILIFI","KALOLENI","74",160,194,354
"13990","KILIFI","KALOLENI","70-74",937,1489,2426
"13991","KILIFI","KALOLENI","75",177,353,530
"13992","KILIFI","KALOLENI","76",93,123,216
"13993","KILIFI","KALOLENI","77",111,158,269
"13994","KILIFI","KALOLENI","78",78,69,147
"13995","KILIFI","KALOLENI","79",109,236,345
"13996","KILIFI","KALOLENI","75-79",568,939,1507
"13997","KILIFI","KALOLENI","80",104,206,310
"13998","KILIFI","KALOLENI","81",60,108,168
"13999","KILIFI","KALOLENI","82",50,71,121
"14000","KILIFI","KALOLENI","83",47,62,109
"14001","KILIFI","KALOLENI","84",32,80,112
"14002","KILIFI","KALOLENI","80-84",293,527,820
"14003","KILIFI","KALOLENI","85",52,119,171
"14004","KILIFI","KALOLENI","86",23,30,53
"14005","KILIFI","KALOLENI","87",34,67,101
"14006","KILIFI","KALOLENI","88",20,18,38
"14007","KILIFI","KALOLENI","89",42,112,154
"14008","KILIFI","KALOLENI","85-89",171,346,517
"14009","KILIFI","KALOLENI","90",22,60,82
"14010","KILIFI","KALOLENI","91",15,27,42
"14011","KILIFI","KALOLENI","92",6,16,22
"14012","KILIFI","KALOLENI","93",11,13,24
"14013","KILIFI","KALOLENI","94",8,19,27
"14014","KILIFI","KALOLENI","90-94",62,135,197
"14015","KILIFI","KALOLENI","95",11,22,33
"14016","KILIFI","KALOLENI","96",4,10,14
"14017","KILIFI","KALOLENI","97",8,10,18
"14018","KILIFI","KALOLENI","98",3,11,14
"14019","KILIFI","KALOLENI","99",13,17,30
"14020","KILIFI","KALOLENI","95-99",39,70,109
"14021","KILIFI","KALOLENI","100+",14,44,58
"14022","KILIFI","KALOLENI","Not Stated",2,1,3
"14023","KILIFI","KAUMA","Total",10965,11673,22638
"14024","KILIFI","KAUMA","0",283,281,564
"14025","KILIFI","KAUMA","1",301,307,608
"14026","KILIFI","KAUMA","2",313,307,620
"14027","KILIFI","KAUMA","3",284,337,621
"14028","KILIFI","KAUMA","4",306,312,618
"14029","KILIFI","KAUMA","0 - 4",1487,1544,3031
"14030","KILIFI","KAUMA","5",342,355,697
"14031","KILIFI","KAUMA","6",361,311,672
"14032","KILIFI","KAUMA","7",313,329,642
"14033","KILIFI","KAUMA","8",321,341,662
"14034","KILIFI","KAUMA","9",363,345,708
"14035","KILIFI","KAUMA","5-9",1700,1681,3381
"14036","KILIFI","KAUMA","10",342,399,741
"14037","KILIFI","KAUMA","11",355,358,713
"14038","KILIFI","KAUMA","12",374,393,767
"14039","KILIFI","KAUMA","13",349,360,709
"14040","KILIFI","KAUMA","14",365,344,709
"14041","KILIFI","KAUMA","10 -14",1785,1854,3639
"14042","KILIFI","KAUMA","15",342,340,682
"14043","KILIFI","KAUMA","16",345,334,679
"14044","KILIFI","KAUMA","17",338,303,641
"14045","KILIFI","KAUMA","18",270,247,517
"14046","KILIFI","KAUMA","19",331,261,592
"14047","KILIFI","KAUMA","15-19",1626,1485,3111
"14048","KILIFI","KAUMA","20",276,268,544
"14049","KILIFI","KAUMA","21",224,200,424
"14050","KILIFI","KAUMA","22",178,182,360
"14051","KILIFI","KAUMA","23",176,182,358
"14052","KILIFI","KAUMA","24",171,143,314
"14053","KILIFI","KAUMA","20-24",1025,975,2000
"14054","KILIFI","KAUMA","25",171,139,310
"14055","KILIFI","KAUMA","26",143,178,321
"14056","KILIFI","KAUMA","27",131,147,278
"14057","KILIFI","KAUMA","28",96,125,221
"14058","KILIFI","KAUMA","29",91,123,214
"14059","KILIFI","KAUMA","25-29",632,712,1344
"14060","KILIFI","KAUMA","30",111,161,272
"14061","KILIFI","KAUMA","31",74,127,201
"14062","KILIFI","KAUMA","32",89,156,245
"14063","KILIFI","KAUMA","33",100,132,232
"14064","KILIFI","KAUMA","34",87,118,205
"14065","KILIFI","KAUMA","30-34",461,694,1155
"14066","KILIFI","KAUMA","35",112,147,259
"14067","KILIFI","KAUMA","36",62,98,160
"14068","KILIFI","KAUMA","37",70,60,130
"14069","KILIFI","KAUMA","38",42,66,108
"14070","KILIFI","KAUMA","39",62,57,119
"14071","KILIFI","KAUMA","35-39",348,428,776
"14072","KILIFI","KAUMA","40",88,82,170
"14073","KILIFI","KAUMA","41",103,135,238
"14074","KILIFI","KAUMA","42",98,130,228
"14075","KILIFI","KAUMA","43",64,100,164
"14076","KILIFI","KAUMA","44",62,65,127
"14077","KILIFI","KAUMA","40-44",415,512,927
"14078","KILIFI","KAUMA","45",103,124,227
"14079","KILIFI","KAUMA","46",50,61,111
"14080","KILIFI","KAUMA","47",61,70,131
"14081","KILIFI","KAUMA","48",37,33,70
"14082","KILIFI","KAUMA","49",60,49,109
"14083","KILIFI","KAUMA","45-49",311,337,648
"14084","KILIFI","KAUMA","50",66,91,157
"14085","KILIFI","KAUMA","51",56,83,139
"14086","KILIFI","KAUMA","52",51,47,98
"14087","KILIFI","KAUMA","53",44,35,79
"14088","KILIFI","KAUMA","54",37,38,75
"14089","KILIFI","KAUMA","50-54",254,294,548
"14090","KILIFI","KAUMA","55",36,18,54
"14091","KILIFI","KAUMA","56",56,45,101
"14092","KILIFI","KAUMA","57",54,56,110
"14093","KILIFI","KAUMA","58",61,76,137
"14094","KILIFI","KAUMA","59",50,111,161
"14095","KILIFI","KAUMA","55-59",257,306,563
"14096","KILIFI","KAUMA","60",44,102,146
"14097","KILIFI","KAUMA","61",34,86,120
"14098","KILIFI","KAUMA","62",39,48,87
"14099","KILIFI","KAUMA","63",33,57,90
"14100","KILIFI","KAUMA","64",33,27,60
"14101","KILIFI","KAUMA","60-64",183,320,503
"14102","KILIFI","KAUMA","65",46,55,101
"14103","KILIFI","KAUMA","66",42,12,54
"14104","KILIFI","KAUMA","67",50,43,93
"14105","KILIFI","KAUMA","68",30,14,44
"14106","KILIFI","KAUMA","69",21,37,58
"14107","KILIFI","KAUMA","65-69",189,161,350
"14108","KILIFI","KAUMA","70",36,52,88
"14109","KILIFI","KAUMA","71",40,28,68
"14110","KILIFI","KAUMA","72",19,16,35
"14111","KILIFI","KAUMA","73",27,16,43
"14112","KILIFI","KAUMA","74",32,19,51
"14113","KILIFI","KAUMA","70-74",154,131,285
"14114","KILIFI","KAUMA","75",20,46,66
"14115","KILIFI","KAUMA","76",13,17,30
"14116","KILIFI","KAUMA","77",10,15,25
"14117","KILIFI","KAUMA","78",5,9,14
"14118","KILIFI","KAUMA","79",19,26,45
"14119","KILIFI","KAUMA","75-79",67,113,180
"14120","KILIFI","KAUMA","80",7,28,35
"14121","KILIFI","KAUMA","81",6,11,17
"14122","KILIFI","KAUMA","82",5,4,9
"14123","KILIFI","KAUMA","83",5,3,8
"14124","KILIFI","KAUMA","84",8,8,16
"14125","KILIFI","KAUMA","80-84",31,54,85
"14126","KILIFI","KAUMA","85",6,10,16
"14127","KILIFI","KAUMA","86",1,3,4
"14128","KILIFI","KAUMA","87",6,18,24
"14129","KILIFI","KAUMA","88",3,1,4
"14130","KILIFI","KAUMA","89",5,17,22
"14131","KILIFI","KAUMA","85-89",21,49,70
"14132","KILIFI","KAUMA","90",4,7,11
"14133","KILIFI","KAUMA","91",3,4,7
"14134","KILIFI","KAUMA","92",NA,4,4
"14135","KILIFI","KAUMA","93",NA,2,2
"14136","KILIFI","KAUMA","94",3,NA,3
"14137","KILIFI","KAUMA","90-94",10,17,27
"14138","KILIFI","KAUMA","95",3,1,4
"14139","KILIFI","KAUMA","96",NA,1,1
"14140","KILIFI","KAUMA","97",NA,1,1
"14141","KILIFI","KAUMA","98",2,NA,2
"14142","KILIFI","KAUMA","99",1,2,3
"14143","KILIFI","KAUMA","95-99",6,5,11
"14144","KILIFI","KAUMA","100+",3,1,4
"14145","KILIFI","KAUMA","Not Stated",NA,NA,NA
"14146","KILIFI","KILIFI NORTH","Total",86986,91836,178822
"14147","KILIFI","KILIFI NORTH","0",2392,2349,4741
"14148","KILIFI","KILIFI NORTH","1",2509,2331,4840
"14149","KILIFI","KILIFI NORTH","2",2474,2549,5023
"14150","KILIFI","KILIFI NORTH","3",2377,2409,4786
"14151","KILIFI","KILIFI NORTH","4",2455,2403,4858
"14152","KILIFI","KILIFI NORTH","0 - 4",12207,12041,24248
"14153","KILIFI","KILIFI NORTH","5",2510,2413,4923
"14154","KILIFI","KILIFI NORTH","6",2371,2399,4770
"14155","KILIFI","KILIFI NORTH","7",2337,2243,4580
"14156","KILIFI","KILIFI NORTH","8",2296,2306,4602
"14157","KILIFI","KILIFI NORTH","9",2362,2290,4652
"14158","KILIFI","KILIFI NORTH","5-9",11876,11651,23527
"14159","KILIFI","KILIFI NORTH","10",2440,2461,4901
"14160","KILIFI","KILIFI NORTH","11",2394,2375,4769
"14161","KILIFI","KILIFI NORTH","12",2416,2413,4829
"14162","KILIFI","KILIFI NORTH","13",2423,2420,4843
"14163","KILIFI","KILIFI NORTH","14",2171,2254,4425
"14164","KILIFI","KILIFI NORTH","10 -14",11844,11923,23767
"14165","KILIFI","KILIFI NORTH","15",2160,2115,4275
"14166","KILIFI","KILIFI NORTH","16",1987,1957,3944
"14167","KILIFI","KILIFI NORTH","17",2145,2066,4211
"14168","KILIFI","KILIFI NORTH","18",1877,1860,3737
"14169","KILIFI","KILIFI NORTH","19",2095,2147,4242
"14170","KILIFI","KILIFI NORTH","15-19",10264,10145,20409
"14171","KILIFI","KILIFI NORTH","20",1907,2202,4109
"14172","KILIFI","KILIFI NORTH","21",1723,1830,3553
"14173","KILIFI","KILIFI NORTH","22",1843,2142,3985
"14174","KILIFI","KILIFI NORTH","23",1826,2004,3830
"14175","KILIFI","KILIFI NORTH","24",1550,1828,3378
"14176","KILIFI","KILIFI NORTH","20-24",8849,10006,18855
"14177","KILIFI","KILIFI NORTH","25",1790,1968,3758
"14178","KILIFI","KILIFI NORTH","26",1645,1788,3433
"14179","KILIFI","KILIFI NORTH","27",1565,1657,3222
"14180","KILIFI","KILIFI NORTH","28",1234,1402,2636
"14181","KILIFI","KILIFI NORTH","29",1310,1436,2746
"14182","KILIFI","KILIFI NORTH","25-29",7544,8251,15795
"14183","KILIFI","KILIFI NORTH","30",1473,1785,3258
"14184","KILIFI","KILIFI NORTH","31",1071,1187,2258
"14185","KILIFI","KILIFI NORTH","32",1247,1478,2725
"14186","KILIFI","KILIFI NORTH","33",1003,1282,2285
"14187","KILIFI","KILIFI NORTH","34",1001,1130,2131
"14188","KILIFI","KILIFI NORTH","30-34",5795,6862,12657
"14189","KILIFI","KILIFI NORTH","35",1214,1249,2463
"14190","KILIFI","KILIFI NORTH","36",828,881,1709
"14191","KILIFI","KILIFI NORTH","37",880,824,1704
"14192","KILIFI","KILIFI NORTH","38",600,635,1235
"14193","KILIFI","KILIFI NORTH","39",758,708,1466
"14194","KILIFI","KILIFI NORTH","35-39",4280,4297,8577
"14195","KILIFI","KILIFI NORTH","40",872,897,1769
"14196","KILIFI","KILIFI NORTH","41",901,1053,1954
"14197","KILIFI","KILIFI NORTH","42",785,989,1774
"14198","KILIFI","KILIFI NORTH","43",662,801,1463
"14199","KILIFI","KILIFI NORTH","44",601,588,1189
"14200","KILIFI","KILIFI NORTH","40-44",3821,4328,8149
"14201","KILIFI","KILIFI NORTH","45",856,801,1657
"14202","KILIFI","KILIFI NORTH","46",564,574,1138
"14203","KILIFI","KILIFI NORTH","47",635,609,1244
"14204","KILIFI","KILIFI NORTH","48",441,417,858
"14205","KILIFI","KILIFI NORTH","49",472,528,1000
"14206","KILIFI","KILIFI NORTH","45-49",2968,2929,5897
"14207","KILIFI","KILIFI NORTH","50",657,829,1486
"14208","KILIFI","KILIFI NORTH","51",445,513,958
"14209","KILIFI","KILIFI NORTH","52",405,403,808
"14210","KILIFI","KILIFI NORTH","53",299,253,552
"14211","KILIFI","KILIFI NORTH","54",382,292,674
"14212","KILIFI","KILIFI NORTH","50-54",2188,2290,4478
"14213","KILIFI","KILIFI NORTH","55",351,255,606
"14214","KILIFI","KILIFI NORTH","56",399,362,761
"14215","KILIFI","KILIFI NORTH","57",376,394,770
"14216","KILIFI","KILIFI NORTH","58",255,344,599
"14217","KILIFI","KILIFI NORTH","59",303,534,837
"14218","KILIFI","KILIFI NORTH","55-59",1684,1889,3573
"14219","KILIFI","KILIFI NORTH","60",354,594,948
"14220","KILIFI","KILIFI NORTH","61",255,432,687
"14221","KILIFI","KILIFI NORTH","62",229,304,533
"14222","KILIFI","KILIFI NORTH","63",241,338,579
"14223","KILIFI","KILIFI NORTH","64",199,253,452
"14224","KILIFI","KILIFI NORTH","60-64",1278,1921,3199
"14225","KILIFI","KILIFI NORTH","65",287,347,634
"14226","KILIFI","KILIFI NORTH","66",193,165,358
"14227","KILIFI","KILIFI NORTH","67",258,237,495
"14228","KILIFI","KILIFI NORTH","68",118,136,254
"14229","KILIFI","KILIFI NORTH","69",164,261,425
"14230","KILIFI","KILIFI NORTH","65-69",1020,1146,2166
"14231","KILIFI","KILIFI NORTH","70",175,357,532
"14232","KILIFI","KILIFI NORTH","71",138,181,319
"14233","KILIFI","KILIFI NORTH","72",90,145,235
"14234","KILIFI","KILIFI NORTH","73",110,114,224
"14235","KILIFI","KILIFI NORTH","74",96,172,268
"14236","KILIFI","KILIFI NORTH","70-74",609,969,1578
"14237","KILIFI","KILIFI NORTH","75",112,155,267
"14238","KILIFI","KILIFI NORTH","76",58,105,163
"14239","KILIFI","KILIFI NORTH","77",71,92,163
"14240","KILIFI","KILIFI NORTH","78",57,69,126
"14241","KILIFI","KILIFI NORTH","79",55,139,194
"14242","KILIFI","KILIFI NORTH","75-79",353,560,913
"14243","KILIFI","KILIFI NORTH","80",63,129,192
"14244","KILIFI","KILIFI NORTH","81",46,45,91
"14245","KILIFI","KILIFI NORTH","82",34,46,80
"14246","KILIFI","KILIFI NORTH","83",27,44,71
"14247","KILIFI","KILIFI NORTH","84",33,41,74
"14248","KILIFI","KILIFI NORTH","80-84",203,305,508
"14249","KILIFI","KILIFI NORTH","85",34,55,89
"14250","KILIFI","KILIFI NORTH","86",22,26,48
"14251","KILIFI","KILIFI NORTH","87",17,39,56
"14252","KILIFI","KILIFI NORTH","88",18,17,35
"14253","KILIFI","KILIFI NORTH","89",34,49,83
"14254","KILIFI","KILIFI NORTH","85-89",125,186,311
"14255","KILIFI","KILIFI NORTH","90",16,35,51
"14256","KILIFI","KILIFI NORTH","91",12,19,31
"14257","KILIFI","KILIFI NORTH","92",5,6,11
"14258","KILIFI","KILIFI NORTH","93",10,7,17
"14259","KILIFI","KILIFI NORTH","94",4,8,12
"14260","KILIFI","KILIFI NORTH","90-94",47,75,122
"14261","KILIFI","KILIFI NORTH","95",4,19,23
"14262","KILIFI","KILIFI NORTH","96",4,6,10
"14263","KILIFI","KILIFI NORTH","97",2,3,5
"14264","KILIFI","KILIFI NORTH","98",3,2,5
"14265","KILIFI","KILIFI NORTH","99",5,9,14
"14266","KILIFI","KILIFI NORTH","95-99",18,39,57
"14267","KILIFI","KILIFI NORTH","100+",13,23,36
"14268","KILIFI","KILIFI NORTH","Not Stated",NA,NA,NA
"14269","KILIFI","KILIFI SOUTH","Total",101852,104897,206749
"14270","KILIFI","KILIFI SOUTH","0",2663,2752,5415
"14271","KILIFI","KILIFI SOUTH","1",2815,2749,5564
"14272","KILIFI","KILIFI SOUTH","2",2713,2601,5314
"14273","KILIFI","KILIFI SOUTH","3",2564,2600,5164
"14274","KILIFI","KILIFI SOUTH","4",2643,2602,5245
"14275","KILIFI","KILIFI SOUTH","0 - 4",13398,13304,26702
"14276","KILIFI","KILIFI SOUTH","5",2829,2645,5474
"14277","KILIFI","KILIFI SOUTH","6",2677,2669,5346
"14278","KILIFI","KILIFI SOUTH","7",2678,2564,5242
"14279","KILIFI","KILIFI SOUTH","8",2465,2486,4951
"14280","KILIFI","KILIFI SOUTH","9",2612,2653,5265
"14281","KILIFI","KILIFI SOUTH","5-9",13261,13017,26278
"14282","KILIFI","KILIFI SOUTH","10",2617,2609,5226
"14283","KILIFI","KILIFI SOUTH","11",2402,2411,4813
"14284","KILIFI","KILIFI SOUTH","12",2595,2483,5078
"14285","KILIFI","KILIFI SOUTH","13",2617,2710,5327
"14286","KILIFI","KILIFI SOUTH","14",2459,2389,4848
"14287","KILIFI","KILIFI SOUTH","10 -14",12690,12602,25292
"14288","KILIFI","KILIFI SOUTH","15",2323,2228,4551
"14289","KILIFI","KILIFI SOUTH","16",2142,2226,4368
"14290","KILIFI","KILIFI SOUTH","17",2234,2233,4467
"14291","KILIFI","KILIFI SOUTH","18",1980,1985,3965
"14292","KILIFI","KILIFI SOUTH","19",2177,2291,4468
"14293","KILIFI","KILIFI SOUTH","15-19",10856,10963,21819
"14294","KILIFI","KILIFI SOUTH","20",2204,2532,4736
"14295","KILIFI","KILIFI SOUTH","21",1913,2262,4175
"14296","KILIFI","KILIFI SOUTH","22",2151,2558,4709
"14297","KILIFI","KILIFI SOUTH","23",2237,2608,4845
"14298","KILIFI","KILIFI SOUTH","24",2142,2474,4616
"14299","KILIFI","KILIFI SOUTH","20-24",10647,12434,23081
"14300","KILIFI","KILIFI SOUTH","25",2375,2644,5019
"14301","KILIFI","KILIFI SOUTH","26",2114,2373,4487
"14302","KILIFI","KILIFI SOUTH","27",2157,2202,4359
"14303","KILIFI","KILIFI SOUTH","28",1746,2000,3746
"14304","KILIFI","KILIFI SOUTH","29",1686,1832,3518
"14305","KILIFI","KILIFI SOUTH","25-29",10078,11051,21129
"14306","KILIFI","KILIFI SOUTH","30",2124,2388,4512
"14307","KILIFI","KILIFI SOUTH","31",1420,1420,2840
"14308","KILIFI","KILIFI SOUTH","32",1695,1893,3588
"14309","KILIFI","KILIFI SOUTH","33",1291,1493,2784
"14310","KILIFI","KILIFI SOUTH","34",1270,1515,2785
"14311","KILIFI","KILIFI SOUTH","30-34",7800,8709,16509
"14312","KILIFI","KILIFI SOUTH","35",1650,1692,3342
"14313","KILIFI","KILIFI SOUTH","36",1173,1072,2245
"14314","KILIFI","KILIFI SOUTH","37",1136,1027,2163
"14315","KILIFI","KILIFI SOUTH","38",931,858,1789
"14316","KILIFI","KILIFI SOUTH","39",874,889,1763
"14317","KILIFI","KILIFI SOUTH","35-39",5764,5538,11302
"14318","KILIFI","KILIFI SOUTH","40",1201,1116,2317
"14319","KILIFI","KILIFI SOUTH","41",1088,1104,2192
"14320","KILIFI","KILIFI SOUTH","42",1116,1176,2292
"14321","KILIFI","KILIFI SOUTH","43",826,832,1658
"14322","KILIFI","KILIFI SOUTH","44",737,676,1413
"14323","KILIFI","KILIFI SOUTH","40-44",4968,4904,9872
"14324","KILIFI","KILIFI SOUTH","45",1220,983,2203
"14325","KILIFI","KILIFI SOUTH","46",727,648,1375
"14326","KILIFI","KILIFI SOUTH","47",787,651,1438
"14327","KILIFI","KILIFI SOUTH","48",601,468,1069
"14328","KILIFI","KILIFI SOUTH","49",604,478,1082
"14329","KILIFI","KILIFI SOUTH","45-49",3939,3228,7167
"14330","KILIFI","KILIFI SOUTH","50",856,872,1728
"14331","KILIFI","KILIFI SOUTH","51",508,456,964
"14332","KILIFI","KILIFI SOUTH","52",483,405,888
"14333","KILIFI","KILIFI SOUTH","53",358,295,653
"14334","KILIFI","KILIFI SOUTH","54",379,272,651
"14335","KILIFI","KILIFI SOUTH","50-54",2584,2300,4884
"14336","KILIFI","KILIFI SOUTH","55",395,300,695
"14337","KILIFI","KILIFI SOUTH","56",463,401,864
"14338","KILIFI","KILIFI SOUTH","57",399,383,782
"14339","KILIFI","KILIFI SOUTH","58",354,321,675
"14340","KILIFI","KILIFI SOUTH","59",379,432,811
"14341","KILIFI","KILIFI SOUTH","55-59",1990,1837,3827
"14342","KILIFI","KILIFI SOUTH","60",400,652,1052
"14343","KILIFI","KILIFI SOUTH","61",272,370,642
"14344","KILIFI","KILIFI SOUTH","62",265,303,568
"14345","KILIFI","KILIFI SOUTH","63",268,374,642
"14346","KILIFI","KILIFI SOUTH","64",215,205,420
"14347","KILIFI","KILIFI SOUTH","60-64",1420,1904,3324
"14348","KILIFI","KILIFI SOUTH","65",310,368,678
"14349","KILIFI","KILIFI SOUTH","66",214,180,394
"14350","KILIFI","KILIFI SOUTH","67",252,271,523
"14351","KILIFI","KILIFI SOUTH","68",139,148,287
"14352","KILIFI","KILIFI SOUTH","69",173,265,438
"14353","KILIFI","KILIFI SOUTH","65-69",1088,1232,2320
"14354","KILIFI","KILIFI SOUTH","70",216,340,556
"14355","KILIFI","KILIFI SOUTH","71",139,172,311
"14356","KILIFI","KILIFI SOUTH","72",104,87,191
"14357","KILIFI","KILIFI SOUTH","73",106,103,209
"14358","KILIFI","KILIFI SOUTH","74",109,137,246
"14359","KILIFI","KILIFI SOUTH","70-74",674,839,1513
"14360","KILIFI","KILIFI SOUTH","75",101,132,233
"14361","KILIFI","KILIFI SOUTH","76",93,77,170
"14362","KILIFI","KILIFI SOUTH","77",79,85,164
"14363","KILIFI","KILIFI SOUTH","78",46,59,105
"14364","KILIFI","KILIFI SOUTH","79",52,102,154
"14365","KILIFI","KILIFI SOUTH","75-79",371,455,826
"14366","KILIFI","KILIFI SOUTH","80",75,128,203
"14367","KILIFI","KILIFI SOUTH","81",30,53,83
"14368","KILIFI","KILIFI SOUTH","82",28,36,64
"14369","KILIFI","KILIFI SOUTH","83",31,41,72
"14370","KILIFI","KILIFI SOUTH","84",30,40,70
"14371","KILIFI","KILIFI SOUTH","80-84",194,298,492
"14372","KILIFI","KILIFI SOUTH","85",25,42,67
"14373","KILIFI","KILIFI SOUTH","86",10,13,23
"14374","KILIFI","KILIFI SOUTH","87",22,32,54
"14375","KILIFI","KILIFI SOUTH","88",8,9,17
"14376","KILIFI","KILIFI SOUTH","89",20,34,54
"14377","KILIFI","KILIFI SOUTH","85-89",85,130,215
"14378","KILIFI","KILIFI SOUTH","90",7,35,42
"14379","KILIFI","KILIFI SOUTH","91",4,11,15
"14380","KILIFI","KILIFI SOUTH","92",1,7,8
"14381","KILIFI","KILIFI SOUTH","93",NA,8,8
"14382","KILIFI","KILIFI SOUTH","94",5,10,15
"14383","KILIFI","KILIFI SOUTH","90-94",17,71,88
"14384","KILIFI","KILIFI SOUTH","95",4,16,20
"14385","KILIFI","KILIFI SOUTH","96",4,6,10
"14386","KILIFI","KILIFI SOUTH","97",3,4,7
"14387","KILIFI","KILIFI SOUTH","98",4,7,11
"14388","KILIFI","KILIFI SOUTH","99",4,19,23
"14389","KILIFI","KILIFI SOUTH","95-99",19,52,71
"14390","KILIFI","KILIFI SOUTH","100+",8,28,36
"14391","KILIFI","KILIFI SOUTH","Not Stated",1,1,2
"14392","KILIFI","MAGARINI","Total",93302,98308,191610
"14393","KILIFI","MAGARINI","0",2474,2405,4879
"14394","KILIFI","MAGARINI","1",2894,2728,5622
"14395","KILIFI","MAGARINI","2",2801,2803,5604
"14396","KILIFI","MAGARINI","3",3014,3054,6068
"14397","KILIFI","MAGARINI","4",3219,3143,6362
"14398","KILIFI","MAGARINI","0 - 4",14402,14133,28535
"14399","KILIFI","MAGARINI","5",3233,3240,6473
"14400","KILIFI","MAGARINI","6",3157,3184,6341
"14401","KILIFI","MAGARINI","7",2863,2938,5801
"14402","KILIFI","MAGARINI","8",3028,3019,6047
"14403","KILIFI","MAGARINI","9",3061,2988,6049
"14404","KILIFI","MAGARINI","5-9",15342,15369,30711
"14405","KILIFI","MAGARINI","10",3282,3163,6445
"14406","KILIFI","MAGARINI","11",2974,3054,6028
"14407","KILIFI","MAGARINI","12",3198,3159,6357
"14408","KILIFI","MAGARINI","13",3085,3094,6179
"14409","KILIFI","MAGARINI","14",2841,2849,5690
"14410","KILIFI","MAGARINI","10 -14",15380,15319,30699
"14411","KILIFI","MAGARINI","15",2759,2720,5479
"14412","KILIFI","MAGARINI","16",2588,2548,5136
"14413","KILIFI","MAGARINI","17",2675,2290,4965
"14414","KILIFI","MAGARINI","18",2353,2105,4458
"14415","KILIFI","MAGARINI","19",2292,2122,4414
"14416","KILIFI","MAGARINI","15-19",12667,11785,24452
"14417","KILIFI","MAGARINI","20",2115,2028,4143
"14418","KILIFI","MAGARINI","21",1560,1621,3181
"14419","KILIFI","MAGARINI","22",1548,1596,3144
"14420","KILIFI","MAGARINI","23",1488,1606,3094
"14421","KILIFI","MAGARINI","24",1186,1348,2534
"14422","KILIFI","MAGARINI","20-24",7897,8199,16096
"14423","KILIFI","MAGARINI","25",1409,1552,2961
"14424","KILIFI","MAGARINI","26",1108,1368,2476
"14425","KILIFI","MAGARINI","27",1050,1258,2308
"14426","KILIFI","MAGARINI","28",854,1186,2040
"14427","KILIFI","MAGARINI","29",855,1091,1946
"14428","KILIFI","MAGARINI","25-29",5276,6455,11731
"14429","KILIFI","MAGARINI","30",1056,1417,2473
"14430","KILIFI","MAGARINI","31",767,1131,1898
"14431","KILIFI","MAGARINI","32",922,1407,2329
"14432","KILIFI","MAGARINI","33",776,1065,1841
"14433","KILIFI","MAGARINI","34",775,1217,1992
"14434","KILIFI","MAGARINI","30-34",4296,6237,10533
"14435","KILIFI","MAGARINI","35",925,980,1905
"14436","KILIFI","MAGARINI","36",606,627,1233
"14437","KILIFI","MAGARINI","37",605,536,1141
"14438","KILIFI","MAGARINI","38",397,408,805
"14439","KILIFI","MAGARINI","39",521,482,1003
"14440","KILIFI","MAGARINI","35-39",3054,3033,6087
"14441","KILIFI","MAGARINI","40",728,749,1477
"14442","KILIFI","MAGARINI","41",785,1196,1981
"14443","KILIFI","MAGARINI","42",640,993,1633
"14444","KILIFI","MAGARINI","43",514,846,1360
"14445","KILIFI","MAGARINI","44",570,680,1250
"14446","KILIFI","MAGARINI","40-44",3237,4464,7701
"14447","KILIFI","MAGARINI","45",816,897,1713
"14448","KILIFI","MAGARINI","46",517,504,1021
"14449","KILIFI","MAGARINI","47",512,482,994
"14450","KILIFI","MAGARINI","48",454,394,848
"14451","KILIFI","MAGARINI","49",452,439,891
"14452","KILIFI","MAGARINI","45-49",2751,2716,5467
"14453","KILIFI","MAGARINI","50",689,790,1479
"14454","KILIFI","MAGARINI","51",465,521,986
"14455","KILIFI","MAGARINI","52",424,396,820
"14456","KILIFI","MAGARINI","53",313,248,561
"14457","KILIFI","MAGARINI","54",347,241,588
"14458","KILIFI","MAGARINI","50-54",2238,2196,4434
"14459","KILIFI","MAGARINI","55",360,237,597
"14460","KILIFI","MAGARINI","56",335,287,622
"14461","KILIFI","MAGARINI","57",340,401,741
"14462","KILIFI","MAGARINI","58",338,349,687
"14463","KILIFI","MAGARINI","59",359,532,891
"14464","KILIFI","MAGARINI","55-59",1732,1806,3538
"14465","KILIFI","MAGARINI","60",399,706,1105
"14466","KILIFI","MAGARINI","61",299,491,790
"14467","KILIFI","MAGARINI","62",278,405,683
"14468","KILIFI","MAGARINI","63",269,447,716
"14469","KILIFI","MAGARINI","64",219,277,496
"14470","KILIFI","MAGARINI","60-64",1464,2326,3790
"14471","KILIFI","MAGARINI","65",378,464,842
"14472","KILIFI","MAGARINI","66",241,202,443
"14473","KILIFI","MAGARINI","67",326,334,660
"14474","KILIFI","MAGARINI","68",203,170,373
"14475","KILIFI","MAGARINI","69",287,427,714
"14476","KILIFI","MAGARINI","65-69",1435,1597,3032
"14477","KILIFI","MAGARINI","70",316,525,841
"14478","KILIFI","MAGARINI","71",232,231,463
"14479","KILIFI","MAGARINI","72",174,139,313
"14480","KILIFI","MAGARINI","73",108,109,217
"14481","KILIFI","MAGARINI","74",124,176,300
"14482","KILIFI","MAGARINI","70-74",954,1180,2134
"14483","KILIFI","MAGARINI","75",134,129,263
"14484","KILIFI","MAGARINI","76",79,75,154
"14485","KILIFI","MAGARINI","77",97,93,190
"14486","KILIFI","MAGARINI","78",62,51,113
"14487","KILIFI","MAGARINI","79",146,206,352
"14488","KILIFI","MAGARINI","75-79",518,554,1072
"14489","KILIFI","MAGARINI","80",116,208,324
"14490","KILIFI","MAGARINI","81",47,86,133
"14491","KILIFI","MAGARINI","82",38,46,84
"14492","KILIFI","MAGARINI","83",64,72,136
"14493","KILIFI","MAGARINI","84",60,74,134
"14494","KILIFI","MAGARINI","80-84",325,486,811
"14495","KILIFI","MAGARINI","85",53,69,122
"14496","KILIFI","MAGARINI","86",18,26,44
"14497","KILIFI","MAGARINI","87",42,53,95
"14498","KILIFI","MAGARINI","88",14,18,32
"14499","KILIFI","MAGARINI","89",67,97,164
"14500","KILIFI","MAGARINI","85-89",194,263,457
"14501","KILIFI","MAGARINI","90",30,40,70
"14502","KILIFI","MAGARINI","91",13,12,25
"14503","KILIFI","MAGARINI","92",5,9,14
"14504","KILIFI","MAGARINI","93",7,10,17
"14505","KILIFI","MAGARINI","94",11,13,24
"14506","KILIFI","MAGARINI","90-94",66,84,150
"14507","KILIFI","MAGARINI","95",11,23,34
"14508","KILIFI","MAGARINI","96",3,3,6
"14509","KILIFI","MAGARINI","97",9,4,13
"14510","KILIFI","MAGARINI","98",9,5,14
"14511","KILIFI","MAGARINI","99",14,29,43
"14512","KILIFI","MAGARINI","95-99",46,64,110
"14513","KILIFI","MAGARINI","100+",28,41,69
"14514","KILIFI","MAGARINI","Not Stated",NA,1,1
"14515","KILIFI","MALINDI","Total",163351,169866,333217
"14516","KILIFI","MALINDI","0",4335,4374,8709
"14517","KILIFI","MALINDI","1",4338,4202,8540
"14518","KILIFI","MALINDI","2",4466,4259,8725
"14519","KILIFI","MALINDI","3",4550,4567,9117
"14520","KILIFI","MALINDI","4",4793,4702,9495
"14521","KILIFI","MALINDI","0 - 4",22482,22104,44586
"14522","KILIFI","MALINDI","5",4714,4668,9382
"14523","KILIFI","MALINDI","6",4521,4597,9118
"14524","KILIFI","MALINDI","7",4404,4260,8664
"14525","KILIFI","MALINDI","8",4138,4140,8278
"14526","KILIFI","MALINDI","9",4408,4326,8734
"14527","KILIFI","MALINDI","5-9",22185,21991,44176
"14528","KILIFI","MALINDI","10",4700,4549,9249
"14529","KILIFI","MALINDI","11",4188,4341,8529
"14530","KILIFI","MALINDI","12",4553,4352,8905
"14531","KILIFI","MALINDI","13",4411,4585,8996
"14532","KILIFI","MALINDI","14",4073,4019,8092
"14533","KILIFI","MALINDI","10 -14",21925,21846,43771
"14534","KILIFI","MALINDI","15",3969,3938,7907
"14535","KILIFI","MALINDI","16",3775,3845,7620
"14536","KILIFI","MALINDI","17",3891,3884,7775
"14537","KILIFI","MALINDI","18",3435,3478,6913
"14538","KILIFI","MALINDI","19",3863,3773,7636
"14539","KILIFI","MALINDI","15-19",18933,18918,37851
"14540","KILIFI","MALINDI","20",3495,3974,7469
"14541","KILIFI","MALINDI","21",2848,3269,6117
"14542","KILIFI","MALINDI","22",3078,3562,6640
"14543","KILIFI","MALINDI","23",3096,3632,6728
"14544","KILIFI","MALINDI","24",2862,3298,6160
"14545","KILIFI","MALINDI","20-24",15379,17735,33114
"14546","KILIFI","MALINDI","25",3256,3555,6811
"14547","KILIFI","MALINDI","26",2758,3200,5958
"14548","KILIFI","MALINDI","27",2695,3066,5761
"14549","KILIFI","MALINDI","28",2400,2805,5205
"14550","KILIFI","MALINDI","29",2356,2706,5062
"14551","KILIFI","MALINDI","25-29",13465,15332,28797
"14552","KILIFI","MALINDI","30",2977,3407,6384
"14553","KILIFI","MALINDI","31",1931,2450,4381
"14554","KILIFI","MALINDI","32",2468,2983,5451
"14555","KILIFI","MALINDI","33",1954,2360,4314
"14556","KILIFI","MALINDI","34",1935,2355,4290
"14557","KILIFI","MALINDI","30-34",11265,13555,24820
"14558","KILIFI","MALINDI","35",2488,2454,4942
"14559","KILIFI","MALINDI","36",1583,1662,3245
"14560","KILIFI","MALINDI","37",1666,1459,3125
"14561","KILIFI","MALINDI","38",1297,1239,2536
"14562","KILIFI","MALINDI","39",1403,1177,2580
"14563","KILIFI","MALINDI","35-39",8437,7991,16428
"14564","KILIFI","MALINDI","40",1872,1582,3454
"14565","KILIFI","MALINDI","41",1753,2022,3775
"14566","KILIFI","MALINDI","42",1580,1905,3485
"14567","KILIFI","MALINDI","43",1276,1618,2894
"14568","KILIFI","MALINDI","44",1180,1201,2381
"14569","KILIFI","MALINDI","40-44",7661,8328,15989
"14570","KILIFI","MALINDI","45",1834,1612,3446
"14571","KILIFI","MALINDI","46",1124,949,2073
"14572","KILIFI","MALINDI","47",1350,1035,2385
"14573","KILIFI","MALINDI","48",968,810,1778
"14574","KILIFI","MALINDI","49",1078,841,1919
"14575","KILIFI","MALINDI","45-49",6354,5247,11601
"14576","KILIFI","MALINDI","50",1374,1364,2738
"14577","KILIFI","MALINDI","51",979,846,1825
"14578","KILIFI","MALINDI","52",836,765,1601
"14579","KILIFI","MALINDI","53",598,446,1044
"14580","KILIFI","MALINDI","54",772,556,1328
"14581","KILIFI","MALINDI","50-54",4559,3977,8536
"14582","KILIFI","MALINDI","55",646,537,1183
"14583","KILIFI","MALINDI","56",793,662,1455
"14584","KILIFI","MALINDI","57",657,666,1323
"14585","KILIFI","MALINDI","58",611,542,1153
"14586","KILIFI","MALINDI","59",631,825,1456
"14587","KILIFI","MALINDI","55-59",3338,3232,6570
"14588","KILIFI","MALINDI","60",750,1055,1805
"14589","KILIFI","MALINDI","61",486,726,1212
"14590","KILIFI","MALINDI","62",466,623,1089
"14591","KILIFI","MALINDI","63",500,657,1157
"14592","KILIFI","MALINDI","64",365,490,855
"14593","KILIFI","MALINDI","60-64",2567,3551,6118
"14594","KILIFI","MALINDI","65",576,653,1229
"14595","KILIFI","MALINDI","66",341,338,679
"14596","KILIFI","MALINDI","67",476,466,942
"14597","KILIFI","MALINDI","68",256,240,496
"14598","KILIFI","MALINDI","69",361,545,906
"14599","KILIFI","MALINDI","65-69",2010,2242,4252
"14600","KILIFI","MALINDI","70",400,620,1020
"14601","KILIFI","MALINDI","71",291,357,648
"14602","KILIFI","MALINDI","72",217,214,431
"14603","KILIFI","MALINDI","73",200,224,424
"14604","KILIFI","MALINDI","74",214,265,479
"14605","KILIFI","MALINDI","70-74",1322,1680,3002
"14606","KILIFI","MALINDI","75",184,216,400
"14607","KILIFI","MALINDI","76",137,130,267
"14608","KILIFI","MALINDI","77",124,155,279
"14609","KILIFI","MALINDI","78",114,70,184
"14610","KILIFI","MALINDI","79",145,245,390
"14611","KILIFI","MALINDI","75-79",704,816,1520
"14612","KILIFI","MALINDI","80",146,285,431
"14613","KILIFI","MALINDI","81",75,127,202
"14614","KILIFI","MALINDI","82",54,72,126
"14615","KILIFI","MALINDI","83",58,96,154
"14616","KILIFI","MALINDI","84",58,100,158
"14617","KILIFI","MALINDI","80-84",391,680,1071
"14618","KILIFI","MALINDI","85",58,100,158
"14619","KILIFI","MALINDI","86",24,40,64
"14620","KILIFI","MALINDI","87",31,69,100
"14621","KILIFI","MALINDI","88",30,27,57
"14622","KILIFI","MALINDI","89",49,115,164
"14623","KILIFI","MALINDI","85-89",192,351,543
"14624","KILIFI","MALINDI","90",39,71,110
"14625","KILIFI","MALINDI","91",23,31,54
"14626","KILIFI","MALINDI","92",10,22,32
"14627","KILIFI","MALINDI","93",10,22,32
"14628","KILIFI","MALINDI","94",9,13,22
"14629","KILIFI","MALINDI","90-94",91,159,250
"14630","KILIFI","MALINDI","95",20,20,40
"14631","KILIFI","MALINDI","96",8,7,15
"14632","KILIFI","MALINDI","97",10,7,17
"14633","KILIFI","MALINDI","98",5,11,16
"14634","KILIFI","MALINDI","99",19,22,41
"14635","KILIFI","MALINDI","95-99",62,67,129
"14636","KILIFI","MALINDI","100+",28,59,87
"14637","KILIFI","MALINDI","Not Stated",1,5,6
"14638","KILIFI","RABAI","Total",58571,62242,120813
"14639","KILIFI","RABAI","0",1454,1411,2865
"14640","KILIFI","RABAI","1",1616,1566,3182
"14641","KILIFI","RABAI","2",1537,1549,3086
"14642","KILIFI","RABAI","3",1586,1581,3167
"14643","KILIFI","RABAI","4",1596,1623,3219
"14644","KILIFI","RABAI","0 - 4",7789,7730,15519
"14645","KILIFI","RABAI","5",1738,1709,3447
"14646","KILIFI","RABAI","6",1590,1522,3112
"14647","KILIFI","RABAI","7",1683,1561,3244
"14648","KILIFI","RABAI","8",1565,1571,3136
"14649","KILIFI","RABAI","9",1590,1550,3140
"14650","KILIFI","RABAI","5-9",8166,7913,16079
"14651","KILIFI","RABAI","10",1734,1694,3428
"14652","KILIFI","RABAI","11",1567,1586,3153
"14653","KILIFI","RABAI","12",1643,1660,3303
"14654","KILIFI","RABAI","13",1737,1828,3565
"14655","KILIFI","RABAI","14",1592,1596,3188
"14656","KILIFI","RABAI","10 -14",8273,8364,16637
"14657","KILIFI","RABAI","15",1525,1467,2992
"14658","KILIFI","RABAI","16",1431,1483,2914
"14659","KILIFI","RABAI","17",1509,1419,2928
"14660","KILIFI","RABAI","18",1305,1235,2540
"14661","KILIFI","RABAI","19",1407,1356,2763
"14662","KILIFI","RABAI","15-19",7177,6960,14137
"14663","KILIFI","RABAI","20",1282,1325,2607
"14664","KILIFI","RABAI","21",1033,1013,2046
"14665","KILIFI","RABAI","22",1037,1121,2158
"14666","KILIFI","RABAI","23",1024,1155,2179
"14667","KILIFI","RABAI","24",867,980,1847
"14668","KILIFI","RABAI","20-24",5243,5594,10837
"14669","KILIFI","RABAI","25",959,1124,2083
"14670","KILIFI","RABAI","26",888,1054,1942
"14671","KILIFI","RABAI","27",850,1027,1877
"14672","KILIFI","RABAI","28",695,871,1566
"14673","KILIFI","RABAI","29",766,944,1710
"14674","KILIFI","RABAI","25-29",4158,5020,9178
"14675","KILIFI","RABAI","30",923,1182,2105
"14676","KILIFI","RABAI","31",609,803,1412
"14677","KILIFI","RABAI","32",706,880,1586
"14678","KILIFI","RABAI","33",660,739,1399
"14679","KILIFI","RABAI","34",564,692,1256
"14680","KILIFI","RABAI","30-34",3462,4296,7758
"14681","KILIFI","RABAI","35",727,854,1581
"14682","KILIFI","RABAI","36",576,651,1227
"14683","KILIFI","RABAI","37",584,603,1187
"14684","KILIFI","RABAI","38",431,411,842
"14685","KILIFI","RABAI","39",474,492,966
"14686","KILIFI","RABAI","35-39",2792,3011,5803
"14687","KILIFI","RABAI","40",590,553,1143
"14688","KILIFI","RABAI","41",598,717,1315
"14689","KILIFI","RABAI","42",584,675,1259
"14690","KILIFI","RABAI","43",471,537,1008
"14691","KILIFI","RABAI","44",415,420,835
"14692","KILIFI","RABAI","40-44",2658,2902,5560
"14693","KILIFI","RABAI","45",659,598,1257
"14694","KILIFI","RABAI","46",407,460,867
"14695","KILIFI","RABAI","47",505,432,937
"14696","KILIFI","RABAI","48",305,273,578
"14697","KILIFI","RABAI","49",364,278,642
"14698","KILIFI","RABAI","45-49",2240,2041,4281
"14699","KILIFI","RABAI","50",472,545,1017
"14700","KILIFI","RABAI","51",351,387,738
"14701","KILIFI","RABAI","52",254,283,537
"14702","KILIFI","RABAI","53",215,169,384
"14703","KILIFI","RABAI","54",237,177,414
"14704","KILIFI","RABAI","50-54",1529,1561,3090
"14705","KILIFI","RABAI","55",236,162,398
"14706","KILIFI","RABAI","56",342,341,683
"14707","KILIFI","RABAI","57",377,338,715
"14708","KILIFI","RABAI","58",243,241,484
"14709","KILIFI","RABAI","59",267,513,780
"14710","KILIFI","RABAI","55-59",1465,1595,3060
"14711","KILIFI","RABAI","60",324,579,903
"14712","KILIFI","RABAI","61",249,360,609
"14713","KILIFI","RABAI","62",191,328,519
"14714","KILIFI","RABAI","63",209,416,625
"14715","KILIFI","RABAI","64",209,236,445
"14716","KILIFI","RABAI","60-64",1182,1919,3101
"14717","KILIFI","RABAI","65",310,360,670
"14718","KILIFI","RABAI","66",186,168,354
"14719","KILIFI","RABAI","67",242,246,488
"14720","KILIFI","RABAI","68",126,129,255
"14721","KILIFI","RABAI","69",213,305,518
"14722","KILIFI","RABAI","65-69",1077,1208,2285
"14723","KILIFI","RABAI","70",208,412,620
"14724","KILIFI","RABAI","71",137,200,337
"14725","KILIFI","RABAI","72",110,140,250
"14726","KILIFI","RABAI","73",102,144,246
"14727","KILIFI","RABAI","74",117,154,271
"14728","KILIFI","RABAI","70-74",674,1050,1724
"14729","KILIFI","RABAI","75",95,153,248
"14730","KILIFI","RABAI","76",61,72,133
"14731","KILIFI","RABAI","77",84,78,162
"14732","KILIFI","RABAI","78",44,54,98
"14733","KILIFI","RABAI","79",85,99,184
"14734","KILIFI","RABAI","75-79",369,456,825
"14735","KILIFI","RABAI","80",62,155,217
"14736","KILIFI","RABAI","81",30,55,85
"14737","KILIFI","RABAI","82",31,39,70
"14738","KILIFI","RABAI","83",20,30,50
"14739","KILIFI","RABAI","84",33,55,88
"14740","KILIFI","RABAI","80-84",176,334,510
"14741","KILIFI","RABAI","85",18,41,59
"14742","KILIFI","RABAI","86",14,14,28
"14743","KILIFI","RABAI","87",20,23,43
"14744","KILIFI","RABAI","88",7,18,25
"14745","KILIFI","RABAI","89",27,76,103
"14746","KILIFI","RABAI","85-89",86,172,258
"14747","KILIFI","RABAI","90",6,28,34
"14748","KILIFI","RABAI","91",6,9,15
"14749","KILIFI","RABAI","92",10,9,19
"14750","KILIFI","RABAI","93",4,9,13
"14751","KILIFI","RABAI","94",4,6,10
"14752","KILIFI","RABAI","90-94",30,61,91
"14753","KILIFI","RABAI","95",7,14,21
"14754","KILIFI","RABAI","96",2,5,7
"14755","KILIFI","RABAI","97",4,2,6
"14756","KILIFI","RABAI","98",4,5,9
"14757","KILIFI","RABAI","99",3,14,17
"14758","KILIFI","RABAI","95-99",20,40,60
"14759","KILIFI","RABAI","100+",4,15,19
"14760","KILIFI","RABAI","Not Stated",1,NA,1
"14761","KIRINYAGA","ALL","Total",302011,308369,610380
"14762","KIRINYAGA","ALL","0",6108,5865,11973
"14763","KIRINYAGA","ALL","1",5654,5623,11277
"14764","KIRINYAGA","ALL","2",5622,5637,11259
"14765","KIRINYAGA","ALL","3",5898,5835,11733
"14766","KIRINYAGA","ALL","4",5554,5695,11249
"14767","KIRINYAGA","ALL","0 - 4",28836,28655,57491
"14768","KIRINYAGA","ALL","5",5620,5427,11047
"14769","KIRINYAGA","ALL","6",5404,5575,10979
"14770","KIRINYAGA","ALL","7",5877,5886,11763
"14771","KIRINYAGA","ALL","8",5669,5538,11207
"14772","KIRINYAGA","ALL","9",6179,6110,12289
"14773","KIRINYAGA","ALL","5-9",28749,28536,57285
"14774","KIRINYAGA","ALL","10",6057,6010,12067
"14775","KIRINYAGA","ALL","11",5654,5816,11470
"14776","KIRINYAGA","ALL","12",6269,6035,12304
"14777","KIRINYAGA","ALL","13",6471,6379,12850
"14778","KIRINYAGA","ALL","14",6150,6155,12305
"14779","KIRINYAGA","ALL","10 -14",30601,30395,60996
"14780","KIRINYAGA","ALL","15",6229,6256,12485
"14781","KIRINYAGA","ALL","16",6236,6114,12350
"14782","KIRINYAGA","ALL","17",6418,6044,12462
"14783","KIRINYAGA","ALL","18",5373,4971,10344
"14784","KIRINYAGA","ALL","19",5381,5047,10428
"14785","KIRINYAGA","ALL","15-19",29637,28432,58069
"14786","KIRINYAGA","ALL","20",4932,4940,9872
"14787","KIRINYAGA","ALL","21",4465,4517,8982
"14788","KIRINYAGA","ALL","22",4580,4655,9235
"14789","KIRINYAGA","ALL","23",4637,5007,9644
"14790","KIRINYAGA","ALL","24",4428,4467,8895
"14791","KIRINYAGA","ALL","20-24",23042,23586,46628
"14792","KIRINYAGA","ALL","25",4649,4619,9268
"14793","KIRINYAGA","ALL","26",3812,4032,7844
"14794","KIRINYAGA","ALL","27",4191,4241,8432
"14795","KIRINYAGA","ALL","28",3863,4093,7956
"14796","KIRINYAGA","ALL","29",4206,4448,8654
"14797","KIRINYAGA","ALL","25-29",20721,21433,42154
"14798","KIRINYAGA","ALL","30",5565,5765,11330
"14799","KIRINYAGA","ALL","31",4122,4243,8365
"14800","KIRINYAGA","ALL","32",5195,5658,10853
"14801","KIRINYAGA","ALL","33",4897,5227,10124
"14802","KIRINYAGA","ALL","34",4335,4741,9076
"14803","KIRINYAGA","ALL","30-34",24114,25634,49748
"14804","KIRINYAGA","ALL","35",6160,6170,12330
"14805","KIRINYAGA","ALL","36",4643,4761,9404
"14806","KIRINYAGA","ALL","37",4865,4583,9448
"14807","KIRINYAGA","ALL","38",4237,4425,8662
"14808","KIRINYAGA","ALL","39",4617,4759,9376
"14809","KIRINYAGA","ALL","35-39",24522,24698,49220
"14810","KIRINYAGA","ALL","40",5482,5435,10917
"14811","KIRINYAGA","ALL","41",4440,4235,8675
"14812","KIRINYAGA","ALL","42",4253,4177,8430
"14813","KIRINYAGA","ALL","43",3803,3830,7633
"14814","KIRINYAGA","ALL","44",3643,3477,7120
"14815","KIRINYAGA","ALL","40-44",21621,21154,42775
"14816","KIRINYAGA","ALL","45",4775,4797,9572
"14817","KIRINYAGA","ALL","46",3679,3503,7182
"14818","KIRINYAGA","ALL","47",3704,3407,7111
"14819","KIRINYAGA","ALL","48",2891,2860,5751
"14820","KIRINYAGA","ALL","49",3204,3147,6351
"14821","KIRINYAGA","ALL","45-49",18253,17714,35967
"14822","KIRINYAGA","ALL","50",3912,4013,7925
"14823","KIRINYAGA","ALL","51",3081,2920,6001
"14824","KIRINYAGA","ALL","52",3018,2843,5861
"14825","KIRINYAGA","ALL","53",2199,2352,4551
"14826","KIRINYAGA","ALL","54",2729,2445,5174
"14827","KIRINYAGA","ALL","50-54",14939,14573,29512
"14828","KIRINYAGA","ALL","55",2886,2783,5669
"14829","KIRINYAGA","ALL","56",3084,2844,5928
"14830","KIRINYAGA","ALL","57",2288,2524,4812
"14831","KIRINYAGA","ALL","58",1960,1977,3937
"14832","KIRINYAGA","ALL","59",2278,2357,4635
"14833","KIRINYAGA","ALL","55-59",12496,12485,24981
"14834","KIRINYAGA","ALL","60",2385,2434,4819
"14835","KIRINYAGA","ALL","61",1807,1845,3652
"14836","KIRINYAGA","ALL","62",1533,1413,2946
"14837","KIRINYAGA","ALL","63",1301,1361,2662
"14838","KIRINYAGA","ALL","64",892,903,1795
"14839","KIRINYAGA","ALL","60-64",7918,7956,15874
"14840","KIRINYAGA","ALL","65",1508,1882,3390
"14841","KIRINYAGA","ALL","66",1032,1037,2069
"14842","KIRINYAGA","ALL","67",1776,1845,3621
"14843","KIRINYAGA","ALL","68",947,880,1827
"14844","KIRINYAGA","ALL","69",1182,1338,2520
"14845","KIRINYAGA","ALL","65-69",6445,6982,13427
"14846","KIRINYAGA","ALL","70",1427,2271,3698
"14847","KIRINYAGA","ALL","71",980,1313,2293
"14848","KIRINYAGA","ALL","72",868,902,1770
"14849","KIRINYAGA","ALL","73",694,705,1399
"14850","KIRINYAGA","ALL","74",662,862,1524
"14851","KIRINYAGA","ALL","70-74",4631,6053,10684
"14852","KIRINYAGA","ALL","75",536,860,1396
"14853","KIRINYAGA","ALL","76",436,632,1068
"14854","KIRINYAGA","ALL","77",485,626,1111
"14855","KIRINYAGA","ALL","78",359,370,729
"14856","KIRINYAGA","ALL","79",409,751,1160
"14857","KIRINYAGA","ALL","75-79",2225,3239,5464
"14858","KIRINYAGA","ALL","80",588,1186,1774
"14859","KIRINYAGA","ALL","81",223,536,759
"14860","KIRINYAGA","ALL","82",231,300,531
"14861","KIRINYAGA","ALL","83",253,389,642
"14862","KIRINYAGA","ALL","84",252,481,733
"14863","KIRINYAGA","ALL","80-84",1547,2892,4439
"14864","KIRINYAGA","ALL","85",240,418,658
"14865","KIRINYAGA","ALL","86",184,248,432
"14866","KIRINYAGA","ALL","87",178,238,416
"14867","KIRINYAGA","ALL","88",105,142,247
"14868","KIRINYAGA","ALL","89",209,564,773
"14869","KIRINYAGA","ALL","85-89",916,1610,2526
"14870","KIRINYAGA","ALL","90",132,435,567
"14871","KIRINYAGA","ALL","91",161,384,545
"14872","KIRINYAGA","ALL","92",55,133,188
"14873","KIRINYAGA","ALL","93",63,122,185
"14874","KIRINYAGA","ALL","94",48,149,197
"14875","KIRINYAGA","ALL","90-94",459,1223,1682
"14876","KIRINYAGA","ALL","95",64,208,272
"14877","KIRINYAGA","ALL","96",39,84,123
"14878","KIRINYAGA","ALL","97",49,85,134
"14879","KIRINYAGA","ALL","98",28,59,87
"14880","KIRINYAGA","ALL","99",40,188,228
"14881","KIRINYAGA","ALL","95-99",220,624,844
"14882","KIRINYAGA","ALL","100+",115,490,605
"14883","KIRINYAGA","ALL","Not Stated",4,5,9
"14884","KIRINYAGA","KIRINYAGA CENTRAL","Total",60118,62617,122735
"14885","KIRINYAGA","KIRINYAGA CENTRAL","0",1161,1143,2304
"14886","KIRINYAGA","KIRINYAGA CENTRAL","1",1096,1139,2235
"14887","KIRINYAGA","KIRINYAGA CENTRAL","2",1065,1096,2161
"14888","KIRINYAGA","KIRINYAGA CENTRAL","3",1155,1148,2303
"14889","KIRINYAGA","KIRINYAGA CENTRAL","4",1102,1152,2254
"14890","KIRINYAGA","KIRINYAGA CENTRAL","0 - 4",5579,5678,11257
"14891","KIRINYAGA","KIRINYAGA CENTRAL","5",1117,1024,2141
"14892","KIRINYAGA","KIRINYAGA CENTRAL","6",1030,1039,2069
"14893","KIRINYAGA","KIRINYAGA CENTRAL","7",1105,1105,2210
"14894","KIRINYAGA","KIRINYAGA CENTRAL","8",1099,1048,2147
"14895","KIRINYAGA","KIRINYAGA CENTRAL","9",1043,1123,2166
"14896","KIRINYAGA","KIRINYAGA CENTRAL","5-9",5394,5339,10733
"14897","KIRINYAGA","KIRINYAGA CENTRAL","10",1120,1111,2231
"14898","KIRINYAGA","KIRINYAGA CENTRAL","11",1110,1125,2235
"14899","KIRINYAGA","KIRINYAGA CENTRAL","12",1203,1172,2375
"14900","KIRINYAGA","KIRINYAGA CENTRAL","13",1198,1211,2409
"14901","KIRINYAGA","KIRINYAGA CENTRAL","14",1172,1219,2391
"14902","KIRINYAGA","KIRINYAGA CENTRAL","10 -14",5803,5838,11641
"14903","KIRINYAGA","KIRINYAGA CENTRAL","15",1208,1237,2445
"14904","KIRINYAGA","KIRINYAGA CENTRAL","16",1254,1193,2447
"14905","KIRINYAGA","KIRINYAGA CENTRAL","17",1317,1283,2600
"14906","KIRINYAGA","KIRINYAGA CENTRAL","18",1044,1019,2063
"14907","KIRINYAGA","KIRINYAGA CENTRAL","19",1073,978,2051
"14908","KIRINYAGA","KIRINYAGA CENTRAL","15-19",5896,5710,11606
"14909","KIRINYAGA","KIRINYAGA CENTRAL","20",964,985,1949
"14910","KIRINYAGA","KIRINYAGA CENTRAL","21",914,928,1842
"14911","KIRINYAGA","KIRINYAGA CENTRAL","22",937,978,1915
"14912","KIRINYAGA","KIRINYAGA CENTRAL","23",894,986,1880
"14913","KIRINYAGA","KIRINYAGA CENTRAL","24",904,936,1840
"14914","KIRINYAGA","KIRINYAGA CENTRAL","20-24",4613,4813,9426
"14915","KIRINYAGA","KIRINYAGA CENTRAL","25",896,959,1855
"14916","KIRINYAGA","KIRINYAGA CENTRAL","26",779,790,1569
"14917","KIRINYAGA","KIRINYAGA CENTRAL","27",826,807,1633
"14918","KIRINYAGA","KIRINYAGA CENTRAL","28",768,817,1585
"14919","KIRINYAGA","KIRINYAGA CENTRAL","29",861,851,1712
"14920","KIRINYAGA","KIRINYAGA CENTRAL","25-29",4130,4224,8354
"14921","KIRINYAGA","KIRINYAGA CENTRAL","30",1067,1132,2199
"14922","KIRINYAGA","KIRINYAGA CENTRAL","31",814,856,1670
"14923","KIRINYAGA","KIRINYAGA CENTRAL","32",1040,1130,2170
"14924","KIRINYAGA","KIRINYAGA CENTRAL","33",975,1077,2052
"14925","KIRINYAGA","KIRINYAGA CENTRAL","34",868,930,1798
"14926","KIRINYAGA","KIRINYAGA CENTRAL","30-34",4764,5125,9889
"14927","KIRINYAGA","KIRINYAGA CENTRAL","35",1147,1217,2364
"14928","KIRINYAGA","KIRINYAGA CENTRAL","36",896,978,1874
"14929","KIRINYAGA","KIRINYAGA CENTRAL","37",1064,948,2012
"14930","KIRINYAGA","KIRINYAGA CENTRAL","38",924,923,1847
"14931","KIRINYAGA","KIRINYAGA CENTRAL","39",919,998,1917
"14932","KIRINYAGA","KIRINYAGA CENTRAL","35-39",4950,5064,10014
"14933","KIRINYAGA","KIRINYAGA CENTRAL","40",1120,1118,2238
"14934","KIRINYAGA","KIRINYAGA CENTRAL","41",910,873,1783
"14935","KIRINYAGA","KIRINYAGA CENTRAL","42",822,845,1667
"14936","KIRINYAGA","KIRINYAGA CENTRAL","43",737,814,1551
"14937","KIRINYAGA","KIRINYAGA CENTRAL","44",726,681,1407
"14938","KIRINYAGA","KIRINYAGA CENTRAL","40-44",4315,4331,8646
"14939","KIRINYAGA","KIRINYAGA CENTRAL","45",995,979,1974
"14940","KIRINYAGA","KIRINYAGA CENTRAL","46",721,696,1417
"14941","KIRINYAGA","KIRINYAGA CENTRAL","47",702,737,1439
"14942","KIRINYAGA","KIRINYAGA CENTRAL","48",596,573,1169
"14943","KIRINYAGA","KIRINYAGA CENTRAL","49",646,639,1285
"14944","KIRINYAGA","KIRINYAGA CENTRAL","45-49",3660,3624,7284
"14945","KIRINYAGA","KIRINYAGA CENTRAL","50",847,838,1685
"14946","KIRINYAGA","KIRINYAGA CENTRAL","51",641,630,1271
"14947","KIRINYAGA","KIRINYAGA CENTRAL","52",590,582,1172
"14948","KIRINYAGA","KIRINYAGA CENTRAL","53",472,563,1035
"14949","KIRINYAGA","KIRINYAGA CENTRAL","54",528,565,1093
"14950","KIRINYAGA","KIRINYAGA CENTRAL","50-54",3078,3178,6256
"14951","KIRINYAGA","KIRINYAGA CENTRAL","55",579,629,1208
"14952","KIRINYAGA","KIRINYAGA CENTRAL","56",603,598,1201
"14953","KIRINYAGA","KIRINYAGA CENTRAL","57",469,579,1048
"14954","KIRINYAGA","KIRINYAGA CENTRAL","58",379,422,801
"14955","KIRINYAGA","KIRINYAGA CENTRAL","59",492,529,1021
"14956","KIRINYAGA","KIRINYAGA CENTRAL","55-59",2522,2757,5279
"14957","KIRINYAGA","KIRINYAGA CENTRAL","60",516,582,1098
"14958","KIRINYAGA","KIRINYAGA CENTRAL","61",391,425,816
"14959","KIRINYAGA","KIRINYAGA CENTRAL","62",356,281,637
"14960","KIRINYAGA","KIRINYAGA CENTRAL","63",328,293,621
"14961","KIRINYAGA","KIRINYAGA CENTRAL","64",189,199,388
"14962","KIRINYAGA","KIRINYAGA CENTRAL","60-64",1780,1780,3560
"14963","KIRINYAGA","KIRINYAGA CENTRAL","65",338,448,786
"14964","KIRINYAGA","KIRINYAGA CENTRAL","66",239,244,483
"14965","KIRINYAGA","KIRINYAGA CENTRAL","67",377,401,778
"14966","KIRINYAGA","KIRINYAGA CENTRAL","68",223,171,394
"14967","KIRINYAGA","KIRINYAGA CENTRAL","69",235,263,498
"14968","KIRINYAGA","KIRINYAGA CENTRAL","65-69",1412,1527,2939
"14969","KIRINYAGA","KIRINYAGA CENTRAL","70",331,502,833
"14970","KIRINYAGA","KIRINYAGA CENTRAL","71",207,273,480
"14971","KIRINYAGA","KIRINYAGA CENTRAL","72",196,192,388
"14972","KIRINYAGA","KIRINYAGA CENTRAL","73",162,173,335
"14973","KIRINYAGA","KIRINYAGA CENTRAL","74",153,193,346
"14974","KIRINYAGA","KIRINYAGA CENTRAL","70-74",1049,1333,2382
"14975","KIRINYAGA","KIRINYAGA CENTRAL","75",117,212,329
"14976","KIRINYAGA","KIRINYAGA CENTRAL","76",96,135,231
"14977","KIRINYAGA","KIRINYAGA CENTRAL","77",104,136,240
"14978","KIRINYAGA","KIRINYAGA CENTRAL","78",90,80,170
"14979","KIRINYAGA","KIRINYAGA CENTRAL","79",90,167,257
"14980","KIRINYAGA","KIRINYAGA CENTRAL","75-79",497,730,1227
"14981","KIRINYAGA","KIRINYAGA CENTRAL","80",134,288,422
"14982","KIRINYAGA","KIRINYAGA CENTRAL","81",55,112,167
"14983","KIRINYAGA","KIRINYAGA CENTRAL","82",46,54,100
"14984","KIRINYAGA","KIRINYAGA CENTRAL","83",63,76,139
"14985","KIRINYAGA","KIRINYAGA CENTRAL","84",46,120,166
"14986","KIRINYAGA","KIRINYAGA CENTRAL","80-84",344,650,994
"14987","KIRINYAGA","KIRINYAGA CENTRAL","85",37,86,123
"14988","KIRINYAGA","KIRINYAGA CENTRAL","86",39,56,95
"14989","KIRINYAGA","KIRINYAGA CENTRAL","87",38,43,81
"14990","KIRINYAGA","KIRINYAGA CENTRAL","88",22,33,55
"14991","KIRINYAGA","KIRINYAGA CENTRAL","89",49,143,192
"14992","KIRINYAGA","KIRINYAGA CENTRAL","85-89",185,361,546
"14993","KIRINYAGA","KIRINYAGA CENTRAL","90",20,113,133
"14994","KIRINYAGA","KIRINYAGA CENTRAL","91",25,103,128
"14995","KIRINYAGA","KIRINYAGA CENTRAL","92",16,29,45
"14996","KIRINYAGA","KIRINYAGA CENTRAL","93",12,21,33
"14997","KIRINYAGA","KIRINYAGA CENTRAL","94",8,33,41
"14998","KIRINYAGA","KIRINYAGA CENTRAL","90-94",81,299,380
"14999","KIRINYAGA","KIRINYAGA CENTRAL","95",16,37,53
"15000","KIRINYAGA","KIRINYAGA CENTRAL","96",7,14,21
"15001","KIRINYAGA","KIRINYAGA CENTRAL","97",4,13,17
"15002","KIRINYAGA","KIRINYAGA CENTRAL","98",4,13,17
"15003","KIRINYAGA","KIRINYAGA CENTRAL","99",8,40,48
"15004","KIRINYAGA","KIRINYAGA CENTRAL","95-99",39,117,156
"15005","KIRINYAGA","KIRINYAGA CENTRAL","100+",27,138,165
"15006","KIRINYAGA","KIRINYAGA CENTRAL","Not Stated",NA,1,1
"15007","KIRINYAGA","KIRINYAGA EAST","Total",67037,68514,135551
"15008","KIRINYAGA","KIRINYAGA EAST","0",1204,1187,2391
"15009","KIRINYAGA","KIRINYAGA EAST","1",1145,1209,2354
"15010","KIRINYAGA","KIRINYAGA EAST","2",1180,1205,2385
"15011","KIRINYAGA","KIRINYAGA EAST","3",1224,1266,2490
"15012","KIRINYAGA","KIRINYAGA EAST","4",1145,1189,2334
"15013","KIRINYAGA","KIRINYAGA EAST","0 - 4",5898,6056,11954
"15014","KIRINYAGA","KIRINYAGA EAST","5",1123,1145,2268
"15015","KIRINYAGA","KIRINYAGA EAST","6",1126,1235,2361
"15016","KIRINYAGA","KIRINYAGA EAST","7",1262,1233,2495
"15017","KIRINYAGA","KIRINYAGA EAST","8",1190,1160,2350
"15018","KIRINYAGA","KIRINYAGA EAST","9",1241,1308,2549
"15019","KIRINYAGA","KIRINYAGA EAST","5-9",5942,6081,12023
"15020","KIRINYAGA","KIRINYAGA EAST","10",1274,1352,2626
"15021","KIRINYAGA","KIRINYAGA EAST","11",1215,1249,2464
"15022","KIRINYAGA","KIRINYAGA EAST","12",1338,1309,2647
"15023","KIRINYAGA","KIRINYAGA EAST","13",1461,1353,2814
"15024","KIRINYAGA","KIRINYAGA EAST","14",1391,1360,2751
"15025","KIRINYAGA","KIRINYAGA EAST","10 -14",6679,6623,13302
"15026","KIRINYAGA","KIRINYAGA EAST","15",1414,1361,2775
"15027","KIRINYAGA","KIRINYAGA EAST","16",1368,1333,2701
"15028","KIRINYAGA","KIRINYAGA EAST","17",1372,1225,2597
"15029","KIRINYAGA","KIRINYAGA EAST","18",1178,1002,2180
"15030","KIRINYAGA","KIRINYAGA EAST","19",1096,1055,2151
"15031","KIRINYAGA","KIRINYAGA EAST","15-19",6428,5976,12404
"15032","KIRINYAGA","KIRINYAGA EAST","20",1018,987,2005
"15033","KIRINYAGA","KIRINYAGA EAST","21",933,869,1802
"15034","KIRINYAGA","KIRINYAGA EAST","22",915,871,1786
"15035","KIRINYAGA","KIRINYAGA EAST","23",947,1000,1947
"15036","KIRINYAGA","KIRINYAGA EAST","24",883,867,1750
"15037","KIRINYAGA","KIRINYAGA EAST","20-24",4696,4594,9290
"15038","KIRINYAGA","KIRINYAGA EAST","25",909,805,1714
"15039","KIRINYAGA","KIRINYAGA EAST","26",727,758,1485
"15040","KIRINYAGA","KIRINYAGA EAST","27",804,815,1619
"15041","KIRINYAGA","KIRINYAGA EAST","28",731,790,1521
"15042","KIRINYAGA","KIRINYAGA EAST","29",738,857,1595
"15043","KIRINYAGA","KIRINYAGA EAST","25-29",3909,4025,7934
"15044","KIRINYAGA","KIRINYAGA EAST","30",1103,1104,2207
"15045","KIRINYAGA","KIRINYAGA EAST","31",865,929,1794
"15046","KIRINYAGA","KIRINYAGA EAST","32",1075,1149,2224
"15047","KIRINYAGA","KIRINYAGA EAST","33",1077,1138,2215
"15048","KIRINYAGA","KIRINYAGA EAST","34",985,1072,2057
"15049","KIRINYAGA","KIRINYAGA EAST","30-34",5105,5392,10497
"15050","KIRINYAGA","KIRINYAGA EAST","35",1313,1311,2624
"15051","KIRINYAGA","KIRINYAGA EAST","36",1108,1007,2115
"15052","KIRINYAGA","KIRINYAGA EAST","37",1095,1000,2095
"15053","KIRINYAGA","KIRINYAGA EAST","38",954,981,1935
"15054","KIRINYAGA","KIRINYAGA EAST","39",1122,1070,2192
"15055","KIRINYAGA","KIRINYAGA EAST","35-39",5592,5369,10961
"15056","KIRINYAGA","KIRINYAGA EAST","40",1250,1260,2510
"15057","KIRINYAGA","KIRINYAGA EAST","41",1037,1036,2073
"15058","KIRINYAGA","KIRINYAGA EAST","42",1004,996,2000
"15059","KIRINYAGA","KIRINYAGA EAST","43",949,906,1855
"15060","KIRINYAGA","KIRINYAGA EAST","44",848,843,1691
"15061","KIRINYAGA","KIRINYAGA EAST","40-44",5088,5041,10129
"15062","KIRINYAGA","KIRINYAGA EAST","45",1063,1103,2166
"15063","KIRINYAGA","KIRINYAGA EAST","46",866,814,1680
"15064","KIRINYAGA","KIRINYAGA EAST","47",890,823,1713
"15065","KIRINYAGA","KIRINYAGA EAST","48",708,694,1402
"15066","KIRINYAGA","KIRINYAGA EAST","49",805,750,1555
"15067","KIRINYAGA","KIRINYAGA EAST","45-49",4332,4184,8516
"15068","KIRINYAGA","KIRINYAGA EAST","50",924,1006,1930
"15069","KIRINYAGA","KIRINYAGA EAST","51",815,745,1560
"15070","KIRINYAGA","KIRINYAGA EAST","52",743,707,1450
"15071","KIRINYAGA","KIRINYAGA EAST","53",581,646,1227
"15072","KIRINYAGA","KIRINYAGA EAST","54",728,659,1387
"15073","KIRINYAGA","KIRINYAGA EAST","50-54",3791,3763,7554
"15074","KIRINYAGA","KIRINYAGA EAST","55",744,749,1493
"15075","KIRINYAGA","KIRINYAGA EAST","56",767,733,1500
"15076","KIRINYAGA","KIRINYAGA EAST","57",602,672,1274
"15077","KIRINYAGA","KIRINYAGA EAST","58",525,538,1063
"15078","KIRINYAGA","KIRINYAGA EAST","59",588,621,1209
"15079","KIRINYAGA","KIRINYAGA EAST","55-59",3226,3313,6539
"15080","KIRINYAGA","KIRINYAGA EAST","60",633,621,1254
"15081","KIRINYAGA","KIRINYAGA EAST","61",477,472,949
"15082","KIRINYAGA","KIRINYAGA EAST","62",382,396,778
"15083","KIRINYAGA","KIRINYAGA EAST","63",362,404,766
"15084","KIRINYAGA","KIRINYAGA EAST","64",217,233,450
"15085","KIRINYAGA","KIRINYAGA EAST","60-64",2071,2126,4197
"15086","KIRINYAGA","KIRINYAGA EAST","65",379,488,867
"15087","KIRINYAGA","KIRINYAGA EAST","66",271,273,544
"15088","KIRINYAGA","KIRINYAGA EAST","67",460,465,925
"15089","KIRINYAGA","KIRINYAGA EAST","68",248,235,483
"15090","KIRINYAGA","KIRINYAGA EAST","69",316,386,702
"15091","KIRINYAGA","KIRINYAGA EAST","65-69",1674,1847,3521
"15092","KIRINYAGA","KIRINYAGA EAST","70",374,596,970
"15093","KIRINYAGA","KIRINYAGA EAST","71",270,399,669
"15094","KIRINYAGA","KIRINYAGA EAST","72",199,222,421
"15095","KIRINYAGA","KIRINYAGA EAST","73",162,196,358
"15096","KIRINYAGA","KIRINYAGA EAST","74",149,223,372
"15097","KIRINYAGA","KIRINYAGA EAST","70-74",1154,1636,2790
"15098","KIRINYAGA","KIRINYAGA EAST","75",135,183,318
"15099","KIRINYAGA","KIRINYAGA EAST","76",111,160,271
"15100","KIRINYAGA","KIRINYAGA EAST","77",138,151,289
"15101","KIRINYAGA","KIRINYAGA EAST","78",83,83,166
"15102","KIRINYAGA","KIRINYAGA EAST","79",94,185,279
"15103","KIRINYAGA","KIRINYAGA EAST","75-79",561,762,1323
"15104","KIRINYAGA","KIRINYAGA EAST","80",160,281,441
"15105","KIRINYAGA","KIRINYAGA EAST","81",68,159,227
"15106","KIRINYAGA","KIRINYAGA EAST","82",53,74,127
"15107","KIRINYAGA","KIRINYAGA EAST","83",59,88,147
"15108","KIRINYAGA","KIRINYAGA EAST","84",85,110,195
"15109","KIRINYAGA","KIRINYAGA EAST","80-84",425,712,1137
"15110","KIRINYAGA","KIRINYAGA EAST","85",59,110,169
"15111","KIRINYAGA","KIRINYAGA EAST","86",39,64,103
"15112","KIRINYAGA","KIRINYAGA EAST","87",58,65,123
"15113","KIRINYAGA","KIRINYAGA EAST","88",24,39,63
"15114","KIRINYAGA","KIRINYAGA EAST","89",55,151,206
"15115","KIRINYAGA","KIRINYAGA EAST","85-89",235,429,664
"15116","KIRINYAGA","KIRINYAGA EAST","90",44,90,134
"15117","KIRINYAGA","KIRINYAGA EAST","91",55,97,152
"15118","KIRINYAGA","KIRINYAGA EAST","92",17,43,60
"15119","KIRINYAGA","KIRINYAGA EAST","93",8,38,46
"15120","KIRINYAGA","KIRINYAGA EAST","94",11,35,46
"15121","KIRINYAGA","KIRINYAGA EAST","90-94",135,303,438
"15122","KIRINYAGA","KIRINYAGA EAST","95",13,53,66
"15123","KIRINYAGA","KIRINYAGA EAST","96",14,20,34
"15124","KIRINYAGA","KIRINYAGA EAST","97",14,15,29
"15125","KIRINYAGA","KIRINYAGA EAST","98",4,12,16
"15126","KIRINYAGA","KIRINYAGA EAST","99",13,61,74
"15127","KIRINYAGA","KIRINYAGA EAST","95-99",58,161,219
"15128","KIRINYAGA","KIRINYAGA EAST","100+",36,119,155
"15129","KIRINYAGA","KIRINYAGA EAST","Not Stated",2,2,4
"15130","KIRINYAGA","KIRINYAGA WEST","Total",56154,58502,114656
"15131","KIRINYAGA","KIRINYAGA WEST","0",1070,1075,2145
"15132","KIRINYAGA","KIRINYAGA WEST","1",1105,1027,2132
"15133","KIRINYAGA","KIRINYAGA WEST","2",1082,1085,2167
"15134","KIRINYAGA","KIRINYAGA WEST","3",1184,1140,2324
"15135","KIRINYAGA","KIRINYAGA WEST","4",1090,1054,2144
"15136","KIRINYAGA","KIRINYAGA WEST","0 - 4",5531,5381,10912
"15137","KIRINYAGA","KIRINYAGA WEST","5",1109,1045,2154
"15138","KIRINYAGA","KIRINYAGA WEST","6",1043,1095,2138
"15139","KIRINYAGA","KIRINYAGA WEST","7",1174,1191,2365
"15140","KIRINYAGA","KIRINYAGA WEST","8",1087,1137,2224
"15141","KIRINYAGA","KIRINYAGA WEST","9",1240,1172,2412
"15142","KIRINYAGA","KIRINYAGA WEST","5-9",5653,5640,11293
"15143","KIRINYAGA","KIRINYAGA WEST","10",1149,1147,2296
"15144","KIRINYAGA","KIRINYAGA WEST","11",1076,1087,2163
"15145","KIRINYAGA","KIRINYAGA WEST","12",1235,1100,2335
"15146","KIRINYAGA","KIRINYAGA WEST","13",1212,1254,2466
"15147","KIRINYAGA","KIRINYAGA WEST","14",1143,1185,2328
"15148","KIRINYAGA","KIRINYAGA WEST","10 -14",5815,5773,11588
"15149","KIRINYAGA","KIRINYAGA WEST","15",1186,1163,2349
"15150","KIRINYAGA","KIRINYAGA WEST","16",1131,1214,2345
"15151","KIRINYAGA","KIRINYAGA WEST","17",1219,1175,2394
"15152","KIRINYAGA","KIRINYAGA WEST","18",1032,953,1985
"15153","KIRINYAGA","KIRINYAGA WEST","19",1043,957,2000
"15154","KIRINYAGA","KIRINYAGA WEST","15-19",5611,5462,11073
"15155","KIRINYAGA","KIRINYAGA WEST","20",877,878,1755
"15156","KIRINYAGA","KIRINYAGA WEST","21",848,803,1651
"15157","KIRINYAGA","KIRINYAGA WEST","22",811,806,1617
"15158","KIRINYAGA","KIRINYAGA WEST","23",849,872,1721
"15159","KIRINYAGA","KIRINYAGA WEST","24",775,756,1531
"15160","KIRINYAGA","KIRINYAGA WEST","20-24",4160,4115,8275
"15161","KIRINYAGA","KIRINYAGA WEST","25",838,856,1694
"15162","KIRINYAGA","KIRINYAGA WEST","26",693,750,1443
"15163","KIRINYAGA","KIRINYAGA WEST","27",685,754,1439
"15164","KIRINYAGA","KIRINYAGA WEST","28",656,731,1387
"15165","KIRINYAGA","KIRINYAGA WEST","29",736,786,1522
"15166","KIRINYAGA","KIRINYAGA WEST","25-29",3608,3877,7485
"15167","KIRINYAGA","KIRINYAGA WEST","30",950,1030,1980
"15168","KIRINYAGA","KIRINYAGA WEST","31",673,709,1382
"15169","KIRINYAGA","KIRINYAGA WEST","32",853,1005,1858
"15170","KIRINYAGA","KIRINYAGA WEST","33",859,918,1777
"15171","KIRINYAGA","KIRINYAGA WEST","34",761,860,1621
"15172","KIRINYAGA","KIRINYAGA WEST","30-34",4096,4522,8618
"15173","KIRINYAGA","KIRINYAGA WEST","35",1094,1116,2210
"15174","KIRINYAGA","KIRINYAGA WEST","36",788,928,1716
"15175","KIRINYAGA","KIRINYAGA WEST","37",793,859,1652
"15176","KIRINYAGA","KIRINYAGA WEST","38",750,804,1554
"15177","KIRINYAGA","KIRINYAGA WEST","39",808,898,1706
"15178","KIRINYAGA","KIRINYAGA WEST","35-39",4233,4605,8838
"15179","KIRINYAGA","KIRINYAGA WEST","40",947,993,1940
"15180","KIRINYAGA","KIRINYAGA WEST","41",743,734,1477
"15181","KIRINYAGA","KIRINYAGA WEST","42",762,773,1535
"15182","KIRINYAGA","KIRINYAGA WEST","43",638,704,1342
"15183","KIRINYAGA","KIRINYAGA WEST","44",603,634,1237
"15184","KIRINYAGA","KIRINYAGA WEST","40-44",3693,3838,7531
"15185","KIRINYAGA","KIRINYAGA WEST","45",835,869,1704
"15186","KIRINYAGA","KIRINYAGA WEST","46",686,680,1366
"15187","KIRINYAGA","KIRINYAGA WEST","47",676,658,1334
"15188","KIRINYAGA","KIRINYAGA WEST","48",564,625,1189
"15189","KIRINYAGA","KIRINYAGA WEST","49",625,629,1254
"15190","KIRINYAGA","KIRINYAGA WEST","45-49",3386,3461,6847
"15191","KIRINYAGA","KIRINYAGA WEST","50",751,815,1566
"15192","KIRINYAGA","KIRINYAGA WEST","51",558,562,1120
"15193","KIRINYAGA","KIRINYAGA WEST","52",567,554,1121
"15194","KIRINYAGA","KIRINYAGA WEST","53",415,442,857
"15195","KIRINYAGA","KIRINYAGA WEST","54",537,452,989
"15196","KIRINYAGA","KIRINYAGA WEST","50-54",2828,2825,5653
"15197","KIRINYAGA","KIRINYAGA WEST","55",558,513,1071
"15198","KIRINYAGA","KIRINYAGA WEST","56",633,574,1207
"15199","KIRINYAGA","KIRINYAGA WEST","57",472,516,988
"15200","KIRINYAGA","KIRINYAGA WEST","58",389,406,795
"15201","KIRINYAGA","KIRINYAGA WEST","59",437,460,897
"15202","KIRINYAGA","KIRINYAGA WEST","55-59",2489,2469,4958
"15203","KIRINYAGA","KIRINYAGA WEST","60",475,478,953
"15204","KIRINYAGA","KIRINYAGA WEST","61",337,406,743
"15205","KIRINYAGA","KIRINYAGA WEST","62",312,282,594
"15206","KIRINYAGA","KIRINYAGA WEST","63",236,259,495
"15207","KIRINYAGA","KIRINYAGA WEST","64",175,195,370
"15208","KIRINYAGA","KIRINYAGA WEST","60-64",1535,1620,3155
"15209","KIRINYAGA","KIRINYAGA WEST","65",292,377,669
"15210","KIRINYAGA","KIRINYAGA WEST","66",200,208,408
"15211","KIRINYAGA","KIRINYAGA WEST","67",369,408,777
"15212","KIRINYAGA","KIRINYAGA WEST","68",203,176,379
"15213","KIRINYAGA","KIRINYAGA WEST","69",282,292,574
"15214","KIRINYAGA","KIRINYAGA WEST","65-69",1346,1461,2807
"15215","KIRINYAGA","KIRINYAGA WEST","70",293,444,737
"15216","KIRINYAGA","KIRINYAGA WEST","71",199,258,457
"15217","KIRINYAGA","KIRINYAGA WEST","72",228,184,412
"15218","KIRINYAGA","KIRINYAGA WEST","73",167,138,305
"15219","KIRINYAGA","KIRINYAGA WEST","74",165,184,349
"15220","KIRINYAGA","KIRINYAGA WEST","70-74",1052,1208,2260
"15221","KIRINYAGA","KIRINYAGA WEST","75",115,183,298
"15222","KIRINYAGA","KIRINYAGA WEST","76",100,164,264
"15223","KIRINYAGA","KIRINYAGA WEST","77",92,137,229
"15224","KIRINYAGA","KIRINYAGA WEST","78",71,84,155
"15225","KIRINYAGA","KIRINYAGA WEST","79",91,172,263
"15226","KIRINYAGA","KIRINYAGA WEST","75-79",469,740,1209
"15227","KIRINYAGA","KIRINYAGA WEST","80",123,246,369
"15228","KIRINYAGA","KIRINYAGA WEST","81",35,107,142
"15229","KIRINYAGA","KIRINYAGA WEST","82",47,78,125
"15230","KIRINYAGA","KIRINYAGA WEST","83",59,101,160
"15231","KIRINYAGA","KIRINYAGA WEST","84",46,109,155
"15232","KIRINYAGA","KIRINYAGA WEST","80-84",310,641,951
"15233","KIRINYAGA","KIRINYAGA WEST","85",58,96,154
"15234","KIRINYAGA","KIRINYAGA WEST","86",42,63,105
"15235","KIRINYAGA","KIRINYAGA WEST","87",31,58,89
"15236","KIRINYAGA","KIRINYAGA WEST","88",21,31,52
"15237","KIRINYAGA","KIRINYAGA WEST","89",33,118,151
"15238","KIRINYAGA","KIRINYAGA WEST","85-89",185,366,551
"15239","KIRINYAGA","KIRINYAGA WEST","90",26,99,125
"15240","KIRINYAGA","KIRINYAGA WEST","91",38,73,111
"15241","KIRINYAGA","KIRINYAGA WEST","92",10,25,35
"15242","KIRINYAGA","KIRINYAGA WEST","93",10,35,45
"15243","KIRINYAGA","KIRINYAGA WEST","94",11,38,49
"15244","KIRINYAGA","KIRINYAGA WEST","90-94",95,270,365
"15245","KIRINYAGA","KIRINYAGA WEST","95",16,51,67
"15246","KIRINYAGA","KIRINYAGA WEST","96",7,17,24
"15247","KIRINYAGA","KIRINYAGA WEST","97",10,26,36
"15248","KIRINYAGA","KIRINYAGA WEST","98",4,13,17
"15249","KIRINYAGA","KIRINYAGA WEST","99",7,30,37
"15250","KIRINYAGA","KIRINYAGA WEST","95-99",44,137,181
"15251","KIRINYAGA","KIRINYAGA WEST","100+",13,90,103
"15252","KIRINYAGA","KIRINYAGA WEST","Not Stated",2,1,3
"15253","KIRINYAGA","MWEA EAST","Total",66432,66114,132546
"15254","KIRINYAGA","MWEA EAST","0",1545,1443,2988
"15255","KIRINYAGA","MWEA EAST","1",1362,1275,2637
"15256","KIRINYAGA","MWEA EAST","2",1363,1284,2647
"15257","KIRINYAGA","MWEA EAST","3",1341,1270,2611
"15258","KIRINYAGA","MWEA EAST","4",1234,1273,2507
"15259","KIRINYAGA","MWEA EAST","0 - 4",6845,6545,13390
"15260","KIRINYAGA","MWEA EAST","5",1277,1254,2531
"15261","KIRINYAGA","MWEA EAST","6",1219,1227,2446
"15262","KIRINYAGA","MWEA EAST","7",1326,1307,2633
"15263","KIRINYAGA","MWEA EAST","8",1243,1204,2447
"15264","KIRINYAGA","MWEA EAST","9",1470,1390,2860
"15265","KIRINYAGA","MWEA EAST","5-9",6535,6382,12917
"15266","KIRINYAGA","MWEA EAST","10",1338,1307,2645
"15267","KIRINYAGA","MWEA EAST","11",1189,1267,2456
"15268","KIRINYAGA","MWEA EAST","12",1395,1324,2719
"15269","KIRINYAGA","MWEA EAST","13",1386,1339,2725
"15270","KIRINYAGA","MWEA EAST","14",1315,1252,2567
"15271","KIRINYAGA","MWEA EAST","10 -14",6623,6489,13112
"15272","KIRINYAGA","MWEA EAST","15",1299,1355,2654
"15273","KIRINYAGA","MWEA EAST","16",1244,1260,2504
"15274","KIRINYAGA","MWEA EAST","17",1292,1287,2579
"15275","KIRINYAGA","MWEA EAST","18",1111,1057,2168
"15276","KIRINYAGA","MWEA EAST","19",1114,1163,2277
"15277","KIRINYAGA","MWEA EAST","15-19",6060,6122,12182
"15278","KIRINYAGA","MWEA EAST","20",1172,1184,2356
"15279","KIRINYAGA","MWEA EAST","21",1015,1108,2123
"15280","KIRINYAGA","MWEA EAST","22",1145,1173,2318
"15281","KIRINYAGA","MWEA EAST","23",1116,1295,2411
"15282","KIRINYAGA","MWEA EAST","24",1098,1161,2259
"15283","KIRINYAGA","MWEA EAST","20-24",5546,5921,11467
"15284","KIRINYAGA","MWEA EAST","25",1176,1234,2410
"15285","KIRINYAGA","MWEA EAST","26",981,1035,2016
"15286","KIRINYAGA","MWEA EAST","27",1107,1126,2233
"15287","KIRINYAGA","MWEA EAST","28",1021,1076,2097
"15288","KIRINYAGA","MWEA EAST","29",1131,1116,2247
"15289","KIRINYAGA","MWEA EAST","25-29",5416,5587,11003
"15290","KIRINYAGA","MWEA EAST","30",1492,1508,3000
"15291","KIRINYAGA","MWEA EAST","31",1026,1038,2064
"15292","KIRINYAGA","MWEA EAST","32",1264,1366,2630
"15293","KIRINYAGA","MWEA EAST","33",1119,1161,2280
"15294","KIRINYAGA","MWEA EAST","34",989,1086,2075
"15295","KIRINYAGA","MWEA EAST","30-34",5890,6159,12049
"15296","KIRINYAGA","MWEA EAST","35",1536,1431,2967
"15297","KIRINYAGA","MWEA EAST","36",1031,1010,2041
"15298","KIRINYAGA","MWEA EAST","37",1066,929,1995
"15299","KIRINYAGA","MWEA EAST","38",928,961,1889
"15300","KIRINYAGA","MWEA EAST","39",969,972,1941
"15301","KIRINYAGA","MWEA EAST","35-39",5530,5303,10833
"15302","KIRINYAGA","MWEA EAST","40",1245,1103,2348
"15303","KIRINYAGA","MWEA EAST","41",943,871,1814
"15304","KIRINYAGA","MWEA EAST","42",914,861,1775
"15305","KIRINYAGA","MWEA EAST","43",797,749,1546
"15306","KIRINYAGA","MWEA EAST","44",786,696,1482
"15307","KIRINYAGA","MWEA EAST","40-44",4685,4280,8965
"15308","KIRINYAGA","MWEA EAST","45",1036,978,2014
"15309","KIRINYAGA","MWEA EAST","46",765,671,1436
"15310","KIRINYAGA","MWEA EAST","47",748,621,1369
"15311","KIRINYAGA","MWEA EAST","48",553,519,1072
"15312","KIRINYAGA","MWEA EAST","49",581,622,1203
"15313","KIRINYAGA","MWEA EAST","45-49",3683,3411,7094
"15314","KIRINYAGA","MWEA EAST","50",766,774,1540
"15315","KIRINYAGA","MWEA EAST","51",556,535,1091
"15316","KIRINYAGA","MWEA EAST","52",611,560,1171
"15317","KIRINYAGA","MWEA EAST","53",406,424,830
"15318","KIRINYAGA","MWEA EAST","54",549,445,994
"15319","KIRINYAGA","MWEA EAST","50-54",2888,2738,5626
"15320","KIRINYAGA","MWEA EAST","55",581,521,1102
"15321","KIRINYAGA","MWEA EAST","56",607,509,1116
"15322","KIRINYAGA","MWEA EAST","57",423,431,854
"15323","KIRINYAGA","MWEA EAST","58",392,367,759
"15324","KIRINYAGA","MWEA EAST","59",432,425,857
"15325","KIRINYAGA","MWEA EAST","55-59",2435,2253,4688
"15326","KIRINYAGA","MWEA EAST","60",460,426,886
"15327","KIRINYAGA","MWEA EAST","61",339,307,646
"15328","KIRINYAGA","MWEA EAST","62",277,229,506
"15329","KIRINYAGA","MWEA EAST","63",219,230,449
"15330","KIRINYAGA","MWEA EAST","64",181,145,326
"15331","KIRINYAGA","MWEA EAST","60-64",1476,1337,2813
"15332","KIRINYAGA","MWEA EAST","65",294,310,604
"15333","KIRINYAGA","MWEA EAST","66",187,158,345
"15334","KIRINYAGA","MWEA EAST","67",316,298,614
"15335","KIRINYAGA","MWEA EAST","68",155,166,321
"15336","KIRINYAGA","MWEA EAST","69",205,209,414
"15337","KIRINYAGA","MWEA EAST","65-69",1157,1141,2298
"15338","KIRINYAGA","MWEA EAST","70",252,369,621
"15339","KIRINYAGA","MWEA EAST","71",165,196,361
"15340","KIRINYAGA","MWEA EAST","72",134,143,277
"15341","KIRINYAGA","MWEA EAST","73",108,97,205
"15342","KIRINYAGA","MWEA EAST","74",99,126,225
"15343","KIRINYAGA","MWEA EAST","70-74",758,931,1689
"15344","KIRINYAGA","MWEA EAST","75",94,138,232
"15345","KIRINYAGA","MWEA EAST","76",65,88,153
"15346","KIRINYAGA","MWEA EAST","77",82,102,184
"15347","KIRINYAGA","MWEA EAST","78",69,59,128
"15348","KIRINYAGA","MWEA EAST","79",60,107,167
"15349","KIRINYAGA","MWEA EAST","75-79",370,494,864
"15350","KIRINYAGA","MWEA EAST","80",83,200,283
"15351","KIRINYAGA","MWEA EAST","81",33,71,104
"15352","KIRINYAGA","MWEA EAST","82",49,49,98
"15353","KIRINYAGA","MWEA EAST","83",34,55,89
"15354","KIRINYAGA","MWEA EAST","84",39,61,100
"15355","KIRINYAGA","MWEA EAST","80-84",238,436,674
"15356","KIRINYAGA","MWEA EAST","85",35,74,109
"15357","KIRINYAGA","MWEA EAST","86",32,30,62
"15358","KIRINYAGA","MWEA EAST","87",29,35,64
"15359","KIRINYAGA","MWEA EAST","88",21,14,35
"15360","KIRINYAGA","MWEA EAST","89",35,71,106
"15361","KIRINYAGA","MWEA EAST","85-89",152,224,376
"15362","KIRINYAGA","MWEA EAST","90",25,75,100
"15363","KIRINYAGA","MWEA EAST","91",24,52,76
"15364","KIRINYAGA","MWEA EAST","92",7,15,22
"15365","KIRINYAGA","MWEA EAST","93",13,16,29
"15366","KIRINYAGA","MWEA EAST","94",11,22,33
"15367","KIRINYAGA","MWEA EAST","90-94",80,180,260
"15368","KIRINYAGA","MWEA EAST","95",12,42,54
"15369","KIRINYAGA","MWEA EAST","96",5,16,21
"15370","KIRINYAGA","MWEA EAST","97",10,14,24
"15371","KIRINYAGA","MWEA EAST","98",11,13,24
"15372","KIRINYAGA","MWEA EAST","99",5,27,32
"15373","KIRINYAGA","MWEA EAST","95-99",43,112,155
"15374","KIRINYAGA","MWEA EAST","100+",22,69,91
"15375","KIRINYAGA","MWEA EAST","Not Stated",NA,NA,NA
"15376","KIRINYAGA","MWEA WEST","Total",52228,52594,104822
"15377","KIRINYAGA","MWEA WEST","0",1127,1016,2143
"15378","KIRINYAGA","MWEA WEST","1",945,973,1918
"15379","KIRINYAGA","MWEA WEST","2",932,965,1897
"15380","KIRINYAGA","MWEA WEST","3",994,1011,2005
"15381","KIRINYAGA","MWEA WEST","4",983,1025,2008
"15382","KIRINYAGA","MWEA WEST","0 - 4",4981,4990,9971
"15383","KIRINYAGA","MWEA WEST","5",993,959,1952
"15384","KIRINYAGA","MWEA WEST","6",986,979,1965
"15385","KIRINYAGA","MWEA WEST","7",1010,1050,2060
"15386","KIRINYAGA","MWEA WEST","8",1050,989,2039
"15387","KIRINYAGA","MWEA WEST","9",1185,1117,2302
"15388","KIRINYAGA","MWEA WEST","5-9",5224,5094,10318
"15389","KIRINYAGA","MWEA WEST","10",1176,1093,2269
"15390","KIRINYAGA","MWEA WEST","11",1064,1088,2152
"15391","KIRINYAGA","MWEA WEST","12",1098,1130,2228
"15392","KIRINYAGA","MWEA WEST","13",1214,1222,2436
"15393","KIRINYAGA","MWEA WEST","14",1128,1139,2267
"15394","KIRINYAGA","MWEA WEST","10 -14",5680,5672,11352
"15395","KIRINYAGA","MWEA WEST","15",1122,1140,2262
"15396","KIRINYAGA","MWEA WEST","16",1239,1114,2353
"15397","KIRINYAGA","MWEA WEST","17",1218,1073,2291
"15398","KIRINYAGA","MWEA WEST","18",1008,940,1948
"15399","KIRINYAGA","MWEA WEST","19",1055,894,1949
"15400","KIRINYAGA","MWEA WEST","15-19",5642,5161,10803
"15401","KIRINYAGA","MWEA WEST","20",900,906,1806
"15402","KIRINYAGA","MWEA WEST","21",755,809,1564
"15403","KIRINYAGA","MWEA WEST","22",772,826,1598
"15404","KIRINYAGA","MWEA WEST","23",829,852,1681
"15405","KIRINYAGA","MWEA WEST","24",767,747,1514
"15406","KIRINYAGA","MWEA WEST","20-24",4023,4140,8163
"15407","KIRINYAGA","MWEA WEST","25",827,759,1586
"15408","KIRINYAGA","MWEA WEST","26",631,699,1330
"15409","KIRINYAGA","MWEA WEST","27",768,739,1507
"15410","KIRINYAGA","MWEA WEST","28",682,679,1361
"15411","KIRINYAGA","MWEA WEST","29",740,838,1578
"15412","KIRINYAGA","MWEA WEST","25-29",3648,3714,7362
"15413","KIRINYAGA","MWEA WEST","30",952,989,1941
"15414","KIRINYAGA","MWEA WEST","31",742,710,1452
"15415","KIRINYAGA","MWEA WEST","32",962,1008,1970
"15416","KIRINYAGA","MWEA WEST","33",865,933,1798
"15417","KIRINYAGA","MWEA WEST","34",730,791,1521
"15418","KIRINYAGA","MWEA WEST","30-34",4251,4431,8682
"15419","KIRINYAGA","MWEA WEST","35",1067,1095,2162
"15420","KIRINYAGA","MWEA WEST","36",820,837,1657
"15421","KIRINYAGA","MWEA WEST","37",847,847,1694
"15422","KIRINYAGA","MWEA WEST","38",681,756,1437
"15423","KIRINYAGA","MWEA WEST","39",798,821,1619
"15424","KIRINYAGA","MWEA WEST","35-39",4213,4356,8569
"15425","KIRINYAGA","MWEA WEST","40",919,961,1880
"15426","KIRINYAGA","MWEA WEST","41",806,721,1527
"15427","KIRINYAGA","MWEA WEST","42",751,702,1453
"15428","KIRINYAGA","MWEA WEST","43",681,657,1338
"15429","KIRINYAGA","MWEA WEST","44",679,623,1302
"15430","KIRINYAGA","MWEA WEST","40-44",3836,3664,7500
"15431","KIRINYAGA","MWEA WEST","45",845,868,1713
"15432","KIRINYAGA","MWEA WEST","46",641,642,1283
"15433","KIRINYAGA","MWEA WEST","47",688,568,1256
"15434","KIRINYAGA","MWEA WEST","48",470,449,919
"15435","KIRINYAGA","MWEA WEST","49",546,507,1053
"15436","KIRINYAGA","MWEA WEST","45-49",3190,3034,6224
"15437","KIRINYAGA","MWEA WEST","50",624,580,1204
"15438","KIRINYAGA","MWEA WEST","51",510,448,958
"15439","KIRINYAGA","MWEA WEST","52",505,439,944
"15440","KIRINYAGA","MWEA WEST","53",325,276,601
"15441","KIRINYAGA","MWEA WEST","54",387,323,710
"15442","KIRINYAGA","MWEA WEST","50-54",2351,2066,4417
"15443","KIRINYAGA","MWEA WEST","55",424,371,795
"15444","KIRINYAGA","MWEA WEST","56",473,430,903
"15445","KIRINYAGA","MWEA WEST","57",322,326,648
"15446","KIRINYAGA","MWEA WEST","58",275,243,518
"15447","KIRINYAGA","MWEA WEST","59",328,322,650
"15448","KIRINYAGA","MWEA WEST","55-59",1822,1692,3514
"15449","KIRINYAGA","MWEA WEST","60",301,327,628
"15450","KIRINYAGA","MWEA WEST","61",263,234,497
"15451","KIRINYAGA","MWEA WEST","62",206,225,431
"15452","KIRINYAGA","MWEA WEST","63",156,175,331
"15453","KIRINYAGA","MWEA WEST","64",130,130,260
"15454","KIRINYAGA","MWEA WEST","60-64",1056,1091,2147
"15455","KIRINYAGA","MWEA WEST","65",204,259,463
"15456","KIRINYAGA","MWEA WEST","66",135,154,289
"15457","KIRINYAGA","MWEA WEST","67",254,273,527
"15458","KIRINYAGA","MWEA WEST","68",118,132,250
"15459","KIRINYAGA","MWEA WEST","69",144,188,332
"15460","KIRINYAGA","MWEA WEST","65-69",855,1006,1861
"15461","KIRINYAGA","MWEA WEST","70",177,360,537
"15462","KIRINYAGA","MWEA WEST","71",139,187,326
"15463","KIRINYAGA","MWEA WEST","72",111,161,272
"15464","KIRINYAGA","MWEA WEST","73",95,100,195
"15465","KIRINYAGA","MWEA WEST","74",96,136,232
"15466","KIRINYAGA","MWEA WEST","70-74",618,944,1562
"15467","KIRINYAGA","MWEA WEST","75",75,144,219
"15468","KIRINYAGA","MWEA WEST","76",64,85,149
"15469","KIRINYAGA","MWEA WEST","77",69,100,169
"15470","KIRINYAGA","MWEA WEST","78",46,64,110
"15471","KIRINYAGA","MWEA WEST","79",74,120,194
"15472","KIRINYAGA","MWEA WEST","75-79",328,513,841
"15473","KIRINYAGA","MWEA WEST","80",88,171,259
"15474","KIRINYAGA","MWEA WEST","81",32,87,119
"15475","KIRINYAGA","MWEA WEST","82",36,45,81
"15476","KIRINYAGA","MWEA WEST","83",38,69,107
"15477","KIRINYAGA","MWEA WEST","84",36,81,117
"15478","KIRINYAGA","MWEA WEST","80-84",230,453,683
"15479","KIRINYAGA","MWEA WEST","85",51,52,103
"15480","KIRINYAGA","MWEA WEST","86",32,35,67
"15481","KIRINYAGA","MWEA WEST","87",22,37,59
"15482","KIRINYAGA","MWEA WEST","88",17,25,42
"15483","KIRINYAGA","MWEA WEST","89",37,81,118
"15484","KIRINYAGA","MWEA WEST","85-89",159,230,389
"15485","KIRINYAGA","MWEA WEST","90",17,58,75
"15486","KIRINYAGA","MWEA WEST","91",19,59,78
"15487","KIRINYAGA","MWEA WEST","92",5,21,26
"15488","KIRINYAGA","MWEA WEST","93",20,12,32
"15489","KIRINYAGA","MWEA WEST","94",7,21,28
"15490","KIRINYAGA","MWEA WEST","90-94",68,171,239
"15491","KIRINYAGA","MWEA WEST","95",7,25,32
"15492","KIRINYAGA","MWEA WEST","96",6,17,23
"15493","KIRINYAGA","MWEA WEST","97",11,17,28
"15494","KIRINYAGA","MWEA WEST","98",5,8,13
"15495","KIRINYAGA","MWEA WEST","99",7,30,37
"15496","KIRINYAGA","MWEA WEST","95-99",36,97,133
"15497","KIRINYAGA","MWEA WEST","100+",17,74,91
"15498","KIRINYAGA","MWEA WEST","Not Stated",NA,1,1
"15499","KIRINYAGA","MT. KENYA FORE","Total",42,28,70
"15500","KIRINYAGA","MT. KENYA FORE","0",1,1,2
"15501","KIRINYAGA","MT. KENYA FORE","1",1,NA,1
"15502","KIRINYAGA","MT. KENYA FORE","2",NA,2,2
"15503","KIRINYAGA","MT. KENYA FORE","3",NA,NA,NA
"15504","KIRINYAGA","MT. KENYA FORE","4",NA,2,2
"15505","KIRINYAGA","MT. KENYA FORE","0 - 4",2,5,7
"15506","KIRINYAGA","MT. KENYA FORE","5",1,NA,1
"15507","KIRINYAGA","MT. KENYA FORE","6",NA,NA,NA
"15508","KIRINYAGA","MT. KENYA FORE","7",NA,NA,NA
"15509","KIRINYAGA","MT. KENYA FORE","8",NA,NA,NA
"15510","KIRINYAGA","MT. KENYA FORE","9",NA,NA,NA
"15511","KIRINYAGA","MT. KENYA FORE","5-9",1,NA,1
"15512","KIRINYAGA","MT. KENYA FORE","10",NA,NA,NA
"15513","KIRINYAGA","MT. KENYA FORE","11",NA,NA,NA
"15514","KIRINYAGA","MT. KENYA FORE","12",NA,NA,NA
"15515","KIRINYAGA","MT. KENYA FORE","13",NA,NA,NA
"15516","KIRINYAGA","MT. KENYA FORE","14",1,NA,1
"15517","KIRINYAGA","MT. KENYA FORE","10 -14",1,NA,1
"15518","KIRINYAGA","MT. KENYA FORE","15",NA,NA,NA
"15519","KIRINYAGA","MT. KENYA FORE","16",NA,NA,NA
"15520","KIRINYAGA","MT. KENYA FORE","17",NA,1,1
"15521","KIRINYAGA","MT. KENYA FORE","18",NA,NA,NA
"15522","KIRINYAGA","MT. KENYA FORE","19",NA,NA,NA
"15523","KIRINYAGA","MT. KENYA FORE","15-19",NA,1,1
"15524","KIRINYAGA","MT. KENYA FORE","20",1,NA,1
"15525","KIRINYAGA","MT. KENYA FORE","21",NA,NA,NA
"15526","KIRINYAGA","MT. KENYA FORE","22",NA,1,1
"15527","KIRINYAGA","MT. KENYA FORE","23",2,2,4
"15528","KIRINYAGA","MT. KENYA FORE","24",1,NA,1
"15529","KIRINYAGA","MT. KENYA FORE","20-24",4,3,7
"15530","KIRINYAGA","MT. KENYA FORE","25",3,6,9
"15531","KIRINYAGA","MT. KENYA FORE","26",1,NA,1
"15532","KIRINYAGA","MT. KENYA FORE","27",1,NA,1
"15533","KIRINYAGA","MT. KENYA FORE","28",5,NA,5
"15534","KIRINYAGA","MT. KENYA FORE","29",NA,NA,NA
"15535","KIRINYAGA","MT. KENYA FORE","25-29",10,6,16
"15536","KIRINYAGA","MT. KENYA FORE","30",1,2,3
"15537","KIRINYAGA","MT. KENYA FORE","31",2,1,3
"15538","KIRINYAGA","MT. KENYA FORE","32",1,NA,1
"15539","KIRINYAGA","MT. KENYA FORE","33",2,NA,2
"15540","KIRINYAGA","MT. KENYA FORE","34",2,2,4
"15541","KIRINYAGA","MT. KENYA FORE","30-34",8,5,13
"15542","KIRINYAGA","MT. KENYA FORE","35",3,NA,3
"15543","KIRINYAGA","MT. KENYA FORE","36",NA,1,1
"15544","KIRINYAGA","MT. KENYA FORE","37",NA,NA,NA
"15545","KIRINYAGA","MT. KENYA FORE","38",NA,NA,NA
"15546","KIRINYAGA","MT. KENYA FORE","39",1,NA,1
"15547","KIRINYAGA","MT. KENYA FORE","35-39",4,1,5
"15548","KIRINYAGA","MT. KENYA FORE","40",1,NA,1
"15549","KIRINYAGA","MT. KENYA FORE","41",1,NA,1
"15550","KIRINYAGA","MT. KENYA FORE","42",NA,NA,NA
"15551","KIRINYAGA","MT. KENYA FORE","43",1,NA,1
"15552","KIRINYAGA","MT. KENYA FORE","44",1,NA,1
"15553","KIRINYAGA","MT. KENYA FORE","40-44",4,NA,4
"15554","KIRINYAGA","MT. KENYA FORE","45",1,NA,1
"15555","KIRINYAGA","MT. KENYA FORE","46",NA,NA,NA
"15556","KIRINYAGA","MT. KENYA FORE","47",NA,NA,NA
"15557","KIRINYAGA","MT. KENYA FORE","48",NA,NA,NA
"15558","KIRINYAGA","MT. KENYA FORE","49",1,NA,1
"15559","KIRINYAGA","MT. KENYA FORE","45-49",2,NA,2
"15560","KIRINYAGA","MT. KENYA FORE","50",NA,NA,NA
"15561","KIRINYAGA","MT. KENYA FORE","51",1,NA,1
"15562","KIRINYAGA","MT. KENYA FORE","52",2,1,3
"15563","KIRINYAGA","MT. KENYA FORE","53",NA,1,1
"15564","KIRINYAGA","MT. KENYA FORE","54",NA,1,1
"15565","KIRINYAGA","MT. KENYA FORE","50-54",3,3,6
"15566","KIRINYAGA","MT. KENYA FORE","55",NA,NA,NA
"15567","KIRINYAGA","MT. KENYA FORE","56",1,NA,1
"15568","KIRINYAGA","MT. KENYA FORE","57",NA,NA,NA
"15569","KIRINYAGA","MT. KENYA FORE","58",NA,1,1
"15570","KIRINYAGA","MT. KENYA FORE","59",1,NA,1
"15571","KIRINYAGA","MT. KENYA FORE","55-59",2,1,3
"15572","KIRINYAGA","MT. KENYA FORE","60",NA,NA,NA
"15573","KIRINYAGA","MT. KENYA FORE","61",NA,1,1
"15574","KIRINYAGA","MT. KENYA FORE","62",NA,NA,NA
"15575","KIRINYAGA","MT. KENYA FORE","63",NA,NA,NA
"15576","KIRINYAGA","MT. KENYA FORE","64",NA,1,1
"15577","KIRINYAGA","MT. KENYA FORE","60-64",NA,2,2
"15578","KIRINYAGA","MT. KENYA FORE","65",1,NA,1
"15579","KIRINYAGA","MT. KENYA FORE","66",NA,NA,NA
"15580","KIRINYAGA","MT. KENYA FORE","67",NA,NA,NA
"15581","KIRINYAGA","MT. KENYA FORE","68",NA,NA,NA
"15582","KIRINYAGA","MT. KENYA FORE","69",NA,NA,NA
"15583","KIRINYAGA","MT. KENYA FORE","65-69",1,NA,1
"15584","KIRINYAGA","MT. KENYA FORE","70",NA,NA,NA
"15585","KIRINYAGA","MT. KENYA FORE","71",NA,NA,NA
"15586","KIRINYAGA","MT. KENYA FORE","72",NA,NA,NA
"15587","KIRINYAGA","MT. KENYA FORE","73",NA,1,1
"15588","KIRINYAGA","MT. KENYA FORE","74",NA,NA,NA
"15589","KIRINYAGA","MT. KENYA FORE","70-74",NA,1,1
"15590","KIRINYAGA","MT. KENYA FORE","75",NA,NA,NA
"15591","KIRINYAGA","MT. KENYA FORE","76",NA,NA,NA
"15592","KIRINYAGA","MT. KENYA FORE","77",NA,NA,NA
"15593","KIRINYAGA","MT. KENYA FORE","78",NA,NA,NA
"15594","KIRINYAGA","MT. KENYA FORE","79",NA,NA,NA
"15595","KIRINYAGA","MT. KENYA FORE","75-79",NA,NA,NA
"15596","KIRINYAGA","MT. KENYA FORE","80",NA,NA,NA
"15597","KIRINYAGA","MT. KENYA FORE","81",NA,NA,NA
"15598","KIRINYAGA","MT. KENYA FORE","82",NA,NA,NA
"15599","KIRINYAGA","MT. KENYA FORE","83",NA,NA,NA
"15600","KIRINYAGA","MT. KENYA FORE","84",NA,NA,NA
"15601","KIRINYAGA","MT. KENYA FORE","80-84",NA,NA,NA
"15602","KIRINYAGA","MT. KENYA FORE","85",NA,NA,NA
"15603","KIRINYAGA","MT. KENYA FORE","86",NA,NA,NA
"15604","KIRINYAGA","MT. KENYA FORE","87",NA,NA,NA
"15605","KIRINYAGA","MT. KENYA FORE","88",NA,NA,NA
"15606","KIRINYAGA","MT. KENYA FORE","89",NA,NA,NA
"15607","KIRINYAGA","MT. KENYA FORE","85-89",NA,NA,NA
"15608","KIRINYAGA","MT. KENYA FORE","90",NA,NA,NA
"15609","KIRINYAGA","MT. KENYA FORE","91",NA,NA,NA
"15610","KIRINYAGA","MT. KENYA FORE","92",NA,NA,NA
"15611","KIRINYAGA","MT. KENYA FORE","93",NA,NA,NA
"15612","KIRINYAGA","MT. KENYA FORE","94",NA,NA,NA
"15613","KIRINYAGA","MT. KENYA FORE","90-94",NA,NA,NA
"15614","KIRINYAGA","MT. KENYA FORE","95",NA,NA,NA
"15615","KIRINYAGA","MT. KENYA FORE","96",NA,NA,NA
"15616","KIRINYAGA","MT. KENYA FORE","97",NA,NA,NA
"15617","KIRINYAGA","MT. KENYA FORE","98",NA,NA,NA
"15618","KIRINYAGA","MT. KENYA FORE","99",NA,NA,NA
"15619","KIRINYAGA","MT. KENYA FORE","95-99",NA,NA,NA
"15620","KIRINYAGA","MT. KENYA FORE","100+",NA,NA,NA
"15621","KIRINYAGA","MT. KENYA FORE","Not Stated",NA,NA,NA
"15622","KISII","ALL","Total",605784,661038,1266822
"15623","KISII","ALL","0",13498,13564,27062
"15624","KISII","ALL","1",13548,13374,26922
"15625","KISII","ALL","2",13895,13822,27717
"15626","KISII","ALL","3",15058,15276,30334
"15627","KISII","ALL","4",15814,15658,31472
"15628","KISII","ALL","0 - 4",71813,71694,143507
"15629","KISII","ALL","5",15818,15813,31631
"15630","KISII","ALL","6",16995,17034,34029
"15631","KISII","ALL","7",17688,17370,35058
"15632","KISII","ALL","8",16709,16858,33567
"15633","KISII","ALL","9",18870,18795,37665
"15634","KISII","ALL","5-9",86080,85870,171950
"15635","KISII","ALL","10",20721,20333,41054
"15636","KISII","ALL","11",17690,18410,36100
"15637","KISII","ALL","12",21501,20343,41844
"15638","KISII","ALL","13",20009,20238,40247
"15639","KISII","ALL","14",18146,17995,36141
"15640","KISII","ALL","10 -14",98067,97319,195386
"15641","KISII","ALL","15",17332,17437,34769
"15642","KISII","ALL","16",15694,15662,31356
"15643","KISII","ALL","17",15979,15617,31596
"15644","KISII","ALL","18",12915,12710,25625
"15645","KISII","ALL","19",13222,13599,26821
"15646","KISII","ALL","15-19",75142,75025,150167
"15647","KISII","ALL","20",10891,12724,23615
"15648","KISII","ALL","21",8954,10945,19899
"15649","KISII","ALL","22",8784,10867,19651
"15650","KISII","ALL","23",8849,11707,20556
"15651","KISII","ALL","24",8119,10686,18805
"15652","KISII","ALL","20-24",45597,56929,102526
"15653","KISII","ALL","25",9666,12796,22462
"15654","KISII","ALL","26",7822,10510,18332
"15655","KISII","ALL","27",8248,10562,18810
"15656","KISII","ALL","28",6535,8565,15100
"15657","KISII","ALL","29",7000,9368,16368
"15658","KISII","ALL","25-29",39271,51801,91072
"15659","KISII","ALL","30",9467,13378,22845
"15660","KISII","ALL","31",7401,10034,17435
"15661","KISII","ALL","32",8714,11889,20603
"15662","KISII","ALL","33",7185,10453,17638
"15663","KISII","ALL","34",6391,8768,15159
"15664","KISII","ALL","30-34",39158,54522,93680
"15665","KISII","ALL","35",8576,9664,18240
"15666","KISII","ALL","36",5782,5527,11309
"15667","KISII","ALL","37",6068,5615,11683
"15668","KISII","ALL","38",4369,4268,8637
"15669","KISII","ALL","39",5383,5485,10868
"15670","KISII","ALL","35-39",30178,30559,60737
"15671","KISII","ALL","40",6462,6506,12968
"15672","KISII","ALL","41",6798,6275,13073
"15673","KISII","ALL","42",5124,4965,10089
"15674","KISII","ALL","43",4898,5053,9951
"15675","KISII","ALL","44",3488,4049,7537
"15676","KISII","ALL","40-44",26770,26848,53618
"15677","KISII","ALL","45",6493,7392,13885
"15678","KISII","ALL","46",4301,5487,9788
"15679","KISII","ALL","47",4700,6067,10767
"15680","KISII","ALL","48",2735,3226,5961
"15681","KISII","ALL","49",3266,4233,7499
"15682","KISII","ALL","45-49",21495,26405,47900
"15683","KISII","ALL","50",4234,4846,9080
"15684","KISII","ALL","51",3500,3476,6976
"15685","KISII","ALL","52",2578,2296,4874
"15686","KISII","ALL","53",2046,1796,3842
"15687","KISII","ALL","54",2556,2180,4736
"15688","KISII","ALL","50-54",14914,14594,29508
"15689","KISII","ALL","55",3359,3013,6372
"15690","KISII","ALL","56",3818,3874,7692
"15691","KISII","ALL","57",4153,5473,9626
"15692","KISII","ALL","58",2811,3318,6129
"15693","KISII","ALL","59",3936,4860,8796
"15694","KISII","ALL","55-59",18077,20538,38615
"15695","KISII","ALL","60",3886,5206,9092
"15696","KISII","ALL","61",3422,3800,7222
"15697","KISII","ALL","62",2411,2671,5082
"15698","KISII","ALL","63",2562,2829,5391
"15699","KISII","ALL","64",1846,2078,3924
"15700","KISII","ALL","60-64",14127,16584,30711
"15701","KISII","ALL","65",2703,3494,6197
"15702","KISII","ALL","66",1567,1632,3199
"15703","KISII","ALL","67",2466,2760,5226
"15704","KISII","ALL","68",1071,1372,2443
"15705","KISII","ALL","69",1947,2517,4464
"15706","KISII","ALL","65-69",9754,11775,21529
"15707","KISII","ALL","70",2049,3375,5424
"15708","KISII","ALL","71",1701,1695,3396
"15709","KISII","ALL","72",1255,1149,2404
"15710","KISII","ALL","73",998,952,1950
"15711","KISII","ALL","74",1027,1343,2370
"15712","KISII","ALL","70-74",7030,8514,15544
"15713","KISII","ALL","75",864,1186,2050
"15714","KISII","ALL","76",558,624,1182
"15715","KISII","ALL","77",871,898,1769
"15716","KISII","ALL","78",480,478,958
"15717","KISII","ALL","79",666,1252,1918
"15718","KISII","ALL","75-79",3439,4438,7877
"15719","KISII","ALL","80",741,1400,2141
"15720","KISII","ALL","81",486,719,1205
"15721","KISII","ALL","82",396,418,814
"15722","KISII","ALL","83",437,473,910
"15723","KISII","ALL","84",414,657,1071
"15724","KISII","ALL","80-84",2474,3667,6141
"15725","KISII","ALL","85",336,552,888
"15726","KISII","ALL","86",261,280,541
"15727","KISII","ALL","87",361,416,777
"15728","KISII","ALL","88",190,229,419
"15729","KISII","ALL","89",337,732,1069
"15730","KISII","ALL","85-89",1485,2209,3694
"15731","KISII","ALL","90",164,401,565
"15732","KISII","ALL","91",117,179,296
"15733","KISII","ALL","92",114,123,237
"15734","KISII","ALL","93",50,102,152
"15735","KISII","ALL","94",89,150,239
"15736","KISII","ALL","90-94",534,955,1489
"15737","KISII","ALL","95",91,152,243
"15738","KISII","ALL","96",43,66,109
"15739","KISII","ALL","97",59,85,144
"15740","KISII","ALL","98",28,63,91
"15741","KISII","ALL","99",51,120,171
"15742","KISII","ALL","95-99",272,486,758
"15743","KISII","ALL","100+",92,299,391
"15744","KISII","ALL","Not Stated",15,7,22
"15745","KISII","ETAGO","Total",40137,43647,83784
"15746","KISII","ETAGO","0",923,929,1852
"15747","KISII","ETAGO","1",941,894,1835
"15748","KISII","ETAGO","2",902,969,1871
"15749","KISII","ETAGO","3",1089,1142,2231
"15750","KISII","ETAGO","4",1204,1178,2382
"15751","KISII","ETAGO","0 - 4",5059,5112,10171
"15752","KISII","ETAGO","5",1210,1234,2444
"15753","KISII","ETAGO","6",1350,1374,2724
"15754","KISII","ETAGO","7",1377,1303,2680
"15755","KISII","ETAGO","8",1305,1334,2639
"15756","KISII","ETAGO","9",1375,1407,2782
"15757","KISII","ETAGO","5-9",6617,6652,13269
"15758","KISII","ETAGO","10",1613,1572,3185
"15759","KISII","ETAGO","11",1379,1442,2821
"15760","KISII","ETAGO","12",1577,1470,3047
"15761","KISII","ETAGO","13",1434,1445,2879
"15762","KISII","ETAGO","14",1239,1227,2466
"15763","KISII","ETAGO","10 -14",7242,7156,14398
"15764","KISII","ETAGO","15",1189,1244,2433
"15765","KISII","ETAGO","16",1042,985,2027
"15766","KISII","ETAGO","17",1033,970,2003
"15767","KISII","ETAGO","18",791,781,1572
"15768","KISII","ETAGO","19",873,894,1767
"15769","KISII","ETAGO","15-19",4928,4874,9802
"15770","KISII","ETAGO","20",708,796,1504
"15771","KISII","ETAGO","21",462,618,1080
"15772","KISII","ETAGO","22",509,632,1141
"15773","KISII","ETAGO","23",501,605,1106
"15774","KISII","ETAGO","24",428,586,1014
"15775","KISII","ETAGO","20-24",2608,3237,5845
"15776","KISII","ETAGO","25",526,692,1218
"15777","KISII","ETAGO","26",458,587,1045
"15778","KISII","ETAGO","27",507,590,1097
"15779","KISII","ETAGO","28",363,426,789
"15780","KISII","ETAGO","29",423,520,943
"15781","KISII","ETAGO","25-29",2277,2815,5092
"15782","KISII","ETAGO","30",576,799,1375
"15783","KISII","ETAGO","31",557,703,1260
"15784","KISII","ETAGO","32",523,768,1291
"15785","KISII","ETAGO","33",502,743,1245
"15786","KISII","ETAGO","34",419,585,1004
"15787","KISII","ETAGO","30-34",2577,3598,6175
"15788","KISII","ETAGO","35",527,577,1104
"15789","KISII","ETAGO","36",353,330,683
"15790","KISII","ETAGO","37",401,331,732
"15791","KISII","ETAGO","38",240,212,452
"15792","KISII","ETAGO","39",295,305,600
"15793","KISII","ETAGO","35-39",1816,1755,3571
"15794","KISII","ETAGO","40",346,372,718
"15795","KISII","ETAGO","41",392,366,758
"15796","KISII","ETAGO","42",305,273,578
"15797","KISII","ETAGO","43",280,247,527
"15798","KISII","ETAGO","44",176,224,400
"15799","KISII","ETAGO","40-44",1499,1482,2981
"15800","KISII","ETAGO","45",412,424,836
"15801","KISII","ETAGO","46",331,418,749
"15802","KISII","ETAGO","47",331,464,795
"15803","KISII","ETAGO","48",136,203,339
"15804","KISII","ETAGO","49",190,292,482
"15805","KISII","ETAGO","45-49",1400,1801,3201
"15806","KISII","ETAGO","50",234,282,516
"15807","KISII","ETAGO","51",229,213,442
"15808","KISII","ETAGO","52",149,121,270
"15809","KISII","ETAGO","53",120,84,204
"15810","KISII","ETAGO","54",118,100,218
"15811","KISII","ETAGO","50-54",850,800,1650
"15812","KISII","ETAGO","55",176,190,366
"15813","KISII","ETAGO","56",247,222,469
"15814","KISII","ETAGO","57",225,352,577
"15815","KISII","ETAGO","58",144,193,337
"15816","KISII","ETAGO","59",201,376,577
"15817","KISII","ETAGO","55-59",993,1333,2326
"15818","KISII","ETAGO","60",217,345,562
"15819","KISII","ETAGO","61",204,253,457
"15820","KISII","ETAGO","62",126,155,281
"15821","KISII","ETAGO","63",121,162,283
"15822","KISII","ETAGO","64",114,132,246
"15823","KISII","ETAGO","60-64",782,1047,1829
"15824","KISII","ETAGO","65",171,216,387
"15825","KISII","ETAGO","66",92,117,209
"15826","KISII","ETAGO","67",125,202,327
"15827","KISII","ETAGO","68",65,101,166
"15828","KISII","ETAGO","69",106,161,267
"15829","KISII","ETAGO","65-69",559,797,1356
"15830","KISII","ETAGO","70",111,175,286
"15831","KISII","ETAGO","71",105,108,213
"15832","KISII","ETAGO","72",64,70,134
"15833","KISII","ETAGO","73",45,51,96
"15834","KISII","ETAGO","74",54,88,142
"15835","KISII","ETAGO","70-74",379,492,871
"15836","KISII","ETAGO","75",56,74,130
"15837","KISII","ETAGO","76",26,47,73
"15838","KISII","ETAGO","77",56,64,120
"15839","KISII","ETAGO","78",28,31,59
"15840","KISII","ETAGO","79",53,81,134
"15841","KISII","ETAGO","75-79",219,297,516
"15842","KISII","ETAGO","80",42,77,119
"15843","KISII","ETAGO","81",38,32,70
"15844","KISII","ETAGO","82",25,20,45
"15845","KISII","ETAGO","83",26,26,52
"15846","KISII","ETAGO","84",26,40,66
"15847","KISII","ETAGO","80-84",157,195,352
"15848","KISII","ETAGO","85",24,28,52
"15849","KISII","ETAGO","86",16,17,33
"15850","KISII","ETAGO","87",26,23,49
"15851","KISII","ETAGO","88",14,12,26
"15852","KISII","ETAGO","89",29,46,75
"15853","KISII","ETAGO","85-89",109,126,235
"15854","KISII","ETAGO","90",7,21,28
"15855","KISII","ETAGO","91",10,8,18
"15856","KISII","ETAGO","92",10,5,15
"15857","KISII","ETAGO","93",2,6,8
"15858","KISII","ETAGO","94",7,2,9
"15859","KISII","ETAGO","90-94",36,42,78
"15860","KISII","ETAGO","95",7,10,17
"15861","KISII","ETAGO","96",4,3,7
"15862","KISII","ETAGO","97",5,9,14
"15863","KISII","ETAGO","98",2,NA,2
"15864","KISII","ETAGO","99",5,5,10
"15865","KISII","ETAGO","95-99",23,27,50
"15866","KISII","ETAGO","100+",6,9,15
"15867","KISII","ETAGO","Not Stated",1,NA,1
"15868","KISII","GUCHA","Total",39631,44108,83739
"15869","KISII","GUCHA","0",916,895,1811
"15870","KISII","GUCHA","1",914,909,1823
"15871","KISII","GUCHA","2",935,903,1838
"15872","KISII","GUCHA","3",1000,970,1970
"15873","KISII","GUCHA","4",1037,1014,2051
"15874","KISII","GUCHA","0 - 4",4802,4691,9493
"15875","KISII","GUCHA","5",1075,1100,2175
"15876","KISII","GUCHA","6",1152,1148,2300
"15877","KISII","GUCHA","7",1222,1198,2420
"15878","KISII","GUCHA","8",1121,1125,2246
"15879","KISII","GUCHA","9",1268,1347,2615
"15880","KISII","GUCHA","5-9",5838,5918,11756
"15881","KISII","GUCHA","10",1504,1453,2957
"15882","KISII","GUCHA","11",1224,1317,2541
"15883","KISII","GUCHA","12",1530,1423,2953
"15884","KISII","GUCHA","13",1384,1396,2780
"15885","KISII","GUCHA","14",1279,1259,2538
"15886","KISII","GUCHA","10 -14",6921,6848,13769
"15887","KISII","GUCHA","15",1192,1170,2362
"15888","KISII","GUCHA","16",1076,1076,2152
"15889","KISII","GUCHA","17",1104,1088,2192
"15890","KISII","GUCHA","18",858,852,1710
"15891","KISII","GUCHA","19",857,865,1722
"15892","KISII","GUCHA","15-19",5087,5051,10138
"15893","KISII","GUCHA","20",676,850,1526
"15894","KISII","GUCHA","21",525,678,1203
"15895","KISII","GUCHA","22",577,716,1293
"15896","KISII","GUCHA","23",515,797,1312
"15897","KISII","GUCHA","24",466,678,1144
"15898","KISII","GUCHA","20-24",2759,3719,6478
"15899","KISII","GUCHA","25",561,846,1407
"15900","KISII","GUCHA","26",437,703,1140
"15901","KISII","GUCHA","27",537,688,1225
"15902","KISII","GUCHA","28",362,585,947
"15903","KISII","GUCHA","29",408,666,1074
"15904","KISII","GUCHA","25-29",2305,3488,5793
"15905","KISII","GUCHA","30",578,889,1467
"15906","KISII","GUCHA","31",496,680,1176
"15907","KISII","GUCHA","32",463,742,1205
"15908","KISII","GUCHA","33",457,611,1068
"15909","KISII","GUCHA","34",355,523,878
"15910","KISII","GUCHA","30-34",2349,3445,5794
"15911","KISII","GUCHA","35",537,612,1149
"15912","KISII","GUCHA","36",364,357,721
"15913","KISII","GUCHA","37",360,368,728
"15914","KISII","GUCHA","38",253,274,527
"15915","KISII","GUCHA","39",342,358,700
"15916","KISII","GUCHA","35-39",1856,1969,3825
"15917","KISII","GUCHA","40",393,404,797
"15918","KISII","GUCHA","41",454,397,851
"15919","KISII","GUCHA","42",322,360,682
"15920","KISII","GUCHA","43",302,357,659
"15921","KISII","GUCHA","44",249,273,522
"15922","KISII","GUCHA","40-44",1720,1791,3511
"15923","KISII","GUCHA","45",391,463,854
"15924","KISII","GUCHA","46",271,394,665
"15925","KISII","GUCHA","47",299,427,726
"15926","KISII","GUCHA","48",168,221,389
"15927","KISII","GUCHA","49",205,314,519
"15928","KISII","GUCHA","45-49",1334,1819,3153
"15929","KISII","GUCHA","50",222,308,530
"15930","KISII","GUCHA","51",252,241,493
"15931","KISII","GUCHA","52",160,120,280
"15932","KISII","GUCHA","53",132,96,228
"15933","KISII","GUCHA","54",150,123,273
"15934","KISII","GUCHA","50-54",916,888,1804
"15935","KISII","GUCHA","55",239,181,420
"15936","KISII","GUCHA","56",216,220,436
"15937","KISII","GUCHA","57",303,306,609
"15938","KISII","GUCHA","58",217,216,433
"15939","KISII","GUCHA","59",268,307,575
"15940","KISII","GUCHA","55-59",1243,1230,2473
"15941","KISII","GUCHA","60",251,414,665
"15942","KISII","GUCHA","61",224,256,480
"15943","KISII","GUCHA","62",160,175,335
"15944","KISII","GUCHA","63",180,168,348
"15945","KISII","GUCHA","64",100,136,236
"15946","KISII","GUCHA","60-64",915,1149,2064
"15947","KISII","GUCHA","65",200,276,476
"15948","KISII","GUCHA","66",108,119,227
"15949","KISII","GUCHA","67",133,161,294
"15950","KISII","GUCHA","68",78,93,171
"15951","KISII","GUCHA","69",113,123,236
"15952","KISII","GUCHA","65-69",632,772,1404
"15953","KISII","GUCHA","70",138,235,373
"15954","KISII","GUCHA","71",107,96,203
"15955","KISII","GUCHA","72",68,65,133
"15956","KISII","GUCHA","73",60,61,121
"15957","KISII","GUCHA","74",69,79,148
"15958","KISII","GUCHA","70-74",442,536,978
"15959","KISII","GUCHA","75",50,62,112
"15960","KISII","GUCHA","76",39,44,83
"15961","KISII","GUCHA","77",45,48,93
"15962","KISII","GUCHA","78",29,31,60
"15963","KISII","GUCHA","79",36,67,103
"15964","KISII","GUCHA","75-79",199,252,451
"15965","KISII","GUCHA","80",38,103,141
"15966","KISII","GUCHA","81",25,43,68
"15967","KISII","GUCHA","82",23,26,49
"15968","KISII","GUCHA","83",38,35,73
"15969","KISII","GUCHA","84",27,37,64
"15970","KISII","GUCHA","80-84",151,244,395
"15971","KISII","GUCHA","85",19,51,70
"15972","KISII","GUCHA","86",21,17,38
"15973","KISII","GUCHA","87",27,31,58
"15974","KISII","GUCHA","88",10,18,28
"15975","KISII","GUCHA","89",23,33,56
"15976","KISII","GUCHA","85-89",100,150,250
"15977","KISII","GUCHA","90",11,35,46
"15978","KISII","GUCHA","91",9,16,25
"15979","KISII","GUCHA","92",10,9,19
"15980","KISII","GUCHA","93",1,5,6
"15981","KISII","GUCHA","94",4,13,17
"15982","KISII","GUCHA","90-94",35,78,113
"15983","KISII","GUCHA","95",6,11,17
"15984","KISII","GUCHA","96",5,3,8
"15985","KISII","GUCHA","97",3,8,11
"15986","KISII","GUCHA","98",2,7,9
"15987","KISII","GUCHA","99",5,15,20
"15988","KISII","GUCHA","95-99",21,44,65
"15989","KISII","GUCHA","100+",6,25,31
"15990","KISII","GUCHA","Not Stated",NA,1,1
"15991","KISII","GUCHA SOUTH","Total",40022,43598,83620
"15992","KISII","GUCHA SOUTH","0",802,840,1642
"15993","KISII","GUCHA SOUTH","1",933,863,1796
"15994","KISII","GUCHA SOUTH","2",922,877,1799
"15995","KISII","GUCHA SOUTH","3",1037,950,1987
"15996","KISII","GUCHA SOUTH","4",1031,1110,2141
"15997","KISII","GUCHA SOUTH","0 - 4",4725,4640,9365
"15998","KISII","GUCHA SOUTH","5",1085,1033,2118
"15999","KISII","GUCHA SOUTH","6",1130,1160,2290
"16000","KISII","GUCHA SOUTH","7",1243,1174,2417
"16001","KISII","GUCHA SOUTH","8",1151,1161,2312
"16002","KISII","GUCHA SOUTH","9",1288,1272,2560
"16003","KISII","GUCHA SOUTH","5-9",5897,5800,11697
"16004","KISII","GUCHA SOUTH","10",1465,1480,2945
"16005","KISII","GUCHA SOUTH","11",1291,1281,2572
"16006","KISII","GUCHA SOUTH","12",1517,1392,2909
"16007","KISII","GUCHA SOUTH","13",1424,1420,2844
"16008","KISII","GUCHA SOUTH","14",1258,1214,2472
"16009","KISII","GUCHA SOUTH","10 -14",6955,6787,13742
"16010","KISII","GUCHA SOUTH","15",1193,1218,2411
"16011","KISII","GUCHA SOUTH","16",1074,998,2072
"16012","KISII","GUCHA SOUTH","17",1087,1002,2089
"16013","KISII","GUCHA SOUTH","18",842,840,1682
"16014","KISII","GUCHA SOUTH","19",875,875,1750
"16015","KISII","GUCHA SOUTH","15-19",5071,4933,10004
"16016","KISII","GUCHA SOUTH","20",736,885,1621
"16017","KISII","GUCHA SOUTH","21",563,647,1210
"16018","KISII","GUCHA SOUTH","22",516,653,1169
"16019","KISII","GUCHA SOUTH","23",563,712,1275
"16020","KISII","GUCHA SOUTH","24",494,693,1187
"16021","KISII","GUCHA SOUTH","20-24",2872,3590,6462
"16022","KISII","GUCHA SOUTH","25",585,775,1360
"16023","KISII","GUCHA SOUTH","26",430,623,1053
"16024","KISII","GUCHA SOUTH","27",526,616,1142
"16025","KISII","GUCHA SOUTH","28",384,517,901
"16026","KISII","GUCHA SOUTH","29",421,562,983
"16027","KISII","GUCHA SOUTH","25-29",2346,3093,5439
"16028","KISII","GUCHA SOUTH","30",590,893,1483
"16029","KISII","GUCHA SOUTH","31",491,754,1245
"16030","KISII","GUCHA SOUTH","32",577,858,1435
"16031","KISII","GUCHA SOUTH","33",463,675,1138
"16032","KISII","GUCHA SOUTH","34",436,576,1012
"16033","KISII","GUCHA SOUTH","30-34",2557,3756,6313
"16034","KISII","GUCHA SOUTH","35",558,630,1188
"16035","KISII","GUCHA SOUTH","36",348,369,717
"16036","KISII","GUCHA SOUTH","37",375,307,682
"16037","KISII","GUCHA SOUTH","38",268,229,497
"16038","KISII","GUCHA SOUTH","39",333,327,660
"16039","KISII","GUCHA SOUTH","35-39",1882,1862,3744
"16040","KISII","GUCHA SOUTH","40",390,430,820
"16041","KISII","GUCHA SOUTH","41",454,381,835
"16042","KISII","GUCHA SOUTH","42",337,282,619
"16043","KISII","GUCHA SOUTH","43",307,299,606
"16044","KISII","GUCHA SOUTH","44",228,244,472
"16045","KISII","GUCHA SOUTH","40-44",1716,1636,3352
"16046","KISII","GUCHA SOUTH","45",438,500,938
"16047","KISII","GUCHA SOUTH","46",304,347,651
"16048","KISII","GUCHA SOUTH","47",313,396,709
"16049","KISII","GUCHA SOUTH","48",148,203,351
"16050","KISII","GUCHA SOUTH","49",238,270,508
"16051","KISII","GUCHA SOUTH","45-49",1441,1716,3157
"16052","KISII","GUCHA SOUTH","50",260,348,608
"16053","KISII","GUCHA SOUTH","51",211,230,441
"16054","KISII","GUCHA SOUTH","52",157,143,300
"16055","KISII","GUCHA SOUTH","53",140,130,270
"16056","KISII","GUCHA SOUTH","54",166,146,312
"16057","KISII","GUCHA SOUTH","50-54",934,997,1931
"16058","KISII","GUCHA SOUTH","55",250,206,456
"16059","KISII","GUCHA SOUTH","56",289,274,563
"16060","KISII","GUCHA SOUTH","57",260,379,639
"16061","KISII","GUCHA SOUTH","58",157,216,373
"16062","KISII","GUCHA SOUTH","59",269,298,567
"16063","KISII","GUCHA SOUTH","55-59",1225,1373,2598
"16064","KISII","GUCHA SOUTH","60",211,317,528
"16065","KISII","GUCHA SOUTH","61",212,232,444
"16066","KISII","GUCHA SOUTH","62",157,196,353
"16067","KISII","GUCHA SOUTH","63",138,193,331
"16068","KISII","GUCHA SOUTH","64",131,162,293
"16069","KISII","GUCHA SOUTH","60-64",849,1100,1949
"16070","KISII","GUCHA SOUTH","65",166,225,391
"16071","KISII","GUCHA SOUTH","66",97,111,208
"16072","KISII","GUCHA SOUTH","67",138,209,347
"16073","KISII","GUCHA SOUTH","68",77,80,157
"16074","KISII","GUCHA SOUTH","69",129,194,323
"16075","KISII","GUCHA SOUTH","65-69",607,819,1426
"16076","KISII","GUCHA SOUTH","70",125,230,355
"16077","KISII","GUCHA SOUTH","71",100,144,244
"16078","KISII","GUCHA SOUTH","72",79,87,166
"16079","KISII","GUCHA SOUTH","73",53,64,117
"16080","KISII","GUCHA SOUTH","74",63,82,145
"16081","KISII","GUCHA SOUTH","70-74",420,607,1027
"16082","KISII","GUCHA SOUTH","75",51,89,140
"16083","KISII","GUCHA SOUTH","76",25,37,62
"16084","KISII","GUCHA SOUTH","77",56,56,112
"16085","KISII","GUCHA SOUTH","78",31,36,67
"16086","KISII","GUCHA SOUTH","79",51,67,118
"16087","KISII","GUCHA SOUTH","75-79",214,285,499
"16088","KISII","GUCHA SOUTH","80",51,108,159
"16089","KISII","GUCHA SOUTH","81",28,48,76
"16090","KISII","GUCHA SOUTH","82",24,31,55
"16091","KISII","GUCHA SOUTH","83",20,38,58
"16092","KISII","GUCHA SOUTH","84",13,64,77
"16093","KISII","GUCHA SOUTH","80-84",136,289,425
"16094","KISII","GUCHA SOUTH","85",24,35,59
"16095","KISII","GUCHA SOUTH","86",15,26,41
"16096","KISII","GUCHA SOUTH","87",37,39,76
"16097","KISII","GUCHA SOUTH","88",11,17,28
"16098","KISII","GUCHA SOUTH","89",20,63,83
"16099","KISII","GUCHA SOUTH","85-89",107,180,287
"16100","KISII","GUCHA SOUTH","90",7,32,39
"16101","KISII","GUCHA SOUTH","91",15,15,30
"16102","KISII","GUCHA SOUTH","92",5,10,15
"16103","KISII","GUCHA SOUTH","93",4,7,11
"16104","KISII","GUCHA SOUTH","94",7,10,17
"16105","KISII","GUCHA SOUTH","90-94",38,74,112
"16106","KISII","GUCHA SOUTH","95",10,12,22
"16107","KISII","GUCHA SOUTH","96",4,4,8
"16108","KISII","GUCHA SOUTH","97",NA,4,4
"16109","KISII","GUCHA SOUTH","98",1,6,7
"16110","KISII","GUCHA SOUTH","99",2,11,13
"16111","KISII","GUCHA SOUTH","95-99",17,37,54
"16112","KISII","GUCHA SOUTH","100+",10,23,33
"16113","KISII","GUCHA SOUTH","Not Stated",3,1,4
"16114","KISII","KENYENYA","Total",62859,68878,131737
"16115","KISII","KENYENYA","0",1391,1387,2778
"16116","KISII","KENYENYA","1",1370,1396,2766
"16117","KISII","KENYENYA","2",1421,1449,2870
"16118","KISII","KENYENYA","3",1592,1681,3273
"16119","KISII","KENYENYA","4",1700,1718,3418
"16120","KISII","KENYENYA","0 - 4",7474,7631,15105
"16121","KISII","KENYENYA","5",1689,1701,3390
"16122","KISII","KENYENYA","6",1851,1819,3670
"16123","KISII","KENYENYA","7",1908,1900,3808
"16124","KISII","KENYENYA","8",1822,1770,3592
"16125","KISII","KENYENYA","9",2119,2057,4176
"16126","KISII","KENYENYA","5-9",9389,9247,18636
"16127","KISII","KENYENYA","10",2281,2200,4481
"16128","KISII","KENYENYA","11",1948,2050,3998
"16129","KISII","KENYENYA","12",2278,2277,4555
"16130","KISII","KENYENYA","13",2201,2246,4447
"16131","KISII","KENYENYA","14",1873,1904,3777
"16132","KISII","KENYENYA","10 -14",10581,10677,21258
"16133","KISII","KENYENYA","15",1877,1911,3788
"16134","KISII","KENYENYA","16",1731,1705,3436
"16135","KISII","KENYENYA","17",1753,1611,3364
"16136","KISII","KENYENYA","18",1335,1273,2608
"16137","KISII","KENYENYA","19",1436,1401,2837
"16138","KISII","KENYENYA","15-19",8132,7901,16033
"16139","KISII","KENYENYA","20",1065,1238,2303
"16140","KISII","KENYENYA","21",852,1047,1899
"16141","KISII","KENYENYA","22",879,1037,1916
"16142","KISII","KENYENYA","23",782,1140,1922
"16143","KISII","KENYENYA","24",666,937,1603
"16144","KISII","KENYENYA","20-24",4244,5399,9643
"16145","KISII","KENYENYA","25",837,1157,1994
"16146","KISII","KENYENYA","26",762,1001,1763
"16147","KISII","KENYENYA","27",780,1027,1807
"16148","KISII","KENYENYA","28",606,800,1406
"16149","KISII","KENYENYA","29",685,911,1596
"16150","KISII","KENYENYA","25-29",3670,4896,8566
"16151","KISII","KENYENYA","30",846,1335,2181
"16152","KISII","KENYENYA","31",697,1024,1721
"16153","KISII","KENYENYA","32",891,1157,2048
"16154","KISII","KENYENYA","33",749,1099,1848
"16155","KISII","KENYENYA","34",587,988,1575
"16156","KISII","KENYENYA","30-34",3770,5603,9373
"16157","KISII","KENYENYA","35",796,968,1764
"16158","KISII","KENYENYA","36",561,563,1124
"16159","KISII","KENYENYA","37",587,613,1200
"16160","KISII","KENYENYA","38",432,415,847
"16161","KISII","KENYENYA","39",587,620,1207
"16162","KISII","KENYENYA","35-39",2963,3179,6142
"16163","KISII","KENYENYA","40",663,629,1292
"16164","KISII","KENYENYA","41",632,713,1345
"16165","KISII","KENYENYA","42",496,487,983
"16166","KISII","KENYENYA","43",525,587,1112
"16167","KISII","KENYENYA","44",412,498,910
"16168","KISII","KENYENYA","40-44",2728,2914,5642
"16169","KISII","KENYENYA","45",686,754,1440
"16170","KISII","KENYENYA","46",487,501,988
"16171","KISII","KENYENYA","47",507,555,1062
"16172","KISII","KENYENYA","48",255,258,513
"16173","KISII","KENYENYA","49",274,419,693
"16174","KISII","KENYENYA","45-49",2209,2487,4696
"16175","KISII","KENYENYA","50",423,461,884
"16176","KISII","KENYENYA","51",393,389,782
"16177","KISII","KENYENYA","52",276,221,497
"16178","KISII","KENYENYA","53",240,197,437
"16179","KISII","KENYENYA","54",272,219,491
"16180","KISII","KENYENYA","50-54",1604,1487,3091
"16181","KISII","KENYENYA","55",340,280,620
"16182","KISII","KENYENYA","56",384,441,825
"16183","KISII","KENYENYA","57",422,585,1007
"16184","KISII","KENYENYA","58",280,327,607
"16185","KISII","KENYENYA","59",424,521,945
"16186","KISII","KENYENYA","55-59",1850,2154,4004
"16187","KISII","KENYENYA","60",421,494,915
"16188","KISII","KENYENYA","61",369,383,752
"16189","KISII","KENYENYA","62",281,297,578
"16190","KISII","KENYENYA","63",266,279,545
"16191","KISII","KENYENYA","64",172,180,352
"16192","KISII","KENYENYA","60-64",1509,1633,3142
"16193","KISII","KENYENYA","65",284,396,680
"16194","KISII","KENYENYA","66",162,189,351
"16195","KISII","KENYENYA","67",245,292,537
"16196","KISII","KENYENYA","68",104,154,258
"16197","KISII","KENYENYA","69",221,251,472
"16198","KISII","KENYENYA","65-69",1016,1282,2298
"16199","KISII","KENYENYA","70",174,346,520
"16200","KISII","KENYENYA","71",189,184,373
"16201","KISII","KENYENYA","72",149,141,290
"16202","KISII","KENYENYA","73",108,108,216
"16203","KISII","KENYENYA","74",126,158,284
"16204","KISII","KENYENYA","70-74",746,937,1683
"16205","KISII","KENYENYA","75",86,139,225
"16206","KISII","KENYENYA","76",65,71,136
"16207","KISII","KENYENYA","77",101,98,199
"16208","KISII","KENYENYA","78",52,56,108
"16209","KISII","KENYENYA","79",69,146,215
"16210","KISII","KENYENYA","75-79",373,510,883
"16211","KISII","KENYENYA","80",72,179,251
"16212","KISII","KENYENYA","81",54,82,136
"16213","KISII","KENYENYA","82",37,48,85
"16214","KISII","KENYENYA","83",64,63,127
"16215","KISII","KENYENYA","84",46,76,122
"16216","KISII","KENYENYA","80-84",273,448,721
"16217","KISII","KENYENYA","85",47,79,126
"16218","KISII","KENYENYA","86",41,32,73
"16219","KISII","KENYENYA","87",43,63,106
"16220","KISII","KENYENYA","88",30,29,59
"16221","KISII","KENYENYA","89",40,79,119
"16222","KISII","KENYENYA","85-89",201,282,483
"16223","KISII","KENYENYA","90",26,45,71
"16224","KISII","KENYENYA","91",8,24,32
"16225","KISII","KENYENYA","92",11,13,24
"16226","KISII","KENYENYA","93",6,17,23
"16227","KISII","KENYENYA","94",13,18,31
"16228","KISII","KENYENYA","90-94",64,117,181
"16229","KISII","KENYENYA","95",14,15,29
"16230","KISII","KENYENYA","96",8,8,16
"16231","KISII","KENYENYA","97",13,10,23
"16232","KISII","KENYENYA","98",7,10,17
"16233","KISII","KENYENYA","99",6,13,19
"16234","KISII","KENYENYA","95-99",48,56,104
"16235","KISII","KENYENYA","100+",15,37,52
"16236","KISII","KENYENYA","Not Stated",NA,1,1
"16237","KISII","KISII CENTRAL","Total",81330,85573,166903
"16238","KISII","KISII CENTRAL","0",1816,1889,3705
"16239","KISII","KISII CENTRAL","1",1770,1775,3545
"16240","KISII","KISII CENTRAL","2",1774,1764,3538
"16241","KISII","KISII CENTRAL","3",1864,1962,3826
"16242","KISII","KISII CENTRAL","4",1989,1922,3911
"16243","KISII","KISII CENTRAL","0 - 4",9213,9312,18525
"16244","KISII","KISII CENTRAL","5",1846,1865,3711
"16245","KISII","KISII CENTRAL","6",2004,1969,3973
"16246","KISII","KISII CENTRAL","7",2042,1998,4040
"16247","KISII","KISII CENTRAL","8",1916,1921,3837
"16248","KISII","KISII CENTRAL","9",2106,2103,4209
"16249","KISII","KISII CENTRAL","5-9",9914,9856,19770
"16250","KISII","KISII CENTRAL","10",2320,2221,4541
"16251","KISII","KISII CENTRAL","11",1948,2094,4042
"16252","KISII","KISII CENTRAL","12",2417,2250,4667
"16253","KISII","KISII CENTRAL","13",2327,2387,4714
"16254","KISII","KISII CENTRAL","14",2147,2198,4345
"16255","KISII","KISII CENTRAL","10 -14",11159,11150,22309
"16256","KISII","KISII CENTRAL","15",2007,2089,4096
"16257","KISII","KISII CENTRAL","16",1868,1966,3834
"16258","KISII","KISII CENTRAL","17",2014,2012,4026
"16259","KISII","KISII CENTRAL","18",1626,1646,3272
"16260","KISII","KISII CENTRAL","19",1791,1870,3661
"16261","KISII","KISII CENTRAL","15-19",9306,9583,18889
"16262","KISII","KISII CENTRAL","20",1595,1783,3378
"16263","KISII","KISII CENTRAL","21",1521,1715,3236
"16264","KISII","KISII CENTRAL","22",1485,1715,3200
"16265","KISII","KISII CENTRAL","23",1617,1919,3536
"16266","KISII","KISII CENTRAL","24",1508,1788,3296
"16267","KISII","KISII CENTRAL","20-24",7726,8920,16646
"16268","KISII","KISII CENTRAL","25",1701,2034,3735
"16269","KISII","KISII CENTRAL","26",1378,1697,3075
"16270","KISII","KISII CENTRAL","27",1389,1644,3033
"16271","KISII","KISII CENTRAL","28",1119,1298,2417
"16272","KISII","KISII CENTRAL","29",1208,1431,2639
"16273","KISII","KISII CENTRAL","25-29",6795,8104,14899
"16274","KISII","KISII CENTRAL","30",1565,1903,3468
"16275","KISII","KISII CENTRAL","31",1119,1380,2499
"16276","KISII","KISII CENTRAL","32",1375,1675,3050
"16277","KISII","KISII CENTRAL","33",1033,1338,2371
"16278","KISII","KISII CENTRAL","34",978,1136,2114
"16279","KISII","KISII CENTRAL","30-34",6070,7432,13502
"16280","KISII","KISII CENTRAL","35",1330,1299,2629
"16281","KISII","KISII CENTRAL","36",918,792,1710
"16282","KISII","KISII CENTRAL","37",962,816,1778
"16283","KISII","KISII CENTRAL","38",702,657,1359
"16284","KISII","KISII CENTRAL","39",846,743,1589
"16285","KISII","KISII CENTRAL","35-39",4758,4307,9065
"16286","KISII","KISII CENTRAL","40",982,936,1918
"16287","KISII","KISII CENTRAL","41",985,857,1842
"16288","KISII","KISII CENTRAL","42",769,676,1445
"16289","KISII","KISII CENTRAL","43",691,620,1311
"16290","KISII","KISII CENTRAL","44",486,505,991
"16291","KISII","KISII CENTRAL","40-44",3913,3594,7507
"16292","KISII","KISII CENTRAL","45",987,915,1902
"16293","KISII","KISII CENTRAL","46",575,708,1283
"16294","KISII","KISII CENTRAL","47",640,768,1408
"16295","KISII","KISII CENTRAL","48",432,418,850
"16296","KISII","KISII CENTRAL","49",492,534,1026
"16297","KISII","KISII CENTRAL","45-49",3126,3343,6469
"16298","KISII","KISII CENTRAL","50",597,622,1219
"16299","KISII","KISII CENTRAL","51",452,417,869
"16300","KISII","KISII CENTRAL","52",369,307,676
"16301","KISII","KISII CENTRAL","53",269,231,500
"16302","KISII","KISII CENTRAL","54",369,314,683
"16303","KISII","KISII CENTRAL","50-54",2056,1891,3947
"16304","KISII","KISII CENTRAL","55",446,389,835
"16305","KISII","KISII CENTRAL","56",474,495,969
"16306","KISII","KISII CENTRAL","57",581,715,1296
"16307","KISII","KISII CENTRAL","58",395,436,831
"16308","KISII","KISII CENTRAL","59",517,590,1107
"16309","KISII","KISII CENTRAL","55-59",2413,2625,5038
"16310","KISII","KISII CENTRAL","60",489,609,1098
"16311","KISII","KISII CENTRAL","61",451,423,874
"16312","KISII","KISII CENTRAL","62",304,311,615
"16313","KISII","KISII CENTRAL","63",328,304,632
"16314","KISII","KISII CENTRAL","64",216,245,461
"16315","KISII","KISII CENTRAL","60-64",1788,1892,3680
"16316","KISII","KISII CENTRAL","65",329,387,716
"16317","KISII","KISII CENTRAL","66",193,191,384
"16318","KISII","KISII CENTRAL","67",331,328,659
"16319","KISII","KISII CENTRAL","68",146,140,286
"16320","KISII","KISII CENTRAL","69",243,247,490
"16321","KISII","KISII CENTRAL","65-69",1242,1293,2535
"16322","KISII","KISII CENTRAL","70",284,369,653
"16323","KISII","KISII CENTRAL","71",210,177,387
"16324","KISII","KISII CENTRAL","72",159,126,285
"16325","KISII","KISII CENTRAL","73",141,114,255
"16326","KISII","KISII CENTRAL","74",102,132,234
"16327","KISII","KISII CENTRAL","70-74",896,918,1814
"16328","KISII","KISII CENTRAL","75",99,129,228
"16329","KISII","KISII CENTRAL","76",75,75,150
"16330","KISII","KISII CENTRAL","77",111,112,223
"16331","KISII","KISII CENTRAL","78",52,55,107
"16332","KISII","KISII CENTRAL","79",81,133,214
"16333","KISII","KISII CENTRAL","75-79",418,504,922
"16334","KISII","KISII CENTRAL","80",90,165,255
"16335","KISII","KISII CENTRAL","81",54,84,138
"16336","KISII","KISII CENTRAL","82",46,46,92
"16337","KISII","KISII CENTRAL","83",52,54,106
"16338","KISII","KISII CENTRAL","84",47,63,110
"16339","KISII","KISII CENTRAL","80-84",289,412,701
"16340","KISII","KISII CENTRAL","85",38,61,99
"16341","KISII","KISII CENTRAL","86",25,29,54
"16342","KISII","KISII CENTRAL","87",34,43,77
"16343","KISII","KISII CENTRAL","88",22,30,52
"16344","KISII","KISII CENTRAL","89",29,87,116
"16345","KISII","KISII CENTRAL","85-89",148,250,398
"16346","KISII","KISII CENTRAL","90",15,34,49
"16347","KISII","KISII CENTRAL","91",14,20,34
"16348","KISII","KISII CENTRAL","92",17,19,36
"16349","KISII","KISII CENTRAL","93",9,13,22
"16350","KISII","KISII CENTRAL","94",10,22,32
"16351","KISII","KISII CENTRAL","90-94",65,108,173
"16352","KISII","KISII CENTRAL","95",11,15,26
"16353","KISII","KISII CENTRAL","96",5,9,14
"16354","KISII","KISII CENTRAL","97",4,8,12
"16355","KISII","KISII CENTRAL","98",3,3,6
"16356","KISII","KISII CENTRAL","99",5,13,18
"16357","KISII","KISII CENTRAL","95-99",28,48,76
"16358","KISII","KISII CENTRAL","100+",7,30,37
"16359","KISII","KISII CENTRAL","Not Stated",NA,1,1
"16360","KISII","KISII SOUTH","Total",64514,70615,135129
"16361","KISII","KISII SOUTH","0",1404,1461,2865
"16362","KISII","KISII SOUTH","1",1470,1499,2969
"16363","KISII","KISII SOUTH","2",1560,1519,3079
"16364","KISII","KISII SOUTH","3",1674,1596,3270
"16365","KISII","KISII SOUTH","4",1591,1707,3298
"16366","KISII","KISII SOUTH","0 - 4",7699,7782,15481
"16367","KISII","KISII SOUTH","5",1622,1734,3356
"16368","KISII","KISII SOUTH","6",1813,1812,3625
"16369","KISII","KISII SOUTH","7",1884,1866,3750
"16370","KISII","KISII SOUTH","8",1838,1881,3719
"16371","KISII","KISII SOUTH","9",2060,2120,4180
"16372","KISII","KISII SOUTH","5-9",9217,9413,18630
"16373","KISII","KISII SOUTH","10",2230,2182,4412
"16374","KISII","KISII SOUTH","11",1848,2022,3870
"16375","KISII","KISII SOUTH","12",2276,2130,4406
"16376","KISII","KISII SOUTH","13",2119,2186,4305
"16377","KISII","KISII SOUTH","14",1962,1927,3889
"16378","KISII","KISII SOUTH","10 -14",10435,10447,20882
"16379","KISII","KISII SOUTH","15",1932,1911,3843
"16380","KISII","KISII SOUTH","16",1760,1820,3580
"16381","KISII","KISII SOUTH","17",1712,1719,3431
"16382","KISII","KISII SOUTH","18",1443,1512,2955
"16383","KISII","KISII SOUTH","19",1522,1548,3070
"16384","KISII","KISII SOUTH","15-19",8369,8510,16879
"16385","KISII","KISII SOUTH","20",1267,1565,2832
"16386","KISII","KISII SOUTH","21",1027,1278,2305
"16387","KISII","KISII SOUTH","22",946,1180,2126
"16388","KISII","KISII SOUTH","23",997,1276,2273
"16389","KISII","KISII SOUTH","24",944,1221,2165
"16390","KISII","KISII SOUTH","20-24",5181,6520,11701
"16391","KISII","KISII SOUTH","25",1075,1417,2492
"16392","KISII","KISII SOUTH","26",869,1064,1933
"16393","KISII","KISII SOUTH","27",869,1150,2019
"16394","KISII","KISII SOUTH","28",756,930,1686
"16395","KISII","KISII SOUTH","29",738,1042,1780
"16396","KISII","KISII SOUTH","25-29",4307,5603,9910
"16397","KISII","KISII SOUTH","30",935,1302,2237
"16398","KISII","KISII SOUTH","31",766,995,1761
"16399","KISII","KISII SOUTH","32",881,1172,2053
"16400","KISII","KISII SOUTH","33",787,1022,1809
"16401","KISII","KISII SOUTH","34",668,835,1503
"16402","KISII","KISII SOUTH","30-34",4037,5326,9363
"16403","KISII","KISII SOUTH","35",891,997,1888
"16404","KISII","KISII SOUTH","36",641,562,1203
"16405","KISII","KISII SOUTH","37",680,583,1263
"16406","KISII","KISII SOUTH","38",462,400,862
"16407","KISII","KISII SOUTH","39",550,550,1100
"16408","KISII","KISII SOUTH","35-39",3224,3092,6316
"16409","KISII","KISII SOUTH","40",635,663,1298
"16410","KISII","KISII SOUTH","41",699,651,1350
"16411","KISII","KISII SOUTH","42",582,578,1160
"16412","KISII","KISII SOUTH","43",547,601,1148
"16413","KISII","KISII SOUTH","44",364,466,830
"16414","KISII","KISII SOUTH","40-44",2827,2959,5786
"16415","KISII","KISII SOUTH","45",695,705,1400
"16416","KISII","KISII SOUTH","46",425,532,957
"16417","KISII","KISII SOUTH","47",514,632,1146
"16418","KISII","KISII SOUTH","48",282,362,644
"16419","KISII","KISII SOUTH","49",331,415,746
"16420","KISII","KISII SOUTH","45-49",2247,2646,4893
"16421","KISII","KISII SOUTH","50",422,516,938
"16422","KISII","KISII SOUTH","51",324,362,686
"16423","KISII","KISII SOUTH","52",268,247,515
"16424","KISII","KISII SOUTH","53",180,196,376
"16425","KISII","KISII SOUTH","54",250,254,504
"16426","KISII","KISII SOUTH","50-54",1444,1575,3019
"16427","KISII","KISII SOUTH","55",377,347,724
"16428","KISII","KISII SOUTH","56",461,379,840
"16429","KISII","KISII SOUTH","57",363,476,839
"16430","KISII","KISII SOUTH","58",237,346,583
"16431","KISII","KISII SOUTH","59",342,434,776
"16432","KISII","KISII SOUTH","55-59",1780,1982,3762
"16433","KISII","KISII SOUTH","60",352,554,906
"16434","KISII","KISII SOUTH","61",310,385,695
"16435","KISII","KISII SOUTH","62",260,263,523
"16436","KISII","KISII SOUTH","63",237,277,514
"16437","KISII","KISII SOUTH","64",215,204,419
"16438","KISII","KISII SOUTH","60-64",1374,1683,3057
"16439","KISII","KISII SOUTH","65",267,371,638
"16440","KISII","KISII SOUTH","66",153,140,293
"16441","KISII","KISII SOUTH","67",267,255,522
"16442","KISII","KISII SOUTH","68",110,158,268
"16443","KISII","KISII SOUTH","69",193,270,463
"16444","KISII","KISII SOUTH","65-69",990,1194,2184
"16445","KISII","KISII SOUTH","70",219,374,593
"16446","KISII","KISII SOUTH","71",159,163,322
"16447","KISII","KISII SOUTH","72",131,100,231
"16448","KISII","KISII SOUTH","73",85,84,169
"16449","KISII","KISII SOUTH","74",83,116,199
"16450","KISII","KISII SOUTH","70-74",677,837,1514
"16451","KISII","KISII SOUTH","75",79,105,184
"16452","KISII","KISII SOUTH","76",58,60,118
"16453","KISII","KISII SOUTH","77",71,65,136
"16454","KISII","KISII SOUTH","78",52,30,82
"16455","KISII","KISII SOUTH","79",59,102,161
"16456","KISII","KISII SOUTH","75-79",319,362,681
"16457","KISII","KISII SOUTH","80",67,113,180
"16458","KISII","KISII SOUTH","81",40,54,94
"16459","KISII","KISII SOUTH","82",39,33,72
"16460","KISII","KISII SOUTH","83",32,28,60
"16461","KISII","KISII SOUTH","84",41,60,101
"16462","KISII","KISII SOUTH","80-84",219,288,507
"16463","KISII","KISII SOUTH","85",18,49,67
"16464","KISII","KISII SOUTH","86",16,27,43
"16465","KISII","KISII SOUTH","87",28,38,66
"16466","KISII","KISII SOUTH","88",13,20,33
"16467","KISII","KISII SOUTH","89",26,70,96
"16468","KISII","KISII SOUTH","85-89",101,204,305
"16469","KISII","KISII SOUTH","90",13,42,55
"16470","KISII","KISII SOUTH","91",7,15,22
"16471","KISII","KISII SOUTH","92",10,14,24
"16472","KISII","KISII SOUTH","93",3,11,14
"16473","KISII","KISII SOUTH","94",6,17,23
"16474","KISII","KISII SOUTH","90-94",39,99,138
"16475","KISII","KISII SOUTH","95",4,15,19
"16476","KISII","KISII SOUTH","96",6,7,13
"16477","KISII","KISII SOUTH","97",3,9,12
"16478","KISII","KISII SOUTH","98",3,5,8
"16479","KISII","KISII SOUTH","99",2,16,18
"16480","KISII","KISII SOUTH","95-99",18,52,70
"16481","KISII","KISII SOUTH","100+",10,41,51
"16482","KISII","KISII SOUTH","Not Stated",NA,NA,NA
"16483","KISII","KITUTU CENTRAL","Total",74608,79561,154169
"16484","KISII","KITUTU CENTRAL","0",1811,1797,3608
"16485","KISII","KITUTU CENTRAL","1",1787,1702,3489
"16486","KISII","KITUTU CENTRAL","2",1767,1709,3476
"16487","KISII","KITUTU CENTRAL","3",1836,1898,3734
"16488","KISII","KITUTU CENTRAL","4",1890,1746,3636
"16489","KISII","KITUTU CENTRAL","0 - 4",9091,8852,17943
"16490","KISII","KITUTU CENTRAL","5",1747,1815,3562
"16491","KISII","KITUTU CENTRAL","6",1955,1924,3879
"16492","KISII","KITUTU CENTRAL","7",1931,2043,3974
"16493","KISII","KITUTU CENTRAL","8",1828,1829,3657
"16494","KISII","KITUTU CENTRAL","9",2121,2069,4190
"16495","KISII","KITUTU CENTRAL","5-9",9582,9680,19262
"16496","KISII","KITUTU CENTRAL","10",2109,2194,4303
"16497","KISII","KITUTU CENTRAL","11",1859,1906,3765
"16498","KISII","KITUTU CENTRAL","12",2332,2294,4626
"16499","KISII","KITUTU CENTRAL","13",2121,2254,4375
"16500","KISII","KITUTU CENTRAL","14",1926,2023,3949
"16501","KISII","KITUTU CENTRAL","10 -14",10347,10671,21018
"16502","KISII","KITUTU CENTRAL","15",1844,1899,3743
"16503","KISII","KITUTU CENTRAL","16",1775,1781,3556
"16504","KISII","KITUTU CENTRAL","17",1732,1832,3564
"16505","KISII","KITUTU CENTRAL","18",1490,1499,2989
"16506","KISII","KITUTU CENTRAL","19",1585,1779,3364
"16507","KISII","KITUTU CENTRAL","15-19",8426,8790,17216
"16508","KISII","KITUTU CENTRAL","20",1401,1783,3184
"16509","KISII","KITUTU CENTRAL","21",1274,1588,2862
"16510","KISII","KITUTU CENTRAL","22",1291,1663,2954
"16511","KISII","KITUTU CENTRAL","23",1415,1880,3295
"16512","KISII","KITUTU CENTRAL","24",1390,1724,3114
"16513","KISII","KITUTU CENTRAL","20-24",6771,8638,15409
"16514","KISII","KITUTU CENTRAL","25",1573,1831,3404
"16515","KISII","KITUTU CENTRAL","26",1322,1701,3023
"16516","KISII","KITUTU CENTRAL","27",1281,1564,2845
"16517","KISII","KITUTU CENTRAL","28",1088,1279,2367
"16518","KISII","KITUTU CENTRAL","29",1209,1356,2565
"16519","KISII","KITUTU CENTRAL","25-29",6473,7731,14204
"16520","KISII","KITUTU CENTRAL","30",1563,1886,3449
"16521","KISII","KITUTU CENTRAL","31",1065,1169,2234
"16522","KISII","KITUTU CENTRAL","32",1368,1476,2844
"16523","KISII","KITUTU CENTRAL","33",1011,1288,2299
"16524","KISII","KITUTU CENTRAL","34",977,1100,2077
"16525","KISII","KITUTU CENTRAL","30-34",5984,6919,12903
"16526","KISII","KITUTU CENTRAL","35",1244,1258,2502
"16527","KISII","KITUTU CENTRAL","36",868,800,1668
"16528","KISII","KITUTU CENTRAL","37",822,746,1568
"16529","KISII","KITUTU CENTRAL","38",620,608,1228
"16530","KISII","KITUTU CENTRAL","39",748,758,1506
"16531","KISII","KITUTU CENTRAL","35-39",4302,4170,8472
"16532","KISII","KITUTU CENTRAL","40",947,808,1755
"16533","KISII","KITUTU CENTRAL","41",886,710,1596
"16534","KISII","KITUTU CENTRAL","42",673,586,1259
"16535","KISII","KITUTU CENTRAL","43",657,579,1236
"16536","KISII","KITUTU CENTRAL","44",451,502,953
"16537","KISII","KITUTU CENTRAL","40-44",3614,3185,6799
"16538","KISII","KITUTU CENTRAL","45",750,830,1580
"16539","KISII","KITUTU CENTRAL","46",511,541,1052
"16540","KISII","KITUTU CENTRAL","47",559,573,1132
"16541","KISII","KITUTU CENTRAL","48",342,354,696
"16542","KISII","KITUTU CENTRAL","49",444,440,884
"16543","KISII","KITUTU CENTRAL","45-49",2606,2738,5344
"16544","KISII","KITUTU CENTRAL","50",523,567,1090
"16545","KISII","KITUTU CENTRAL","51",362,386,748
"16546","KISII","KITUTU CENTRAL","52",345,300,645
"16547","KISII","KITUTU CENTRAL","53",261,214,475
"16548","KISII","KITUTU CENTRAL","54",321,280,601
"16549","KISII","KITUTU CENTRAL","50-54",1812,1747,3559
"16550","KISII","KITUTU CENTRAL","55",407,363,770
"16551","KISII","KITUTU CENTRAL","56",439,385,824
"16552","KISII","KITUTU CENTRAL","57",428,504,932
"16553","KISII","KITUTU CENTRAL","58",325,368,693
"16554","KISII","KITUTU CENTRAL","59",381,438,819
"16555","KISII","KITUTU CENTRAL","55-59",1980,2058,4038
"16556","KISII","KITUTU CENTRAL","60",396,483,879
"16557","KISII","KITUTU CENTRAL","61",309,343,652
"16558","KISII","KITUTU CENTRAL","62",216,247,463
"16559","KISII","KITUTU CENTRAL","63",273,291,564
"16560","KISII","KITUTU CENTRAL","64",193,216,409
"16561","KISII","KITUTU CENTRAL","60-64",1387,1580,2967
"16562","KISII","KITUTU CENTRAL","65",247,319,566
"16563","KISII","KITUTU CENTRAL","66",163,168,331
"16564","KISII","KITUTU CENTRAL","67",267,242,509
"16565","KISII","KITUTU CENTRAL","68",96,113,209
"16566","KISII","KITUTU CENTRAL","69",166,221,387
"16567","KISII","KITUTU CENTRAL","65-69",939,1063,2002
"16568","KISII","KITUTU CENTRAL","70",206,302,508
"16569","KISII","KITUTU CENTRAL","71",158,133,291
"16570","KISII","KITUTU CENTRAL","72",115,112,227
"16571","KISII","KITUTU CENTRAL","73",84,76,160
"16572","KISII","KITUTU CENTRAL","74",91,116,207
"16573","KISII","KITUTU CENTRAL","70-74",654,739,1393
"16574","KISII","KITUTU CENTRAL","75",79,110,189
"16575","KISII","KITUTU CENTRAL","76",41,43,84
"16576","KISII","KITUTU CENTRAL","77",75,81,156
"16577","KISII","KITUTU CENTRAL","78",37,23,60
"16578","KISII","KITUTU CENTRAL","79",47,113,160
"16579","KISII","KITUTU CENTRAL","75-79",279,370,649
"16580","KISII","KITUTU CENTRAL","80",65,117,182
"16581","KISII","KITUTU CENTRAL","81",34,55,89
"16582","KISII","KITUTU CENTRAL","82",39,41,80
"16583","KISII","KITUTU CENTRAL","83",33,45,78
"16584","KISII","KITUTU CENTRAL","84",37,39,76
"16585","KISII","KITUTU CENTRAL","80-84",208,297,505
"16586","KISII","KITUTU CENTRAL","85",19,38,57
"16587","KISII","KITUTU CENTRAL","86",20,19,39
"16588","KISII","KITUTU CENTRAL","87",20,34,54
"16589","KISII","KITUTU CENTRAL","88",11,22,33
"16590","KISII","KITUTU CENTRAL","89",24,63,87
"16591","KISII","KITUTU CENTRAL","85-89",94,176,270
"16592","KISII","KITUTU CENTRAL","90",15,38,53
"16593","KISII","KITUTU CENTRAL","91",7,13,20
"16594","KISII","KITUTU CENTRAL","92",4,11,15
"16595","KISII","KITUTU CENTRAL","93",3,6,9
"16596","KISII","KITUTU CENTRAL","94",3,8,11
"16597","KISII","KITUTU CENTRAL","90-94",32,76,108
"16598","KISII","KITUTU CENTRAL","95",6,24,30
"16599","KISII","KITUTU CENTRAL","96",NA,4,4
"16600","KISII","KITUTU CENTRAL","97",3,8,11
"16601","KISII","KITUTU CENTRAL","98",3,4,7
"16602","KISII","KITUTU CENTRAL","99",5,7,12
"16603","KISII","KITUTU CENTRAL","95-99",17,47,64
"16604","KISII","KITUTU CENTRAL","100+",7,33,40
"16605","KISII","KITUTU CENTRAL","Not Stated",3,1,4
"16606","KISII","MARANI","Total",50598,56864,107462
"16607","KISII","MARANI","0",1107,1105,2212
"16608","KISII","MARANI","1",1116,1135,2251
"16609","KISII","MARANI","2",1137,1218,2355
"16610","KISII","MARANI","3",1317,1285,2602
"16611","KISII","MARANI","4",1321,1346,2667
"16612","KISII","MARANI","0 - 4",5998,6089,12087
"16613","KISII","MARANI","5",1389,1349,2738
"16614","KISII","MARANI","6",1462,1473,2935
"16615","KISII","MARANI","7",1450,1458,2908
"16616","KISII","MARANI","8",1489,1454,2943
"16617","KISII","MARANI","9",1586,1564,3150
"16618","KISII","MARANI","5-9",7376,7298,14674
"16619","KISII","MARANI","10",1806,1746,3552
"16620","KISII","MARANI","11",1485,1564,3049
"16621","KISII","MARANI","12",2002,1780,3782
"16622","KISII","MARANI","13",1752,1765,3517
"16623","KISII","MARANI","14",1715,1537,3252
"16624","KISII","MARANI","10 -14",8760,8392,17152
"16625","KISII","MARANI","15",1571,1505,3076
"16626","KISII","MARANI","16",1365,1311,2676
"16627","KISII","MARANI","17",1440,1374,2814
"16628","KISII","MARANI","18",1107,1048,2155
"16629","KISII","MARANI","19",978,1075,2053
"16630","KISII","MARANI","15-19",6461,6313,12774
"16631","KISII","MARANI","20",827,931,1758
"16632","KISII","MARANI","21",632,831,1463
"16633","KISII","MARANI","22",613,808,1421
"16634","KISII","MARANI","23",566,832,1398
"16635","KISII","MARANI","24",558,725,1283
"16636","KISII","MARANI","20-24",3196,4127,7323
"16637","KISII","MARANI","25",656,912,1568
"16638","KISII","MARANI","26",518,775,1293
"16639","KISII","MARANI","27",520,845,1365
"16640","KISII","MARANI","28",441,716,1157
"16641","KISII","MARANI","29",455,699,1154
"16642","KISII","MARANI","25-29",2590,3947,6537
"16643","KISII","MARANI","30",641,1117,1758
"16644","KISII","MARANI","31",489,754,1243
"16645","KISII","MARANI","32",571,1014,1585
"16646","KISII","MARANI","33",514,915,1429
"16647","KISII","MARANI","34",437,783,1220
"16648","KISII","MARANI","30-34",2652,4583,7235
"16649","KISII","MARANI","35",625,818,1443
"16650","KISII","MARANI","36",453,469,922
"16651","KISII","MARANI","37",451,497,948
"16652","KISII","MARANI","38",369,429,798
"16653","KISII","MARANI","39",385,506,891
"16654","KISII","MARANI","35-39",2283,2719,5002
"16655","KISII","MARANI","40",532,583,1115
"16656","KISII","MARANI","41",541,525,1066
"16657","KISII","MARANI","42",416,443,859
"16658","KISII","MARANI","43",383,391,774
"16659","KISII","MARANI","44",285,328,613
"16660","KISII","MARANI","40-44",2157,2270,4427
"16661","KISII","MARANI","45",496,668,1164
"16662","KISII","MARANI","46",361,487,848
"16663","KISII","MARANI","47",400,539,939
"16664","KISII","MARANI","48",251,326,577
"16665","KISII","MARANI","49",268,385,653
"16666","KISII","MARANI","45-49",1776,2405,4181
"16667","KISII","MARANI","50",382,441,823
"16668","KISII","MARANI","51",311,294,605
"16669","KISII","MARANI","52",201,210,411
"16670","KISII","MARANI","53",181,171,352
"16671","KISII","MARANI","54",249,211,460
"16672","KISII","MARANI","50-54",1324,1327,2651
"16673","KISII","MARANI","55",287,277,564
"16674","KISII","MARANI","56",310,391,701
"16675","KISII","MARANI","57",414,609,1023
"16676","KISII","MARANI","58",291,343,634
"16677","KISII","MARANI","59",426,514,940
"16678","KISII","MARANI","55-59",1728,2134,3862
"16679","KISII","MARANI","60",434,608,1042
"16680","KISII","MARANI","61",313,381,694
"16681","KISII","MARANI","62",228,274,502
"16682","KISII","MARANI","63",259,301,560
"16683","KISII","MARANI","64",194,232,426
"16684","KISII","MARANI","60-64",1428,1796,3224
"16685","KISII","MARANI","65",292,357,649
"16686","KISII","MARANI","66",199,166,365
"16687","KISII","MARANI","67",286,286,572
"16688","KISII","MARANI","68",121,150,271
"16689","KISII","MARANI","69",236,295,531
"16690","KISII","MARANI","65-69",1134,1254,2388
"16691","KISII","MARANI","70",248,396,644
"16692","KISII","MARANI","71",177,172,349
"16693","KISII","MARANI","72",140,109,249
"16694","KISII","MARANI","73",106,110,216
"16695","KISII","MARANI","74",119,144,263
"16696","KISII","MARANI","70-74",790,931,1721
"16697","KISII","MARANI","75",112,128,240
"16698","KISII","MARANI","76",64,56,120
"16699","KISII","MARANI","77",92,117,209
"16700","KISII","MARANI","78",59,69,128
"16701","KISII","MARANI","79",68,156,224
"16702","KISII","MARANI","75-79",395,526,921
"16703","KISII","MARANI","80",87,143,230
"16704","KISII","MARANI","81",68,81,149
"16705","KISII","MARANI","82",43,37,80
"16706","KISII","MARANI","83",44,49,93
"16707","KISII","MARANI","84",63,76,139
"16708","KISII","MARANI","80-84",305,386,691
"16709","KISII","MARANI","85",37,51,88
"16710","KISII","MARANI","86",19,21,40
"16711","KISII","MARANI","87",38,27,65
"16712","KISII","MARANI","88",14,21,35
"16713","KISII","MARANI","89",39,84,123
"16714","KISII","MARANI","85-89",147,204,351
"16715","KISII","MARANI","90",17,46,63
"16716","KISII","MARANI","91",15,18,33
"16717","KISII","MARANI","92",6,9,15
"16718","KISII","MARANI","93",7,5,12
"16719","KISII","MARANI","94",10,19,29
"16720","KISII","MARANI","90-94",55,97,152
"16721","KISII","MARANI","95",9,13,22
"16722","KISII","MARANI","96",1,9,10
"16723","KISII","MARANI","97",9,7,16
"16724","KISII","MARANI","98",1,6,7
"16725","KISII","MARANI","99",9,9,18
"16726","KISII","MARANI","95-99",29,44,73
"16727","KISII","MARANI","100+",6,21,27
"16728","KISII","MARANI","Not Stated",8,1,9
"16729","KISII","MASABA SOUTH","Total",58143,64248,122391
"16730","KISII","MASABA SOUTH","0",1319,1225,2544
"16731","KISII","MASABA SOUTH","1",1251,1146,2397
"16732","KISII","MASABA SOUTH","2",1288,1310,2598
"16733","KISII","MASABA SOUTH","3",1391,1363,2754
"16734","KISII","MASABA SOUTH","4",1578,1508,3086
"16735","KISII","MASABA SOUTH","0 - 4",6827,6552,13379
"16736","KISII","MASABA SOUTH","5",1564,1567,3131
"16737","KISII","MASABA SOUTH","6",1535,1609,3144
"16738","KISII","MASABA SOUTH","7",1789,1714,3503
"16739","KISII","MASABA SOUTH","8",1567,1569,3136
"16740","KISII","MASABA SOUTH","9",1879,1876,3755
"16741","KISII","MASABA SOUTH","5-9",8334,8335,16669
"16742","KISII","MASABA SOUTH","10",2076,1945,4021
"16743","KISII","MASABA SOUTH","11",1760,1694,3454
"16744","KISII","MASABA SOUTH","12",2121,1927,4048
"16745","KISII","MASABA SOUTH","13",1998,1923,3921
"16746","KISII","MASABA SOUTH","14",1761,1749,3510
"16747","KISII","MASABA SOUTH","10 -14",9716,9238,18954
"16748","KISII","MASABA SOUTH","15",1752,1741,3493
"16749","KISII","MASABA SOUTH","16",1486,1518,3004
"16750","KISII","MASABA SOUTH","17",1541,1556,3097
"16751","KISII","MASABA SOUTH","18",1253,1239,2492
"16752","KISII","MASABA SOUTH","19",1268,1290,2558
"16753","KISII","MASABA SOUTH","15-19",7300,7344,14644
"16754","KISII","MASABA SOUTH","20",1033,1082,2115
"16755","KISII","MASABA SOUTH","21",819,946,1765
"16756","KISII","MASABA SOUTH","22",777,947,1724
"16757","KISII","MASABA SOUTH","23",718,968,1686
"16758","KISII","MASABA SOUTH","24",721,870,1591
"16759","KISII","MASABA SOUTH","20-24",4068,4813,8881
"16760","KISII","MASABA SOUTH","25",827,1187,2014
"16761","KISII","MASABA SOUTH","26",634,908,1542
"16762","KISII","MASABA SOUTH","27",650,894,1544
"16763","KISII","MASABA SOUTH","28",512,720,1232
"16764","KISII","MASABA SOUTH","29",535,789,1324
"16765","KISII","MASABA SOUTH","25-29",3158,4498,7656
"16766","KISII","MASABA SOUTH","30",825,1182,2007
"16767","KISII","MASABA SOUTH","31",637,992,1629
"16768","KISII","MASABA SOUTH","32",762,1174,1936
"16769","KISII","MASABA SOUTH","33",644,1063,1707
"16770","KISII","MASABA SOUTH","34",589,864,1453
"16771","KISII","MASABA SOUTH","30-34",3457,5275,8732
"16772","KISII","MASABA SOUTH","35",777,949,1726
"16773","KISII","MASABA SOUTH","36",468,507,975
"16774","KISII","MASABA SOUTH","37",534,565,1099
"16775","KISII","MASABA SOUTH","38",347,384,731
"16776","KISII","MASABA SOUTH","39",500,531,1031
"16777","KISII","MASABA SOUTH","35-39",2626,2936,5562
"16778","KISII","MASABA SOUTH","40",638,714,1352
"16779","KISII","MASABA SOUTH","41",733,714,1447
"16780","KISII","MASABA SOUTH","42",459,557,1016
"16781","KISII","MASABA SOUTH","43",467,523,990
"16782","KISII","MASABA SOUTH","44",294,376,670
"16783","KISII","MASABA SOUTH","40-44",2591,2884,5475
"16784","KISII","MASABA SOUTH","45",648,837,1485
"16785","KISII","MASABA SOUTH","46",428,669,1097
"16786","KISII","MASABA SOUTH","47",448,678,1126
"16787","KISII","MASABA SOUTH","48",273,333,606
"16788","KISII","MASABA SOUTH","49",323,384,707
"16789","KISII","MASABA SOUTH","45-49",2120,2901,5021
"16790","KISII","MASABA SOUTH","50",455,474,929
"16791","KISII","MASABA SOUTH","51",384,391,775
"16792","KISII","MASABA SOUTH","52",242,235,477
"16793","KISII","MASABA SOUTH","53",191,190,381
"16794","KISII","MASABA SOUTH","54",260,212,472
"16795","KISII","MASABA SOUTH","50-54",1532,1502,3034
"16796","KISII","MASABA SOUTH","55",314,265,579
"16797","KISII","MASABA SOUTH","56",421,487,908
"16798","KISII","MASABA SOUTH","57",523,701,1224
"16799","KISII","MASABA SOUTH","58",307,357,664
"16800","KISII","MASABA SOUTH","59",458,570,1028
"16801","KISII","MASABA SOUTH","55-59",2023,2380,4403
"16802","KISII","MASABA SOUTH","60",449,551,1000
"16803","KISII","MASABA SOUTH","61",406,430,836
"16804","KISII","MASABA SOUTH","62",260,277,537
"16805","KISII","MASABA SOUTH","63",281,343,624
"16806","KISII","MASABA SOUTH","64",175,213,388
"16807","KISII","MASABA SOUTH","60-64",1571,1814,3385
"16808","KISII","MASABA SOUTH","65",288,399,687
"16809","KISII","MASABA SOUTH","66",159,184,343
"16810","KISII","MASABA SOUTH","67",260,316,576
"16811","KISII","MASABA SOUTH","68",105,140,245
"16812","KISII","MASABA SOUTH","69",216,306,522
"16813","KISII","MASABA SOUTH","65-69",1028,1345,2373
"16814","KISII","MASABA SOUTH","70",229,374,603
"16815","KISII","MASABA SOUTH","71",188,219,407
"16816","KISII","MASABA SOUTH","72",148,133,281
"16817","KISII","MASABA SOUTH","73",120,103,223
"16818","KISII","MASABA SOUTH","74",117,162,279
"16819","KISII","MASABA SOUTH","70-74",802,991,1793
"16820","KISII","MASABA SOUTH","75",104,135,239
"16821","KISII","MASABA SOUTH","76",66,82,148
"16822","KISII","MASABA SOUTH","77",86,107,193
"16823","KISII","MASABA SOUTH","78",42,49,91
"16824","KISII","MASABA SOUTH","79",85,181,266
"16825","KISII","MASABA SOUTH","75-79",383,554,937
"16826","KISII","MASABA SOUTH","80",96,159,255
"16827","KISII","MASABA SOUTH","81",63,90,153
"16828","KISII","MASABA SOUTH","82",49,53,102
"16829","KISII","MASABA SOUTH","83",56,55,111
"16830","KISII","MASABA SOUTH","84",46,71,117
"16831","KISII","MASABA SOUTH","80-84",310,428,738
"16832","KISII","MASABA SOUTH","85",42,60,102
"16833","KISII","MASABA SOUTH","86",36,31,67
"16834","KISII","MASABA SOUTH","87",49,57,106
"16835","KISII","MASABA SOUTH","88",29,33,62
"16836","KISII","MASABA SOUTH","89",42,101,143
"16837","KISII","MASABA SOUTH","85-89",198,282,480
"16838","KISII","MASABA SOUTH","90",21,45,66
"16839","KISII","MASABA SOUTH","91",8,17,25
"16840","KISII","MASABA SOUTH","92",22,10,32
"16841","KISII","MASABA SOUTH","93",5,11,16
"16842","KISII","MASABA SOUTH","94",13,14,27
"16843","KISII","MASABA SOUTH","90-94",69,97,166
"16844","KISII","MASABA SOUTH","95",7,13,20
"16845","KISII","MASABA SOUTH","96",1,12,13
"16846","KISII","MASABA SOUTH","97",8,7,15
"16847","KISII","MASABA SOUTH","98",3,9,12
"16848","KISII","MASABA SOUTH","99",4,11,15
"16849","KISII","MASABA SOUTH","95-99",23,52,75
"16850","KISII","MASABA SOUTH","100+",7,27,34
"16851","KISII","MASABA SOUTH","Not Stated",NA,NA,NA
"16852","KISII","NYAMACHE","Total",62113,68782,130895
"16853","KISII","NYAMACHE","0",1345,1378,2723
"16854","KISII","NYAMACHE","1",1327,1366,2693
"16855","KISII","NYAMACHE","2",1429,1366,2795
"16856","KISII","NYAMACHE","3",1474,1629,3103
"16857","KISII","NYAMACHE","4",1618,1629,3247
"16858","KISII","NYAMACHE","0 - 4",7193,7368,14561
"16859","KISII","NYAMACHE","5",1784,1618,3402
"16860","KISII","NYAMACHE","6",1859,1803,3662
"16861","KISII","NYAMACHE","7",1948,1823,3771
"16862","KISII","NYAMACHE","8",1803,1896,3699
"16863","KISII","NYAMACHE","9",2114,1949,4063
"16864","KISII","NYAMACHE","5-9",9508,9089,18597
"16865","KISII","NYAMACHE","10",2207,2245,4452
"16866","KISII","NYAMACHE","11",1946,2039,3985
"16867","KISII","NYAMACHE","12",2298,2244,4542
"16868","KISII","NYAMACHE","13",2165,2086,4251
"16869","KISII","NYAMACHE","14",1971,1929,3900
"16870","KISII","NYAMACHE","10 -14",10587,10543,21130
"16871","KISII","NYAMACHE","15",1857,1770,3627
"16872","KISII","NYAMACHE","16",1634,1640,3274
"16873","KISII","NYAMACHE","17",1670,1572,3242
"16874","KISII","NYAMACHE","18",1441,1311,2752
"16875","KISII","NYAMACHE","19",1354,1295,2649
"16876","KISII","NYAMACHE","15-19",7956,7588,15544
"16877","KISII","NYAMACHE","20",984,1156,2140
"16878","KISII","NYAMACHE","21",842,1023,1865
"16879","KISII","NYAMACHE","22",732,969,1701
"16880","KISII","NYAMACHE","23",763,1021,1784
"16881","KISII","NYAMACHE","24",599,948,1547
"16882","KISII","NYAMACHE","20-24",3920,5117,9037
"16883","KISII","NYAMACHE","25",829,1275,2104
"16884","KISII","NYAMACHE","26",655,913,1568
"16885","KISII","NYAMACHE","27",753,1012,1765
"16886","KISII","NYAMACHE","28",582,830,1412
"16887","KISII","NYAMACHE","29",567,909,1476
"16888","KISII","NYAMACHE","25-29",3386,4939,8325
"16889","KISII","NYAMACHE","30",921,1390,2311
"16890","KISII","NYAMACHE","31",692,1058,1750
"16891","KISII","NYAMACHE","32",822,1177,1999
"16892","KISII","NYAMACHE","33",665,1159,1824
"16893","KISII","NYAMACHE","34",629,931,1560
"16894","KISII","NYAMACHE","30-34",3729,5715,9444
"16895","KISII","NYAMACHE","35",833,1029,1862
"16896","KISII","NYAMACHE","36",517,522,1039
"16897","KISII","NYAMACHE","37",575,540,1115
"16898","KISII","NYAMACHE","38",439,450,889
"16899","KISII","NYAMACHE","39",532,514,1046
"16900","KISII","NYAMACHE","35-39",2896,3055,5951
"16901","KISII","NYAMACHE","40",620,643,1263
"16902","KISII","NYAMACHE","41",669,639,1308
"16903","KISII","NYAMACHE","42",503,456,959
"16904","KISII","NYAMACHE","43",497,563,1060
"16905","KISII","NYAMACHE","44",361,442,803
"16906","KISII","NYAMACHE","40-44",2650,2743,5393
"16907","KISII","NYAMACHE","45",668,916,1584
"16908","KISII","NYAMACHE","46",399,631,1030
"16909","KISII","NYAMACHE","47",448,673,1121
"16910","KISII","NYAMACHE","48",303,365,668
"16911","KISII","NYAMACHE","49",346,557,903
"16912","KISII","NYAMACHE","45-49",2164,3142,5306
"16913","KISII","NYAMACHE","50",467,552,1019
"16914","KISII","NYAMACHE","51",385,350,735
"16915","KISII","NYAMACHE","52",233,257,490
"16916","KISII","NYAMACHE","53",227,189,416
"16917","KISII","NYAMACHE","54",245,208,453
"16918","KISII","NYAMACHE","50-54",1557,1556,3113
"16919","KISII","NYAMACHE","55",326,325,651
"16920","KISII","NYAMACHE","56",387,380,767
"16921","KISII","NYAMACHE","57",421,567,988
"16922","KISII","NYAMACHE","58",315,338,653
"16923","KISII","NYAMACHE","59",423,527,950
"16924","KISII","NYAMACHE","55-59",1872,2137,4009
"16925","KISII","NYAMACHE","60",466,550,1016
"16926","KISII","NYAMACHE","61",411,475,886
"16927","KISII","NYAMACHE","62",285,314,599
"16928","KISII","NYAMACHE","63",319,347,666
"16929","KISII","NYAMACHE","64",224,256,480
"16930","KISII","NYAMACHE","60-64",1705,1942,3647
"16931","KISII","NYAMACHE","65",319,363,682
"16932","KISII","NYAMACHE","66",178,166,344
"16933","KISII","NYAMACHE","67",274,322,596
"16934","KISII","NYAMACHE","68",114,171,285
"16935","KISII","NYAMACHE","69",208,325,533
"16936","KISII","NYAMACHE","65-69",1093,1347,2440
"16937","KISII","NYAMACHE","70",216,394,610
"16938","KISII","NYAMACHE","71",219,209,428
"16939","KISII","NYAMACHE","72",137,143,280
"16940","KISII","NYAMACHE","73",131,117,248
"16941","KISII","NYAMACHE","74",136,179,315
"16942","KISII","NYAMACHE","70-74",839,1042,1881
"16943","KISII","NYAMACHE","75",103,141,244
"16944","KISII","NYAMACHE","76",69,78,147
"16945","KISII","NYAMACHE","77",118,102,220
"16946","KISII","NYAMACHE","78",74,74,148
"16947","KISII","NYAMACHE","79",82,140,222
"16948","KISII","NYAMACHE","75-79",446,535,981
"16949","KISII","NYAMACHE","80",101,167,268
"16950","KISII","NYAMACHE","81",55,112,167
"16951","KISII","NYAMACHE","82",46,60,106
"16952","KISII","NYAMACHE","83",49,53,102
"16953","KISII","NYAMACHE","84",42,94,136
"16954","KISII","NYAMACHE","80-84",293,486,779
"16955","KISII","NYAMACHE","85",47,62,109
"16956","KISII","NYAMACHE","86",32,40,72
"16957","KISII","NYAMACHE","87",37,41,78
"16958","KISII","NYAMACHE","88",25,18,43
"16959","KISII","NYAMACHE","89",53,79,132
"16960","KISII","NYAMACHE","85-89",194,240,434
"16961","KISII","NYAMACHE","90",23,46,69
"16962","KISII","NYAMACHE","91",18,23,41
"16963","KISII","NYAMACHE","92",15,15,30
"16964","KISII","NYAMACHE","93",8,14,22
"16965","KISII","NYAMACHE","94",13,15,28
"16966","KISII","NYAMACHE","90-94",77,113,190
"16967","KISII","NYAMACHE","95",13,13,26
"16968","KISII","NYAMACHE","96",7,6,13
"16969","KISII","NYAMACHE","97",7,11,18
"16970","KISII","NYAMACHE","98",3,10,13
"16971","KISII","NYAMACHE","99",4,14,18
"16972","KISII","NYAMACHE","95-99",34,54,88
"16973","KISII","NYAMACHE","100+",14,31,45
"16974","KISII","NYAMACHE","Not Stated",NA,NA,NA
"16975","KISII","SAMETA","Total",31829,35164,66993
"16976","KISII","SAMETA","0",664,658,1322
"16977","KISII","SAMETA","1",669,689,1358
"16978","KISII","SAMETA","2",760,738,1498
"16979","KISII","SAMETA","3",784,800,1584
"16980","KISII","SAMETA","4",855,780,1635
"16981","KISII","SAMETA","0 - 4",3732,3665,7397
"16982","KISII","SAMETA","5",807,797,1604
"16983","KISII","SAMETA","6",884,943,1827
"16984","KISII","SAMETA","7",894,893,1787
"16985","KISII","SAMETA","8",869,918,1787
"16986","KISII","SAMETA","9",954,1031,1985
"16987","KISII","SAMETA","5-9",4408,4582,8990
"16988","KISII","SAMETA","10",1110,1095,2205
"16989","KISII","SAMETA","11",1002,1001,2003
"16990","KISII","SAMETA","12",1153,1156,2309
"16991","KISII","SAMETA","13",1084,1130,2214
"16992","KISII","SAMETA","14",1015,1028,2043
"16993","KISII","SAMETA","10 -14",5364,5410,10774
"16994","KISII","SAMETA","15",918,979,1897
"16995","KISII","SAMETA","16",883,862,1745
"16996","KISII","SAMETA","17",893,881,1774
"16997","KISII","SAMETA","18",729,709,1438
"16998","KISII","SAMETA","19",683,707,1390
"16999","KISII","SAMETA","15-19",4106,4138,8244
"17000","KISII","SAMETA","20",599,655,1254
"17001","KISII","SAMETA","21",437,574,1011
"17002","KISII","SAMETA","22",459,547,1006
"17003","KISII","SAMETA","23",412,557,969
"17004","KISII","SAMETA","24",345,516,861
"17005","KISII","SAMETA","20-24",2252,2849,5101
"17006","KISII","SAMETA","25",496,670,1166
"17007","KISII","SAMETA","26",359,538,897
"17008","KISII","SAMETA","27",436,532,968
"17009","KISII","SAMETA","28",322,464,786
"17010","KISII","SAMETA","29",351,483,834
"17011","KISII","SAMETA","25-29",1964,2687,4651
"17012","KISII","SAMETA","30",427,682,1109
"17013","KISII","SAMETA","31",392,525,917
"17014","KISII","SAMETA","32",481,676,1157
"17015","KISII","SAMETA","33",360,540,900
"17016","KISII","SAMETA","34",316,447,763
"17017","KISII","SAMETA","30-34",1976,2870,4846
"17018","KISII","SAMETA","35",458,527,985
"17019","KISII","SAMETA","36",291,256,547
"17020","KISII","SAMETA","37",321,249,570
"17021","KISII","SAMETA","38",237,210,447
"17022","KISII","SAMETA","39",265,273,538
"17023","KISII","SAMETA","35-39",1572,1515,3087
"17024","KISII","SAMETA","40",316,324,640
"17025","KISII","SAMETA","41",353,322,675
"17026","KISII","SAMETA","42",262,267,529
"17027","KISII","SAMETA","43",242,286,528
"17028","KISII","SAMETA","44",182,191,373
"17029","KISII","SAMETA","40-44",1355,1390,2745
"17030","KISII","SAMETA","45",322,380,702
"17031","KISII","SAMETA","46",209,259,468
"17032","KISII","SAMETA","47",241,362,603
"17033","KISII","SAMETA","48",145,183,328
"17034","KISII","SAMETA","49",155,223,378
"17035","KISII","SAMETA","45-49",1072,1407,2479
"17036","KISII","SAMETA","50",249,275,524
"17037","KISII","SAMETA","51",197,203,400
"17038","KISII","SAMETA","52",178,135,313
"17039","KISII","SAMETA","53",105,98,203
"17040","KISII","SAMETA","54",156,113,269
"17041","KISII","SAMETA","50-54",885,824,1709
"17042","KISII","SAMETA","55",197,190,387
"17043","KISII","SAMETA","56",190,200,390
"17044","KISII","SAMETA","57",213,279,492
"17045","KISII","SAMETA","58",143,178,321
"17046","KISII","SAMETA","59",227,285,512
"17047","KISII","SAMETA","55-59",970,1132,2102
"17048","KISII","SAMETA","60",200,281,481
"17049","KISII","SAMETA","61",213,239,452
"17050","KISII","SAMETA","62",134,162,296
"17051","KISII","SAMETA","63",160,164,324
"17052","KISII","SAMETA","64",112,102,214
"17053","KISII","SAMETA","60-64",819,948,1767
"17054","KISII","SAMETA","65",140,185,325
"17055","KISII","SAMETA","66",63,81,144
"17056","KISII","SAMETA","67",140,147,287
"17057","KISII","SAMETA","68",55,72,127
"17058","KISII","SAMETA","69",116,124,240
"17059","KISII","SAMETA","65-69",514,609,1123
"17060","KISII","SAMETA","70",99,180,279
"17061","KISII","SAMETA","71",89,90,179
"17062","KISII","SAMETA","72",65,63,128
"17063","KISII","SAMETA","73",65,64,129
"17064","KISII","SAMETA","74",67,87,154
"17065","KISII","SAMETA","70-74",385,484,869
"17066","KISII","SAMETA","75",45,74,119
"17067","KISII","SAMETA","76",30,31,61
"17068","KISII","SAMETA","77",60,48,108
"17069","KISII","SAMETA","78",24,24,48
"17070","KISII","SAMETA","79",35,66,101
"17071","KISII","SAMETA","75-79",194,243,437
"17072","KISII","SAMETA","80",32,69,101
"17073","KISII","SAMETA","81",27,38,65
"17074","KISII","SAMETA","82",25,23,48
"17075","KISII","SAMETA","83",23,27,50
"17076","KISII","SAMETA","84",26,37,63
"17077","KISII","SAMETA","80-84",133,194,327
"17078","KISII","SAMETA","85",21,38,59
"17079","KISII","SAMETA","86",20,21,41
"17080","KISII","SAMETA","87",22,20,42
"17081","KISII","SAMETA","88",11,9,20
"17082","KISII","SAMETA","89",12,27,39
"17083","KISII","SAMETA","85-89",86,115,201
"17084","KISII","SAMETA","90",9,17,26
"17085","KISII","SAMETA","91",6,10,16
"17086","KISII","SAMETA","92",4,8,12
"17087","KISII","SAMETA","93",2,7,9
"17088","KISII","SAMETA","94",3,12,15
"17089","KISII","SAMETA","90-94",24,54,78
"17090","KISII","SAMETA","95",4,11,15
"17091","KISII","SAMETA","96",2,1,3
"17092","KISII","SAMETA","97",4,4,8
"17093","KISII","SAMETA","98",NA,3,3
"17094","KISII","SAMETA","99",4,6,10
"17095","KISII","SAMETA","95-99",14,25,39
"17096","KISII","SAMETA","100+",4,22,26
"17097","KISII","SAMETA","Not Stated",NA,1,1
"17098","KISUMU","ALL","Total",560942,594609,1155551
"17099","KISUMU","ALL","0",13840,13762,27602
"17100","KISUMU","ALL","1",14183,14016,28199
"17101","KISUMU","ALL","2",13853,14170,28023
"17102","KISUMU","ALL","3",14330,14622,28952
"17103","KISUMU","ALL","4",13994,14300,28294
"17104","KISUMU","ALL","0 - 4",70200,70870,141070
"17105","KISUMU","ALL","5",14355,14032,28387
"17106","KISUMU","ALL","6",14800,14823,29623
"17107","KISUMU","ALL","7",14594,14960,29554
"17108","KISUMU","ALL","8",14287,14214,28501
"17109","KISUMU","ALL","9",15696,15904,31600
"17110","KISUMU","ALL","5-9",73732,73933,147665
"17111","KISUMU","ALL","10",17169,16451,33620
"17112","KISUMU","ALL","11",15177,15848,31025
"17113","KISUMU","ALL","12",17562,17558,35120
"17114","KISUMU","ALL","13",16707,17268,33975
"17115","KISUMU","ALL","14",15203,15580,30783
"17116","KISUMU","ALL","10 -14",81818,82705,164523
"17117","KISUMU","ALL","15",14847,15229,30076
"17118","KISUMU","ALL","16",13353,14022,27375
"17119","KISUMU","ALL","17",13966,14001,27967
"17120","KISUMU","ALL","18",11539,11815,23354
"17121","KISUMU","ALL","19",12506,13626,26132
"17122","KISUMU","ALL","15-19",66211,68693,134904
"17123","KISUMU","ALL","20",11213,13337,24550
"17124","KISUMU","ALL","21",10392,12367,22759
"17125","KISUMU","ALL","22",9647,11925,21572
"17126","KISUMU","ALL","23",10213,12669,22882
"17127","KISUMU","ALL","24",9592,11685,21277
"17128","KISUMU","ALL","20-24",51057,61983,113040
"17129","KISUMU","ALL","25",10828,12584,23412
"17130","KISUMU","ALL","26",8804,10748,19552
"17131","KISUMU","ALL","27",9713,11339,21052
"17132","KISUMU","ALL","28",7365,8433,15798
"17133","KISUMU","ALL","29",7646,9326,16972
"17134","KISUMU","ALL","25-29",44356,52430,96786
"17135","KISUMU","ALL","30",10435,12598,23033
"17136","KISUMU","ALL","31",7297,8086,15383
"17137","KISUMU","ALL","32",9441,10620,20061
"17138","KISUMU","ALL","33",7563,8803,16366
"17139","KISUMU","ALL","34",7410,8045,15455
"17140","KISUMU","ALL","30-34",42146,48152,90298
"17141","KISUMU","ALL","35",9069,8767,17836
"17142","KISUMU","ALL","36",6582,5794,12376
"17143","KISUMU","ALL","37",7026,5675,12701
"17144","KISUMU","ALL","38",5000,4127,9127
"17145","KISUMU","ALL","39",5869,4874,10743
"17146","KISUMU","ALL","35-39",33546,29237,62783
"17147","KISUMU","ALL","40",7165,6234,13399
"17148","KISUMU","ALL","41",5864,4784,10648
"17149","KISUMU","ALL","42",5460,4441,9901
"17150","KISUMU","ALL","43",4937,4849,9786
"17151","KISUMU","ALL","44",3793,3616,7409
"17152","KISUMU","ALL","40-44",27219,23924,51143
"17153","KISUMU","ALL","45",5200,4779,9979
"17154","KISUMU","ALL","46",3738,3272,7010
"17155","KISUMU","ALL","47",3940,3508,7448
"17156","KISUMU","ALL","48",2428,2245,4673
"17157","KISUMU","ALL","49",2724,2580,5304
"17158","KISUMU","ALL","45-49",18030,16384,34414
"17159","KISUMU","ALL","50",3542,4049,7591
"17160","KISUMU","ALL","51",2885,3407,6292
"17161","KISUMU","ALL","52",2362,2576,4938
"17162","KISUMU","ALL","53",2008,2186,4194
"17163","KISUMU","ALL","54",2225,2241,4466
"17164","KISUMU","ALL","50-54",13022,14459,27481
"17165","KISUMU","ALL","55",2418,2525,4943
"17166","KISUMU","ALL","56",2371,3008,5379
"17167","KISUMU","ALL","57",2499,3746,6245
"17168","KISUMU","ALL","58",1760,2037,3797
"17169","KISUMU","ALL","59",2126,2642,4768
"17170","KISUMU","ALL","55-59",11174,13958,25132
"17171","KISUMU","ALL","60",2587,3690,6277
"17172","KISUMU","ALL","61",2119,2575,4694
"17173","KISUMU","ALL","62",1686,2047,3733
"17174","KISUMU","ALL","63",1764,2183,3947
"17175","KISUMU","ALL","64",1396,1649,3045
"17176","KISUMU","ALL","60-64",9552,12144,21696
"17177","KISUMU","ALL","65",1936,2532,4468
"17178","KISUMU","ALL","66",1271,1756,3027
"17179","KISUMU","ALL","67",1941,2596,4537
"17180","KISUMU","ALL","68",785,912,1697
"17181","KISUMU","ALL","69",1361,1477,2838
"17182","KISUMU","ALL","65-69",7294,9273,16567
"17183","KISUMU","ALL","70",1802,2613,4415
"17184","KISUMU","ALL","71",1314,1363,2677
"17185","KISUMU","ALL","72",1004,1099,2103
"17186","KISUMU","ALL","73",814,898,1712
"17187","KISUMU","ALL","74",799,1062,1861
"17188","KISUMU","ALL","70-74",5733,7035,12768
"17189","KISUMU","ALL","75",662,939,1601
"17190","KISUMU","ALL","76",565,860,1425
"17191","KISUMU","ALL","77",636,958,1594
"17192","KISUMU","ALL","78",330,447,777
"17193","KISUMU","ALL","79",418,836,1254
"17194","KISUMU","ALL","75-79",2611,4040,6651
"17195","KISUMU","ALL","80",554,1033,1587
"17196","KISUMU","ALL","81",365,562,927
"17197","KISUMU","ALL","82",292,382,674
"17198","KISUMU","ALL","83",372,435,807
"17199","KISUMU","ALL","84",298,439,737
"17200","KISUMU","ALL","80-84",1881,2851,4732
"17201","KISUMU","ALL","85",237,416,653
"17202","KISUMU","ALL","86",186,221,407
"17203","KISUMU","ALL","87",240,404,644
"17204","KISUMU","ALL","88",91,167,258
"17205","KISUMU","ALL","89",142,386,528
"17206","KISUMU","ALL","85-89",896,1594,2490
"17207","KISUMU","ALL","90",87,236,323
"17208","KISUMU","ALL","91",67,135,202
"17209","KISUMU","ALL","92",66,83,149
"17210","KISUMU","ALL","93",41,69,110
"17211","KISUMU","ALL","94",38,54,92
"17212","KISUMU","ALL","90-94",299,577,876
"17213","KISUMU","ALL","95",37,76,113
"17214","KISUMU","ALL","96",19,50,69
"17215","KISUMU","ALL","97",20,36,56
"17216","KISUMU","ALL","98",17,36,53
"17217","KISUMU","ALL","99",21,57,78
"17218","KISUMU","ALL","95-99",114,255,369
"17219","KISUMU","ALL","100+",39,97,136
"17220","KISUMU","ALL","Not Stated",12,15,27
"17221","KISUMU","KISUMU EAST","Total",108304,112689,220993
"17222","KISUMU","KISUMU EAST","0",2946,3060,6006
"17223","KISUMU","KISUMU EAST","1",2954,2980,5934
"17224","KISUMU","KISUMU EAST","2",2809,2800,5609
"17225","KISUMU","KISUMU EAST","3",2945,2923,5868
"17226","KISUMU","KISUMU EAST","4",2748,2761,5509
"17227","KISUMU","KISUMU EAST","0 - 4",14402,14524,28926
"17228","KISUMU","KISUMU EAST","5",2621,2574,5195
"17229","KISUMU","KISUMU EAST","6",2703,2763,5466
"17230","KISUMU","KISUMU EAST","7",2643,2687,5330
"17231","KISUMU","KISUMU EAST","8",2559,2548,5107
"17232","KISUMU","KISUMU EAST","9",2727,2881,5608
"17233","KISUMU","KISUMU EAST","5-9",13253,13453,26706
"17234","KISUMU","KISUMU EAST","10",2975,2934,5909
"17235","KISUMU","KISUMU EAST","11",2507,2567,5074
"17236","KISUMU","KISUMU EAST","12",2998,2994,5992
"17237","KISUMU","KISUMU EAST","13",2683,2983,5666
"17238","KISUMU","KISUMU EAST","14",2445,2710,5155
"17239","KISUMU","KISUMU EAST","10 -14",13608,14188,27796
"17240","KISUMU","KISUMU EAST","15",2323,2553,4876
"17241","KISUMU","KISUMU EAST","16",2256,2440,4696
"17242","KISUMU","KISUMU EAST","17",2272,2470,4742
"17243","KISUMU","KISUMU EAST","18",1982,2159,4141
"17244","KISUMU","KISUMU EAST","19",2025,2641,4666
"17245","KISUMU","KISUMU EAST","15-19",10858,12263,23121
"17246","KISUMU","KISUMU EAST","20",2069,2850,4919
"17247","KISUMU","KISUMU EAST","21",2162,2828,4990
"17248","KISUMU","KISUMU EAST","22",2131,2901,5032
"17249","KISUMU","KISUMU EAST","23",2439,3167,5606
"17250","KISUMU","KISUMU EAST","24",2428,2929,5357
"17251","KISUMU","KISUMU EAST","20-24",11229,14675,25904
"17252","KISUMU","KISUMU EAST","25",2659,3158,5817
"17253","KISUMU","KISUMU EAST","26",2236,2646,4882
"17254","KISUMU","KISUMU EAST","27",2519,2679,5198
"17255","KISUMU","KISUMU EAST","28",1896,2020,3916
"17256","KISUMU","KISUMU EAST","29",1946,2101,4047
"17257","KISUMU","KISUMU EAST","25-29",11256,12604,23860
"17258","KISUMU","KISUMU EAST","30",2688,2848,5536
"17259","KISUMU","KISUMU EAST","31",1852,1682,3534
"17260","KISUMU","KISUMU EAST","32",2326,2259,4585
"17261","KISUMU","KISUMU EAST","33",1742,1690,3432
"17262","KISUMU","KISUMU EAST","34",1634,1571,3205
"17263","KISUMU","KISUMU EAST","30-34",10242,10050,20292
"17264","KISUMU","KISUMU EAST","35",2037,1714,3751
"17265","KISUMU","KISUMU EAST","36",1506,1202,2708
"17266","KISUMU","KISUMU EAST","37",1489,1096,2585
"17267","KISUMU","KISUMU EAST","38",1092,846,1938
"17268","KISUMU","KISUMU EAST","39",1287,949,2236
"17269","KISUMU","KISUMU EAST","35-39",7411,5807,13218
"17270","KISUMU","KISUMU EAST","40",1508,1215,2723
"17271","KISUMU","KISUMU EAST","41",1137,820,1957
"17272","KISUMU","KISUMU EAST","42",1085,793,1878
"17273","KISUMU","KISUMU EAST","43",927,813,1740
"17274","KISUMU","KISUMU EAST","44",679,566,1245
"17275","KISUMU","KISUMU EAST","40-44",5336,4207,9543
"17276","KISUMU","KISUMU EAST","45",1018,743,1761
"17277","KISUMU","KISUMU EAST","46",651,493,1144
"17278","KISUMU","KISUMU EAST","47",755,554,1309
"17279","KISUMU","KISUMU EAST","48",453,351,804
"17280","KISUMU","KISUMU EAST","49",510,419,929
"17281","KISUMU","KISUMU EAST","45-49",3387,2560,5947
"17282","KISUMU","KISUMU EAST","50",637,615,1252
"17283","KISUMU","KISUMU EAST","51",439,467,906
"17284","KISUMU","KISUMU EAST","52",377,384,761
"17285","KISUMU","KISUMU EAST","53",335,324,659
"17286","KISUMU","KISUMU EAST","54",361,355,716
"17287","KISUMU","KISUMU EAST","50-54",2149,2145,4294
"17288","KISUMU","KISUMU EAST","55",395,363,758
"17289","KISUMU","KISUMU EAST","56",372,423,795
"17290","KISUMU","KISUMU EAST","57",371,507,878
"17291","KISUMU","KISUMU EAST","58",248,250,498
"17292","KISUMU","KISUMU EAST","59",287,346,633
"17293","KISUMU","KISUMU EAST","55-59",1673,1889,3562
"17294","KISUMU","KISUMU EAST","60",366,464,830
"17295","KISUMU","KISUMU EAST","61",307,319,626
"17296","KISUMU","KISUMU EAST","62",243,279,522
"17297","KISUMU","KISUMU EAST","63",227,262,489
"17298","KISUMU","KISUMU EAST","64",193,219,412
"17299","KISUMU","KISUMU EAST","60-64",1336,1543,2879
"17300","KISUMU","KISUMU EAST","65",267,291,558
"17301","KISUMU","KISUMU EAST","66",167,198,365
"17302","KISUMU","KISUMU EAST","67",235,288,523
"17303","KISUMU","KISUMU EAST","68",103,101,204
"17304","KISUMU","KISUMU EAST","69",159,185,344
"17305","KISUMU","KISUMU EAST","65-69",931,1063,1994
"17306","KISUMU","KISUMU EAST","70",219,284,503
"17307","KISUMU","KISUMU EAST","71",152,145,297
"17308","KISUMU","KISUMU EAST","72",101,118,219
"17309","KISUMU","KISUMU EAST","73",88,94,182
"17310","KISUMU","KISUMU EAST","74",86,99,185
"17311","KISUMU","KISUMU EAST","70-74",646,740,1386
"17312","KISUMU","KISUMU EAST","75",78,89,167
"17313","KISUMU","KISUMU EAST","76",60,101,161
"17314","KISUMU","KISUMU EAST","77",64,99,163
"17315","KISUMU","KISUMU EAST","78",30,44,74
"17316","KISUMU","KISUMU EAST","79",40,91,131
"17317","KISUMU","KISUMU EAST","75-79",272,424,696
"17318","KISUMU","KISUMU EAST","80",47,103,150
"17319","KISUMU","KISUMU EAST","81",28,54,82
"17320","KISUMU","KISUMU EAST","82",33,30,63
"17321","KISUMU","KISUMU EAST","83",39,57,96
"17322","KISUMU","KISUMU EAST","84",21,55,76
"17323","KISUMU","KISUMU EAST","80-84",168,299,467
"17324","KISUMU","KISUMU EAST","85",40,39,79
"17325","KISUMU","KISUMU EAST","86",20,25,45
"17326","KISUMU","KISUMU EAST","87",25,46,71
"17327","KISUMU","KISUMU EAST","88",10,16,26
"17328","KISUMU","KISUMU EAST","89",12,31,43
"17329","KISUMU","KISUMU EAST","85-89",107,157,264
"17330","KISUMU","KISUMU EAST","90",9,22,31
"17331","KISUMU","KISUMU EAST","91",4,15,19
"17332","KISUMU","KISUMU EAST","92",5,4,9
"17333","KISUMU","KISUMU EAST","93",3,9,12
"17334","KISUMU","KISUMU EAST","94",3,9,12
"17335","KISUMU","KISUMU EAST","90-94",24,59,83
"17336","KISUMU","KISUMU EAST","95",4,12,16
"17337","KISUMU","KISUMU EAST","96",1,2,3
"17338","KISUMU","KISUMU EAST","97",2,9,11
"17339","KISUMU","KISUMU EAST","98",2,2,4
"17340","KISUMU","KISUMU EAST","99",1,4,5
"17341","KISUMU","KISUMU EAST","95-99",10,29,39
"17342","KISUMU","KISUMU EAST","100+",5,7,12
"17343","KISUMU","KISUMU EAST","Not Stated",1,3,4
"17344","KISUMU","KISUMU CENTRAL","Total",84155,89985,174140
"17345","KISUMU","KISUMU CENTRAL","0",2216,2078,4294
"17346","KISUMU","KISUMU CENTRAL","1",2170,2118,4288
"17347","KISUMU","KISUMU CENTRAL","2",1946,2006,3952
"17348","KISUMU","KISUMU CENTRAL","3",1988,2107,4095
"17349","KISUMU","KISUMU CENTRAL","4",1870,1987,3857
"17350","KISUMU","KISUMU CENTRAL","0 - 4",10190,10296,20486
"17351","KISUMU","KISUMU CENTRAL","5",1712,1803,3515
"17352","KISUMU","KISUMU CENTRAL","6",1817,1902,3719
"17353","KISUMU","KISUMU CENTRAL","7",1912,1911,3823
"17354","KISUMU","KISUMU CENTRAL","8",1773,1796,3569
"17355","KISUMU","KISUMU CENTRAL","9",1873,1983,3856
"17356","KISUMU","KISUMU CENTRAL","5-9",9087,9395,18482
"17357","KISUMU","KISUMU CENTRAL","10",2040,1941,3981
"17358","KISUMU","KISUMU CENTRAL","11",1765,1942,3707
"17359","KISUMU","KISUMU CENTRAL","12",1918,2237,4155
"17360","KISUMU","KISUMU CENTRAL","13",1845,2174,4019
"17361","KISUMU","KISUMU CENTRAL","14",1761,1899,3660
"17362","KISUMU","KISUMU CENTRAL","10 -14",9329,10193,19522
"17363","KISUMU","KISUMU CENTRAL","15",1665,1968,3633
"17364","KISUMU","KISUMU CENTRAL","16",1574,1945,3519
"17365","KISUMU","KISUMU CENTRAL","17",1701,2050,3751
"17366","KISUMU","KISUMU CENTRAL","18",1521,1769,3290
"17367","KISUMU","KISUMU CENTRAL","19",1650,2196,3846
"17368","KISUMU","KISUMU CENTRAL","15-19",8111,9928,18039
"17369","KISUMU","KISUMU CENTRAL","20",1600,2288,3888
"17370","KISUMU","KISUMU CENTRAL","21",1673,2310,3983
"17371","KISUMU","KISUMU CENTRAL","22",1780,2331,4111
"17372","KISUMU","KISUMU CENTRAL","23",1933,2532,4465
"17373","KISUMU","KISUMU CENTRAL","24",1861,2491,4352
"17374","KISUMU","KISUMU CENTRAL","20-24",8847,11952,20799
"17375","KISUMU","KISUMU CENTRAL","25",2091,2512,4603
"17376","KISUMU","KISUMU CENTRAL","26",1738,2273,4011
"17377","KISUMU","KISUMU CENTRAL","27",1883,2260,4143
"17378","KISUMU","KISUMU CENTRAL","28",1580,1875,3455
"17379","KISUMU","KISUMU CENTRAL","29",1634,2014,3648
"17380","KISUMU","KISUMU CENTRAL","25-29",8926,10934,19860
"17381","KISUMU","KISUMU CENTRAL","30",2107,2515,4622
"17382","KISUMU","KISUMU CENTRAL","31",1413,1572,2985
"17383","KISUMU","KISUMU CENTRAL","32",1933,2138,4071
"17384","KISUMU","KISUMU CENTRAL","33",1450,1609,3059
"17385","KISUMU","KISUMU CENTRAL","34",1485,1515,3000
"17386","KISUMU","KISUMU CENTRAL","30-34",8388,9349,17737
"17387","KISUMU","KISUMU CENTRAL","35",1752,1634,3386
"17388","KISUMU","KISUMU CENTRAL","36",1246,1232,2478
"17389","KISUMU","KISUMU CENTRAL","37",1305,1120,2425
"17390","KISUMU","KISUMU CENTRAL","38",1113,949,2062
"17391","KISUMU","KISUMU CENTRAL","39",1139,1006,2145
"17392","KISUMU","KISUMU CENTRAL","35-39",6555,5941,12496
"17393","KISUMU","KISUMU CENTRAL","40",1425,1186,2611
"17394","KISUMU","KISUMU CENTRAL","41",1093,802,1895
"17395","KISUMU","KISUMU CENTRAL","42",1065,852,1917
"17396","KISUMU","KISUMU CENTRAL","43",887,697,1584
"17397","KISUMU","KISUMU CENTRAL","44",683,552,1235
"17398","KISUMU","KISUMU CENTRAL","40-44",5153,4089,9242
"17399","KISUMU","KISUMU CENTRAL","45",982,783,1765
"17400","KISUMU","KISUMU CENTRAL","46",674,544,1218
"17401","KISUMU","KISUMU CENTRAL","47",696,510,1206
"17402","KISUMU","KISUMU CENTRAL","48",486,391,877
"17403","KISUMU","KISUMU CENTRAL","49",545,412,957
"17404","KISUMU","KISUMU CENTRAL","45-49",3383,2640,6023
"17405","KISUMU","KISUMU CENTRAL","50",675,558,1233
"17406","KISUMU","KISUMU CENTRAL","51",445,323,768
"17407","KISUMU","KISUMU CENTRAL","52",455,330,785
"17408","KISUMU","KISUMU CENTRAL","53",364,284,648
"17409","KISUMU","KISUMU CENTRAL","54",402,274,676
"17410","KISUMU","KISUMU CENTRAL","50-54",2341,1769,4110
"17411","KISUMU","KISUMU CENTRAL","55",394,296,690
"17412","KISUMU","KISUMU CENTRAL","56",382,325,707
"17413","KISUMU","KISUMU CENTRAL","57",326,309,635
"17414","KISUMU","KISUMU CENTRAL","58",261,225,486
"17415","KISUMU","KISUMU CENTRAL","59",315,260,575
"17416","KISUMU","KISUMU CENTRAL","55-59",1678,1415,3093
"17417","KISUMU","KISUMU CENTRAL","60",291,259,550
"17418","KISUMU","KISUMU CENTRAL","61",185,165,350
"17419","KISUMU","KISUMU CENTRAL","62",185,152,337
"17420","KISUMU","KISUMU CENTRAL","63",185,157,342
"17421","KISUMU","KISUMU CENTRAL","64",151,124,275
"17422","KISUMU","KISUMU CENTRAL","60-64",997,857,1854
"17423","KISUMU","KISUMU CENTRAL","65",158,160,318
"17424","KISUMU","KISUMU CENTRAL","66",84,94,178
"17425","KISUMU","KISUMU CENTRAL","67",134,126,260
"17426","KISUMU","KISUMU CENTRAL","68",72,50,122
"17427","KISUMU","KISUMU CENTRAL","69",97,83,180
"17428","KISUMU","KISUMU CENTRAL","65-69",545,513,1058
"17429","KISUMU","KISUMU CENTRAL","70",112,113,225
"17430","KISUMU","KISUMU CENTRAL","71",78,74,152
"17431","KISUMU","KISUMU CENTRAL","72",55,64,119
"17432","KISUMU","KISUMU CENTRAL","73",48,49,97
"17433","KISUMU","KISUMU CENTRAL","74",66,46,112
"17434","KISUMU","KISUMU CENTRAL","70-74",359,346,705
"17435","KISUMU","KISUMU CENTRAL","75",37,34,71
"17436","KISUMU","KISUMU CENTRAL","76",28,31,59
"17437","KISUMU","KISUMU CENTRAL","77",29,30,59
"17438","KISUMU","KISUMU CENTRAL","78",25,22,47
"17439","KISUMU","KISUMU CENTRAL","79",16,26,42
"17440","KISUMU","KISUMU CENTRAL","75-79",135,143,278
"17441","KISUMU","KISUMU CENTRAL","80",29,42,71
"17442","KISUMU","KISUMU CENTRAL","81",15,23,38
"17443","KISUMU","KISUMU CENTRAL","82",6,25,31
"17444","KISUMU","KISUMU CENTRAL","83",14,12,26
"17445","KISUMU","KISUMU CENTRAL","84",11,16,27
"17446","KISUMU","KISUMU CENTRAL","80-84",75,118,193
"17447","KISUMU","KISUMU CENTRAL","85",10,23,33
"17448","KISUMU","KISUMU CENTRAL","86",8,11,19
"17449","KISUMU","KISUMU CENTRAL","87",6,11,17
"17450","KISUMU","KISUMU CENTRAL","88",5,6,11
"17451","KISUMU","KISUMU CENTRAL","89",6,12,18
"17452","KISUMU","KISUMU CENTRAL","85-89",35,63,98
"17453","KISUMU","KISUMU CENTRAL","90",6,11,17
"17454","KISUMU","KISUMU CENTRAL","91",2,2,4
"17455","KISUMU","KISUMU CENTRAL","92",3,6,9
"17456","KISUMU","KISUMU CENTRAL","93",NA,2,2
"17457","KISUMU","KISUMU CENTRAL","94",3,1,4
"17458","KISUMU","KISUMU CENTRAL","90-94",14,22,36
"17459","KISUMU","KISUMU CENTRAL","95",NA,6,6
"17460","KISUMU","KISUMU CENTRAL","96",1,3,4
"17461","KISUMU","KISUMU CENTRAL","97",1,1,2
"17462","KISUMU","KISUMU CENTRAL","98",1,2,3
"17463","KISUMU","KISUMU CENTRAL","99",NA,2,2
"17464","KISUMU","KISUMU CENTRAL","95-99",3,14,17
"17465","KISUMU","KISUMU CENTRAL","100+",NA,1,1
"17466","KISUMU","KISUMU CENTRAL","Not Stated",4,7,11
"17467","KISUMU","KISUMU WEST","Total",85697,87121,172818
"17468","KISUMU","KISUMU WEST","0",2057,2018,4075
"17469","KISUMU","KISUMU WEST","1",2036,2034,4070
"17470","KISUMU","KISUMU WEST","2",2128,2100,4228
"17471","KISUMU","KISUMU WEST","3",1985,2066,4051
"17472","KISUMU","KISUMU WEST","4",2007,1931,3938
"17473","KISUMU","KISUMU WEST","0 - 4",10213,10149,20362
"17474","KISUMU","KISUMU WEST","5",2040,1970,4010
"17475","KISUMU","KISUMU WEST","6",2073,2107,4180
"17476","KISUMU","KISUMU WEST","7",2173,2220,4393
"17477","KISUMU","KISUMU WEST","8",2147,2065,4212
"17478","KISUMU","KISUMU WEST","9",2270,2283,4553
"17479","KISUMU","KISUMU WEST","5-9",10703,10645,21348
"17480","KISUMU","KISUMU WEST","10",2485,2451,4936
"17481","KISUMU","KISUMU WEST","11",2177,2426,4603
"17482","KISUMU","KISUMU WEST","12",2494,2548,5042
"17483","KISUMU","KISUMU WEST","13",2413,2509,4922
"17484","KISUMU","KISUMU WEST","14",2221,2254,4475
"17485","KISUMU","KISUMU WEST","10 -14",11790,12188,23978
"17486","KISUMU","KISUMU WEST","15",2070,2092,4162
"17487","KISUMU","KISUMU WEST","16",1963,2047,4010
"17488","KISUMU","KISUMU WEST","17",2086,2104,4190
"17489","KISUMU","KISUMU WEST","18",1968,2138,4106
"17490","KISUMU","KISUMU WEST","19",2414,2331,4745
"17491","KISUMU","KISUMU WEST","15-19",10501,10712,21213
"17492","KISUMU","KISUMU WEST","20",2112,2062,4174
"17493","KISUMU","KISUMU WEST","21",1800,1865,3665
"17494","KISUMU","KISUMU WEST","22",1629,1782,3411
"17495","KISUMU","KISUMU WEST","23",1595,1836,3431
"17496","KISUMU","KISUMU WEST","24",1551,1697,3248
"17497","KISUMU","KISUMU WEST","20-24",8687,9242,17929
"17498","KISUMU","KISUMU WEST","25",1679,1821,3500
"17499","KISUMU","KISUMU WEST","26",1384,1469,2853
"17500","KISUMU","KISUMU WEST","27",1544,1707,3251
"17501","KISUMU","KISUMU WEST","28",1181,1200,2381
"17502","KISUMU","KISUMU WEST","29",1266,1351,2617
"17503","KISUMU","KISUMU WEST","25-29",7054,7548,14602
"17504","KISUMU","KISUMU WEST","30",1658,1718,3376
"17505","KISUMU","KISUMU WEST","31",1125,1088,2213
"17506","KISUMU","KISUMU WEST","32",1482,1441,2923
"17507","KISUMU","KISUMU WEST","33",1133,1271,2404
"17508","KISUMU","KISUMU WEST","34",1145,1107,2252
"17509","KISUMU","KISUMU WEST","30-34",6543,6625,13168
"17510","KISUMU","KISUMU WEST","35",1445,1288,2733
"17511","KISUMU","KISUMU WEST","36",1062,856,1918
"17512","KISUMU","KISUMU WEST","37",1143,871,2014
"17513","KISUMU","KISUMU WEST","38",816,603,1419
"17514","KISUMU","KISUMU WEST","39",905,717,1622
"17515","KISUMU","KISUMU WEST","35-39",5371,4335,9706
"17516","KISUMU","KISUMU WEST","40",1093,901,1994
"17517","KISUMU","KISUMU WEST","41",842,688,1530
"17518","KISUMU","KISUMU WEST","42",822,624,1446
"17519","KISUMU","KISUMU WEST","43",754,680,1434
"17520","KISUMU","KISUMU WEST","44",574,480,1054
"17521","KISUMU","KISUMU WEST","40-44",4085,3373,7458
"17522","KISUMU","KISUMU WEST","45",796,668,1464
"17523","KISUMU","KISUMU WEST","46",529,452,981
"17524","KISUMU","KISUMU WEST","47",600,487,1087
"17525","KISUMU","KISUMU WEST","48",384,317,701
"17526","KISUMU","KISUMU WEST","49",429,366,795
"17527","KISUMU","KISUMU WEST","45-49",2738,2290,5028
"17528","KISUMU","KISUMU WEST","50",548,586,1134
"17529","KISUMU","KISUMU WEST","51",430,505,935
"17530","KISUMU","KISUMU WEST","52",348,378,726
"17531","KISUMU","KISUMU WEST","53",304,342,646
"17532","KISUMU","KISUMU WEST","54",345,330,675
"17533","KISUMU","KISUMU WEST","50-54",1975,2141,4116
"17534","KISUMU","KISUMU WEST","55",393,405,798
"17535","KISUMU","KISUMU WEST","56",354,474,828
"17536","KISUMU","KISUMU WEST","57",370,553,923
"17537","KISUMU","KISUMU WEST","58",250,294,544
"17538","KISUMU","KISUMU WEST","59",302,419,721
"17539","KISUMU","KISUMU WEST","55-59",1669,2145,3814
"17540","KISUMU","KISUMU WEST","60",412,553,965
"17541","KISUMU","KISUMU WEST","61",329,405,734
"17542","KISUMU","KISUMU WEST","62",258,313,571
"17543","KISUMU","KISUMU WEST","63",281,349,630
"17544","KISUMU","KISUMU WEST","64",205,245,450
"17545","KISUMU","KISUMU WEST","60-64",1485,1865,3350
"17546","KISUMU","KISUMU WEST","65",300,404,704
"17547","KISUMU","KISUMU WEST","66",224,247,471
"17548","KISUMU","KISUMU WEST","67",304,362,666
"17549","KISUMU","KISUMU WEST","68",117,137,254
"17550","KISUMU","KISUMU WEST","69",183,215,398
"17551","KISUMU","KISUMU WEST","65-69",1128,1365,2493
"17552","KISUMU","KISUMU WEST","70",301,407,708
"17553","KISUMU","KISUMU WEST","71",191,234,425
"17554","KISUMU","KISUMU WEST","72",162,157,319
"17555","KISUMU","KISUMU WEST","73",132,158,290
"17556","KISUMU","KISUMU WEST","74",115,150,265
"17557","KISUMU","KISUMU WEST","70-74",901,1106,2007
"17558","KISUMU","KISUMU WEST","75",94,159,253
"17559","KISUMU","KISUMU WEST","76",88,133,221
"17560","KISUMU","KISUMU WEST","77",95,153,248
"17561","KISUMU","KISUMU WEST","78",57,62,119
"17562","KISUMU","KISUMU WEST","79",58,119,177
"17563","KISUMU","KISUMU WEST","75-79",392,626,1018
"17564","KISUMU","KISUMU WEST","80",75,145,220
"17565","KISUMU","KISUMU WEST","81",61,87,148
"17566","KISUMU","KISUMU WEST","82",41,64,105
"17567","KISUMU","KISUMU WEST","83",58,77,135
"17568","KISUMU","KISUMU WEST","84",52,62,114
"17569","KISUMU","KISUMU WEST","80-84",287,435,722
"17570","KISUMU","KISUMU WEST","85",35,56,91
"17571","KISUMU","KISUMU WEST","86",30,44,74
"17572","KISUMU","KISUMU WEST","87",24,59,83
"17573","KISUMU","KISUMU WEST","88",13,22,35
"17574","KISUMU","KISUMU WEST","89",24,28,52
"17575","KISUMU","KISUMU WEST","85-89",126,209,335
"17576","KISUMU","KISUMU WEST","90",8,30,38
"17577","KISUMU","KISUMU WEST","91",9,18,27
"17578","KISUMU","KISUMU WEST","92",8,11,19
"17579","KISUMU","KISUMU WEST","93",4,8,12
"17580","KISUMU","KISUMU WEST","94",3,5,8
"17581","KISUMU","KISUMU WEST","90-94",32,72,104
"17582","KISUMU","KISUMU WEST","95",2,12,14
"17583","KISUMU","KISUMU WEST","96",1,7,8
"17584","KISUMU","KISUMU WEST","97",3,2,5
"17585","KISUMU","KISUMU WEST","98",1,4,5
"17586","KISUMU","KISUMU WEST","99",3,6,9
"17587","KISUMU","KISUMU WEST","95-99",10,31,41
"17588","KISUMU","KISUMU WEST","100+",5,18,23
"17589","KISUMU","KISUMU WEST","Not Stated",2,1,3
"17590","KISUMU","SEME","Total",57658,64007,121665
"17591","KISUMU","SEME","0",1353,1410,2763
"17592","KISUMU","SEME","1",1563,1512,3075
"17593","KISUMU","SEME","2",1509,1523,3032
"17594","KISUMU","SEME","3",1511,1587,3098
"17595","KISUMU","SEME","4",1499,1530,3029
"17596","KISUMU","SEME","0 - 4",7435,7562,14997
"17597","KISUMU","SEME","5",1626,1560,3186
"17598","KISUMU","SEME","6",1716,1685,3401
"17599","KISUMU","SEME","7",1638,1732,3370
"17600","KISUMU","SEME","8",1649,1685,3334
"17601","KISUMU","SEME","9",1842,1834,3676
"17602","KISUMU","SEME","5-9",8471,8496,16967
"17603","KISUMU","SEME","10",1989,1869,3858
"17604","KISUMU","SEME","11",1844,1857,3701
"17605","KISUMU","SEME","12",2031,2049,4080
"17606","KISUMU","SEME","13",2047,1937,3984
"17607","KISUMU","SEME","14",1918,1797,3715
"17608","KISUMU","SEME","10 -14",9829,9509,19338
"17609","KISUMU","SEME","15",1846,1722,3568
"17610","KISUMU","SEME","16",1641,1580,3221
"17611","KISUMU","SEME","17",1607,1529,3136
"17612","KISUMU","SEME","18",1275,1202,2477
"17613","KISUMU","SEME","19",1318,1347,2665
"17614","KISUMU","SEME","15-19",7687,7380,15067
"17615","KISUMU","SEME","20",1118,1196,2314
"17616","KISUMU","SEME","21",923,1056,1979
"17617","KISUMU","SEME","22",789,993,1782
"17618","KISUMU","SEME","23",799,999,1798
"17619","KISUMU","SEME","24",701,961,1662
"17620","KISUMU","SEME","20-24",4330,5205,9535
"17621","KISUMU","SEME","25",812,952,1764
"17622","KISUMU","SEME","26",648,870,1518
"17623","KISUMU","SEME","27",664,917,1581
"17624","KISUMU","SEME","28",522,615,1137
"17625","KISUMU","SEME","29",570,794,1364
"17626","KISUMU","SEME","25-29",3216,4148,7364
"17627","KISUMU","SEME","30",738,1115,1853
"17628","KISUMU","SEME","31",547,839,1386
"17629","KISUMU","SEME","32",684,939,1623
"17630","KISUMU","SEME","33",630,849,1479
"17631","KISUMU","SEME","34",637,751,1388
"17632","KISUMU","SEME","30-34",3236,4493,7729
"17633","KISUMU","SEME","35",724,808,1532
"17634","KISUMU","SEME","36",496,485,981
"17635","KISUMU","SEME","37",560,519,1079
"17636","KISUMU","SEME","38",394,371,765
"17637","KISUMU","SEME","39",486,446,932
"17638","KISUMU","SEME","35-39",2660,2629,5289
"17639","KISUMU","SEME","40",612,602,1214
"17640","KISUMU","SEME","41",529,513,1042
"17641","KISUMU","SEME","42",474,461,935
"17642","KISUMU","SEME","43",486,543,1029
"17643","KISUMU","SEME","44",349,434,783
"17644","KISUMU","SEME","40-44",2450,2553,5003
"17645","KISUMU","SEME","45",453,532,985
"17646","KISUMU","SEME","46",376,416,792
"17647","KISUMU","SEME","47",365,435,800
"17648","KISUMU","SEME","48",253,271,524
"17649","KISUMU","SEME","49",234,316,550
"17650","KISUMU","SEME","45-49",1681,1970,3651
"17651","KISUMU","SEME","50",327,494,821
"17652","KISUMU","SEME","51",304,425,729
"17653","KISUMU","SEME","52",241,338,579
"17654","KISUMU","SEME","53",225,304,529
"17655","KISUMU","SEME","54",218,283,501
"17656","KISUMU","SEME","50-54",1315,1844,3159
"17657","KISUMU","SEME","55",240,324,564
"17658","KISUMU","SEME","56",236,386,622
"17659","KISUMU","SEME","57",314,518,832
"17660","KISUMU","SEME","58",191,289,480
"17661","KISUMU","SEME","59",228,369,597
"17662","KISUMU","SEME","55-59",1209,1886,3095
"17663","KISUMU","SEME","60",338,581,919
"17664","KISUMU","SEME","61",260,389,649
"17665","KISUMU","SEME","62",225,329,554
"17666","KISUMU","SEME","63",207,345,552
"17667","KISUMU","SEME","64",169,226,395
"17668","KISUMU","SEME","60-64",1199,1870,3069
"17669","KISUMU","SEME","65",258,400,658
"17670","KISUMU","SEME","66",198,325,523
"17671","KISUMU","SEME","67",303,458,761
"17672","KISUMU","SEME","68",105,157,262
"17673","KISUMU","SEME","69",219,241,460
"17674","KISUMU","SEME","65-69",1083,1581,2664
"17675","KISUMU","SEME","70",253,470,723
"17676","KISUMU","SEME","71",219,223,442
"17677","KISUMU","SEME","72",155,193,348
"17678","KISUMU","SEME","73",114,137,251
"17679","KISUMU","SEME","74",121,195,316
"17680","KISUMU","SEME","70-74",862,1218,2080
"17681","KISUMU","SEME","75",103,159,262
"17682","KISUMU","SEME","76",101,150,251
"17683","KISUMU","SEME","77",119,203,322
"17684","KISUMU","SEME","78",51,90,141
"17685","KISUMU","SEME","79",81,142,223
"17686","KISUMU","SEME","75-79",455,744,1199
"17687","KISUMU","SEME","80",84,168,252
"17688","KISUMU","SEME","81",72,106,178
"17689","KISUMU","SEME","82",47,63,110
"17690","KISUMU","SEME","83",65,65,130
"17691","KISUMU","SEME","84",48,70,118
"17692","KISUMU","SEME","80-84",316,472,788
"17693","KISUMU","SEME","85",35,73,108
"17694","KISUMU","SEME","86",28,41,69
"17695","KISUMU","SEME","87",46,85,131
"17696","KISUMU","SEME","88",15,22,37
"17697","KISUMU","SEME","89",18,74,92
"17698","KISUMU","SEME","85-89",142,295,437
"17699","KISUMU","SEME","90",11,33,44
"17700","KISUMU","SEME","91",15,28,43
"17701","KISUMU","SEME","92",13,14,27
"17702","KISUMU","SEME","93",6,9,15
"17703","KISUMU","SEME","94",6,11,17
"17704","KISUMU","SEME","90-94",51,95,146
"17705","KISUMU","SEME","95",8,12,20
"17706","KISUMU","SEME","96",5,4,9
"17707","KISUMU","SEME","97",4,4,8
"17708","KISUMU","SEME","98",3,8,11
"17709","KISUMU","SEME","99",6,10,16
"17710","KISUMU","SEME","95-99",26,38,64
"17711","KISUMU","SEME","100+",5,19,24
"17712","KISUMU","SEME","Not Stated",NA,NA,NA
"17713","KISUMU","MUHORONI","Total",76770,77345,154115
"17714","KISUMU","MUHORONI","0",1716,1739,3455
"17715","KISUMU","MUHORONI","1",1773,1846,3619
"17716","KISUMU","MUHORONI","2",1799,1850,3649
"17717","KISUMU","MUHORONI","3",1932,1990,3922
"17718","KISUMU","MUHORONI","4",2040,2039,4079
"17719","KISUMU","MUHORONI","0 - 4",9260,9464,18724
"17720","KISUMU","MUHORONI","5",2086,2045,4131
"17721","KISUMU","MUHORONI","6",2145,2100,4245
"17722","KISUMU","MUHORONI","7",2037,2140,4177
"17723","KISUMU","MUHORONI","8",2039,2051,4090
"17724","KISUMU","MUHORONI","9",2300,2274,4574
"17725","KISUMU","MUHORONI","5-9",10607,10610,21217
"17726","KISUMU","MUHORONI","10",2477,2339,4816
"17727","KISUMU","MUHORONI","11",2264,2324,4588
"17728","KISUMU","MUHORONI","12",2649,2539,5188
"17729","KISUMU","MUHORONI","13",2523,2559,5082
"17730","KISUMU","MUHORONI","14",2231,2218,4449
"17731","KISUMU","MUHORONI","10 -14",12144,11979,24123
"17732","KISUMU","MUHORONI","15",2237,2122,4359
"17733","KISUMU","MUHORONI","16",1925,1888,3813
"17734","KISUMU","MUHORONI","17",1973,1831,3804
"17735","KISUMU","MUHORONI","18",1522,1449,2971
"17736","KISUMU","MUHORONI","19",1637,1678,3315
"17737","KISUMU","MUHORONI","15-19",9294,8968,18262
"17738","KISUMU","MUHORONI","20",1371,1580,2951
"17739","KISUMU","MUHORONI","21",1328,1388,2716
"17740","KISUMU","MUHORONI","22",1113,1270,2383
"17741","KISUMU","MUHORONI","23",1184,1380,2564
"17742","KISUMU","MUHORONI","24",1064,1161,2225
"17743","KISUMU","MUHORONI","20-24",6060,6779,12839
"17744","KISUMU","MUHORONI","25",1254,1334,2588
"17745","KISUMU","MUHORONI","26",937,1133,2070
"17746","KISUMU","MUHORONI","27",1098,1258,2356
"17747","KISUMU","MUHORONI","28",820,906,1726
"17748","KISUMU","MUHORONI","29",825,991,1816
"17749","KISUMU","MUHORONI","25-29",4934,5622,10556
"17750","KISUMU","MUHORONI","30",1123,1358,2481
"17751","KISUMU","MUHORONI","31",884,957,1841
"17752","KISUMU","MUHORONI","32",1165,1257,2422
"17753","KISUMU","MUHORONI","33",1016,1143,2159
"17754","KISUMU","MUHORONI","34",967,1063,2030
"17755","KISUMU","MUHORONI","30-34",5155,5778,10933
"17756","KISUMU","MUHORONI","35",1182,1093,2275
"17757","KISUMU","MUHORONI","36",927,672,1599
"17758","KISUMU","MUHORONI","37",909,654,1563
"17759","KISUMU","MUHORONI","38",609,443,1052
"17760","KISUMU","MUHORONI","39",817,608,1425
"17761","KISUMU","MUHORONI","35-39",4444,3470,7914
"17762","KISUMU","MUHORONI","40",913,735,1648
"17763","KISUMU","MUHORONI","41",895,671,1566
"17764","KISUMU","MUHORONI","42",772,573,1345
"17765","KISUMU","MUHORONI","43",739,664,1403
"17766","KISUMU","MUHORONI","44",576,534,1110
"17767","KISUMU","MUHORONI","40-44",3895,3177,7072
"17768","KISUMU","MUHORONI","45",816,671,1487
"17769","KISUMU","MUHORONI","46",618,434,1052
"17770","KISUMU","MUHORONI","47",626,473,1099
"17771","KISUMU","MUHORONI","48",341,272,613
"17772","KISUMU","MUHORONI","49",413,323,736
"17773","KISUMU","MUHORONI","45-49",2814,2173,4987
"17774","KISUMU","MUHORONI","50",529,530,1059
"17775","KISUMU","MUHORONI","51",464,503,967
"17776","KISUMU","MUHORONI","52",383,340,723
"17777","KISUMU","MUHORONI","53",301,262,563
"17778","KISUMU","MUHORONI","54",337,306,643
"17779","KISUMU","MUHORONI","50-54",2014,1941,3955
"17780","KISUMU","MUHORONI","55",344,349,693
"17781","KISUMU","MUHORONI","56",428,413,841
"17782","KISUMU","MUHORONI","57",407,572,979
"17783","KISUMU","MUHORONI","58",298,289,587
"17784","KISUMU","MUHORONI","59",366,375,741
"17785","KISUMU","MUHORONI","55-59",1843,1998,3841
"17786","KISUMU","MUHORONI","60",395,511,906
"17787","KISUMU","MUHORONI","61",347,365,712
"17788","KISUMU","MUHORONI","62",241,280,521
"17789","KISUMU","MUHORONI","63",293,301,594
"17790","KISUMU","MUHORONI","64",218,248,466
"17791","KISUMU","MUHORONI","60-64",1494,1705,3199
"17792","KISUMU","MUHORONI","65",278,338,616
"17793","KISUMU","MUHORONI","66",189,281,470
"17794","KISUMU","MUHORONI","67",286,378,664
"17795","KISUMU","MUHORONI","68",121,127,248
"17796","KISUMU","MUHORONI","69",221,232,453
"17797","KISUMU","MUHORONI","65-69",1095,1356,2451
"17798","KISUMU","MUHORONI","70",260,353,613
"17799","KISUMU","MUHORONI","71",191,210,401
"17800","KISUMU","MUHORONI","72",164,171,335
"17801","KISUMU","MUHORONI","73",105,127,232
"17802","KISUMU","MUHORONI","74",132,168,300
"17803","KISUMU","MUHORONI","70-74",852,1029,1881
"17804","KISUMU","MUHORONI","75",100,139,239
"17805","KISUMU","MUHORONI","76",65,138,203
"17806","KISUMU","MUHORONI","77",91,120,211
"17807","KISUMU","MUHORONI","78",50,65,115
"17808","KISUMU","MUHORONI","79",69,116,185
"17809","KISUMU","MUHORONI","75-79",375,578,953
"17810","KISUMU","MUHORONI","80",81,142,223
"17811","KISUMU","MUHORONI","81",59,77,136
"17812","KISUMU","MUHORONI","82",45,47,92
"17813","KISUMU","MUHORONI","83",52,58,110
"17814","KISUMU","MUHORONI","84",45,60,105
"17815","KISUMU","MUHORONI","80-84",282,384,666
"17816","KISUMU","MUHORONI","85",29,61,90
"17817","KISUMU","MUHORONI","86",20,23,43
"17818","KISUMU","MUHORONI","87",45,46,91
"17819","KISUMU","MUHORONI","88",13,31,44
"17820","KISUMU","MUHORONI","89",25,58,83
"17821","KISUMU","MUHORONI","85-89",132,219,351
"17822","KISUMU","MUHORONI","90",16,27,43
"17823","KISUMU","MUHORONI","91",11,14,25
"17824","KISUMU","MUHORONI","92",13,15,28
"17825","KISUMU","MUHORONI","93",9,8,17
"17826","KISUMU","MUHORONI","94",7,7,14
"17827","KISUMU","MUHORONI","90-94",56,71,127
"17828","KISUMU","MUHORONI","95",3,8,11
"17829","KISUMU","MUHORONI","96",5,10,15
"17830","KISUMU","MUHORONI","97",2,4,6
"17831","KISUMU","MUHORONI","98",1,4,5
"17832","KISUMU","MUHORONI","99",3,6,9
"17833","KISUMU","MUHORONI","95-99",14,32,46
"17834","KISUMU","MUHORONI","100+",4,11,15
"17835","KISUMU","MUHORONI","Not Stated",2,1,3
"17836","KISUMU","NYANDO","Total",77121,84380,161501
"17837","KISUMU","NYANDO","0",1902,1847,3749
"17838","KISUMU","NYANDO","1",1922,1851,3773
"17839","KISUMU","NYANDO","2",1891,1974,3865
"17840","KISUMU","NYANDO","3",2046,2032,4078
"17841","KISUMU","NYANDO","4",1894,2018,3912
"17842","KISUMU","NYANDO","0 - 4",9655,9722,19377
"17843","KISUMU","NYANDO","5",2148,2085,4233
"17844","KISUMU","NYANDO","6",2189,2106,4295
"17845","KISUMU","NYANDO","7",2217,2217,4434
"17846","KISUMU","NYANDO","8",2161,2059,4220
"17847","KISUMU","NYANDO","9",2352,2376,4728
"17848","KISUMU","NYANDO","5-9",11067,10843,21910
"17849","KISUMU","NYANDO","10",2647,2571,5218
"17850","KISUMU","NYANDO","11",2354,2467,4821
"17851","KISUMU","NYANDO","12",2857,2699,5556
"17852","KISUMU","NYANDO","13",2650,2550,5200
"17853","KISUMU","NYANDO","14",2357,2387,4744
"17854","KISUMU","NYANDO","10 -14",12865,12674,25539
"17855","KISUMU","NYANDO","15",2415,2474,4889
"17856","KISUMU","NYANDO","16",2003,2096,4099
"17857","KISUMU","NYANDO","17",2175,2114,4289
"17858","KISUMU","NYANDO","18",1608,1576,3184
"17859","KISUMU","NYANDO","19",1801,1820,3621
"17860","KISUMU","NYANDO","15-19",10002,10080,20082
"17861","KISUMU","NYANDO","20",1508,1815,3323
"17862","KISUMU","NYANDO","21",1280,1570,2850
"17863","KISUMU","NYANDO","22",1192,1490,2682
"17864","KISUMU","NYANDO","23",1234,1494,2728
"17865","KISUMU","NYANDO","24",1111,1329,2440
"17866","KISUMU","NYANDO","20-24",6325,7698,14023
"17867","KISUMU","NYANDO","25",1292,1531,2823
"17868","KISUMU","NYANDO","26",1063,1303,2366
"17869","KISUMU","NYANDO","27",1161,1360,2521
"17870","KISUMU","NYANDO","28",758,962,1720
"17871","KISUMU","NYANDO","29",770,1087,1857
"17872","KISUMU","NYANDO","25-29",5044,6243,11287
"17873","KISUMU","NYANDO","30",1177,1499,2676
"17874","KISUMU","NYANDO","31",807,1058,1865
"17875","KISUMU","NYANDO","32",1062,1456,2518
"17876","KISUMU","NYANDO","33",885,1314,2199
"17877","KISUMU","NYANDO","34",855,1124,1979
"17878","KISUMU","NYANDO","30-34",4786,6451,11237
"17879","KISUMU","NYANDO","35",1050,1187,2237
"17880","KISUMU","NYANDO","36",730,729,1459
"17881","KISUMU","NYANDO","37",875,743,1618
"17882","KISUMU","NYANDO","38",543,476,1019
"17883","KISUMU","NYANDO","39",671,593,1264
"17884","KISUMU","NYANDO","35-39",3869,3728,7597
"17885","KISUMU","NYANDO","40",890,838,1728
"17886","KISUMU","NYANDO","41",700,647,1347
"17887","KISUMU","NYANDO","42",686,582,1268
"17888","KISUMU","NYANDO","43",574,767,1341
"17889","KISUMU","NYANDO","44",486,503,989
"17890","KISUMU","NYANDO","40-44",3336,3337,6673
"17891","KISUMU","NYANDO","45",589,641,1230
"17892","KISUMU","NYANDO","46",484,461,945
"17893","KISUMU","NYANDO","47",474,509,983
"17894","KISUMU","NYANDO","48",258,310,568
"17895","KISUMU","NYANDO","49",307,360,667
"17896","KISUMU","NYANDO","45-49",2112,2281,4393
"17897","KISUMU","NYANDO","50",437,671,1108
"17898","KISUMU","NYANDO","51",444,648,1092
"17899","KISUMU","NYANDO","52",290,428,718
"17900","KISUMU","NYANDO","53",242,341,583
"17901","KISUMU","NYANDO","54",270,315,585
"17902","KISUMU","NYANDO","50-54",1683,2403,4086
"17903","KISUMU","NYANDO","55",323,401,724
"17904","KISUMU","NYANDO","56",276,506,782
"17905","KISUMU","NYANDO","57",377,672,1049
"17906","KISUMU","NYANDO","58",274,334,608
"17907","KISUMU","NYANDO","59",334,421,755
"17908","KISUMU","NYANDO","55-59",1584,2334,3918
"17909","KISUMU","NYANDO","60",409,621,1030
"17910","KISUMU","NYANDO","61",377,434,811
"17911","KISUMU","NYANDO","62",260,326,586
"17912","KISUMU","NYANDO","63",277,379,656
"17913","KISUMU","NYANDO","64",245,289,534
"17914","KISUMU","NYANDO","60-64",1568,2049,3617
"17915","KISUMU","NYANDO","65",339,452,791
"17916","KISUMU","NYANDO","66",198,284,482
"17917","KISUMU","NYANDO","67",310,493,803
"17918","KISUMU","NYANDO","68",137,156,293
"17919","KISUMU","NYANDO","69",242,227,469
"17920","KISUMU","NYANDO","65-69",1226,1612,2838
"17921","KISUMU","NYANDO","70",309,470,779
"17922","KISUMU","NYANDO","71",210,220,430
"17923","KISUMU","NYANDO","72",152,160,312
"17924","KISUMU","NYANDO","73",155,145,300
"17925","KISUMU","NYANDO","74",122,190,312
"17926","KISUMU","NYANDO","70-74",948,1185,2133
"17927","KISUMU","NYANDO","75",119,166,285
"17928","KISUMU","NYANDO","76",103,161,264
"17929","KISUMU","NYANDO","77",112,169,281
"17930","KISUMU","NYANDO","78",48,79,127
"17931","KISUMU","NYANDO","79",64,169,233
"17932","KISUMU","NYANDO","75-79",446,744,1190
"17933","KISUMU","NYANDO","80",130,196,326
"17934","KISUMU","NYANDO","81",61,108,169
"17935","KISUMU","NYANDO","82",53,60,113
"17936","KISUMU","NYANDO","83",75,76,151
"17937","KISUMU","NYANDO","84",48,82,130
"17938","KISUMU","NYANDO","80-84",367,522,889
"17939","KISUMU","NYANDO","85",42,81,123
"17940","KISUMU","NYANDO","86",39,31,70
"17941","KISUMU","NYANDO","87",44,70,114
"17942","KISUMU","NYANDO","88",14,38,52
"17943","KISUMU","NYANDO","89",25,80,105
"17944","KISUMU","NYANDO","85-89",164,300,464
"17945","KISUMU","NYANDO","90",13,56,69
"17946","KISUMU","NYANDO","91",9,28,37
"17947","KISUMU","NYANDO","92",8,14,22
"17948","KISUMU","NYANDO","93",6,14,20
"17949","KISUMU","NYANDO","94",8,7,15
"17950","KISUMU","NYANDO","90-94",44,119,163
"17951","KISUMU","NYANDO","95",5,10,15
"17952","KISUMU","NYANDO","96",4,11,15
"17953","KISUMU","NYANDO","97",4,6,10
"17954","KISUMU","NYANDO","98",3,7,10
"17955","KISUMU","NYANDO","99",4,6,10
"17956","KISUMU","NYANDO","95-99",20,40,60
"17957","KISUMU","NYANDO","100+",8,13,21
"17958","KISUMU","NYANDO","Not Stated",2,2,4
"17959","KISUMU","NYAKACH","Total",71237,79082,150319
"17960","KISUMU","NYAKACH","0",1650,1610,3260
"17961","KISUMU","NYAKACH","1",1765,1675,3440
"17962","KISUMU","NYAKACH","2",1771,1917,3688
"17963","KISUMU","NYAKACH","3",1923,1917,3840
"17964","KISUMU","NYAKACH","4",1936,2034,3970
"17965","KISUMU","NYAKACH","0 - 4",9045,9153,18198
"17966","KISUMU","NYAKACH","5",2122,1995,4117
"17967","KISUMU","NYAKACH","6",2157,2160,4317
"17968","KISUMU","NYAKACH","7",1974,2053,4027
"17969","KISUMU","NYAKACH","8",1959,2010,3969
"17970","KISUMU","NYAKACH","9",2332,2273,4605
"17971","KISUMU","NYAKACH","5-9",10544,10491,21035
"17972","KISUMU","NYAKACH","10",2556,2346,4902
"17973","KISUMU","NYAKACH","11",2266,2265,4531
"17974","KISUMU","NYAKACH","12",2615,2492,5107
"17975","KISUMU","NYAKACH","13",2546,2556,5102
"17976","KISUMU","NYAKACH","14",2270,2315,4585
"17977","KISUMU","NYAKACH","10 -14",12253,11974,24227
"17978","KISUMU","NYAKACH","15",2291,2298,4589
"17979","KISUMU","NYAKACH","16",1991,2026,4017
"17980","KISUMU","NYAKACH","17",2152,1903,4055
"17981","KISUMU","NYAKACH","18",1663,1522,3185
"17982","KISUMU","NYAKACH","19",1661,1613,3274
"17983","KISUMU","NYAKACH","15-19",9758,9362,19120
"17984","KISUMU","NYAKACH","20",1435,1546,2981
"17985","KISUMU","NYAKACH","21",1226,1350,2576
"17986","KISUMU","NYAKACH","22",1013,1158,2171
"17987","KISUMU","NYAKACH","23",1029,1261,2290
"17988","KISUMU","NYAKACH","24",876,1117,1993
"17989","KISUMU","NYAKACH","20-24",5579,6432,12011
"17990","KISUMU","NYAKACH","25",1041,1276,2317
"17991","KISUMU","NYAKACH","26",798,1054,1852
"17992","KISUMU","NYAKACH","27",844,1158,2002
"17993","KISUMU","NYAKACH","28",608,855,1463
"17994","KISUMU","NYAKACH","29",635,988,1623
"17995","KISUMU","NYAKACH","25-29",3926,5331,9257
"17996","KISUMU","NYAKACH","30",944,1545,2489
"17997","KISUMU","NYAKACH","31",669,890,1559
"17998","KISUMU","NYAKACH","32",789,1130,1919
"17999","KISUMU","NYAKACH","33",707,927,1634
"18000","KISUMU","NYAKACH","34",687,914,1601
"18001","KISUMU","NYAKACH","30-34",3796,5406,9202
"18002","KISUMU","NYAKACH","35",879,1043,1922
"18003","KISUMU","NYAKACH","36",615,618,1233
"18004","KISUMU","NYAKACH","37",745,672,1417
"18005","KISUMU","NYAKACH","38",433,439,872
"18006","KISUMU","NYAKACH","39",564,555,1119
"18007","KISUMU","NYAKACH","35-39",3236,3327,6563
"18008","KISUMU","NYAKACH","40",724,757,1481
"18009","KISUMU","NYAKACH","41",668,643,1311
"18010","KISUMU","NYAKACH","42",556,556,1112
"18011","KISUMU","NYAKACH","43",570,685,1255
"18012","KISUMU","NYAKACH","44",446,547,993
"18013","KISUMU","NYAKACH","40-44",2964,3188,6152
"18014","KISUMU","NYAKACH","45",546,741,1287
"18015","KISUMU","NYAKACH","46",406,472,878
"18016","KISUMU","NYAKACH","47",424,540,964
"18017","KISUMU","NYAKACH","48",253,333,586
"18018","KISUMU","NYAKACH","49",286,384,670
"18019","KISUMU","NYAKACH","45-49",1915,2470,4385
"18020","KISUMU","NYAKACH","50",389,595,984
"18021","KISUMU","NYAKACH","51",359,536,895
"18022","KISUMU","NYAKACH","52",268,378,646
"18023","KISUMU","NYAKACH","53",237,329,566
"18024","KISUMU","NYAKACH","54",292,378,670
"18025","KISUMU","NYAKACH","50-54",1545,2216,3761
"18026","KISUMU","NYAKACH","55",329,387,716
"18027","KISUMU","NYAKACH","56",323,481,804
"18028","KISUMU","NYAKACH","57",334,615,949
"18029","KISUMU","NYAKACH","58",238,356,594
"18030","KISUMU","NYAKACH","59",294,452,746
"18031","KISUMU","NYAKACH","55-59",1518,2291,3809
"18032","KISUMU","NYAKACH","60",376,701,1077
"18033","KISUMU","NYAKACH","61",314,498,812
"18034","KISUMU","NYAKACH","62",274,368,642
"18035","KISUMU","NYAKACH","63",294,390,684
"18036","KISUMU","NYAKACH","64",215,298,513
"18037","KISUMU","NYAKACH","60-64",1473,2255,3728
"18038","KISUMU","NYAKACH","65",336,487,823
"18039","KISUMU","NYAKACH","66",211,327,538
"18040","KISUMU","NYAKACH","67",369,491,860
"18041","KISUMU","NYAKACH","68",130,184,314
"18042","KISUMU","NYAKACH","69",240,294,534
"18043","KISUMU","NYAKACH","65-69",1286,1783,3069
"18044","KISUMU","NYAKACH","70",348,516,864
"18045","KISUMU","NYAKACH","71",273,257,530
"18046","KISUMU","NYAKACH","72",215,236,451
"18047","KISUMU","NYAKACH","73",172,188,360
"18048","KISUMU","NYAKACH","74",157,214,371
"18049","KISUMU","NYAKACH","70-74",1165,1411,2576
"18050","KISUMU","NYAKACH","75",131,193,324
"18051","KISUMU","NYAKACH","76",120,146,266
"18052","KISUMU","NYAKACH","77",126,184,310
"18053","KISUMU","NYAKACH","78",69,85,154
"18054","KISUMU","NYAKACH","79",90,173,263
"18055","KISUMU","NYAKACH","75-79",536,781,1317
"18056","KISUMU","NYAKACH","80",108,237,345
"18057","KISUMU","NYAKACH","81",69,107,176
"18058","KISUMU","NYAKACH","82",67,93,160
"18059","KISUMU","NYAKACH","83",69,90,159
"18060","KISUMU","NYAKACH","84",73,94,167
"18061","KISUMU","NYAKACH","80-84",386,621,1007
"18062","KISUMU","NYAKACH","85",46,83,129
"18063","KISUMU","NYAKACH","86",41,46,87
"18064","KISUMU","NYAKACH","87",50,87,137
"18065","KISUMU","NYAKACH","88",21,32,53
"18066","KISUMU","NYAKACH","89",32,103,135
"18067","KISUMU","NYAKACH","85-89",190,351,541
"18068","KISUMU","NYAKACH","90",24,57,81
"18069","KISUMU","NYAKACH","91",17,30,47
"18070","KISUMU","NYAKACH","92",16,19,35
"18071","KISUMU","NYAKACH","93",13,19,32
"18072","KISUMU","NYAKACH","94",8,14,22
"18073","KISUMU","NYAKACH","90-94",78,139,217
"18074","KISUMU","NYAKACH","95",15,16,31
"18075","KISUMU","NYAKACH","96",2,13,15
"18076","KISUMU","NYAKACH","97",4,10,14
"18077","KISUMU","NYAKACH","98",6,9,15
"18078","KISUMU","NYAKACH","99",4,23,27
"18079","KISUMU","NYAKACH","95-99",31,71,102
"18080","KISUMU","NYAKACH","100+",12,28,40
"18081","KISUMU","NYAKACH","Not Stated",1,1,2
"18082","KITUI","ALL","Total",549003,587151,1136154
"18083","KITUI","ALL","0",11522,11378,22900
"18084","KITUI","ALL","1",12622,12372,24994
"18085","KITUI","ALL","2",12778,12696,25474
"18086","KITUI","ALL","3",13214,13095,26309
"18087","KITUI","ALL","4",13436,13077,26513
"18088","KITUI","ALL","0 - 4",63572,62618,126190
"18089","KITUI","ALL","5",14125,13808,27933
"18090","KITUI","ALL","6",14179,13945,28124
"18091","KITUI","ALL","7",13599,13295,26894
"18092","KITUI","ALL","8",15343,15118,30461
"18093","KITUI","ALL","9",15761,15299,31060
"18094","KITUI","ALL","5-9",73007,71465,144472
"18095","KITUI","ALL","10",16734,16201,32935
"18096","KITUI","ALL","11",17057,17687,34744
"18097","KITUI","ALL","12",18535,17215,35750
"18098","KITUI","ALL","13",17838,17513,35351
"18099","KITUI","ALL","14",17560,17106,34666
"18100","KITUI","ALL","10 -14",87724,85722,173446
"18101","KITUI","ALL","15",17786,17159,34945
"18102","KITUI","ALL","16",16926,16661,33587
"18103","KITUI","ALL","17",16725,15746,32471
"18104","KITUI","ALL","18",12815,11867,24682
"18105","KITUI","ALL","19",13293,12170,25463
"18106","KITUI","ALL","15-19",77545,73603,151148
"18107","KITUI","ALL","20",11354,11057,22411
"18108","KITUI","ALL","21",9090,9347,18437
"18109","KITUI","ALL","22",7845,8414,16259
"18110","KITUI","ALL","23",7840,9064,16904
"18111","KITUI","ALL","24",6859,7850,14709
"18112","KITUI","ALL","20-24",42988,45732,88720
"18113","KITUI","ALL","25",7857,8534,16391
"18114","KITUI","ALL","26",5661,6847,12508
"18115","KITUI","ALL","27",6430,7066,13496
"18116","KITUI","ALL","28",5152,6196,11348
"18117","KITUI","ALL","29",6175,7591,13766
"18118","KITUI","ALL","25-29",31275,36234,67509
"18119","KITUI","ALL","30",7097,9085,16182
"18120","KITUI","ALL","31",5582,6685,12267
"18121","KITUI","ALL","32",6510,8280,14790
"18122","KITUI","ALL","33",5977,7748,13725
"18123","KITUI","ALL","34",5081,6646,11727
"18124","KITUI","ALL","30-34",30247,38444,68691
"18125","KITUI","ALL","35",6899,8505,15404
"18126","KITUI","ALL","36",4680,5701,10381
"18127","KITUI","ALL","37",5372,5937,11309
"18128","KITUI","ALL","38",3729,4534,8263
"18129","KITUI","ALL","39",5326,5995,11321
"18130","KITUI","ALL","35-39",26006,30672,56678
"18131","KITUI","ALL","40",5271,5825,11096
"18132","KITUI","ALL","41",5457,5758,11215
"18133","KITUI","ALL","42",4593,5232,9825
"18134","KITUI","ALL","43",4283,5420,9703
"18135","KITUI","ALL","44",4157,5348,9505
"18136","KITUI","ALL","40-44",23761,27583,51344
"18137","KITUI","ALL","45",6177,7417,13594
"18138","KITUI","ALL","46",4337,4988,9325
"18139","KITUI","ALL","47",4236,4966,9202
"18140","KITUI","ALL","48",3060,3563,6623
"18141","KITUI","ALL","49",4073,4835,8908
"18142","KITUI","ALL","45-49",21883,25769,47652
"18143","KITUI","ALL","50",3930,4964,8894
"18144","KITUI","ALL","51",3604,4350,7954
"18145","KITUI","ALL","52",2885,3210,6095
"18146","KITUI","ALL","53",2207,2469,4676
"18147","KITUI","ALL","54",3091,3109,6200
"18148","KITUI","ALL","50-54",15717,18102,33819
"18149","KITUI","ALL","55",3231,3113,6344
"18150","KITUI","ALL","56",3481,3612,7093
"18151","KITUI","ALL","57",2591,3098,5689
"18152","KITUI","ALL","58",1838,2484,4322
"18153","KITUI","ALL","59",2635,3621,6256
"18154","KITUI","ALL","55-59",13776,15928,29704
"18155","KITUI","ALL","60",3176,3872,7048
"18156","KITUI","ALL","61",2532,2993,5525
"18157","KITUI","ALL","62",2051,2207,4258
"18158","KITUI","ALL","63",2093,2437,4530
"18159","KITUI","ALL","64",1680,1963,3643
"18160","KITUI","ALL","60-64",11532,13472,25004
"18161","KITUI","ALL","65",2401,2884,5285
"18162","KITUI","ALL","66",1687,1692,3379
"18163","KITUI","ALL","67",2828,3116,5944
"18164","KITUI","ALL","68",1371,1597,2968
"18165","KITUI","ALL","69",1922,3129,5051
"18166","KITUI","ALL","65-69",10209,12418,22627
"18167","KITUI","ALL","70",2337,3765,6102
"18168","KITUI","ALL","71",1650,2114,3764
"18169","KITUI","ALL","72",1165,1418,2583
"18170","KITUI","ALL","73",1392,2511,3903
"18171","KITUI","ALL","74",1161,1943,3104
"18172","KITUI","ALL","70-74",7705,11751,19456
"18173","KITUI","ALL","75",1165,1479,2644
"18174","KITUI","ALL","76",756,939,1695
"18175","KITUI","ALL","77",930,1105,2035
"18176","KITUI","ALL","78",767,684,1451
"18177","KITUI","ALL","79",931,1763,2694
"18178","KITUI","ALL","75-79",4549,5970,10519
"18179","KITUI","ALL","80",1132,1938,3070
"18180","KITUI","ALL","81",604,873,1477
"18181","KITUI","ALL","82",537,479,1016
"18182","KITUI","ALL","83",595,771,1366
"18183","KITUI","ALL","84",723,1264,1987
"18184","KITUI","ALL","80-84",3591,5325,8916
"18185","KITUI","ALL","85",458,623,1081
"18186","KITUI","ALL","86",341,251,592
"18187","KITUI","ALL","87",381,463,844
"18188","KITUI","ALL","88",198,215,413
"18189","KITUI","ALL","89",498,1052,1550
"18190","KITUI","ALL","85-89",1876,2604,4480
"18191","KITUI","ALL","90",440,934,1374
"18192","KITUI","ALL","91",279,698,977
"18193","KITUI","ALL","92",201,292,493
"18194","KITUI","ALL","93",131,223,354
"18195","KITUI","ALL","94",155,225,380
"18196","KITUI","ALL","90-94",1206,2372,3578
"18197","KITUI","ALL","95",168,303,471
"18198","KITUI","ALL","96",72,96,168
"18199","KITUI","ALL","97",112,84,196
"18200","KITUI","ALL","98",60,106,166
"18201","KITUI","ALL","99",146,291,437
"18202","KITUI","ALL","95-99",558,880,1438
"18203","KITUI","ALL","100+",272,481,753
"18204","KITUI","ALL","Not Stated",4,6,10
"18205","KITUI","IKUTHA","Total",39986,42976,82962
"18206","KITUI","IKUTHA","0",755,816,1571
"18207","KITUI","IKUTHA","1",857,852,1709
"18208","KITUI","IKUTHA","2",826,799,1625
"18209","KITUI","IKUTHA","3",882,920,1802
"18210","KITUI","IKUTHA","4",1005,971,1976
"18211","KITUI","IKUTHA","0 - 4",4325,4358,8683
"18212","KITUI","IKUTHA","5",1094,1058,2152
"18213","KITUI","IKUTHA","6",1144,1094,2238
"18214","KITUI","IKUTHA","7",1091,1080,2171
"18215","KITUI","IKUTHA","8",1387,1335,2722
"18216","KITUI","IKUTHA","9",1381,1257,2638
"18217","KITUI","IKUTHA","5-9",6097,5824,11921
"18218","KITUI","IKUTHA","10",1393,1303,2696
"18219","KITUI","IKUTHA","11",1404,1508,2912
"18220","KITUI","IKUTHA","12",1609,1517,3126
"18221","KITUI","IKUTHA","13",1487,1410,2897
"18222","KITUI","IKUTHA","14",1378,1323,2701
"18223","KITUI","IKUTHA","10 -14",7271,7061,14332
"18224","KITUI","IKUTHA","15",1444,1414,2858
"18225","KITUI","IKUTHA","16",1446,1382,2828
"18226","KITUI","IKUTHA","17",1339,1307,2646
"18227","KITUI","IKUTHA","18",1057,960,2017
"18228","KITUI","IKUTHA","19",990,915,1905
"18229","KITUI","IKUTHA","15-19",6276,5978,12254
"18230","KITUI","IKUTHA","20",865,811,1676
"18231","KITUI","IKUTHA","21",672,632,1304
"18232","KITUI","IKUTHA","22",454,477,931
"18233","KITUI","IKUTHA","23",454,522,976
"18234","KITUI","IKUTHA","24",404,483,887
"18235","KITUI","IKUTHA","20-24",2849,2925,5774
"18236","KITUI","IKUTHA","25",470,502,972
"18237","KITUI","IKUTHA","26",297,412,709
"18238","KITUI","IKUTHA","27",354,414,768
"18239","KITUI","IKUTHA","28",300,378,678
"18240","KITUI","IKUTHA","29",381,479,860
"18241","KITUI","IKUTHA","25-29",1802,2185,3987
"18242","KITUI","IKUTHA","30",411,635,1046
"18243","KITUI","IKUTHA","31",377,435,812
"18244","KITUI","IKUTHA","32",415,548,963
"18245","KITUI","IKUTHA","33",388,553,941
"18246","KITUI","IKUTHA","34",332,417,749
"18247","KITUI","IKUTHA","30-34",1923,2588,4511
"18248","KITUI","IKUTHA","35",459,582,1041
"18249","KITUI","IKUTHA","36",287,433,720
"18250","KITUI","IKUTHA","37",309,465,774
"18251","KITUI","IKUTHA","38",201,274,475
"18252","KITUI","IKUTHA","39",337,485,822
"18253","KITUI","IKUTHA","35-39",1593,2239,3832
"18254","KITUI","IKUTHA","40",293,341,634
"18255","KITUI","IKUTHA","41",362,426,788
"18256","KITUI","IKUTHA","42",322,315,637
"18257","KITUI","IKUTHA","43",286,393,679
"18258","KITUI","IKUTHA","44",251,364,615
"18259","KITUI","IKUTHA","40-44",1514,1839,3353
"18260","KITUI","IKUTHA","45",440,509,949
"18261","KITUI","IKUTHA","46",285,378,663
"18262","KITUI","IKUTHA","47",338,415,753
"18263","KITUI","IKUTHA","48",231,262,493
"18264","KITUI","IKUTHA","49",286,411,697
"18265","KITUI","IKUTHA","45-49",1580,1975,3555
"18266","KITUI","IKUTHA","50",271,375,646
"18267","KITUI","IKUTHA","51",229,258,487
"18268","KITUI","IKUTHA","52",189,206,395
"18269","KITUI","IKUTHA","53",166,112,278
"18270","KITUI","IKUTHA","54",248,173,421
"18271","KITUI","IKUTHA","50-54",1103,1124,2227
"18272","KITUI","IKUTHA","55",189,155,344
"18273","KITUI","IKUTHA","56",216,242,458
"18274","KITUI","IKUTHA","57",153,218,371
"18275","KITUI","IKUTHA","58",115,199,314
"18276","KITUI","IKUTHA","59",171,242,413
"18277","KITUI","IKUTHA","55-59",844,1056,1900
"18278","KITUI","IKUTHA","60",168,263,431
"18279","KITUI","IKUTHA","61",158,226,384
"18280","KITUI","IKUTHA","62",132,150,282
"18281","KITUI","IKUTHA","63",152,190,342
"18282","KITUI","IKUTHA","64",124,140,264
"18283","KITUI","IKUTHA","60-64",734,969,1703
"18284","KITUI","IKUTHA","65",164,208,372
"18285","KITUI","IKUTHA","66",112,133,245
"18286","KITUI","IKUTHA","67",234,231,465
"18287","KITUI","IKUTHA","68",101,80,181
"18288","KITUI","IKUTHA","69",128,174,302
"18289","KITUI","IKUTHA","65-69",739,826,1565
"18290","KITUI","IKUTHA","70",136,178,314
"18291","KITUI","IKUTHA","71",116,137,253
"18292","KITUI","IKUTHA","72",71,109,180
"18293","KITUI","IKUTHA","73",113,290,403
"18294","KITUI","IKUTHA","74",74,125,199
"18295","KITUI","IKUTHA","70-74",510,839,1349
"18296","KITUI","IKUTHA","75",71,107,178
"18297","KITUI","IKUTHA","76",60,70,130
"18298","KITUI","IKUTHA","77",73,61,134
"18299","KITUI","IKUTHA","78",53,46,99
"18300","KITUI","IKUTHA","79",67,95,162
"18301","KITUI","IKUTHA","75-79",324,379,703
"18302","KITUI","IKUTHA","80",72,90,162
"18303","KITUI","IKUTHA","81",35,43,78
"18304","KITUI","IKUTHA","82",37,26,63
"18305","KITUI","IKUTHA","83",40,43,83
"18306","KITUI","IKUTHA","84",52,164,216
"18307","KITUI","IKUTHA","80-84",236,366,602
"18308","KITUI","IKUTHA","85",30,42,72
"18309","KITUI","IKUTHA","86",17,8,25
"18310","KITUI","IKUTHA","87",30,21,51
"18311","KITUI","IKUTHA","88",15,11,26
"18312","KITUI","IKUTHA","89",31,62,93
"18313","KITUI","IKUTHA","85-89",123,144,267
"18314","KITUI","IKUTHA","90",23,66,89
"18315","KITUI","IKUTHA","91",21,60,81
"18316","KITUI","IKUTHA","92",13,21,34
"18317","KITUI","IKUTHA","93",16,30,46
"18318","KITUI","IKUTHA","94",13,23,36
"18319","KITUI","IKUTHA","90-94",86,200,286
"18320","KITUI","IKUTHA","95",9,16,25
"18321","KITUI","IKUTHA","96",3,11,14
"18322","KITUI","IKUTHA","97",8,10,18
"18323","KITUI","IKUTHA","98",2,5,7
"18324","KITUI","IKUTHA","99",15,22,37
"18325","KITUI","IKUTHA","95-99",37,64,101
"18326","KITUI","IKUTHA","100+",18,37,55
"18327","KITUI","IKUTHA","Not Stated",2,NA,2
"18328","KITUI","KATULANI","Total",23150,23957,47107
"18329","KITUI","KATULANI","0",369,404,773
"18330","KITUI","KATULANI","1",473,475,948
"18331","KITUI","KATULANI","2",441,424,865
"18332","KITUI","KATULANI","3",452,470,922
"18333","KITUI","KATULANI","4",463,442,905
"18334","KITUI","KATULANI","0 - 4",2198,2215,4413
"18335","KITUI","KATULANI","5",511,410,921
"18336","KITUI","KATULANI","6",463,445,908
"18337","KITUI","KATULANI","7",486,454,940
"18338","KITUI","KATULANI","8",503,498,1001
"18339","KITUI","KATULANI","9",584,514,1098
"18340","KITUI","KATULANI","5-9",2547,2321,4868
"18341","KITUI","KATULANI","10",634,626,1260
"18342","KITUI","KATULANI","11",650,672,1322
"18343","KITUI","KATULANI","12",718,721,1439
"18344","KITUI","KATULANI","13",656,690,1346
"18345","KITUI","KATULANI","14",740,681,1421
"18346","KITUI","KATULANI","10 -14",3398,3390,6788
"18347","KITUI","KATULANI","15",678,671,1349
"18348","KITUI","KATULANI","16",719,682,1401
"18349","KITUI","KATULANI","17",720,643,1363
"18350","KITUI","KATULANI","18",528,453,981
"18351","KITUI","KATULANI","19",625,527,1152
"18352","KITUI","KATULANI","15-19",3270,2976,6246
"18353","KITUI","KATULANI","20",526,446,972
"18354","KITUI","KATULANI","21",428,341,769
"18355","KITUI","KATULANI","22",383,279,662
"18356","KITUI","KATULANI","23",363,328,691
"18357","KITUI","KATULANI","24",307,309,616
"18358","KITUI","KATULANI","20-24",2007,1703,3710
"18359","KITUI","KATULANI","25",368,309,677
"18360","KITUI","KATULANI","26",270,276,546
"18361","KITUI","KATULANI","27",279,279,558
"18362","KITUI","KATULANI","28",211,232,443
"18363","KITUI","KATULANI","29",284,273,557
"18364","KITUI","KATULANI","25-29",1412,1369,2781
"18365","KITUI","KATULANI","30",310,306,616
"18366","KITUI","KATULANI","31",239,251,490
"18367","KITUI","KATULANI","32",307,357,664
"18368","KITUI","KATULANI","33",264,330,594
"18369","KITUI","KATULANI","34",230,290,520
"18370","KITUI","KATULANI","30-34",1350,1534,2884
"18371","KITUI","KATULANI","35",311,375,686
"18372","KITUI","KATULANI","36",209,268,477
"18373","KITUI","KATULANI","37",272,279,551
"18374","KITUI","KATULANI","38",188,238,426
"18375","KITUI","KATULANI","39",272,300,572
"18376","KITUI","KATULANI","35-39",1252,1460,2712
"18377","KITUI","KATULANI","40",281,294,575
"18378","KITUI","KATULANI","41",260,280,540
"18379","KITUI","KATULANI","42",219,246,465
"18380","KITUI","KATULANI","43",204,245,449
"18381","KITUI","KATULANI","44",210,261,471
"18382","KITUI","KATULANI","40-44",1174,1326,2500
"18383","KITUI","KATULANI","45",334,340,674
"18384","KITUI","KATULANI","46",185,207,392
"18385","KITUI","KATULANI","47",209,229,438
"18386","KITUI","KATULANI","48",145,167,312
"18387","KITUI","KATULANI","49",218,222,440
"18388","KITUI","KATULANI","45-49",1091,1165,2256
"18389","KITUI","KATULANI","50",187,242,429
"18390","KITUI","KATULANI","51",177,212,389
"18391","KITUI","KATULANI","52",141,164,305
"18392","KITUI","KATULANI","53",117,134,251
"18393","KITUI","KATULANI","54",131,142,273
"18394","KITUI","KATULANI","50-54",753,894,1647
"18395","KITUI","KATULANI","55",174,144,318
"18396","KITUI","KATULANI","56",145,170,315
"18397","KITUI","KATULANI","57",128,149,277
"18398","KITUI","KATULANI","58",84,140,224
"18399","KITUI","KATULANI","59",132,187,319
"18400","KITUI","KATULANI","55-59",663,790,1453
"18401","KITUI","KATULANI","60",159,203,362
"18402","KITUI","KATULANI","61",94,145,239
"18403","KITUI","KATULANI","62",97,99,196
"18404","KITUI","KATULANI","63",118,102,220
"18405","KITUI","KATULANI","64",92,79,171
"18406","KITUI","KATULANI","60-64",560,628,1188
"18407","KITUI","KATULANI","65",106,123,229
"18408","KITUI","KATULANI","66",75,77,152
"18409","KITUI","KATULANI","67",138,164,302
"18410","KITUI","KATULANI","68",74,77,151
"18411","KITUI","KATULANI","69",104,162,266
"18412","KITUI","KATULANI","65-69",497,603,1100
"18413","KITUI","KATULANI","70",123,194,317
"18414","KITUI","KATULANI","71",75,121,196
"18415","KITUI","KATULANI","72",59,58,117
"18416","KITUI","KATULANI","73",67,136,203
"18417","KITUI","KATULANI","74",39,73,112
"18418","KITUI","KATULANI","70-74",363,582,945
"18419","KITUI","KATULANI","75",55,65,120
"18420","KITUI","KATULANI","76",40,48,88
"18421","KITUI","KATULANI","77",52,65,117
"18422","KITUI","KATULANI","78",39,43,82
"18423","KITUI","KATULANI","79",41,116,157
"18424","KITUI","KATULANI","75-79",227,337,564
"18425","KITUI","KATULANI","80",65,98,163
"18426","KITUI","KATULANI","81",37,55,92
"18427","KITUI","KATULANI","82",35,18,53
"18428","KITUI","KATULANI","83",32,64,96
"18429","KITUI","KATULANI","84",35,63,98
"18430","KITUI","KATULANI","80-84",204,298,502
"18431","KITUI","KATULANI","85",22,36,58
"18432","KITUI","KATULANI","86",18,12,30
"18433","KITUI","KATULANI","87",10,22,32
"18434","KITUI","KATULANI","88",9,13,22
"18435","KITUI","KATULANI","89",23,70,93
"18436","KITUI","KATULANI","85-89",82,153,235
"18437","KITUI","KATULANI","90",18,33,51
"18438","KITUI","KATULANI","91",14,67,81
"18439","KITUI","KATULANI","92",11,10,21
"18440","KITUI","KATULANI","93",6,16,22
"18441","KITUI","KATULANI","94",5,7,12
"18442","KITUI","KATULANI","90-94",54,133,187
"18443","KITUI","KATULANI","95",5,18,23
"18444","KITUI","KATULANI","96",7,8,15
"18445","KITUI","KATULANI","97",6,8,14
"18446","KITUI","KATULANI","98",8,7,15
"18447","KITUI","KATULANI","99",4,18,22
"18448","KITUI","KATULANI","95-99",30,59,89
"18449","KITUI","KATULANI","100+",18,21,39
"18450","KITUI","KATULANI","Not Stated",NA,NA,NA
"18451","KITUI","KISASI","Total",22646,23496,46142
"18452","KITUI","KISASI","0",392,343,735
"18453","KITUI","KISASI","1",561,539,1100
"18454","KITUI","KISASI","2",472,470,942
"18455","KITUI","KISASI","3",505,493,998
"18456","KITUI","KISASI","4",506,491,997
"18457","KITUI","KISASI","0 - 4",2436,2336,4772
"18458","KITUI","KISASI","5",550,554,1104
"18459","KITUI","KISASI","6",458,465,923
"18460","KITUI","KISASI","7",505,440,945
"18461","KITUI","KISASI","8",535,568,1103
"18462","KITUI","KISASI","9",606,586,1192
"18463","KITUI","KISASI","5-9",2654,2613,5267
"18464","KITUI","KISASI","10",675,642,1317
"18465","KITUI","KISASI","11",719,632,1351
"18466","KITUI","KISASI","12",727,659,1386
"18467","KITUI","KISASI","13",722,699,1421
"18468","KITUI","KISASI","14",701,720,1421
"18469","KITUI","KISASI","10 -14",3544,3352,6896
"18470","KITUI","KISASI","15",752,692,1444
"18471","KITUI","KISASI","16",756,699,1455
"18472","KITUI","KISASI","17",733,687,1420
"18473","KITUI","KISASI","18",605,494,1099
"18474","KITUI","KISASI","19",595,531,1126
"18475","KITUI","KISASI","15-19",3441,3103,6544
"18476","KITUI","KISASI","20",469,452,921
"18477","KITUI","KISASI","21",352,330,682
"18478","KITUI","KISASI","22",340,323,663
"18479","KITUI","KISASI","23",339,350,689
"18480","KITUI","KISASI","24",308,296,604
"18481","KITUI","KISASI","20-24",1808,1751,3559
"18482","KITUI","KISASI","25",308,302,610
"18483","KITUI","KISASI","26",285,252,537
"18484","KITUI","KISASI","27",246,218,464
"18485","KITUI","KISASI","28",194,233,427
"18486","KITUI","KISASI","29",240,290,530
"18487","KITUI","KISASI","25-29",1273,1295,2568
"18488","KITUI","KISASI","30",331,363,694
"18489","KITUI","KISASI","31",259,268,527
"18490","KITUI","KISASI","32",289,340,629
"18491","KITUI","KISASI","33",243,306,549
"18492","KITUI","KISASI","34",226,264,490
"18493","KITUI","KISASI","30-34",1348,1541,2889
"18494","KITUI","KISASI","35",270,363,633
"18495","KITUI","KISASI","36",195,230,425
"18496","KITUI","KISASI","37",228,241,469
"18497","KITUI","KISASI","38",156,182,338
"18498","KITUI","KISASI","39",240,293,533
"18499","KITUI","KISASI","35-39",1089,1309,2398
"18500","KITUI","KISASI","40",247,231,478
"18501","KITUI","KISASI","41",242,238,480
"18502","KITUI","KISASI","42",203,217,420
"18503","KITUI","KISASI","43",191,216,407
"18504","KITUI","KISASI","44",160,255,415
"18505","KITUI","KISASI","40-44",1043,1157,2200
"18506","KITUI","KISASI","45",263,308,571
"18507","KITUI","KISASI","46",189,211,400
"18508","KITUI","KISASI","47",184,193,377
"18509","KITUI","KISASI","48",130,131,261
"18510","KITUI","KISASI","49",179,176,355
"18511","KITUI","KISASI","45-49",945,1019,1964
"18512","KITUI","KISASI","50",156,169,325
"18513","KITUI","KISASI","51",180,189,369
"18514","KITUI","KISASI","52",104,130,234
"18515","KITUI","KISASI","53",110,109,219
"18516","KITUI","KISASI","54",124,121,245
"18517","KITUI","KISASI","50-54",674,718,1392
"18518","KITUI","KISASI","55",155,136,291
"18519","KITUI","KISASI","56",154,165,319
"18520","KITUI","KISASI","57",117,126,243
"18521","KITUI","KISASI","58",76,117,193
"18522","KITUI","KISASI","59",122,190,312
"18523","KITUI","KISASI","55-59",624,734,1358
"18524","KITUI","KISASI","60",116,144,260
"18525","KITUI","KISASI","61",99,131,230
"18526","KITUI","KISASI","62",93,88,181
"18527","KITUI","KISASI","63",96,106,202
"18528","KITUI","KISASI","64",62,56,118
"18529","KITUI","KISASI","60-64",466,525,991
"18530","KITUI","KISASI","65",104,128,232
"18531","KITUI","KISASI","66",87,69,156
"18532","KITUI","KISASI","67",132,159,291
"18533","KITUI","KISASI","68",50,80,130
"18534","KITUI","KISASI","69",69,147,216
"18535","KITUI","KISASI","65-69",442,583,1025
"18536","KITUI","KISASI","70",101,148,249
"18537","KITUI","KISASI","71",70,76,146
"18538","KITUI","KISASI","72",47,55,102
"18539","KITUI","KISASI","73",73,181,254
"18540","KITUI","KISASI","74",52,97,149
"18541","KITUI","KISASI","70-74",343,557,900
"18542","KITUI","KISASI","75",48,83,131
"18543","KITUI","KISASI","76",26,58,84
"18544","KITUI","KISASI","77",38,52,90
"18545","KITUI","KISASI","78",22,41,63
"18546","KITUI","KISASI","79",37,89,126
"18547","KITUI","KISASI","75-79",171,323,494
"18548","KITUI","KISASI","80",44,113,157
"18549","KITUI","KISASI","81",27,46,73
"18550","KITUI","KISASI","82",27,22,49
"18551","KITUI","KISASI","83",27,39,66
"18552","KITUI","KISASI","84",32,68,100
"18553","KITUI","KISASI","80-84",157,288,445
"18554","KITUI","KISASI","85",24,23,47
"18555","KITUI","KISASI","86",17,12,29
"18556","KITUI","KISASI","87",12,12,24
"18557","KITUI","KISASI","88",10,7,17
"18558","KITUI","KISASI","89",25,44,69
"18559","KITUI","KISASI","85-89",88,98,186
"18560","KITUI","KISASI","90",24,39,63
"18561","KITUI","KISASI","91",20,62,82
"18562","KITUI","KISASI","92",7,11,18
"18563","KITUI","KISASI","93",8,14,22
"18564","KITUI","KISASI","94",8,5,13
"18565","KITUI","KISASI","90-94",67,131,198
"18566","KITUI","KISASI","95",6,13,19
"18567","KITUI","KISASI","96",4,1,5
"18568","KITUI","KISASI","97",7,3,10
"18569","KITUI","KISASI","98",1,3,4
"18570","KITUI","KISASI","99",5,9,14
"18571","KITUI","KISASI","95-99",23,29,52
"18572","KITUI","KISASI","100+",10,33,43
"18573","KITUI","KISASI","Not Stated",NA,1,1
"18574","KITUI","KITUI CENTRAL","Total",52123,53863,105986
"18575","KITUI","KITUI CENTRAL","0",1059,1064,2123
"18576","KITUI","KITUI CENTRAL","1",1216,1203,2419
"18577","KITUI","KITUI CENTRAL","2",1128,1099,2227
"18578","KITUI","KITUI CENTRAL","3",1200,1132,2332
"18579","KITUI","KITUI CENTRAL","4",1130,1077,2207
"18580","KITUI","KITUI CENTRAL","0 - 4",5733,5575,11308
"18581","KITUI","KITUI CENTRAL","5",1119,1100,2219
"18582","KITUI","KITUI CENTRAL","6",1113,1056,2169
"18583","KITUI","KITUI CENTRAL","7",1128,1097,2225
"18584","KITUI","KITUI CENTRAL","8",1112,1145,2257
"18585","KITUI","KITUI CENTRAL","9",1214,1204,2418
"18586","KITUI","KITUI CENTRAL","5-9",5686,5602,11288
"18587","KITUI","KITUI CENTRAL","10",1291,1177,2468
"18588","KITUI","KITUI CENTRAL","11",1214,1280,2494
"18589","KITUI","KITUI CENTRAL","12",1331,1265,2596
"18590","KITUI","KITUI CENTRAL","13",1302,1333,2635
"18591","KITUI","KITUI CENTRAL","14",1219,1255,2474
"18592","KITUI","KITUI CENTRAL","10 -14",6357,6310,12667
"18593","KITUI","KITUI CENTRAL","15",1275,1228,2503
"18594","KITUI","KITUI CENTRAL","16",1204,1202,2406
"18595","KITUI","KITUI CENTRAL","17",1250,1184,2434
"18596","KITUI","KITUI CENTRAL","18",1033,1004,2037
"18597","KITUI","KITUI CENTRAL","19",1250,1125,2375
"18598","KITUI","KITUI CENTRAL","15-19",6012,5743,11755
"18599","KITUI","KITUI CENTRAL","20",1106,1183,2289
"18600","KITUI","KITUI CENTRAL","21",1021,1149,2170
"18601","KITUI","KITUI CENTRAL","22",982,1108,2090
"18602","KITUI","KITUI CENTRAL","23",1038,1216,2254
"18603","KITUI","KITUI CENTRAL","24",974,1057,2031
"18604","KITUI","KITUI CENTRAL","20-24",5121,5713,10834
"18605","KITUI","KITUI CENTRAL","25",1053,1080,2133
"18606","KITUI","KITUI CENTRAL","26",823,904,1727
"18607","KITUI","KITUI CENTRAL","27",948,923,1871
"18608","KITUI","KITUI CENTRAL","28",753,805,1558
"18609","KITUI","KITUI CENTRAL","29",873,904,1777
"18610","KITUI","KITUI CENTRAL","25-29",4450,4616,9066
"18611","KITUI","KITUI CENTRAL","30",1020,1063,2083
"18612","KITUI","KITUI CENTRAL","31",721,709,1430
"18613","KITUI","KITUI CENTRAL","32",864,897,1761
"18614","KITUI","KITUI CENTRAL","33",735,765,1500
"18615","KITUI","KITUI CENTRAL","34",698,693,1391
"18616","KITUI","KITUI CENTRAL","30-34",4038,4127,8165
"18617","KITUI","KITUI CENTRAL","35",808,830,1638
"18618","KITUI","KITUI CENTRAL","36",597,623,1220
"18619","KITUI","KITUI CENTRAL","37",646,618,1264
"18620","KITUI","KITUI CENTRAL","38",524,548,1072
"18621","KITUI","KITUI CENTRAL","39",598,575,1173
"18622","KITUI","KITUI CENTRAL","35-39",3173,3194,6367
"18623","KITUI","KITUI CENTRAL","40",659,705,1364
"18624","KITUI","KITUI CENTRAL","41",647,567,1214
"18625","KITUI","KITUI CENTRAL","42",542,558,1100
"18626","KITUI","KITUI CENTRAL","43",486,482,968
"18627","KITUI","KITUI CENTRAL","44",445,516,961
"18628","KITUI","KITUI CENTRAL","40-44",2779,2828,5607
"18629","KITUI","KITUI CENTRAL","45",610,678,1288
"18630","KITUI","KITUI CENTRAL","46",431,433,864
"18631","KITUI","KITUI CENTRAL","47",437,465,902
"18632","KITUI","KITUI CENTRAL","48",295,353,648
"18633","KITUI","KITUI CENTRAL","49",449,479,928
"18634","KITUI","KITUI CENTRAL","45-49",2222,2408,4630
"18635","KITUI","KITUI CENTRAL","50",417,512,929
"18636","KITUI","KITUI CENTRAL","51",376,349,725
"18637","KITUI","KITUI CENTRAL","52",320,305,625
"18638","KITUI","KITUI CENTRAL","53",204,225,429
"18639","KITUI","KITUI CENTRAL","54",330,326,656
"18640","KITUI","KITUI CENTRAL","50-54",1647,1717,3364
"18641","KITUI","KITUI CENTRAL","55",363,310,673
"18642","KITUI","KITUI CENTRAL","56",345,370,715
"18643","KITUI","KITUI CENTRAL","57",289,284,573
"18644","KITUI","KITUI CENTRAL","58",185,257,442
"18645","KITUI","KITUI CENTRAL","59",249,314,563
"18646","KITUI","KITUI CENTRAL","55-59",1431,1535,2966
"18647","KITUI","KITUI CENTRAL","60",311,338,649
"18648","KITUI","KITUI CENTRAL","61",258,260,518
"18649","KITUI","KITUI CENTRAL","62",199,185,384
"18650","KITUI","KITUI CENTRAL","63",173,206,379
"18651","KITUI","KITUI CENTRAL","64",153,157,310
"18652","KITUI","KITUI CENTRAL","60-64",1094,1146,2240
"18653","KITUI","KITUI CENTRAL","65",230,247,477
"18654","KITUI","KITUI CENTRAL","66",138,143,281
"18655","KITUI","KITUI CENTRAL","67",245,261,506
"18656","KITUI","KITUI CENTRAL","68",113,136,249
"18657","KITUI","KITUI CENTRAL","69",150,212,362
"18658","KITUI","KITUI CENTRAL","65-69",876,999,1875
"18659","KITUI","KITUI CENTRAL","70",181,313,494
"18660","KITUI","KITUI CENTRAL","71",126,146,272
"18661","KITUI","KITUI CENTRAL","72",88,128,216
"18662","KITUI","KITUI CENTRAL","73",110,180,290
"18663","KITUI","KITUI CENTRAL","74",99,176,275
"18664","KITUI","KITUI CENTRAL","70-74",604,943,1547
"18665","KITUI","KITUI CENTRAL","75",95,115,210
"18666","KITUI","KITUI CENTRAL","76",46,71,117
"18667","KITUI","KITUI CENTRAL","77",81,87,168
"18668","KITUI","KITUI CENTRAL","78",64,45,109
"18669","KITUI","KITUI CENTRAL","79",56,149,205
"18670","KITUI","KITUI CENTRAL","75-79",342,467,809
"18671","KITUI","KITUI CENTRAL","80",74,153,227
"18672","KITUI","KITUI CENTRAL","81",42,62,104
"18673","KITUI","KITUI CENTRAL","82",41,33,74
"18674","KITUI","KITUI CENTRAL","83",49,52,101
"18675","KITUI","KITUI CENTRAL","84",48,55,103
"18676","KITUI","KITUI CENTRAL","80-84",254,355,609
"18677","KITUI","KITUI CENTRAL","85",44,58,102
"18678","KITUI","KITUI CENTRAL","86",24,34,58
"18679","KITUI","KITUI CENTRAL","87",23,48,71
"18680","KITUI","KITUI CENTRAL","88",14,15,29
"18681","KITUI","KITUI CENTRAL","89",40,89,129
"18682","KITUI","KITUI CENTRAL","85-89",145,244,389
"18683","KITUI","KITUI CENTRAL","90",36,102,138
"18684","KITUI","KITUI CENTRAL","91",25,66,91
"18685","KITUI","KITUI CENTRAL","92",21,19,40
"18686","KITUI","KITUI CENTRAL","93",11,16,27
"18687","KITUI","KITUI CENTRAL","94",7,16,23
"18688","KITUI","KITUI CENTRAL","90-94",100,219,319
"18689","KITUI","KITUI CENTRAL","95",12,23,35
"18690","KITUI","KITUI CENTRAL","96",1,6,7
"18691","KITUI","KITUI CENTRAL","97",9,8,17
"18692","KITUI","KITUI CENTRAL","98",6,11,17
"18693","KITUI","KITUI CENTRAL","99",9,24,33
"18694","KITUI","KITUI CENTRAL","95-99",37,72,109
"18695","KITUI","KITUI CENTRAL","100+",21,49,70
"18696","KITUI","KITUI CENTRAL","Not Stated",1,1,2
"18697","KITUI","KITUI WEST","Total",33887,36983,70870
"18698","KITUI","KITUI WEST","0",738,716,1454
"18699","KITUI","KITUI WEST","1",717,710,1427
"18700","KITUI","KITUI WEST","2",772,798,1570
"18701","KITUI","KITUI WEST","3",758,787,1545
"18702","KITUI","KITUI WEST","4",749,817,1566
"18703","KITUI","KITUI WEST","0 - 4",3734,3828,7562
"18704","KITUI","KITUI WEST","5",760,784,1544
"18705","KITUI","KITUI WEST","6",858,780,1638
"18706","KITUI","KITUI WEST","7",856,754,1610
"18707","KITUI","KITUI WEST","8",864,862,1726
"18708","KITUI","KITUI WEST","9",909,875,1784
"18709","KITUI","KITUI WEST","5-9",4247,4055,8302
"18710","KITUI","KITUI WEST","10",951,940,1891
"18711","KITUI","KITUI WEST","11",982,993,1975
"18712","KITUI","KITUI WEST","12",1024,986,2010
"18713","KITUI","KITUI WEST","13",1008,976,1984
"18714","KITUI","KITUI WEST","14",1065,965,2030
"18715","KITUI","KITUI WEST","10 -14",5030,4860,9890
"18716","KITUI","KITUI WEST","15",1038,940,1978
"18717","KITUI","KITUI WEST","16",961,967,1928
"18718","KITUI","KITUI WEST","17",1016,930,1946
"18719","KITUI","KITUI WEST","18",825,756,1581
"18720","KITUI","KITUI WEST","19",778,765,1543
"18721","KITUI","KITUI WEST","15-19",4618,4358,8976
"18722","KITUI","KITUI WEST","20",716,617,1333
"18723","KITUI","KITUI WEST","21",629,583,1212
"18724","KITUI","KITUI WEST","22",451,512,963
"18725","KITUI","KITUI WEST","23",517,566,1083
"18726","KITUI","KITUI WEST","24",385,470,855
"18727","KITUI","KITUI WEST","20-24",2698,2748,5446
"18728","KITUI","KITUI WEST","25",459,538,997
"18729","KITUI","KITUI WEST","26",333,421,754
"18730","KITUI","KITUI WEST","27",399,467,866
"18731","KITUI","KITUI WEST","28",375,419,794
"18732","KITUI","KITUI WEST","29",423,493,916
"18733","KITUI","KITUI WEST","25-29",1989,2338,4327
"18734","KITUI","KITUI WEST","30",455,608,1063
"18735","KITUI","KITUI WEST","31",349,402,751
"18736","KITUI","KITUI WEST","32",434,549,983
"18737","KITUI","KITUI WEST","33",397,476,873
"18738","KITUI","KITUI WEST","34",345,444,789
"18739","KITUI","KITUI WEST","30-34",1980,2479,4459
"18740","KITUI","KITUI WEST","35",476,586,1062
"18741","KITUI","KITUI WEST","36",339,408,747
"18742","KITUI","KITUI WEST","37",410,456,866
"18743","KITUI","KITUI WEST","38",243,317,560
"18744","KITUI","KITUI WEST","39",384,411,795
"18745","KITUI","KITUI WEST","35-39",1852,2178,4030
"18746","KITUI","KITUI WEST","40",351,389,740
"18747","KITUI","KITUI WEST","41",339,383,722
"18748","KITUI","KITUI WEST","42",284,360,644
"18749","KITUI","KITUI WEST","43",288,380,668
"18750","KITUI","KITUI WEST","44",290,376,666
"18751","KITUI","KITUI WEST","40-44",1552,1888,3440
"18752","KITUI","KITUI WEST","45",350,496,846
"18753","KITUI","KITUI WEST","46",282,398,680
"18754","KITUI","KITUI WEST","47",269,346,615
"18755","KITUI","KITUI WEST","48",209,255,464
"18756","KITUI","KITUI WEST","49",288,357,645
"18757","KITUI","KITUI WEST","45-49",1398,1852,3250
"18758","KITUI","KITUI WEST","50",214,406,620
"18759","KITUI","KITUI WEST","51",239,326,565
"18760","KITUI","KITUI WEST","52",218,233,451
"18761","KITUI","KITUI WEST","53",141,175,316
"18762","KITUI","KITUI WEST","54",212,222,434
"18763","KITUI","KITUI WEST","50-54",1024,1362,2386
"18764","KITUI","KITUI WEST","55",211,248,459
"18765","KITUI","KITUI WEST","56",237,242,479
"18766","KITUI","KITUI WEST","57",165,259,424
"18767","KITUI","KITUI WEST","58",137,180,317
"18768","KITUI","KITUI WEST","59",181,243,424
"18769","KITUI","KITUI WEST","55-59",931,1172,2103
"18770","KITUI","KITUI WEST","60",246,275,521
"18771","KITUI","KITUI WEST","61",190,204,394
"18772","KITUI","KITUI WEST","62",172,193,365
"18773","KITUI","KITUI WEST","63",133,176,309
"18774","KITUI","KITUI WEST","64",115,122,237
"18775","KITUI","KITUI WEST","60-64",856,970,1826
"18776","KITUI","KITUI WEST","65",144,218,362
"18777","KITUI","KITUI WEST","66",120,125,245
"18778","KITUI","KITUI WEST","67",201,211,412
"18779","KITUI","KITUI WEST","68",93,118,211
"18780","KITUI","KITUI WEST","69",145,204,349
"18781","KITUI","KITUI WEST","65-69",703,876,1579
"18782","KITUI","KITUI WEST","70",151,305,456
"18783","KITUI","KITUI WEST","71",115,136,251
"18784","KITUI","KITUI WEST","72",91,104,195
"18785","KITUI","KITUI WEST","73",83,111,194
"18786","KITUI","KITUI WEST","74",68,121,189
"18787","KITUI","KITUI WEST","70-74",508,777,1285
"18788","KITUI","KITUI WEST","75",69,75,144
"18789","KITUI","KITUI WEST","76",54,60,114
"18790","KITUI","KITUI WEST","77",67,80,147
"18791","KITUI","KITUI WEST","78",56,48,104
"18792","KITUI","KITUI WEST","79",59,131,190
"18793","KITUI","KITUI WEST","75-79",305,394,699
"18794","KITUI","KITUI WEST","80",77,147,224
"18795","KITUI","KITUI WEST","81",43,74,117
"18796","KITUI","KITUI WEST","82",31,36,67
"18797","KITUI","KITUI WEST","83",54,52,106
"18798","KITUI","KITUI WEST","84",30,68,98
"18799","KITUI","KITUI WEST","80-84",235,377,612
"18800","KITUI","KITUI WEST","85",22,38,60
"18801","KITUI","KITUI WEST","86",18,19,37
"18802","KITUI","KITUI WEST","87",27,42,69
"18803","KITUI","KITUI WEST","88",6,20,26
"18804","KITUI","KITUI WEST","89",26,77,103
"18805","KITUI","KITUI WEST","85-89",99,196,295
"18806","KITUI","KITUI WEST","90",37,81,118
"18807","KITUI","KITUI WEST","91",15,49,64
"18808","KITUI","KITUI WEST","92",8,19,27
"18809","KITUI","KITUI WEST","93",4,10,14
"18810","KITUI","KITUI WEST","94",12,15,27
"18811","KITUI","KITUI WEST","90-94",76,174,250
"18812","KITUI","KITUI WEST","95",6,19,25
"18813","KITUI","KITUI WEST","96",7,8,15
"18814","KITUI","KITUI WEST","97",7,5,12
"18815","KITUI","KITUI WEST","98",3,7,10
"18816","KITUI","KITUI WEST","99",12,22,34
"18817","KITUI","KITUI WEST","95-99",35,61,96
"18818","KITUI","KITUI WEST","100+",17,40,57
"18819","KITUI","KITUI WEST","Not Stated",NA,NA,NA
"18820","KITUI","KYUSO","Total",36789,40077,76866
"18821","KITUI","KYUSO","0",820,830,1650
"18822","KITUI","KYUSO","1",948,883,1831
"18823","KITUI","KYUSO","2",961,985,1946
"18824","KITUI","KYUSO","3",1056,1019,2075
"18825","KITUI","KYUSO","4",1016,1016,2032
"18826","KITUI","KYUSO","0 - 4",4801,4733,9534
"18827","KITUI","KYUSO","5",1154,1069,2223
"18828","KITUI","KYUSO","6",1104,1101,2205
"18829","KITUI","KYUSO","7",964,980,1944
"18830","KITUI","KYUSO","8",1185,1125,2310
"18831","KITUI","KYUSO","9",1124,1116,2240
"18832","KITUI","KYUSO","5-9",5531,5391,10922
"18833","KITUI","KYUSO","10",1159,1150,2309
"18834","KITUI","KYUSO","11",1311,1296,2607
"18835","KITUI","KYUSO","12",1307,1231,2538
"18836","KITUI","KYUSO","13",1258,1315,2573
"18837","KITUI","KYUSO","14",1275,1290,2565
"18838","KITUI","KYUSO","10 -14",6310,6282,12592
"18839","KITUI","KYUSO","15",1262,1183,2445
"18840","KITUI","KYUSO","16",1166,1192,2358
"18841","KITUI","KYUSO","17",1088,1056,2144
"18842","KITUI","KYUSO","18",838,811,1649
"18843","KITUI","KYUSO","19",829,816,1645
"18844","KITUI","KYUSO","15-19",5183,5058,10241
"18845","KITUI","KYUSO","20",739,739,1478
"18846","KITUI","KYUSO","21",608,631,1239
"18847","KITUI","KYUSO","22",465,599,1064
"18848","KITUI","KYUSO","23",437,630,1067
"18849","KITUI","KYUSO","24",414,501,915
"18850","KITUI","KYUSO","20-24",2663,3100,5763
"18851","KITUI","KYUSO","25",475,560,1035
"18852","KITUI","KYUSO","26",341,424,765
"18853","KITUI","KYUSO","27",356,440,796
"18854","KITUI","KYUSO","28",281,411,692
"18855","KITUI","KYUSO","29",352,471,823
"18856","KITUI","KYUSO","25-29",1805,2306,4111
"18857","KITUI","KYUSO","30",375,587,962
"18858","KITUI","KYUSO","31",335,473,808
"18859","KITUI","KYUSO","32",347,518,865
"18860","KITUI","KYUSO","33",346,536,882
"18861","KITUI","KYUSO","34",281,479,760
"18862","KITUI","KYUSO","30-34",1684,2593,4277
"18863","KITUI","KYUSO","35",427,565,992
"18864","KITUI","KYUSO","36",274,306,580
"18865","KITUI","KYUSO","37",348,324,672
"18866","KITUI","KYUSO","38",213,243,456
"18867","KITUI","KYUSO","39",310,350,660
"18868","KITUI","KYUSO","35-39",1572,1788,3360
"18869","KITUI","KYUSO","40",301,301,602
"18870","KITUI","KYUSO","41",337,329,666
"18871","KITUI","KYUSO","42",262,301,563
"18872","KITUI","KYUSO","43",244,353,597
"18873","KITUI","KYUSO","44",276,350,626
"18874","KITUI","KYUSO","40-44",1420,1634,3054
"18875","KITUI","KYUSO","45",416,480,896
"18876","KITUI","KYUSO","46",268,307,575
"18877","KITUI","KYUSO","47",255,300,555
"18878","KITUI","KYUSO","48",196,213,409
"18879","KITUI","KYUSO","49",244,297,541
"18880","KITUI","KYUSO","45-49",1379,1597,2976
"18881","KITUI","KYUSO","50",247,257,504
"18882","KITUI","KYUSO","51",176,276,452
"18883","KITUI","KYUSO","52",193,200,393
"18884","KITUI","KYUSO","53",125,169,294
"18885","KITUI","KYUSO","54",153,195,348
"18886","KITUI","KYUSO","50-54",894,1097,1991
"18887","KITUI","KYUSO","55",210,200,410
"18888","KITUI","KYUSO","56",200,247,447
"18889","KITUI","KYUSO","57",173,165,338
"18890","KITUI","KYUSO","58",100,157,257
"18891","KITUI","KYUSO","59",161,236,397
"18892","KITUI","KYUSO","55-59",844,1005,1849
"18893","KITUI","KYUSO","60",195,266,461
"18894","KITUI","KYUSO","61",148,170,318
"18895","KITUI","KYUSO","62",126,137,263
"18896","KITUI","KYUSO","63",134,155,289
"18897","KITUI","KYUSO","64",123,123,246
"18898","KITUI","KYUSO","60-64",726,851,1577
"18899","KITUI","KYUSO","65",176,205,381
"18900","KITUI","KYUSO","66",117,89,206
"18901","KITUI","KYUSO","67",171,200,371
"18902","KITUI","KYUSO","68",90,107,197
"18903","KITUI","KYUSO","69",138,246,384
"18904","KITUI","KYUSO","65-69",692,847,1539
"18905","KITUI","KYUSO","70",151,309,460
"18906","KITUI","KYUSO","71",106,132,238
"18907","KITUI","KYUSO","72",65,97,162
"18908","KITUI","KYUSO","73",82,83,165
"18909","KITUI","KYUSO","74",73,131,204
"18910","KITUI","KYUSO","70-74",477,752,1229
"18911","KITUI","KYUSO","75",79,86,165
"18912","KITUI","KYUSO","76",51,61,112
"18913","KITUI","KYUSO","77",63,55,118
"18914","KITUI","KYUSO","78",49,49,98
"18915","KITUI","KYUSO","79",61,122,183
"18916","KITUI","KYUSO","75-79",303,373,676
"18917","KITUI","KYUSO","80",80,153,233
"18918","KITUI","KYUSO","81",45,60,105
"18919","KITUI","KYUSO","82",35,36,71
"18920","KITUI","KYUSO","83",40,35,75
"18921","KITUI","KYUSO","84",37,56,93
"18922","KITUI","KYUSO","80-84",237,340,577
"18923","KITUI","KYUSO","85",25,41,66
"18924","KITUI","KYUSO","86",20,10,30
"18925","KITUI","KYUSO","87",31,28,59
"18926","KITUI","KYUSO","88",16,16,32
"18927","KITUI","KYUSO","89",45,61,106
"18928","KITUI","KYUSO","85-89",137,156,293
"18929","KITUI","KYUSO","90",28,42,70
"18930","KITUI","KYUSO","91",15,20,35
"18931","KITUI","KYUSO","92",9,14,23
"18932","KITUI","KYUSO","93",9,11,20
"18933","KITUI","KYUSO","94",7,9,16
"18934","KITUI","KYUSO","90-94",68,96,164
"18935","KITUI","KYUSO","95",11,15,26
"18936","KITUI","KYUSO","96",4,5,9
"18937","KITUI","KYUSO","97",8,1,9
"18938","KITUI","KYUSO","98",4,11,15
"18939","KITUI","KYUSO","99",16,20,36
"18940","KITUI","KYUSO","95-99",43,52,95
"18941","KITUI","KYUSO","100+",20,25,45
"18942","KITUI","KYUSO","Not Stated",NA,1,1
"18943","KITUI","LOWER YATTA","Total",31701,31628,63329
"18944","KITUI","LOWER YATTA","0",573,594,1167
"18945","KITUI","LOWER YATTA","1",631,623,1254
"18946","KITUI","LOWER YATTA","2",680,661,1341
"18947","KITUI","LOWER YATTA","3",647,660,1307
"18948","KITUI","LOWER YATTA","4",618,620,1238
"18949","KITUI","LOWER YATTA","0 - 4",3149,3158,6307
"18950","KITUI","LOWER YATTA","5",677,641,1318
"18951","KITUI","LOWER YATTA","6",665,570,1235
"18952","KITUI","LOWER YATTA","7",699,654,1353
"18953","KITUI","LOWER YATTA","8",753,795,1548
"18954","KITUI","LOWER YATTA","9",837,822,1659
"18955","KITUI","LOWER YATTA","5-9",3631,3482,7113
"18956","KITUI","LOWER YATTA","10",908,853,1761
"18957","KITUI","LOWER YATTA","11",962,936,1898
"18958","KITUI","LOWER YATTA","12",1010,937,1947
"18959","KITUI","LOWER YATTA","13",1038,955,1993
"18960","KITUI","LOWER YATTA","14",1018,947,1965
"18961","KITUI","LOWER YATTA","10 -14",4936,4628,9564
"18962","KITUI","LOWER YATTA","15",1014,950,1964
"18963","KITUI","LOWER YATTA","16",934,939,1873
"18964","KITUI","LOWER YATTA","17",1007,928,1935
"18965","KITUI","LOWER YATTA","18",749,653,1402
"18966","KITUI","LOWER YATTA","19",790,698,1488
"18967","KITUI","LOWER YATTA","15-19",4494,4168,8662
"18968","KITUI","LOWER YATTA","20",723,618,1341
"18969","KITUI","LOWER YATTA","21",510,469,979
"18970","KITUI","LOWER YATTA","22",421,404,825
"18971","KITUI","LOWER YATTA","23",476,478,954
"18972","KITUI","LOWER YATTA","24",366,423,789
"18973","KITUI","LOWER YATTA","20-24",2496,2392,4888
"18974","KITUI","LOWER YATTA","25",501,485,986
"18975","KITUI","LOWER YATTA","26",347,360,707
"18976","KITUI","LOWER YATTA","27",416,373,789
"18977","KITUI","LOWER YATTA","28",361,350,711
"18978","KITUI","LOWER YATTA","29",403,383,786
"18979","KITUI","LOWER YATTA","25-29",2028,1951,3979
"18980","KITUI","LOWER YATTA","30",499,501,1000
"18981","KITUI","LOWER YATTA","31",341,323,664
"18982","KITUI","LOWER YATTA","32",494,483,977
"18983","KITUI","LOWER YATTA","33",438,418,856
"18984","KITUI","LOWER YATTA","34",363,385,748
"18985","KITUI","LOWER YATTA","30-34",2135,2110,4245
"18986","KITUI","LOWER YATTA","35",493,463,956
"18987","KITUI","LOWER YATTA","36",308,327,635
"18988","KITUI","LOWER YATTA","37",344,322,666
"18989","KITUI","LOWER YATTA","38",223,249,472
"18990","KITUI","LOWER YATTA","39",349,346,695
"18991","KITUI","LOWER YATTA","35-39",1717,1707,3424
"18992","KITUI","LOWER YATTA","40",369,353,722
"18993","KITUI","LOWER YATTA","41",383,339,722
"18994","KITUI","LOWER YATTA","42",292,306,598
"18995","KITUI","LOWER YATTA","43",265,327,592
"18996","KITUI","LOWER YATTA","44",223,305,528
"18997","KITUI","LOWER YATTA","40-44",1532,1630,3162
"18998","KITUI","LOWER YATTA","45",392,374,766
"18999","KITUI","LOWER YATTA","46",235,249,484
"19000","KITUI","LOWER YATTA","47",266,286,552
"19001","KITUI","LOWER YATTA","48",192,180,372
"19002","KITUI","LOWER YATTA","49",295,277,572
"19003","KITUI","LOWER YATTA","45-49",1380,1366,2746
"19004","KITUI","LOWER YATTA","50",253,284,537
"19005","KITUI","LOWER YATTA","51",233,265,498
"19006","KITUI","LOWER YATTA","52",191,187,378
"19007","KITUI","LOWER YATTA","53",138,131,269
"19008","KITUI","LOWER YATTA","54",175,162,337
"19009","KITUI","LOWER YATTA","50-54",990,1029,2019
"19010","KITUI","LOWER YATTA","55",191,205,396
"19011","KITUI","LOWER YATTA","56",201,222,423
"19012","KITUI","LOWER YATTA","57",179,160,339
"19013","KITUI","LOWER YATTA","58",111,138,249
"19014","KITUI","LOWER YATTA","59",146,201,347
"19015","KITUI","LOWER YATTA","55-59",828,926,1754
"19016","KITUI","LOWER YATTA","60",185,205,390
"19017","KITUI","LOWER YATTA","61",142,157,299
"19018","KITUI","LOWER YATTA","62",127,125,252
"19019","KITUI","LOWER YATTA","63",131,114,245
"19020","KITUI","LOWER YATTA","64",88,76,164
"19021","KITUI","LOWER YATTA","60-64",673,677,1350
"19022","KITUI","LOWER YATTA","65",146,141,287
"19023","KITUI","LOWER YATTA","66",99,107,206
"19024","KITUI","LOWER YATTA","67",190,228,418
"19025","KITUI","LOWER YATTA","68",71,88,159
"19026","KITUI","LOWER YATTA","69",109,249,358
"19027","KITUI","LOWER YATTA","65-69",615,813,1428
"19028","KITUI","LOWER YATTA","70",134,185,319
"19029","KITUI","LOWER YATTA","71",97,147,244
"19030","KITUI","LOWER YATTA","72",69,66,135
"19031","KITUI","LOWER YATTA","73",73,148,221
"19032","KITUI","LOWER YATTA","74",62,102,164
"19033","KITUI","LOWER YATTA","70-74",435,648,1083
"19034","KITUI","LOWER YATTA","75",44,71,115
"19035","KITUI","LOWER YATTA","76",43,45,88
"19036","KITUI","LOWER YATTA","77",55,68,123
"19037","KITUI","LOWER YATTA","78",50,30,80
"19038","KITUI","LOWER YATTA","79",51,60,111
"19039","KITUI","LOWER YATTA","75-79",243,274,517
"19040","KITUI","LOWER YATTA","80",56,92,148
"19041","KITUI","LOWER YATTA","81",27,37,64
"19042","KITUI","LOWER YATTA","82",25,27,52
"19043","KITUI","LOWER YATTA","83",37,47,84
"19044","KITUI","LOWER YATTA","84",30,45,75
"19045","KITUI","LOWER YATTA","80-84",175,248,423
"19046","KITUI","LOWER YATTA","85",16,28,44
"19047","KITUI","LOWER YATTA","86",19,17,36
"19048","KITUI","LOWER YATTA","87",25,20,45
"19049","KITUI","LOWER YATTA","88",11,8,19
"19050","KITUI","LOWER YATTA","89",27,58,85
"19051","KITUI","LOWER YATTA","85-89",98,131,229
"19052","KITUI","LOWER YATTA","90",29,59,88
"19053","KITUI","LOWER YATTA","91",31,79,110
"19054","KITUI","LOWER YATTA","92",10,37,47
"19055","KITUI","LOWER YATTA","93",8,17,25
"19056","KITUI","LOWER YATTA","94",7,17,24
"19057","KITUI","LOWER YATTA","90-94",85,209,294
"19058","KITUI","LOWER YATTA","95",9,24,33
"19059","KITUI","LOWER YATTA","96",6,6,12
"19060","KITUI","LOWER YATTA","97",10,7,17
"19061","KITUI","LOWER YATTA","98",1,6,7
"19062","KITUI","LOWER YATTA","99",5,13,18
"19063","KITUI","LOWER YATTA","95-99",31,56,87
"19064","KITUI","LOWER YATTA","100+",30,25,55
"19065","KITUI","LOWER YATTA","Not Stated",NA,NA,NA
"19066","KITUI","MATINYANI","Total",23362,24448,47810
"19067","KITUI","MATINYANI","0",465,486,951
"19068","KITUI","MATINYANI","1",523,543,1066
"19069","KITUI","MATINYANI","2",499,508,1007
"19070","KITUI","MATINYANI","3",496,487,983
"19071","KITUI","MATINYANI","4",520,540,1060
"19072","KITUI","MATINYANI","0 - 4",2503,2564,5067
"19073","KITUI","MATINYANI","5",543,517,1060
"19074","KITUI","MATINYANI","6",540,505,1045
"19075","KITUI","MATINYANI","7",492,513,1005
"19076","KITUI","MATINYANI","8",585,540,1125
"19077","KITUI","MATINYANI","9",592,583,1175
"19078","KITUI","MATINYANI","5-9",2752,2658,5410
"19079","KITUI","MATINYANI","10",596,564,1160
"19080","KITUI","MATINYANI","11",638,611,1249
"19081","KITUI","MATINYANI","12",693,660,1353
"19082","KITUI","MATINYANI","13",705,634,1339
"19083","KITUI","MATINYANI","14",682,695,1377
"19084","KITUI","MATINYANI","10 -14",3314,3164,6478
"19085","KITUI","MATINYANI","15",720,690,1410
"19086","KITUI","MATINYANI","16",644,632,1276
"19087","KITUI","MATINYANI","17",664,612,1276
"19088","KITUI","MATINYANI","18",516,421,937
"19089","KITUI","MATINYANI","19",579,488,1067
"19090","KITUI","MATINYANI","15-19",3123,2843,5966
"19091","KITUI","MATINYANI","20",482,441,923
"19092","KITUI","MATINYANI","21",402,389,791
"19093","KITUI","MATINYANI","22",374,343,717
"19094","KITUI","MATINYANI","23",382,362,744
"19095","KITUI","MATINYANI","24",302,285,587
"19096","KITUI","MATINYANI","20-24",1942,1820,3762
"19097","KITUI","MATINYANI","25",361,338,699
"19098","KITUI","MATINYANI","26",244,283,527
"19099","KITUI","MATINYANI","27",307,300,607
"19100","KITUI","MATINYANI","28",272,263,535
"19101","KITUI","MATINYANI","29",269,336,605
"19102","KITUI","MATINYANI","25-29",1453,1520,2973
"19103","KITUI","MATINYANI","30",330,376,706
"19104","KITUI","MATINYANI","31",280,265,545
"19105","KITUI","MATINYANI","32",316,381,697
"19106","KITUI","MATINYANI","33",270,315,585
"19107","KITUI","MATINYANI","34",234,264,498
"19108","KITUI","MATINYANI","30-34",1430,1601,3031
"19109","KITUI","MATINYANI","35",330,347,677
"19110","KITUI","MATINYANI","36",246,278,524
"19111","KITUI","MATINYANI","37",238,244,482
"19112","KITUI","MATINYANI","38",210,213,423
"19113","KITUI","MATINYANI","39",270,241,511
"19114","KITUI","MATINYANI","35-39",1294,1323,2617
"19115","KITUI","MATINYANI","40",249,284,533
"19116","KITUI","MATINYANI","41",283,267,550
"19117","KITUI","MATINYANI","42",200,243,443
"19118","KITUI","MATINYANI","43",199,248,447
"19119","KITUI","MATINYANI","44",184,211,395
"19120","KITUI","MATINYANI","40-44",1115,1253,2368
"19121","KITUI","MATINYANI","45",277,292,569
"19122","KITUI","MATINYANI","46",196,235,431
"19123","KITUI","MATINYANI","47",184,235,419
"19124","KITUI","MATINYANI","48",125,191,316
"19125","KITUI","MATINYANI","49",179,260,439
"19126","KITUI","MATINYANI","45-49",961,1213,2174
"19127","KITUI","MATINYANI","50",222,279,501
"19128","KITUI","MATINYANI","51",166,185,351
"19129","KITUI","MATINYANI","52",119,144,263
"19130","KITUI","MATINYANI","53",114,115,229
"19131","KITUI","MATINYANI","54",169,155,324
"19132","KITUI","MATINYANI","50-54",790,878,1668
"19133","KITUI","MATINYANI","55",193,180,373
"19134","KITUI","MATINYANI","56",196,206,402
"19135","KITUI","MATINYANI","57",116,169,285
"19136","KITUI","MATINYANI","58",89,109,198
"19137","KITUI","MATINYANI","59",136,171,307
"19138","KITUI","MATINYANI","55-59",730,835,1565
"19139","KITUI","MATINYANI","60",161,207,368
"19140","KITUI","MATINYANI","61",133,163,296
"19141","KITUI","MATINYANI","62",114,111,225
"19142","KITUI","MATINYANI","63",110,148,258
"19143","KITUI","MATINYANI","64",66,74,140
"19144","KITUI","MATINYANI","60-64",584,703,1287
"19145","KITUI","MATINYANI","65",111,126,237
"19146","KITUI","MATINYANI","66",77,70,147
"19147","KITUI","MATINYANI","67",124,154,278
"19148","KITUI","MATINYANI","68",65,81,146
"19149","KITUI","MATINYANI","69",87,156,243
"19150","KITUI","MATINYANI","65-69",464,587,1051
"19151","KITUI","MATINYANI","70",136,249,385
"19152","KITUI","MATINYANI","71",82,143,225
"19153","KITUI","MATINYANI","72",57,81,138
"19154","KITUI","MATINYANI","73",53,110,163
"19155","KITUI","MATINYANI","74",49,90,139
"19156","KITUI","MATINYANI","70-74",377,673,1050
"19157","KITUI","MATINYANI","75",58,63,121
"19158","KITUI","MATINYANI","76",42,39,81
"19159","KITUI","MATINYANI","77",47,45,92
"19160","KITUI","MATINYANI","78",42,25,67
"19161","KITUI","MATINYANI","79",34,71,105
"19162","KITUI","MATINYANI","75-79",223,243,466
"19163","KITUI","MATINYANI","80",46,87,133
"19164","KITUI","MATINYANI","81",31,45,76
"19165","KITUI","MATINYANI","82",28,17,45
"19166","KITUI","MATINYANI","83",19,26,45
"19167","KITUI","MATINYANI","84",24,46,70
"19168","KITUI","MATINYANI","80-84",148,221,369
"19169","KITUI","MATINYANI","85",16,32,48
"19170","KITUI","MATINYANI","86",12,8,20
"19171","KITUI","MATINYANI","87",15,28,43
"19172","KITUI","MATINYANI","88",6,13,19
"19173","KITUI","MATINYANI","89",19,53,72
"19174","KITUI","MATINYANI","85-89",68,134,202
"19175","KITUI","MATINYANI","90",25,57,82
"19176","KITUI","MATINYANI","91",23,68,91
"19177","KITUI","MATINYANI","92",3,19,22
"19178","KITUI","MATINYANI","93",9,14,23
"19179","KITUI","MATINYANI","94",8,10,18
"19180","KITUI","MATINYANI","90-94",68,168,236
"19181","KITUI","MATINYANI","95",8,21,29
"19182","KITUI","MATINYANI","96",2,2,4
"19183","KITUI","MATINYANI","97",2,3,5
"19184","KITUI","MATINYANI","98",3,6,9
"19185","KITUI","MATINYANI","99",NA,6,6
"19186","KITUI","MATINYANI","95-99",15,38,53
"19187","KITUI","MATINYANI","100+",8,9,17
"19188","KITUI","MATINYANI","Not Stated",NA,NA,NA
"19189","KITUI","MIGWANI","Total",37525,41726,79251
"19190","KITUI","MIGWANI","0",833,785,1618
"19191","KITUI","MIGWANI","1",941,890,1831
"19192","KITUI","MIGWANI","2",891,922,1813
"19193","KITUI","MIGWANI","3",877,886,1763
"19194","KITUI","MIGWANI","4",936,898,1834
"19195","KITUI","MIGWANI","0 - 4",4478,4381,8859
"19196","KITUI","MIGWANI","5",930,985,1915
"19197","KITUI","MIGWANI","6",955,926,1881
"19198","KITUI","MIGWANI","7",891,913,1804
"19199","KITUI","MIGWANI","8",981,1007,1988
"19200","KITUI","MIGWANI","9",1009,990,1999
"19201","KITUI","MIGWANI","5-9",4766,4821,9587
"19202","KITUI","MIGWANI","10",1179,1028,2207
"19203","KITUI","MIGWANI","11",1165,1154,2319
"19204","KITUI","MIGWANI","12",1236,1096,2332
"19205","KITUI","MIGWANI","13",1145,1120,2265
"19206","KITUI","MIGWANI","14",1180,1147,2327
"19207","KITUI","MIGWANI","10 -14",5905,5545,11450
"19208","KITUI","MIGWANI","15",1142,1107,2249
"19209","KITUI","MIGWANI","16",1108,1128,2236
"19210","KITUI","MIGWANI","17",1171,1029,2200
"19211","KITUI","MIGWANI","18",891,787,1678
"19212","KITUI","MIGWANI","19",906,803,1709
"19213","KITUI","MIGWANI","15-19",5218,4854,10072
"19214","KITUI","MIGWANI","20",801,755,1556
"19215","KITUI","MIGWANI","21",698,642,1340
"19216","KITUI","MIGWANI","22",543,633,1176
"19217","KITUI","MIGWANI","23",566,652,1218
"19218","KITUI","MIGWANI","24",495,629,1124
"19219","KITUI","MIGWANI","20-24",3103,3311,6414
"19220","KITUI","MIGWANI","25",532,596,1128
"19221","KITUI","MIGWANI","26",382,476,858
"19222","KITUI","MIGWANI","27",468,543,1011
"19223","KITUI","MIGWANI","28",325,490,815
"19224","KITUI","MIGWANI","29",432,566,998
"19225","KITUI","MIGWANI","25-29",2139,2671,4810
"19226","KITUI","MIGWANI","30",443,690,1133
"19227","KITUI","MIGWANI","31",399,550,949
"19228","KITUI","MIGWANI","32",445,590,1035
"19229","KITUI","MIGWANI","33",377,558,935
"19230","KITUI","MIGWANI","34",347,495,842
"19231","KITUI","MIGWANI","30-34",2011,2883,4894
"19232","KITUI","MIGWANI","35",478,606,1084
"19233","KITUI","MIGWANI","36",322,413,735
"19234","KITUI","MIGWANI","37",410,415,825
"19235","KITUI","MIGWANI","38",231,336,567
"19236","KITUI","MIGWANI","39",321,437,758
"19237","KITUI","MIGWANI","35-39",1762,2207,3969
"19238","KITUI","MIGWANI","40",316,471,787
"19239","KITUI","MIGWANI","41",375,417,792
"19240","KITUI","MIGWANI","42",288,366,654
"19241","KITUI","MIGWANI","43",301,397,698
"19242","KITUI","MIGWANI","44",291,373,664
"19243","KITUI","MIGWANI","40-44",1571,2024,3595
"19244","KITUI","MIGWANI","45",367,549,916
"19245","KITUI","MIGWANI","46",255,377,632
"19246","KITUI","MIGWANI","47",263,405,668
"19247","KITUI","MIGWANI","48",171,294,465
"19248","KITUI","MIGWANI","49",248,396,644
"19249","KITUI","MIGWANI","45-49",1304,2021,3325
"19250","KITUI","MIGWANI","50",295,414,709
"19251","KITUI","MIGWANI","51",209,375,584
"19252","KITUI","MIGWANI","52",180,260,440
"19253","KITUI","MIGWANI","53",160,198,358
"19254","KITUI","MIGWANI","54",227,261,488
"19255","KITUI","MIGWANI","50-54",1071,1508,2579
"19256","KITUI","MIGWANI","55",221,298,519
"19257","KITUI","MIGWANI","56",277,300,577
"19258","KITUI","MIGWANI","57",204,253,457
"19259","KITUI","MIGWANI","58",146,187,333
"19260","KITUI","MIGWANI","59",208,270,478
"19261","KITUI","MIGWANI","55-59",1056,1308,2364
"19262","KITUI","MIGWANI","60",260,307,567
"19263","KITUI","MIGWANI","61",199,281,480
"19264","KITUI","MIGWANI","62",150,180,330
"19265","KITUI","MIGWANI","63",174,192,366
"19266","KITUI","MIGWANI","64",108,162,270
"19267","KITUI","MIGWANI","60-64",891,1122,2013
"19268","KITUI","MIGWANI","65",192,228,420
"19269","KITUI","MIGWANI","66",151,155,306
"19270","KITUI","MIGWANI","67",225,273,498
"19271","KITUI","MIGWANI","68",87,115,202
"19272","KITUI","MIGWANI","69",137,178,315
"19273","KITUI","MIGWANI","65-69",792,949,1741
"19274","KITUI","MIGWANI","70",165,320,485
"19275","KITUI","MIGWANI","71",118,167,285
"19276","KITUI","MIGWANI","72",74,100,174
"19277","KITUI","MIGWANI","73",94,98,192
"19278","KITUI","MIGWANI","74",73,122,195
"19279","KITUI","MIGWANI","70-74",524,807,1331
"19280","KITUI","MIGWANI","75",105,109,214
"19281","KITUI","MIGWANI","76",36,60,96
"19282","KITUI","MIGWANI","77",75,107,182
"19283","KITUI","MIGWANI","78",55,46,101
"19284","KITUI","MIGWANI","79",72,123,195
"19285","KITUI","MIGWANI","75-79",343,445,788
"19286","KITUI","MIGWANI","80",81,154,235
"19287","KITUI","MIGWANI","81",54,68,122
"19288","KITUI","MIGWANI","82",49,32,81
"19289","KITUI","MIGWANI","83",44,46,90
"19290","KITUI","MIGWANI","84",54,67,121
"19291","KITUI","MIGWANI","80-84",282,367,649
"19292","KITUI","MIGWANI","85",40,37,77
"19293","KITUI","MIGWANI","86",26,19,45
"19294","KITUI","MIGWANI","87",30,49,79
"19295","KITUI","MIGWANI","88",16,18,34
"19296","KITUI","MIGWANI","89",30,81,111
"19297","KITUI","MIGWANI","85-89",142,204,346
"19298","KITUI","MIGWANI","90",29,82,111
"19299","KITUI","MIGWANI","91",11,28,39
"19300","KITUI","MIGWANI","92",26,29,55
"19301","KITUI","MIGWANI","93",13,14,27
"19302","KITUI","MIGWANI","94",11,23,34
"19303","KITUI","MIGWANI","90-94",90,176,266
"19304","KITUI","MIGWANI","95",12,25,37
"19305","KITUI","MIGWANI","96",9,5,14
"19306","KITUI","MIGWANI","97",13,4,17
"19307","KITUI","MIGWANI","98",7,8,15
"19308","KITUI","MIGWANI","99",13,20,33
"19309","KITUI","MIGWANI","95-99",54,62,116
"19310","KITUI","MIGWANI","100+",23,59,82
"19311","KITUI","MIGWANI","Not Stated",NA,1,1
"19312","KITUI","MUMONI","Total",13748,15596,29344
"19313","KITUI","MUMONI","0",311,329,640
"19314","KITUI","MUMONI","1",336,332,668
"19315","KITUI","MUMONI","2",350,345,695
"19316","KITUI","MUMONI","3",408,399,807
"19317","KITUI","MUMONI","4",379,355,734
"19318","KITUI","MUMONI","0 - 4",1784,1760,3544
"19319","KITUI","MUMONI","5",378,421,799
"19320","KITUI","MUMONI","6",409,439,848
"19321","KITUI","MUMONI","7",340,349,689
"19322","KITUI","MUMONI","8",453,426,879
"19323","KITUI","MUMONI","9",412,414,826
"19324","KITUI","MUMONI","5-9",1992,2049,4041
"19325","KITUI","MUMONI","10",472,472,944
"19326","KITUI","MUMONI","11",469,517,986
"19327","KITUI","MUMONI","12",507,478,985
"19328","KITUI","MUMONI","13",541,537,1078
"19329","KITUI","MUMONI","14",482,511,993
"19330","KITUI","MUMONI","10 -14",2471,2515,4986
"19331","KITUI","MUMONI","15",506,512,1018
"19332","KITUI","MUMONI","16",467,482,949
"19333","KITUI","MUMONI","17",422,424,846
"19334","KITUI","MUMONI","18",341,340,681
"19335","KITUI","MUMONI","19",291,307,598
"19336","KITUI","MUMONI","15-19",2027,2065,4092
"19337","KITUI","MUMONI","20",291,302,593
"19338","KITUI","MUMONI","21",186,240,426
"19339","KITUI","MUMONI","22",174,194,368
"19340","KITUI","MUMONI","23",173,223,396
"19341","KITUI","MUMONI","24",139,193,332
"19342","KITUI","MUMONI","20-24",963,1152,2115
"19343","KITUI","MUMONI","25",172,219,391
"19344","KITUI","MUMONI","26",105,192,297
"19345","KITUI","MUMONI","27",118,168,286
"19346","KITUI","MUMONI","28",117,136,253
"19347","KITUI","MUMONI","29",119,210,329
"19348","KITUI","MUMONI","25-29",631,925,1556
"19349","KITUI","MUMONI","30",118,231,349
"19350","KITUI","MUMONI","31",125,186,311
"19351","KITUI","MUMONI","32",126,195,321
"19352","KITUI","MUMONI","33",131,209,340
"19353","KITUI","MUMONI","34",102,182,284
"19354","KITUI","MUMONI","30-34",602,1003,1605
"19355","KITUI","MUMONI","35",165,218,383
"19356","KITUI","MUMONI","36",87,131,218
"19357","KITUI","MUMONI","37",116,109,225
"19358","KITUI","MUMONI","38",93,83,176
"19359","KITUI","MUMONI","39",126,120,246
"19360","KITUI","MUMONI","35-39",587,661,1248
"19361","KITUI","MUMONI","40",107,123,230
"19362","KITUI","MUMONI","41",107,129,236
"19363","KITUI","MUMONI","42",95,110,205
"19364","KITUI","MUMONI","43",87,125,212
"19365","KITUI","MUMONI","44",106,120,226
"19366","KITUI","MUMONI","40-44",502,607,1109
"19367","KITUI","MUMONI","45",135,173,308
"19368","KITUI","MUMONI","46",91,117,208
"19369","KITUI","MUMONI","47",80,122,202
"19370","KITUI","MUMONI","48",66,77,143
"19371","KITUI","MUMONI","49",103,115,218
"19372","KITUI","MUMONI","45-49",475,604,1079
"19373","KITUI","MUMONI","50",75,113,188
"19374","KITUI","MUMONI","51",72,123,195
"19375","KITUI","MUMONI","52",62,80,142
"19376","KITUI","MUMONI","53",62,73,135
"19377","KITUI","MUMONI","54",54,81,135
"19378","KITUI","MUMONI","50-54",325,470,795
"19379","KITUI","MUMONI","55",73,53,126
"19380","KITUI","MUMONI","56",68,81,149
"19381","KITUI","MUMONI","57",51,90,141
"19382","KITUI","MUMONI","58",48,63,111
"19383","KITUI","MUMONI","59",64,77,141
"19384","KITUI","MUMONI","55-59",304,364,668
"19385","KITUI","MUMONI","60",92,113,205
"19386","KITUI","MUMONI","61",73,62,135
"19387","KITUI","MUMONI","62",42,43,85
"19388","KITUI","MUMONI","63",51,60,111
"19389","KITUI","MUMONI","64",40,46,86
"19390","KITUI","MUMONI","60-64",298,324,622
"19391","KITUI","MUMONI","65",64,81,145
"19392","KITUI","MUMONI","66",41,45,86
"19393","KITUI","MUMONI","67",55,77,132
"19394","KITUI","MUMONI","68",54,65,119
"19395","KITUI","MUMONI","69",40,104,144
"19396","KITUI","MUMONI","65-69",254,372,626
"19397","KITUI","MUMONI","70",63,125,188
"19398","KITUI","MUMONI","71",46,47,93
"19399","KITUI","MUMONI","72",33,28,61
"19400","KITUI","MUMONI","73",42,25,67
"19401","KITUI","MUMONI","74",39,45,84
"19402","KITUI","MUMONI","70-74",223,270,493
"19403","KITUI","MUMONI","75",31,38,69
"19404","KITUI","MUMONI","76",15,21,36
"19405","KITUI","MUMONI","77",18,17,35
"19406","KITUI","MUMONI","78",21,14,35
"19407","KITUI","MUMONI","79",28,60,88
"19408","KITUI","MUMONI","75-79",113,150,263
"19409","KITUI","MUMONI","80",29,62,91
"19410","KITUI","MUMONI","81",13,27,40
"19411","KITUI","MUMONI","82",11,12,23
"19412","KITUI","MUMONI","83",13,13,26
"19413","KITUI","MUMONI","84",20,18,38
"19414","KITUI","MUMONI","80-84",86,132,218
"19415","KITUI","MUMONI","85",18,18,36
"19416","KITUI","MUMONI","86",14,8,22
"19417","KITUI","MUMONI","87",10,13,23
"19418","KITUI","MUMONI","88",7,7,14
"19419","KITUI","MUMONI","89",17,37,54
"19420","KITUI","MUMONI","85-89",66,83,149
"19421","KITUI","MUMONI","90",7,21,28
"19422","KITUI","MUMONI","91",8,5,13
"19423","KITUI","MUMONI","92",5,9,14
"19424","KITUI","MUMONI","93",2,7,9
"19425","KITUI","MUMONI","94",6,5,11
"19426","KITUI","MUMONI","90-94",28,47,75
"19427","KITUI","MUMONI","95",NA,8,8
"19428","KITUI","MUMONI","96",3,4,7
"19429","KITUI","MUMONI","97",3,NA,3
"19430","KITUI","MUMONI","98",1,4,5
"19431","KITUI","MUMONI","99",5,11,16
"19432","KITUI","MUMONI","95-99",12,27,39
"19433","KITUI","MUMONI","100+",5,16,21
"19434","KITUI","MUMONI","Not Stated",NA,NA,NA
"19435","KITUI","MUTITU","Total",26388,28896,55284
"19436","KITUI","MUTITU","0",576,533,1109
"19437","KITUI","MUTITU","1",604,605,1209
"19438","KITUI","MUTITU","2",676,679,1355
"19439","KITUI","MUTITU","3",704,679,1383
"19440","KITUI","MUTITU","4",766,701,1467
"19441","KITUI","MUTITU","0 - 4",3326,3197,6523
"19442","KITUI","MUTITU","5",764,758,1522
"19443","KITUI","MUTITU","6",785,820,1605
"19444","KITUI","MUTITU","7",768,740,1508
"19445","KITUI","MUTITU","8",841,815,1656
"19446","KITUI","MUTITU","9",832,858,1690
"19447","KITUI","MUTITU","5-9",3990,3991,7981
"19448","KITUI","MUTITU","10",965,892,1857
"19449","KITUI","MUTITU","11",895,984,1879
"19450","KITUI","MUTITU","12",1003,1012,2015
"19451","KITUI","MUTITU","13",923,974,1897
"19452","KITUI","MUTITU","14",953,932,1885
"19453","KITUI","MUTITU","10 -14",4739,4794,9533
"19454","KITUI","MUTITU","15",979,961,1940
"19455","KITUI","MUTITU","16",886,908,1794
"19456","KITUI","MUTITU","17",832,770,1602
"19457","KITUI","MUTITU","18",609,568,1177
"19458","KITUI","MUTITU","19",620,557,1177
"19459","KITUI","MUTITU","15-19",3926,3764,7690
"19460","KITUI","MUTITU","20",481,436,917
"19461","KITUI","MUTITU","21",283,372,655
"19462","KITUI","MUTITU","22",309,346,655
"19463","KITUI","MUTITU","23",276,361,637
"19464","KITUI","MUTITU","24",245,320,565
"19465","KITUI","MUTITU","20-24",1594,1835,3429
"19466","KITUI","MUTITU","25",331,386,717
"19467","KITUI","MUTITU","26",198,328,526
"19468","KITUI","MUTITU","27",231,310,541
"19469","KITUI","MUTITU","28",204,246,450
"19470","KITUI","MUTITU","29",223,339,562
"19471","KITUI","MUTITU","25-29",1187,1609,2796
"19472","KITUI","MUTITU","30",275,392,667
"19473","KITUI","MUTITU","31",200,282,482
"19474","KITUI","MUTITU","32",243,366,609
"19475","KITUI","MUTITU","33",272,353,625
"19476","KITUI","MUTITU","34",202,281,483
"19477","KITUI","MUTITU","30-34",1192,1674,2866
"19478","KITUI","MUTITU","35",279,438,717
"19479","KITUI","MUTITU","36",219,252,471
"19480","KITUI","MUTITU","37",223,291,514
"19481","KITUI","MUTITU","38",150,212,362
"19482","KITUI","MUTITU","39",209,257,466
"19483","KITUI","MUTITU","35-39",1080,1450,2530
"19484","KITUI","MUTITU","40",207,237,444
"19485","KITUI","MUTITU","41",247,265,512
"19486","KITUI","MUTITU","42",250,237,487
"19487","KITUI","MUTITU","43",207,248,455
"19488","KITUI","MUTITU","44",210,272,482
"19489","KITUI","MUTITU","40-44",1121,1259,2380
"19490","KITUI","MUTITU","45",315,392,707
"19491","KITUI","MUTITU","46",217,215,432
"19492","KITUI","MUTITU","47",210,234,444
"19493","KITUI","MUTITU","48",122,159,281
"19494","KITUI","MUTITU","49",163,180,343
"19495","KITUI","MUTITU","45-49",1027,1180,2207
"19496","KITUI","MUTITU","50",160,219,379
"19497","KITUI","MUTITU","51",198,218,416
"19498","KITUI","MUTITU","52",114,125,239
"19499","KITUI","MUTITU","53",85,102,187
"19500","KITUI","MUTITU","54",171,146,317
"19501","KITUI","MUTITU","50-54",728,810,1538
"19502","KITUI","MUTITU","55",123,123,246
"19503","KITUI","MUTITU","56",137,120,257
"19504","KITUI","MUTITU","57",79,114,193
"19505","KITUI","MUTITU","58",78,87,165
"19506","KITUI","MUTITU","59",109,200,309
"19507","KITUI","MUTITU","55-59",526,644,1170
"19508","KITUI","MUTITU","60",139,180,319
"19509","KITUI","MUTITU","61",129,156,285
"19510","KITUI","MUTITU","62",79,112,191
"19511","KITUI","MUTITU","63",101,112,213
"19512","KITUI","MUTITU","64",97,126,223
"19513","KITUI","MUTITU","60-64",545,686,1231
"19514","KITUI","MUTITU","65",112,140,252
"19515","KITUI","MUTITU","66",81,67,148
"19516","KITUI","MUTITU","67",122,111,233
"19517","KITUI","MUTITU","68",56,68,124
"19518","KITUI","MUTITU","69",77,119,196
"19519","KITUI","MUTITU","65-69",448,505,953
"19520","KITUI","MUTITU","70",122,180,302
"19521","KITUI","MUTITU","71",72,120,192
"19522","KITUI","MUTITU","72",55,59,114
"19523","KITUI","MUTITU","73",65,149,214
"19524","KITUI","MUTITU","74",64,121,185
"19525","KITUI","MUTITU","70-74",378,629,1007
"19526","KITUI","MUTITU","75",56,64,120
"19527","KITUI","MUTITU","76",24,34,58
"19528","KITUI","MUTITU","77",33,59,92
"19529","KITUI","MUTITU","78",40,38,78
"19530","KITUI","MUTITU","79",62,88,150
"19531","KITUI","MUTITU","75-79",215,283,498
"19532","KITUI","MUTITU","80",43,108,151
"19533","KITUI","MUTITU","81",40,48,88
"19534","KITUI","MUTITU","82",19,24,43
"19535","KITUI","MUTITU","83",29,59,88
"19536","KITUI","MUTITU","84",53,70,123
"19537","KITUI","MUTITU","80-84",184,309,493
"19538","KITUI","MUTITU","85",22,30,52
"19539","KITUI","MUTITU","86",12,11,23
"19540","KITUI","MUTITU","87",21,17,38
"19541","KITUI","MUTITU","88",13,9,22
"19542","KITUI","MUTITU","89",26,47,73
"19543","KITUI","MUTITU","85-89",94,114,208
"19544","KITUI","MUTITU","90",22,46,68
"19545","KITUI","MUTITU","91",10,17,27
"19546","KITUI","MUTITU","92",8,7,15
"19547","KITUI","MUTITU","93",4,9,13
"19548","KITUI","MUTITU","94",5,9,14
"19549","KITUI","MUTITU","90-94",49,88,137
"19550","KITUI","MUTITU","95",19,39,58
"19551","KITUI","MUTITU","96",2,3,5
"19552","KITUI","MUTITU","97",3,6,9
"19553","KITUI","MUTITU","98",2,5,7
"19554","KITUI","MUTITU","99",7,8,15
"19555","KITUI","MUTITU","95-99",33,61,94
"19556","KITUI","MUTITU","100+",6,13,19
"19557","KITUI","MUTITU","Not Stated",NA,1,1
"19558","KITUI","MUTITU NORTH","Total",10337,10877,21214
"19559","KITUI","MUTITU NORTH","0",217,219,436
"19560","KITUI","MUTITU NORTH","1",221,205,426
"19561","KITUI","MUTITU NORTH","2",220,232,452
"19562","KITUI","MUTITU NORTH","3",229,207,436
"19563","KITUI","MUTITU NORTH","4",241,237,478
"19564","KITUI","MUTITU NORTH","0 - 4",1128,1100,2228
"19565","KITUI","MUTITU NORTH","5",271,233,504
"19566","KITUI","MUTITU NORTH","6",287,235,522
"19567","KITUI","MUTITU NORTH","7",257,241,498
"19568","KITUI","MUTITU NORTH","8",316,260,576
"19569","KITUI","MUTITU NORTH","9",287,311,598
"19570","KITUI","MUTITU NORTH","5-9",1418,1280,2698
"19571","KITUI","MUTITU NORTH","10",299,323,622
"19572","KITUI","MUTITU NORTH","11",324,354,678
"19573","KITUI","MUTITU NORTH","12",344,298,642
"19574","KITUI","MUTITU NORTH","13",354,409,763
"19575","KITUI","MUTITU NORTH","14",339,310,649
"19576","KITUI","MUTITU NORTH","10 -14",1660,1694,3354
"19577","KITUI","MUTITU NORTH","15",376,346,722
"19578","KITUI","MUTITU NORTH","16",325,314,639
"19579","KITUI","MUTITU NORTH","17",307,306,613
"19580","KITUI","MUTITU NORTH","18",241,212,453
"19581","KITUI","MUTITU NORTH","19",233,199,432
"19582","KITUI","MUTITU NORTH","15-19",1482,1377,2859
"19583","KITUI","MUTITU NORTH","20",203,160,363
"19584","KITUI","MUTITU NORTH","21",130,149,279
"19585","KITUI","MUTITU NORTH","22",121,128,249
"19586","KITUI","MUTITU NORTH","23",122,148,270
"19587","KITUI","MUTITU NORTH","24",111,108,219
"19588","KITUI","MUTITU NORTH","20-24",687,693,1380
"19589","KITUI","MUTITU NORTH","25",142,147,289
"19590","KITUI","MUTITU NORTH","26",105,125,230
"19591","KITUI","MUTITU NORTH","27",108,119,227
"19592","KITUI","MUTITU NORTH","28",75,102,177
"19593","KITUI","MUTITU NORTH","29",101,149,250
"19594","KITUI","MUTITU NORTH","25-29",531,642,1173
"19595","KITUI","MUTITU NORTH","30",89,137,226
"19596","KITUI","MUTITU NORTH","31",84,119,203
"19597","KITUI","MUTITU NORTH","32",121,141,262
"19598","KITUI","MUTITU NORTH","33",103,140,243
"19599","KITUI","MUTITU NORTH","34",87,116,203
"19600","KITUI","MUTITU NORTH","30-34",484,653,1137
"19601","KITUI","MUTITU NORTH","35",128,160,288
"19602","KITUI","MUTITU NORTH","36",97,78,175
"19603","KITUI","MUTITU NORTH","37",111,115,226
"19604","KITUI","MUTITU NORTH","38",64,73,137
"19605","KITUI","MUTITU NORTH","39",116,94,210
"19606","KITUI","MUTITU NORTH","35-39",516,520,1036
"19607","KITUI","MUTITU NORTH","40",117,118,235
"19608","KITUI","MUTITU NORTH","41",101,119,220
"19609","KITUI","MUTITU NORTH","42",89,89,178
"19610","KITUI","MUTITU NORTH","43",83,121,204
"19611","KITUI","MUTITU NORTH","44",72,102,174
"19612","KITUI","MUTITU NORTH","40-44",462,549,1011
"19613","KITUI","MUTITU NORTH","45",122,154,276
"19614","KITUI","MUTITU NORTH","46",94,103,197
"19615","KITUI","MUTITU NORTH","47",67,93,160
"19616","KITUI","MUTITU NORTH","48",50,51,101
"19617","KITUI","MUTITU NORTH","49",81,88,169
"19618","KITUI","MUTITU NORTH","45-49",414,489,903
"19619","KITUI","MUTITU NORTH","50",78,71,149
"19620","KITUI","MUTITU NORTH","51",85,90,175
"19621","KITUI","MUTITU NORTH","52",64,74,138
"19622","KITUI","MUTITU NORTH","53",51,57,108
"19623","KITUI","MUTITU NORTH","54",74,45,119
"19624","KITUI","MUTITU NORTH","50-54",352,337,689
"19625","KITUI","MUTITU NORTH","55",78,74,152
"19626","KITUI","MUTITU NORTH","56",67,80,147
"19627","KITUI","MUTITU NORTH","57",55,70,125
"19628","KITUI","MUTITU NORTH","58",33,47,80
"19629","KITUI","MUTITU NORTH","59",68,70,138
"19630","KITUI","MUTITU NORTH","55-59",301,341,642
"19631","KITUI","MUTITU NORTH","60",55,83,138
"19632","KITUI","MUTITU NORTH","61",53,68,121
"19633","KITUI","MUTITU NORTH","62",54,60,114
"19634","KITUI","MUTITU NORTH","63",37,51,88
"19635","KITUI","MUTITU NORTH","64",32,26,58
"19636","KITUI","MUTITU NORTH","60-64",231,288,519
"19637","KITUI","MUTITU NORTH","65",48,52,100
"19638","KITUI","MUTITU NORTH","66",29,36,65
"19639","KITUI","MUTITU NORTH","67",79,55,134
"19640","KITUI","MUTITU NORTH","68",32,47,79
"19641","KITUI","MUTITU NORTH","69",48,66,114
"19642","KITUI","MUTITU NORTH","65-69",236,256,492
"19643","KITUI","MUTITU NORTH","70",45,92,137
"19644","KITUI","MUTITU NORTH","71",39,53,92
"19645","KITUI","MUTITU NORTH","72",30,37,67
"19646","KITUI","MUTITU NORTH","73",19,27,46
"19647","KITUI","MUTITU NORTH","74",22,49,71
"19648","KITUI","MUTITU NORTH","70-74",155,258,413
"19649","KITUI","MUTITU NORTH","75",28,55,83
"19650","KITUI","MUTITU NORTH","76",25,27,52
"19651","KITUI","MUTITU NORTH","77",18,18,36
"19652","KITUI","MUTITU NORTH","78",11,16,27
"19653","KITUI","MUTITU NORTH","79",17,42,59
"19654","KITUI","MUTITU NORTH","75-79",99,158,257
"19655","KITUI","MUTITU NORTH","80",27,39,66
"19656","KITUI","MUTITU NORTH","81",15,18,33
"19657","KITUI","MUTITU NORTH","82",18,11,29
"19658","KITUI","MUTITU NORTH","83",16,21,37
"19659","KITUI","MUTITU NORTH","84",19,18,37
"19660","KITUI","MUTITU NORTH","80-84",95,107,202
"19661","KITUI","MUTITU NORTH","85",15,20,35
"19662","KITUI","MUTITU NORTH","86",18,9,27
"19663","KITUI","MUTITU NORTH","87",9,19,28
"19664","KITUI","MUTITU NORTH","88",11,10,21
"19665","KITUI","MUTITU NORTH","89",3,21,24
"19666","KITUI","MUTITU NORTH","85-89",56,79,135
"19667","KITUI","MUTITU NORTH","90",8,18,26
"19668","KITUI","MUTITU NORTH","91",4,5,9
"19669","KITUI","MUTITU NORTH","92",2,NA,2
"19670","KITUI","MUTITU NORTH","93",4,6,10
"19671","KITUI","MUTITU NORTH","94",NA,3,3
"19672","KITUI","MUTITU NORTH","90-94",18,32,50
"19673","KITUI","MUTITU NORTH","95",1,6,7
"19674","KITUI","MUTITU NORTH","96",1,2,3
"19675","KITUI","MUTITU NORTH","97",3,3,6
"19676","KITUI","MUTITU NORTH","98",1,1,2
"19677","KITUI","MUTITU NORTH","99",1,5,6
"19678","KITUI","MUTITU NORTH","95-99",7,17,24
"19679","KITUI","MUTITU NORTH","100+",5,7,12
"19680","KITUI","MUTITU NORTH","Not Stated",NA,NA,NA
"19681","KITUI","MUTOMO","Total",54819,58531,113350
"19682","KITUI","MUTOMO","0",1223,1147,2370
"19683","KITUI","MUTOMO","1",1192,1169,2361
"19684","KITUI","MUTOMO","2",1307,1254,2561
"19685","KITUI","MUTOMO","3",1329,1309,2638
"19686","KITUI","MUTOMO","4",1384,1359,2743
"19687","KITUI","MUTOMO","0 - 4",6435,6238,12673
"19688","KITUI","MUTOMO","5",1523,1486,3009
"19689","KITUI","MUTOMO","6",1503,1541,3044
"19690","KITUI","MUTOMO","7",1480,1479,2959
"19691","KITUI","MUTOMO","8",1734,1740,3474
"19692","KITUI","MUTOMO","9",1721,1673,3394
"19693","KITUI","MUTOMO","5-9",7961,7919,15880
"19694","KITUI","MUTOMO","10",1869,1856,3725
"19695","KITUI","MUTOMO","11",1817,1953,3770
"19696","KITUI","MUTOMO","12",2103,1911,4014
"19697","KITUI","MUTOMO","13",1900,1846,3746
"19698","KITUI","MUTOMO","14",1793,1729,3522
"19699","KITUI","MUTOMO","10 -14",9482,9295,18777
"19700","KITUI","MUTOMO","15",1875,1864,3739
"19701","KITUI","MUTOMO","16",1871,1777,3648
"19702","KITUI","MUTOMO","17",1910,1742,3652
"19703","KITUI","MUTOMO","18",1433,1283,2716
"19704","KITUI","MUTOMO","19",1320,1176,2496
"19705","KITUI","MUTOMO","15-19",8409,7842,16251
"19706","KITUI","MUTOMO","20",1112,1119,2231
"19707","KITUI","MUTOMO","21",840,768,1608
"19708","KITUI","MUTOMO","22",698,712,1410
"19709","KITUI","MUTOMO","23",671,774,1445
"19710","KITUI","MUTOMO","24",568,619,1187
"19711","KITUI","MUTOMO","20-24",3889,3992,7881
"19712","KITUI","MUTOMO","25",673,751,1424
"19713","KITUI","MUTOMO","26",457,585,1042
"19714","KITUI","MUTOMO","27",558,598,1156
"19715","KITUI","MUTOMO","28",409,518,927
"19716","KITUI","MUTOMO","29",539,668,1207
"19717","KITUI","MUTOMO","25-29",2636,3120,5756
"19718","KITUI","MUTOMO","30",608,798,1406
"19719","KITUI","MUTOMO","31",479,607,1086
"19720","KITUI","MUTOMO","32",591,771,1362
"19721","KITUI","MUTOMO","33",542,678,1220
"19722","KITUI","MUTOMO","34",394,567,961
"19723","KITUI","MUTOMO","30-34",2614,3421,6035
"19724","KITUI","MUTOMO","35",572,773,1345
"19725","KITUI","MUTOMO","36",423,525,948
"19726","KITUI","MUTOMO","37",443,585,1028
"19727","KITUI","MUTOMO","38",294,439,733
"19728","KITUI","MUTOMO","39",469,635,1104
"19729","KITUI","MUTOMO","35-39",2201,2957,5158
"19730","KITUI","MUTOMO","40",484,550,1034
"19731","KITUI","MUTOMO","41",497,580,1077
"19732","KITUI","MUTOMO","42",435,547,982
"19733","KITUI","MUTOMO","43",395,514,909
"19734","KITUI","MUTOMO","44",403,521,924
"19735","KITUI","MUTOMO","40-44",2214,2712,4926
"19736","KITUI","MUTOMO","45",655,772,1427
"19737","KITUI","MUTOMO","46",420,501,921
"19738","KITUI","MUTOMO","47",416,487,903
"19739","KITUI","MUTOMO","48",350,349,699
"19740","KITUI","MUTOMO","49",357,476,833
"19741","KITUI","MUTOMO","45-49",2198,2585,4783
"19742","KITUI","MUTOMO","50",363,449,812
"19743","KITUI","MUTOMO","51",370,399,769
"19744","KITUI","MUTOMO","52",263,245,508
"19745","KITUI","MUTOMO","53",197,219,416
"19746","KITUI","MUTOMO","54",281,267,548
"19747","KITUI","MUTOMO","50-54",1474,1579,3053
"19748","KITUI","MUTOMO","55",244,243,487
"19749","KITUI","MUTOMO","56",334,285,619
"19750","KITUI","MUTOMO","57",249,295,544
"19751","KITUI","MUTOMO","58",162,249,411
"19752","KITUI","MUTOMO","59",242,352,594
"19753","KITUI","MUTOMO","55-59",1231,1424,2655
"19754","KITUI","MUTOMO","60",303,358,661
"19755","KITUI","MUTOMO","61",232,289,521
"19756","KITUI","MUTOMO","62",194,186,380
"19757","KITUI","MUTOMO","63",202,253,455
"19758","KITUI","MUTOMO","64",184,327,511
"19759","KITUI","MUTOMO","60-64",1115,1413,2528
"19760","KITUI","MUTOMO","65",218,266,484
"19761","KITUI","MUTOMO","66",151,136,287
"19762","KITUI","MUTOMO","67",261,247,508
"19763","KITUI","MUTOMO","68",108,104,212
"19764","KITUI","MUTOMO","69",186,234,420
"19765","KITUI","MUTOMO","65-69",924,987,1911
"19766","KITUI","MUTOMO","70",206,263,469
"19767","KITUI","MUTOMO","71",148,203,351
"19768","KITUI","MUTOMO","72",117,155,272
"19769","KITUI","MUTOMO","73",213,479,692
"19770","KITUI","MUTOMO","74",135,188,323
"19771","KITUI","MUTOMO","70-74",819,1288,2107
"19772","KITUI","MUTOMO","75",127,157,284
"19773","KITUI","MUTOMO","76",88,127,215
"19774","KITUI","MUTOMO","77",87,117,204
"19775","KITUI","MUTOMO","78",71,67,138
"19776","KITUI","MUTOMO","79",71,174,245
"19777","KITUI","MUTOMO","75-79",444,642,1086
"19778","KITUI","MUTOMO","80",113,148,261
"19779","KITUI","MUTOMO","81",52,92,144
"19780","KITUI","MUTOMO","82",53,42,95
"19781","KITUI","MUTOMO","83",61,96,157
"19782","KITUI","MUTOMO","84",98,220,318
"19783","KITUI","MUTOMO","80-84",377,598,975
"19784","KITUI","MUTOMO","85",49,56,105
"19785","KITUI","MUTOMO","86",42,15,57
"19786","KITUI","MUTOMO","87",38,33,71
"19787","KITUI","MUTOMO","88",18,14,32
"19788","KITUI","MUTOMO","89",46,86,132
"19789","KITUI","MUTOMO","85-89",193,204,397
"19790","KITUI","MUTOMO","90",54,99,153
"19791","KITUI","MUTOMO","91",27,48,75
"19792","KITUI","MUTOMO","92",18,22,40
"19793","KITUI","MUTOMO","93",9,18,27
"19794","KITUI","MUTOMO","94",21,26,47
"19795","KITUI","MUTOMO","90-94",129,213,342
"19796","KITUI","MUTOMO","95",18,19,37
"19797","KITUI","MUTOMO","96",7,7,14
"19798","KITUI","MUTOMO","97",10,8,18
"19799","KITUI","MUTOMO","98",9,10,19
"19800","KITUI","MUTOMO","99",12,23,35
"19801","KITUI","MUTOMO","95-99",56,67,123
"19802","KITUI","MUTOMO","100+",18,34,52
"19803","KITUI","MUTOMO","Not Stated",NA,1,1
"19804","KITUI","MWINGI CENTRAL","Total",52539,56174,108713
"19805","KITUI","MWINGI CENTRAL","0",1258,1161,2419
"19806","KITUI","MWINGI CENTRAL","1",1259,1242,2501
"19807","KITUI","MWINGI CENTRAL","2",1318,1240,2558
"19808","KITUI","MWINGI CENTRAL","3",1319,1293,2612
"19809","KITUI","MWINGI CENTRAL","4",1302,1224,2526
"19810","KITUI","MWINGI CENTRAL","0 - 4",6456,6160,12616
"19811","KITUI","MWINGI CENTRAL","5",1351,1367,2718
"19812","KITUI","MWINGI CENTRAL","6",1363,1373,2736
"19813","KITUI","MWINGI CENTRAL","7",1261,1295,2556
"19814","KITUI","MWINGI CENTRAL","8",1388,1335,2723
"19815","KITUI","MWINGI CENTRAL","9",1534,1364,2898
"19816","KITUI","MWINGI CENTRAL","5-9",6897,6734,13631
"19817","KITUI","MWINGI CENTRAL","10",1463,1470,2933
"19818","KITUI","MWINGI CENTRAL","11",1529,1550,3079
"19819","KITUI","MWINGI CENTRAL","12",1711,1467,3178
"19820","KITUI","MWINGI CENTRAL","13",1600,1613,3213
"19821","KITUI","MWINGI CENTRAL","14",1643,1559,3202
"19822","KITUI","MWINGI CENTRAL","10 -14",7946,7659,15605
"19823","KITUI","MWINGI CENTRAL","15",1647,1588,3235
"19824","KITUI","MWINGI CENTRAL","16",1522,1577,3099
"19825","KITUI","MWINGI CENTRAL","17",1570,1511,3081
"19826","KITUI","MWINGI CENTRAL","18",1133,1095,2228
"19827","KITUI","MWINGI CENTRAL","19",1250,1189,2439
"19828","KITUI","MWINGI CENTRAL","15-19",7122,6960,14082
"19829","KITUI","MWINGI CENTRAL","20",1094,1240,2334
"19830","KITUI","MWINGI CENTRAL","21",955,1094,2049
"19831","KITUI","MWINGI CENTRAL","22",902,975,1877
"19832","KITUI","MWINGI CENTRAL","23",854,1041,1895
"19833","KITUI","MWINGI CENTRAL","24",781,933,1714
"19834","KITUI","MWINGI CENTRAL","20-24",4586,5283,9869
"19835","KITUI","MWINGI CENTRAL","25",934,1053,1987
"19836","KITUI","MWINGI CENTRAL","26",613,750,1363
"19837","KITUI","MWINGI CENTRAL","27",716,786,1502
"19838","KITUI","MWINGI CENTRAL","28",577,674,1251
"19839","KITUI","MWINGI CENTRAL","29",632,859,1491
"19840","KITUI","MWINGI CENTRAL","25-29",3472,4122,7594
"19841","KITUI","MWINGI CENTRAL","30",789,1016,1805
"19842","KITUI","MWINGI CENTRAL","31",555,682,1237
"19843","KITUI","MWINGI CENTRAL","32",622,876,1498
"19844","KITUI","MWINGI CENTRAL","33",579,782,1361
"19845","KITUI","MWINGI CENTRAL","34",479,658,1137
"19846","KITUI","MWINGI CENTRAL","30-34",3024,4014,7038
"19847","KITUI","MWINGI CENTRAL","35",658,772,1430
"19848","KITUI","MWINGI CENTRAL","36",433,534,967
"19849","KITUI","MWINGI CENTRAL","37",518,593,1111
"19850","KITUI","MWINGI CENTRAL","38",383,461,844
"19851","KITUI","MWINGI CENTRAL","39",494,533,1027
"19852","KITUI","MWINGI CENTRAL","35-39",2486,2893,5379
"19853","KITUI","MWINGI CENTRAL","40",527,554,1081
"19854","KITUI","MWINGI CENTRAL","41",497,555,1052
"19855","KITUI","MWINGI CENTRAL","42",394,510,904
"19856","KITUI","MWINGI CENTRAL","43",357,487,844
"19857","KITUI","MWINGI CENTRAL","44",375,467,842
"19858","KITUI","MWINGI CENTRAL","40-44",2150,2573,4723
"19859","KITUI","MWINGI CENTRAL","45",537,663,1200
"19860","KITUI","MWINGI CENTRAL","46",440,458,898
"19861","KITUI","MWINGI CENTRAL","47",360,406,766
"19862","KITUI","MWINGI CENTRAL","48",332,319,651
"19863","KITUI","MWINGI CENTRAL","49",379,416,795
"19864","KITUI","MWINGI CENTRAL","45-49",2048,2262,4310
"19865","KITUI","MWINGI CENTRAL","50",386,479,865
"19866","KITUI","MWINGI CENTRAL","51",290,355,645
"19867","KITUI","MWINGI CENTRAL","52",275,292,567
"19868","KITUI","MWINGI CENTRAL","53",200,233,433
"19869","KITUI","MWINGI CENTRAL","54",318,339,657
"19870","KITUI","MWINGI CENTRAL","50-54",1469,1698,3167
"19871","KITUI","MWINGI CENTRAL","55",320,287,607
"19872","KITUI","MWINGI CENTRAL","56",338,349,687
"19873","KITUI","MWINGI CENTRAL","57",247,265,512
"19874","KITUI","MWINGI CENTRAL","58",169,180,349
"19875","KITUI","MWINGI CENTRAL","59",255,270,525
"19876","KITUI","MWINGI CENTRAL","55-59",1329,1351,2680
"19877","KITUI","MWINGI CENTRAL","60",266,337,603
"19878","KITUI","MWINGI CENTRAL","61",224,248,472
"19879","KITUI","MWINGI CENTRAL","62",174,175,349
"19880","KITUI","MWINGI CENTRAL","63",159,194,353
"19881","KITUI","MWINGI CENTRAL","64",136,169,305
"19882","KITUI","MWINGI CENTRAL","60-64",959,1123,2082
"19883","KITUI","MWINGI CENTRAL","65",206,257,463
"19884","KITUI","MWINGI CENTRAL","66",152,158,310
"19885","KITUI","MWINGI CENTRAL","67",235,251,486
"19886","KITUI","MWINGI CENTRAL","68",121,143,264
"19887","KITUI","MWINGI CENTRAL","69",159,307,466
"19888","KITUI","MWINGI CENTRAL","65-69",873,1116,1989
"19889","KITUI","MWINGI CENTRAL","70",209,264,473
"19890","KITUI","MWINGI CENTRAL","71",149,135,284
"19891","KITUI","MWINGI CENTRAL","72",116,118,234
"19892","KITUI","MWINGI CENTRAL","73",99,136,235
"19893","KITUI","MWINGI CENTRAL","74",106,149,255
"19894","KITUI","MWINGI CENTRAL","70-74",679,802,1481
"19895","KITUI","MWINGI CENTRAL","75",88,110,198
"19896","KITUI","MWINGI CENTRAL","76",80,74,154
"19897","KITUI","MWINGI CENTRAL","77",84,100,184
"19898","KITUI","MWINGI CENTRAL","78",71,61,132
"19899","KITUI","MWINGI CENTRAL","79",87,164,251
"19900","KITUI","MWINGI CENTRAL","75-79",410,509,919
"19901","KITUI","MWINGI CENTRAL","80",108,151,259
"19902","KITUI","MWINGI CENTRAL","81",42,74,116
"19903","KITUI","MWINGI CENTRAL","82",47,48,95
"19904","KITUI","MWINGI CENTRAL","83",50,64,114
"19905","KITUI","MWINGI CENTRAL","84",62,101,163
"19906","KITUI","MWINGI CENTRAL","80-84",309,438,747
"19907","KITUI","MWINGI CENTRAL","85",35,46,81
"19908","KITUI","MWINGI CENTRAL","86",24,26,50
"19909","KITUI","MWINGI CENTRAL","87",29,31,60
"19910","KITUI","MWINGI CENTRAL","88",12,18,30
"19911","KITUI","MWINGI CENTRAL","89",53,74,127
"19912","KITUI","MWINGI CENTRAL","85-89",153,195,348
"19913","KITUI","MWINGI CENTRAL","90",30,57,87
"19914","KITUI","MWINGI CENTRAL","91",19,41,60
"19915","KITUI","MWINGI CENTRAL","92",24,31,55
"19916","KITUI","MWINGI CENTRAL","93",6,9,15
"19917","KITUI","MWINGI CENTRAL","94",11,22,33
"19918","KITUI","MWINGI CENTRAL","90-94",90,160,250
"19919","KITUI","MWINGI CENTRAL","95",22,18,40
"19920","KITUI","MWINGI CENTRAL","96",5,7,12
"19921","KITUI","MWINGI CENTRAL","97",6,7,13
"19922","KITUI","MWINGI CENTRAL","98",5,7,12
"19923","KITUI","MWINGI CENTRAL","99",17,38,55
"19924","KITUI","MWINGI CENTRAL","95-99",55,77,132
"19925","KITUI","MWINGI CENTRAL","100+",26,45,71
"19926","KITUI","MWINGI CENTRAL","Not Stated",NA,NA,NA
"19927","KITUI","MWINGI EAST","Total",40314,44820,85134
"19928","KITUI","MWINGI EAST","0",897,887,1784
"19929","KITUI","MWINGI EAST","1",923,978,1901
"19930","KITUI","MWINGI EAST","2",1022,1068,2090
"19931","KITUI","MWINGI EAST","3",1156,1126,2282
"19932","KITUI","MWINGI EAST","4",1147,1092,2239
"19933","KITUI","MWINGI EAST","0 - 4",5145,5151,10296
"19934","KITUI","MWINGI EAST","5",1181,1148,2329
"19935","KITUI","MWINGI EAST","6",1259,1282,2541
"19936","KITUI","MWINGI EAST","7",1190,1090,2280
"19937","KITUI","MWINGI EAST","8",1279,1266,2545
"19938","KITUI","MWINGI EAST","9",1290,1307,2597
"19939","KITUI","MWINGI EAST","5-9",6199,6093,12292
"19940","KITUI","MWINGI EAST","10",1381,1369,2750
"19941","KITUI","MWINGI EAST","11",1415,1579,2994
"19942","KITUI","MWINGI EAST","12",1518,1394,2912
"19943","KITUI","MWINGI EAST","13",1528,1439,2967
"19944","KITUI","MWINGI EAST","14",1509,1434,2943
"19945","KITUI","MWINGI EAST","10 -14",7351,7215,14566
"19946","KITUI","MWINGI EAST","15",1472,1452,2924
"19947","KITUI","MWINGI EAST","16",1388,1353,2741
"19948","KITUI","MWINGI EAST","17",1263,1231,2494
"19949","KITUI","MWINGI EAST","18",917,941,1858
"19950","KITUI","MWINGI EAST","19",965,896,1861
"19951","KITUI","MWINGI EAST","15-19",6005,5873,11878
"19952","KITUI","MWINGI EAST","20",752,735,1487
"19953","KITUI","MWINGI EAST","21",571,606,1177
"19954","KITUI","MWINGI EAST","22",480,592,1072
"19955","KITUI","MWINGI EAST","23",476,579,1055
"19956","KITUI","MWINGI EAST","24",408,530,938
"19957","KITUI","MWINGI EAST","20-24",2687,3042,5729
"19958","KITUI","MWINGI EAST","25",399,526,925
"19959","KITUI","MWINGI EAST","26",335,441,776
"19960","KITUI","MWINGI EAST","27",344,478,822
"19961","KITUI","MWINGI EAST","28",279,407,686
"19962","KITUI","MWINGI EAST","29",325,494,819
"19963","KITUI","MWINGI EAST","25-29",1682,2346,4028
"19964","KITUI","MWINGI EAST","30",419,605,1024
"19965","KITUI","MWINGI EAST","31",332,493,825
"19966","KITUI","MWINGI EAST","32",356,566,922
"19967","KITUI","MWINGI EAST","33",330,602,932
"19968","KITUI","MWINGI EAST","34",307,518,825
"19969","KITUI","MWINGI EAST","30-34",1744,2784,4528
"19970","KITUI","MWINGI EAST","35",397,579,976
"19971","KITUI","MWINGI EAST","36",257,390,647
"19972","KITUI","MWINGI EAST","37",329,398,727
"19973","KITUI","MWINGI EAST","38",228,291,519
"19974","KITUI","MWINGI EAST","39",326,396,722
"19975","KITUI","MWINGI EAST","35-39",1537,2054,3591
"19976","KITUI","MWINGI EAST","40",296,363,659
"19977","KITUI","MWINGI EAST","41",317,379,696
"19978","KITUI","MWINGI EAST","42",290,365,655
"19979","KITUI","MWINGI EAST","43",286,412,698
"19980","KITUI","MWINGI EAST","44",259,378,637
"19981","KITUI","MWINGI EAST","40-44",1448,1897,3345
"19982","KITUI","MWINGI EAST","45",410,586,996
"19983","KITUI","MWINGI EAST","46",345,362,707
"19984","KITUI","MWINGI EAST","47",289,330,619
"19985","KITUI","MWINGI EAST","48",189,267,456
"19986","KITUI","MWINGI EAST","49",257,309,566
"19987","KITUI","MWINGI EAST","45-49",1490,1854,3344
"19988","KITUI","MWINGI EAST","50",245,318,563
"19989","KITUI","MWINGI EAST","51",255,342,597
"19990","KITUI","MWINGI EAST","52",160,254,414
"19991","KITUI","MWINGI EAST","53",155,193,348
"19992","KITUI","MWINGI EAST","54",175,241,416
"19993","KITUI","MWINGI EAST","50-54",990,1348,2338
"19994","KITUI","MWINGI EAST","55",232,226,458
"19995","KITUI","MWINGI EAST","56",251,254,505
"19996","KITUI","MWINGI EAST","57",166,216,382
"19997","KITUI","MWINGI EAST","58",131,164,295
"19998","KITUI","MWINGI EAST","59",143,248,391
"19999","KITUI","MWINGI EAST","55-59",923,1108,2031
"20000","KITUI","MWINGI EAST","60",207,233,440
"20001","KITUI","MWINGI EAST","61",165,187,352
"20002","KITUI","MWINGI EAST","62",138,181,319
"20003","KITUI","MWINGI EAST","63",136,164,300
"20004","KITUI","MWINGI EAST","64",120,139,259
"20005","KITUI","MWINGI EAST","60-64",766,904,1670
"20006","KITUI","MWINGI EAST","65",161,210,371
"20007","KITUI","MWINGI EAST","66",126,133,259
"20008","KITUI","MWINGI EAST","67",193,217,410
"20009","KITUI","MWINGI EAST","68",130,145,275
"20010","KITUI","MWINGI EAST","69",154,262,416
"20011","KITUI","MWINGI EAST","65-69",764,967,1731
"20012","KITUI","MWINGI EAST","70",156,258,414
"20013","KITUI","MWINGI EAST","71",121,154,275
"20014","KITUI","MWINGI EAST","72",85,101,186
"20015","KITUI","MWINGI EAST","73",107,152,259
"20016","KITUI","MWINGI EAST","74",80,160,240
"20017","KITUI","MWINGI EAST","70-74",549,825,1374
"20018","KITUI","MWINGI EAST","75",102,152,254
"20019","KITUI","MWINGI EAST","76",67,77,144
"20020","KITUI","MWINGI EAST","77",65,85,150
"20021","KITUI","MWINGI EAST","78",59,64,123
"20022","KITUI","MWINGI EAST","79",83,117,200
"20023","KITUI","MWINGI EAST","75-79",376,495,871
"20024","KITUI","MWINGI EAST","80",100,145,245
"20025","KITUI","MWINGI EAST","81",49,59,108
"20026","KITUI","MWINGI EAST","82",43,46,89
"20027","KITUI","MWINGI EAST","83",50,62,112
"20028","KITUI","MWINGI EAST","84",62,109,171
"20029","KITUI","MWINGI EAST","80-84",304,421,725
"20030","KITUI","MWINGI EAST","85",44,56,100
"20031","KITUI","MWINGI EAST","86",32,15,47
"20032","KITUI","MWINGI EAST","87",36,34,70
"20033","KITUI","MWINGI EAST","88",19,21,40
"20034","KITUI","MWINGI EAST","89",39,69,108
"20035","KITUI","MWINGI EAST","85-89",170,195,365
"20036","KITUI","MWINGI EAST","90",40,54,94
"20037","KITUI","MWINGI EAST","91",19,35,54
"20038","KITUI","MWINGI EAST","92",17,30,47
"20039","KITUI","MWINGI EAST","93",15,13,28
"20040","KITUI","MWINGI EAST","94",18,18,36
"20041","KITUI","MWINGI EAST","90-94",109,150,259
"20042","KITUI","MWINGI EAST","95",19,15,34
"20043","KITUI","MWINGI EAST","96",4,14,18
"20044","KITUI","MWINGI EAST","97",8,7,15
"20045","KITUI","MWINGI EAST","98",1,6,7
"20046","KITUI","MWINGI EAST","99",13,20,33
"20047","KITUI","MWINGI EAST","95-99",45,62,107
"20048","KITUI","MWINGI EAST","100+",29,36,65
"20049","KITUI","MWINGI EAST","Not Stated",1,NA,1
"20050","KITUI","NZAMBANI","Total",22929,23857,46786
"20051","KITUI","NZAMBANI","0",487,457,944
"20052","KITUI","NZAMBANI","1",529,498,1027
"20053","KITUI","NZAMBANI","2",517,541,1058
"20054","KITUI","NZAMBANI","3",491,498,989
"20055","KITUI","NZAMBANI","4",568,508,1076
"20056","KITUI","NZAMBANI","0 - 4",2592,2502,5094
"20057","KITUI","NZAMBANI","5",558,545,1103
"20058","KITUI","NZAMBANI","6",499,515,1014
"20059","KITUI","NZAMBANI","7",529,500,1029
"20060","KITUI","NZAMBANI","8",557,557,1114
"20061","KITUI","NZAMBANI","9",573,615,1188
"20062","KITUI","NZAMBANI","5-9",2716,2732,5448
"20063","KITUI","NZAMBANI","10",624,656,1280
"20064","KITUI","NZAMBANI","11",655,656,1311
"20065","KITUI","NZAMBANI","12",741,663,1404
"20066","KITUI","NZAMBANI","13",727,677,1404
"20067","KITUI","NZAMBANI","14",661,681,1342
"20068","KITUI","NZAMBANI","10 -14",3408,3333,6741
"20069","KITUI","NZAMBANI","15",715,669,1384
"20070","KITUI","NZAMBANI","16",669,595,1264
"20071","KITUI","NZAMBANI","17",687,609,1296
"20072","KITUI","NZAMBANI","18",499,457,956
"20073","KITUI","NZAMBANI","19",591,512,1103
"20074","KITUI","NZAMBANI","15-19",3161,2842,6003
"20075","KITUI","NZAMBANI","20",459,414,873
"20076","KITUI","NZAMBANI","21",346,429,775
"20077","KITUI","NZAMBANI","22",372,375,747
"20078","KITUI","NZAMBANI","23",342,377,719
"20079","KITUI","NZAMBANI","24",330,338,668
"20080","KITUI","NZAMBANI","20-24",1849,1933,3782
"20081","KITUI","NZAMBANI","25",326,353,679
"20082","KITUI","NZAMBANI","26",277,316,593
"20083","KITUI","NZAMBANI","27",306,295,601
"20084","KITUI","NZAMBANI","28",211,271,482
"20085","KITUI","NZAMBANI","29",322,328,650
"20086","KITUI","NZAMBANI","25-29",1442,1563,3005
"20087","KITUI","NZAMBANI","30",296,333,629
"20088","KITUI","NZAMBANI","31",257,281,538
"20089","KITUI","NZAMBANI","32",318,357,675
"20090","KITUI","NZAMBANI","33",292,332,624
"20091","KITUI","NZAMBANI","34",227,259,486
"20092","KITUI","NZAMBANI","30-34",1390,1562,2952
"20093","KITUI","NZAMBANI","35",313,356,669
"20094","KITUI","NZAMBANI","36",208,255,463
"20095","KITUI","NZAMBANI","37",253,263,516
"20096","KITUI","NZAMBANI","38",183,201,384
"20097","KITUI","NZAMBANI","39",271,266,537
"20098","KITUI","NZAMBANI","35-39",1228,1341,2569
"20099","KITUI","NZAMBANI","40",239,248,487
"20100","KITUI","NZAMBANI","41",251,265,516
"20101","KITUI","NZAMBANI","42",224,236,460
"20102","KITUI","NZAMBANI","43",204,228,432
"20103","KITUI","NZAMBANI","44",192,225,417
"20104","KITUI","NZAMBANI","40-44",1110,1202,2312
"20105","KITUI","NZAMBANI","45",263,314,577
"20106","KITUI","NZAMBANI","46",187,203,390
"20107","KITUI","NZAMBANI","47",201,207,408
"20108","KITUI","NZAMBANI","48",125,143,268
"20109","KITUI","NZAMBANI","49",202,184,386
"20110","KITUI","NZAMBANI","45-49",978,1051,2029
"20111","KITUI","NZAMBANI","50",190,176,366
"20112","KITUI","NZAMBANI","51",157,221,378
"20113","KITUI","NZAMBANI","52",141,154,295
"20114","KITUI","NZAMBANI","53",90,117,207
"20115","KITUI","NZAMBANI","54",135,125,260
"20116","KITUI","NZAMBANI","50-54",713,793,1506
"20117","KITUI","NZAMBANI","55",132,141,273
"20118","KITUI","NZAMBANI","56",166,156,322
"20119","KITUI","NZAMBANI","57",109,143,252
"20120","KITUI","NZAMBANI","58",83,102,185
"20121","KITUI","NZAMBANI","59",110,148,258
"20122","KITUI","NZAMBANI","55-59",600,690,1290
"20123","KITUI","NZAMBANI","60",124,146,270
"20124","KITUI","NZAMBANI","61",130,138,268
"20125","KITUI","NZAMBANI","62",77,98,175
"20126","KITUI","NZAMBANI","63",81,94,175
"20127","KITUI","NZAMBANI","64",70,71,141
"20128","KITUI","NZAMBANI","60-64",482,547,1029
"20129","KITUI","NZAMBANI","65",105,112,217
"20130","KITUI","NZAMBANI","66",69,51,120
"20131","KITUI","NZAMBANI","67",111,130,241
"20132","KITUI","NZAMBANI","68",62,59,121
"20133","KITUI","NZAMBANI","69",92,142,234
"20134","KITUI","NZAMBANI","65-69",439,494,933
"20135","KITUI","NZAMBANI","70",106,149,255
"20136","KITUI","NZAMBANI","71",74,85,159
"20137","KITUI","NZAMBANI","72",43,60,103
"20138","KITUI","NZAMBANI","73",59,127,186
"20139","KITUI","NZAMBANI","74",58,115,173
"20140","KITUI","NZAMBANI","70-74",340,536,876
"20141","KITUI","NZAMBANI","75",54,65,119
"20142","KITUI","NZAMBANI","76",23,27,50
"20143","KITUI","NZAMBANI","77",31,42,73
"20144","KITUI","NZAMBANI","78",38,23,61
"20145","KITUI","NZAMBANI","79",41,72,113
"20146","KITUI","NZAMBANI","75-79",187,229,416
"20147","KITUI","NZAMBANI","80",54,87,141
"20148","KITUI","NZAMBANI","81",28,34,62
"20149","KITUI","NZAMBANI","82",20,17,37
"20150","KITUI","NZAMBANI","83",17,18,35
"20151","KITUI","NZAMBANI","84",29,58,87
"20152","KITUI","NZAMBANI","80-84",148,214,362
"20153","KITUI","NZAMBANI","85",18,26,44
"20154","KITUI","NZAMBANI","86",12,13,25
"20155","KITUI","NZAMBANI","87",13,17,30
"20156","KITUI","NZAMBANI","88",8,7,15
"20157","KITUI","NZAMBANI","89",15,57,72
"20158","KITUI","NZAMBANI","85-89",66,120,186
"20159","KITUI","NZAMBANI","90",12,45,57
"20160","KITUI","NZAMBANI","91",12,39,51
"20161","KITUI","NZAMBANI","92",16,10,26
"20162","KITUI","NZAMBANI","93",3,14,17
"20163","KITUI","NZAMBANI","94",6,10,16
"20164","KITUI","NZAMBANI","90-94",49,118,167
"20165","KITUI","NZAMBANI","95",7,13,20
"20166","KITUI","NZAMBANI","96",3,2,5
"20167","KITUI","NZAMBANI","97",5,1,6
"20168","KITUI","NZAMBANI","98",3,6,9
"20169","KITUI","NZAMBANI","99",5,16,21
"20170","KITUI","NZAMBANI","95-99",23,38,61
"20171","KITUI","NZAMBANI","100+",8,17,25
"20172","KITUI","NZAMBANI","Not Stated",NA,NA,NA
"20173","KITUI","THAGICU","Total",7141,7994,15135
"20174","KITUI","THAGICU","0",169,193,362
"20175","KITUI","THAGICU","1",181,168,349
"20176","KITUI","THAGICU","2",182,178,360
"20177","KITUI","THAGICU","3",188,197,385
"20178","KITUI","THAGICU","4",192,192,384
"20179","KITUI","THAGICU","0 - 4",912,928,1840
"20180","KITUI","THAGICU","5",204,186,390
"20181","KITUI","THAGICU","6",188,211,399
"20182","KITUI","THAGICU","7",193,190,383
"20183","KITUI","THAGICU","8",234,205,439
"20184","KITUI","THAGICU","9",227,205,432
"20185","KITUI","THAGICU","5-9",1046,997,2043
"20186","KITUI","THAGICU","10",244,251,495
"20187","KITUI","THAGICU","11",226,263,489
"20188","KITUI","THAGICU","12",261,253,514
"20189","KITUI","THAGICU","13",256,232,488
"20190","KITUI","THAGICU","14",257,259,516
"20191","KITUI","THAGICU","10 -14",1244,1258,2502
"20192","KITUI","THAGICU","15",227,214,441
"20193","KITUI","THAGICU","16",208,196,404
"20194","KITUI","THAGICU","17",190,253,443
"20195","KITUI","THAGICU","18",158,175,333
"20196","KITUI","THAGICU","19",161,186,347
"20197","KITUI","THAGICU","15-19",944,1024,1968
"20198","KITUI","THAGICU","20",128,164,292
"20199","KITUI","THAGICU","21",127,155,282
"20200","KITUI","THAGICU","22",93,128,221
"20201","KITUI","THAGICU","23",99,140,239
"20202","KITUI","THAGICU","24",102,104,206
"20203","KITUI","THAGICU","20-24",549,691,1240
"20204","KITUI","THAGICU","25",98,104,202
"20205","KITUI","THAGICU","26",75,88,163
"20206","KITUI","THAGICU","27",72,91,163
"20207","KITUI","THAGICU","28",63,79,142
"20208","KITUI","THAGICU","29",72,124,196
"20209","KITUI","THAGICU","25-29",380,486,866
"20210","KITUI","THAGICU","30",85,122,207
"20211","KITUI","THAGICU","31",73,73,146
"20212","KITUI","THAGICU","32",65,105,170
"20213","KITUI","THAGICU","33",74,107,181
"20214","KITUI","THAGICU","34",62,95,157
"20215","KITUI","THAGICU","30-34",359,502,861
"20216","KITUI","THAGICU","35",93,145,238
"20217","KITUI","THAGICU","36",66,102,168
"20218","KITUI","THAGICU","37",49,68,117
"20219","KITUI","THAGICU","38",45,54,99
"20220","KITUI","THAGICU","39",70,86,156
"20221","KITUI","THAGICU","35-39",323,455,778
"20222","KITUI","THAGICU","40",61,66,127
"20223","KITUI","THAGICU","41",50,52,102
"20224","KITUI","THAGICU","42",48,58,106
"20225","KITUI","THAGICU","43",53,49,102
"20226","KITUI","THAGICU","44",59,46,105
"20227","KITUI","THAGICU","40-44",271,271,542
"20228","KITUI","THAGICU","45",68,81,149
"20229","KITUI","THAGICU","46",67,57,124
"20230","KITUI","THAGICU","47",60,52,112
"20231","KITUI","THAGICU","48",27,45,72
"20232","KITUI","THAGICU","49",37,48,85
"20233","KITUI","THAGICU","45-49",259,283,542
"20234","KITUI","THAGICU","50",39,51,90
"20235","KITUI","THAGICU","51",52,47,99
"20236","KITUI","THAGICU","52",47,35,82
"20237","KITUI","THAGICU","53",25,25,50
"20238","KITUI","THAGICU","54",35,29,64
"20239","KITUI","THAGICU","50-54",198,187,385
"20240","KITUI","THAGICU","55",33,25,58
"20241","KITUI","THAGICU","56",43,45,88
"20242","KITUI","THAGICU","57",24,34,58
"20243","KITUI","THAGICU","58",24,40,64
"20244","KITUI","THAGICU","59",32,58,90
"20245","KITUI","THAGICU","55-59",156,202,358
"20246","KITUI","THAGICU","60",42,54,96
"20247","KITUI","THAGICU","61",34,34,68
"20248","KITUI","THAGICU","62",22,21,43
"20249","KITUI","THAGICU","63",26,34,60
"20250","KITUI","THAGICU","64",21,21,42
"20251","KITUI","THAGICU","60-64",145,164,309
"20252","KITUI","THAGICU","65",20,48,68
"20253","KITUI","THAGICU","66",12,20,32
"20254","KITUI","THAGICU","67",24,32,56
"20255","KITUI","THAGICU","68",24,26,50
"20256","KITUI","THAGICU","69",31,75,106
"20257","KITUI","THAGICU","65-69",111,201,312
"20258","KITUI","THAGICU","70",38,53,91
"20259","KITUI","THAGICU","71",29,34,63
"20260","KITUI","THAGICU","72",14,15,29
"20261","KITUI","THAGICU","73",10,23,33
"20262","KITUI","THAGICU","74",16,18,34
"20263","KITUI","THAGICU","70-74",107,143,250
"20264","KITUI","THAGICU","75",13,13,26
"20265","KITUI","THAGICU","76",7,6,13
"20266","KITUI","THAGICU","77",11,7,18
"20267","KITUI","THAGICU","78",10,5,15
"20268","KITUI","THAGICU","79",15,22,37
"20269","KITUI","THAGICU","75-79",56,53,109
"20270","KITUI","THAGICU","80",17,27,44
"20271","KITUI","THAGICU","81",7,9,16
"20272","KITUI","THAGICU","82",7,9,16
"20273","KITUI","THAGICU","83",3,7,10
"20274","KITUI","THAGICU","84",7,12,19
"20275","KITUI","THAGICU","80-84",41,64,105
"20276","KITUI","THAGICU","85",4,14,18
"20277","KITUI","THAGICU","86",2,3,5
"20278","KITUI","THAGICU","87",5,7,12
"20279","KITUI","THAGICU","88",1,1,2
"20280","KITUI","THAGICU","89",9,28,37
"20281","KITUI","THAGICU","85-89",21,53,74
"20282","KITUI","THAGICU","90",5,7,12
"20283","KITUI","THAGICU","91",3,5,8
"20284","KITUI","THAGICU","92",1,1,2
"20285","KITUI","THAGICU","93",NA,1,1
"20286","KITUI","THAGICU","94",3,3,6
"20287","KITUI","THAGICU","90-94",12,17,29
"20288","KITUI","THAGICU","95",1,3,4
"20289","KITUI","THAGICU","96",NA,1,1
"20290","KITUI","THAGICU","97",1,NA,1
"20291","KITUI","THAGICU","98",NA,1,1
"20292","KITUI","THAGICU","99",1,4,5
"20293","KITUI","THAGICU","95-99",3,9,12
"20294","KITUI","THAGICU","100+",4,6,10
"20295","KITUI","THAGICU","Not Stated",NA,NA,NA
"20296","KITUI","TSEIKURU","Total",19619,21252,40871
"20297","KITUI","TSEIKURU","0",380,414,794
"20298","KITUI","TSEIKURU","1",510,457,967
"20299","KITUI","TSEIKURU","2",516,493,1009
"20300","KITUI","TSEIKURU","3",517,533,1050
"20301","KITUI","TSEIKURU","4",514,537,1051
"20302","KITUI","TSEIKURU","0 - 4",2437,2434,4871
"20303","KITUI","TSEIKURU","5",557,546,1103
"20304","KITUI","TSEIKURU","6",586,587,1173
"20305","KITUI","TSEIKURU","7",469,526,995
"20306","KITUI","TSEIKURU","8",636,639,1275
"20307","KITUI","TSEIKURU","9",629,605,1234
"20308","KITUI","TSEIKURU","5-9",2877,2903,5780
"20309","KITUI","TSEIKURU","10",631,629,1260
"20310","KITUI","TSEIKURU","11",682,749,1431
"20311","KITUI","TSEIKURU","12",692,667,1359
"20312","KITUI","TSEIKURU","13",688,654,1342
"20313","KITUI","TSEIKURU","14",665,668,1333
"20314","KITUI","TSEIKURU","10 -14",3358,3367,6725
"20315","KITUI","TSEIKURU","15",664,678,1342
"20316","KITUI","TSEIKURU","16",652,636,1288
"20317","KITUI","TSEIKURU","17",556,524,1080
"20318","KITUI","TSEIKURU","18",442,457,899
"20319","KITUI","TSEIKURU","19",520,480,1000
"20320","KITUI","TSEIKURU","15-19",2834,2775,5609
"20321","KITUI","TSEIKURU","20",407,425,832
"20322","KITUI","TSEIKURU","21",332,368,700
"20323","KITUI","TSEIKURU","22",283,286,569
"20324","KITUI","TSEIKURU","23",255,317,572
"20325","KITUI","TSEIKURU","24",220,252,472
"20326","KITUI","TSEIKURU","20-24",1497,1648,3145
"20327","KITUI","TSEIKURU","25",255,285,540
"20328","KITUI","TSEIKURU","26",174,214,388
"20329","KITUI","TSEIKURU","27",204,264,468
"20330","KITUI","TSEIKURU","28",145,182,327
"20331","KITUI","TSEIKURU","29",185,225,410
"20332","KITUI","TSEIKURU","25-29",963,1170,2133
"20333","KITUI","TSEIKURU","30",244,322,566
"20334","KITUI","TSEIKURU","31",177,286,463
"20335","KITUI","TSEIKURU","32",157,240,397
"20336","KITUI","TSEIKURU","33",196,288,484
"20337","KITUI","TSEIKURU","34",165,239,404
"20338","KITUI","TSEIKURU","30-34",939,1375,2314
"20339","KITUI","TSEIKURU","35",242,347,589
"20340","KITUI","TSEIKURU","36",113,148,261
"20341","KITUI","TSEIKURU","37",125,151,276
"20342","KITUI","TSEIKURU","38",100,120,220
"20343","KITUI","TSEIKURU","39",164,170,334
"20344","KITUI","TSEIKURU","35-39",744,936,1680
"20345","KITUI","TSEIKURU","40",167,197,364
"20346","KITUI","TSEIKURU","41",162,168,330
"20347","KITUI","TSEIKURU","42",156,168,324
"20348","KITUI","TSEIKURU","43",147,195,342
"20349","KITUI","TSEIKURU","44",151,206,357
"20350","KITUI","TSEIKURU","40-44",783,934,1717
"20351","KITUI","TSEIKURU","45",223,256,479
"20352","KITUI","TSEIKURU","46",150,177,327
"20353","KITUI","TSEIKURU","47",148,161,309
"20354","KITUI","TSEIKURU","48",105,107,212
"20355","KITUI","TSEIKURU","49",108,144,252
"20356","KITUI","TSEIKURU","45-49",734,845,1579
"20357","KITUI","TSEIKURU","50",132,150,282
"20358","KITUI","TSEIKURU","51",140,120,260
"20359","KITUI","TSEIKURU","52",104,122,226
"20360","KITUI","TSEIKURU","53",67,82,149
"20361","KITUI","TSEIKURU","54",79,79,158
"20362","KITUI","TSEIKURU","50-54",522,553,1075
"20363","KITUI","TSEIKURU","55",89,65,154
"20364","KITUI","TSEIKURU","56",106,78,184
"20365","KITUI","TSEIKURU","57",87,88,175
"20366","KITUI","TSEIKURU","58",67,68,135
"20367","KITUI","TSEIKURU","59",106,144,250
"20368","KITUI","TSEIKURU","55-59",455,443,898
"20369","KITUI","TSEIKURU","60",147,160,307
"20370","KITUI","TSEIKURU","61",71,74,145
"20371","KITUI","TSEIKURU","62",61,63,124
"20372","KITUI","TSEIKURU","63",79,86,165
"20373","KITUI","TSEIKURU","64",49,49,98
"20374","KITUI","TSEIKURU","60-64",407,432,839
"20375","KITUI","TSEIKURU","65",94,94,188
"20376","KITUI","TSEIKURU","66",50,78,128
"20377","KITUI","TSEIKURU","67",88,115,203
"20378","KITUI","TSEIKURU","68",40,58,98
"20379","KITUI","TSEIKURU","69",68,92,160
"20380","KITUI","TSEIKURU","65-69",340,437,777
"20381","KITUI","TSEIKURU","70",114,180,294
"20382","KITUI","TSEIKURU","71",67,78,145
"20383","KITUI","TSEIKURU","72",51,47,98
"20384","KITUI","TSEIKURU","73",30,56,86
"20385","KITUI","TSEIKURU","74",52,61,113
"20386","KITUI","TSEIKURU","70-74",314,422,736
"20387","KITUI","TSEIKURU","75",42,51,93
"20388","KITUI","TSEIKURU","76",29,34,63
"20389","KITUI","TSEIKURU","77",32,40,72
"20390","KITUI","TSEIKURU","78",16,23,39
"20391","KITUI","TSEIKURU","79",49,68,117
"20392","KITUI","TSEIKURU","75-79",168,216,384
"20393","KITUI","TSEIKURU","80",46,84,130
"20394","KITUI","TSEIKURU","81",17,22,39
"20395","KITUI","TSEIKURU","82",11,23,34
"20396","KITUI","TSEIKURU","83",14,27,41
"20397","KITUI","TSEIKURU","84",31,26,57
"20398","KITUI","TSEIKURU","80-84",119,182,301
"20399","KITUI","TSEIKURU","85",14,22,36
"20400","KITUI","TSEIKURU","86",14,12,26
"20401","KITUI","TSEIKURU","87",17,22,39
"20402","KITUI","TSEIKURU","88",6,7,13
"20403","KITUI","TSEIKURU","89",24,38,62
"20404","KITUI","TSEIKURU","85-89",75,101,176
"20405","KITUI","TSEIKURU","90",13,26,39
"20406","KITUI","TSEIKURU","91",2,4,6
"20407","KITUI","TSEIKURU","92",2,3,5
"20408","KITUI","TSEIKURU","93",4,4,8
"20409","KITUI","TSEIKURU","94",7,4,11
"20410","KITUI","TSEIKURU","90-94",28,41,69
"20411","KITUI","TSEIKURU","95",3,8,11
"20412","KITUI","TSEIKURU","96",4,4,8
"20413","KITUI","TSEIKURU","97",3,3,6
"20414","KITUI","TSEIKURU","98",3,2,5
"20415","KITUI","TSEIKURU","99",6,12,18
"20416","KITUI","TSEIKURU","95-99",19,29,48
"20417","KITUI","TSEIKURU","100+",6,9,15
"20418","KITUI","TSEIKURU","Not Stated",NA,NA,NA
"20419","KWALE","ALL","Total",425121,441681,866802
"20420","KWALE","ALL","0",12299,12331,24630
"20421","KWALE","ALL","1",12681,12369,25050
"20422","KWALE","ALL","2",13139,12927,26066
"20423","KWALE","ALL","3",13232,13391,26623
"20424","KWALE","ALL","4",14178,13743,27921
"20425","KWALE","ALL","0 - 4",65529,64761,130290
"20426","KWALE","ALL","5",14617,14090,28707
"20427","KWALE","ALL","6",13767,13384,27151
"20428","KWALE","ALL","7",13075,12628,25703
"20429","KWALE","ALL","8",12336,12373,24709
"20430","KWALE","ALL","9",12904,12568,25472
"20431","KWALE","ALL","5-9",66699,65043,131742
"20432","KWALE","ALL","10",13154,13022,26176
"20433","KWALE","ALL","11",11892,12012,23904
"20434","KWALE","ALL","12",13224,12692,25916
"20435","KWALE","ALL","13",13177,13028,26205
"20436","KWALE","ALL","14",11751,11337,23088
"20437","KWALE","ALL","10 -14",63198,62091,125289
"20438","KWALE","ALL","15",10958,10500,21458
"20439","KWALE","ALL","16",10204,9978,20182
"20440","KWALE","ALL","17",10150,9284,19434
"20441","KWALE","ALL","18",9239,8656,17895
"20442","KWALE","ALL","19",8865,9270,18135
"20443","KWALE","ALL","15-19",49416,47688,97104
"20444","KWALE","ALL","20",8332,9523,17855
"20445","KWALE","ALL","21",6015,7024,13039
"20446","KWALE","ALL","22",6346,7794,14140
"20447","KWALE","ALL","23",6212,7735,13947
"20448","KWALE","ALL","24",5798,7016,12814
"20449","KWALE","ALL","20-24",32703,39092,71795
"20450","KWALE","ALL","25",7114,8147,15261
"20451","KWALE","ALL","26",5713,7025,12738
"20452","KWALE","ALL","27",5737,6623,12360
"20453","KWALE","ALL","28",4927,6257,11184
"20454","KWALE","ALL","29",4811,6336,11147
"20455","KWALE","ALL","25-29",28302,34388,62690
"20456","KWALE","ALL","30",6798,8858,15656
"20457","KWALE","ALL","31",4234,5303,9537
"20458","KWALE","ALL","32",5223,6372,11595
"20459","KWALE","ALL","33",4259,5315,9574
"20460","KWALE","ALL","34",4224,4867,9091
"20461","KWALE","ALL","30-34",24738,30715,55453
"20462","KWALE","ALL","35",5763,6312,12075
"20463","KWALE","ALL","36",3835,4168,8003
"20464","KWALE","ALL","37",3652,3776,7428
"20465","KWALE","ALL","38",2886,3076,5962
"20466","KWALE","ALL","39",3179,3167,6346
"20467","KWALE","ALL","35-39",19315,20499,39814
"20468","KWALE","ALL","40",4734,4956,9690
"20469","KWALE","ALL","41",3641,3860,7501
"20470","KWALE","ALL","42",3854,4262,8116
"20471","KWALE","ALL","43",3172,3625,6797
"20472","KWALE","ALL","44",2844,2867,5711
"20473","KWALE","ALL","40-44",18245,19570,37815
"20474","KWALE","ALL","45",4511,4288,8799
"20475","KWALE","ALL","46",2684,2820,5504
"20476","KWALE","ALL","47",2959,2694,5653
"20477","KWALE","ALL","48",2164,2008,4172
"20478","KWALE","ALL","49",2462,1943,4405
"20479","KWALE","ALL","45-49",14780,13753,28533
"20480","KWALE","ALL","50",3789,3654,7443
"20481","KWALE","ALL","51",2372,1791,4163
"20482","KWALE","ALL","52",1846,1401,3247
"20483","KWALE","ALL","53",1223,871,2094
"20484","KWALE","ALL","54",1513,1041,2554
"20485","KWALE","ALL","50-54",10743,8758,19501
"20486","KWALE","ALL","55",1752,1370,3122
"20487","KWALE","ALL","56",2012,1738,3750
"20488","KWALE","ALL","57",1722,1671,3393
"20489","KWALE","ALL","58",1418,1326,2744
"20490","KWALE","ALL","59",1680,2075,3755
"20491","KWALE","ALL","55-59",8584,8180,16764
"20492","KWALE","ALL","60",2433,3463,5896
"20493","KWALE","ALL","61",1316,1749,3065
"20494","KWALE","ALL","62",1349,1394,2743
"20495","KWALE","ALL","63",1374,1604,2978
"20496","KWALE","ALL","64",1102,1181,2283
"20497","KWALE","ALL","60-64",7574,9391,16965
"20498","KWALE","ALL","65",1784,2034,3818
"20499","KWALE","ALL","66",1076,912,1988
"20500","KWALE","ALL","67",1473,1332,2805
"20501","KWALE","ALL","68",816,773,1589
"20502","KWALE","ALL","69",1132,1521,2653
"20503","KWALE","ALL","65-69",6281,6572,12853
"20504","KWALE","ALL","70",1682,2590,4272
"20505","KWALE","ALL","71",648,780,1428
"20506","KWALE","ALL","72",657,707,1364
"20507","KWALE","ALL","73",577,520,1097
"20508","KWALE","ALL","74",606,670,1276
"20509","KWALE","ALL","70-74",4170,5267,9437
"20510","KWALE","ALL","75",738,736,1474
"20511","KWALE","ALL","76",375,361,736
"20512","KWALE","ALL","77",407,426,833
"20513","KWALE","ALL","78",331,272,603
"20514","KWALE","ALL","79",421,549,970
"20515","KWALE","ALL","75-79",2272,2344,4616
"20516","KWALE","ALL","80",565,985,1550
"20517","KWALE","ALL","81",218,241,459
"20518","KWALE","ALL","82",198,192,390
"20519","KWALE","ALL","83",179,228,407
"20520","KWALE","ALL","84",196,258,454
"20521","KWALE","ALL","80-84",1356,1904,3260
"20522","KWALE","ALL","85",202,296,498
"20523","KWALE","ALL","86",120,103,223
"20524","KWALE","ALL","87",127,152,279
"20525","KWALE","ALL","88",76,84,160
"20526","KWALE","ALL","89",174,270,444
"20527","KWALE","ALL","85-89",699,905,1604
"20528","KWALE","ALL","90",131,259,390
"20529","KWALE","ALL","91",49,58,107
"20530","KWALE","ALL","92",42,30,72
"20531","KWALE","ALL","93",22,29,51
"20532","KWALE","ALL","94",36,44,80
"20533","KWALE","ALL","90-94",280,420,700
"20534","KWALE","ALL","95",35,42,77
"20535","KWALE","ALL","96",23,25,48
"20536","KWALE","ALL","97",17,25,42
"20537","KWALE","ALL","98",15,24,39
"20538","KWALE","ALL","99",42,58,100
"20539","KWALE","ALL","95-99",132,174,306
"20540","KWALE","ALL","100+",99,160,259
"20541","KWALE","ALL","Not Stated",6,6,12
"20542","KWALE","KINANGO","Total",45413,48806,94219
"20543","KWALE","KINANGO","0",1494,1537,3031
"20544","KWALE","KINANGO","1",1547,1457,3004
"20545","KWALE","KINANGO","2",1622,1612,3234
"20546","KWALE","KINANGO","3",1658,1721,3379
"20547","KWALE","KINANGO","4",1758,1694,3452
"20548","KWALE","KINANGO","0 - 4",8079,8021,16100
"20549","KWALE","KINANGO","5",1768,1784,3552
"20550","KWALE","KINANGO","6",1799,1684,3483
"20551","KWALE","KINANGO","7",1553,1553,3106
"20552","KWALE","KINANGO","8",1591,1594,3185
"20553","KWALE","KINANGO","9",1507,1476,2983
"20554","KWALE","KINANGO","5-9",8218,8091,16309
"20555","KWALE","KINANGO","10",1634,1562,3196
"20556","KWALE","KINANGO","11",1510,1530,3040
"20557","KWALE","KINANGO","12",1639,1574,3213
"20558","KWALE","KINANGO","13",1585,1440,3025
"20559","KWALE","KINANGO","14",1347,1284,2631
"20560","KWALE","KINANGO","10 -14",7715,7390,15105
"20561","KWALE","KINANGO","15",1344,1242,2586
"20562","KWALE","KINANGO","16",1228,1195,2423
"20563","KWALE","KINANGO","17",1192,1016,2208
"20564","KWALE","KINANGO","18",1030,939,1969
"20565","KWALE","KINANGO","19",917,999,1916
"20566","KWALE","KINANGO","15-19",5711,5391,11102
"20567","KWALE","KINANGO","20",802,1026,1828
"20568","KWALE","KINANGO","21",577,667,1244
"20569","KWALE","KINANGO","22",527,723,1250
"20570","KWALE","KINANGO","23",564,776,1340
"20571","KWALE","KINANGO","24",471,665,1136
"20572","KWALE","KINANGO","20-24",2941,3857,6798
"20573","KWALE","KINANGO","25",551,751,1302
"20574","KWALE","KINANGO","26",456,663,1119
"20575","KWALE","KINANGO","27",462,580,1042
"20576","KWALE","KINANGO","28",411,610,1021
"20577","KWALE","KINANGO","29",423,630,1053
"20578","KWALE","KINANGO","25-29",2303,3234,5537
"20579","KWALE","KINANGO","30",514,808,1322
"20580","KWALE","KINANGO","31",329,551,880
"20581","KWALE","KINANGO","32",424,647,1071
"20582","KWALE","KINANGO","33",360,562,922
"20583","KWALE","KINANGO","34",372,526,898
"20584","KWALE","KINANGO","30-34",1999,3094,5093
"20585","KWALE","KINANGO","35",497,599,1096
"20586","KWALE","KINANGO","36",318,382,700
"20587","KWALE","KINANGO","37",277,321,598
"20588","KWALE","KINANGO","38",222,260,482
"20589","KWALE","KINANGO","39",242,259,501
"20590","KWALE","KINANGO","35-39",1556,1821,3377
"20591","KWALE","KINANGO","40",336,386,722
"20592","KWALE","KINANGO","41",306,385,691
"20593","KWALE","KINANGO","42",342,513,855
"20594","KWALE","KINANGO","43",292,417,709
"20595","KWALE","KINANGO","44",256,308,564
"20596","KWALE","KINANGO","40-44",1532,2009,3541
"20597","KWALE","KINANGO","45",369,393,762
"20598","KWALE","KINANGO","46",223,313,536
"20599","KWALE","KINANGO","47",221,253,474
"20600","KWALE","KINANGO","48",169,162,331
"20601","KWALE","KINANGO","49",204,185,389
"20602","KWALE","KINANGO","45-49",1186,1306,2492
"20603","KWALE","KINANGO","50",336,364,700
"20604","KWALE","KINANGO","51",241,188,429
"20605","KWALE","KINANGO","52",193,142,335
"20606","KWALE","KINANGO","53",118,66,184
"20607","KWALE","KINANGO","54",125,94,219
"20608","KWALE","KINANGO","50-54",1013,854,1867
"20609","KWALE","KINANGO","55",127,103,230
"20610","KWALE","KINANGO","56",162,120,282
"20611","KWALE","KINANGO","57",188,153,341
"20612","KWALE","KINANGO","58",105,129,234
"20613","KWALE","KINANGO","59",157,214,371
"20614","KWALE","KINANGO","55-59",739,719,1458
"20615","KWALE","KINANGO","60",249,356,605
"20616","KWALE","KINANGO","61",148,213,361
"20617","KWALE","KINANGO","62",143,166,309
"20618","KWALE","KINANGO","63",152,171,323
"20619","KWALE","KINANGO","64",116,166,282
"20620","KWALE","KINANGO","60-64",808,1072,1880
"20621","KWALE","KINANGO","65",165,222,387
"20622","KWALE","KINANGO","66",104,112,216
"20623","KWALE","KINANGO","67",155,162,317
"20624","KWALE","KINANGO","68",71,69,140
"20625","KWALE","KINANGO","69",142,185,327
"20626","KWALE","KINANGO","65-69",637,750,1387
"20627","KWALE","KINANGO","70",170,259,429
"20628","KWALE","KINANGO","71",62,78,140
"20629","KWALE","KINANGO","72",65,81,146
"20630","KWALE","KINANGO","73",55,66,121
"20631","KWALE","KINANGO","74",63,66,129
"20632","KWALE","KINANGO","70-74",415,550,965
"20633","KWALE","KINANGO","75",89,71,160
"20634","KWALE","KINANGO","76",47,32,79
"20635","KWALE","KINANGO","77",48,41,89
"20636","KWALE","KINANGO","78",28,18,46
"20637","KWALE","KINANGO","79",43,55,98
"20638","KWALE","KINANGO","75-79",255,217,472
"20639","KWALE","KINANGO","80",56,109,165
"20640","KWALE","KINANGO","81",22,24,46
"20641","KWALE","KINANGO","82",27,16,43
"20642","KWALE","KINANGO","83",21,21,42
"20643","KWALE","KINANGO","84",27,37,64
"20644","KWALE","KINANGO","80-84",153,207,360
"20645","KWALE","KINANGO","85",24,32,56
"20646","KWALE","KINANGO","86",13,17,30
"20647","KWALE","KINANGO","87",13,24,37
"20648","KWALE","KINANGO","88",5,11,16
"20649","KWALE","KINANGO","89",29,39,68
"20650","KWALE","KINANGO","85-89",84,123,207
"20651","KWALE","KINANGO","90",20,29,49
"20652","KWALE","KINANGO","91",7,6,13
"20653","KWALE","KINANGO","92",4,3,7
"20654","KWALE","KINANGO","93",2,7,9
"20655","KWALE","KINANGO","94",1,8,9
"20656","KWALE","KINANGO","90-94",34,53,87
"20657","KWALE","KINANGO","95",5,4,9
"20658","KWALE","KINANGO","96",5,4,9
"20659","KWALE","KINANGO","97",2,2,4
"20660","KWALE","KINANGO","98",NA,2,2
"20661","KWALE","KINANGO","99",8,11,19
"20662","KWALE","KINANGO","95-99",20,23,43
"20663","KWALE","KINANGO","100+",15,24,39
"20664","KWALE","KINANGO","Not Stated",NA,NA,NA
"20665","KWALE","LUNGA LUNGA","Total",97174,101245,198419
"20666","KWALE","LUNGA LUNGA","0",2910,2878,5788
"20667","KWALE","LUNGA LUNGA","1",3023,3039,6062
"20668","KWALE","LUNGA LUNGA","2",3194,3098,6292
"20669","KWALE","LUNGA LUNGA","3",3180,3406,6586
"20670","KWALE","LUNGA LUNGA","4",3568,3362,6930
"20671","KWALE","LUNGA LUNGA","0 - 4",15875,15783,31658
"20672","KWALE","LUNGA LUNGA","5",3503,3311,6814
"20673","KWALE","LUNGA LUNGA","6",3460,3477,6937
"20674","KWALE","LUNGA LUNGA","7",3233,3164,6397
"20675","KWALE","LUNGA LUNGA","8",3130,3116,6246
"20676","KWALE","LUNGA LUNGA","9",3260,3216,6476
"20677","KWALE","LUNGA LUNGA","5-9",16586,16284,32870
"20678","KWALE","LUNGA LUNGA","10",3335,3305,6640
"20679","KWALE","LUNGA LUNGA","11",2931,2862,5793
"20680","KWALE","LUNGA LUNGA","12",3407,3167,6574
"20681","KWALE","LUNGA LUNGA","13",3228,3157,6385
"20682","KWALE","LUNGA LUNGA","14",2918,2727,5645
"20683","KWALE","LUNGA LUNGA","10 -14",15819,15218,31037
"20684","KWALE","LUNGA LUNGA","15",2723,2556,5279
"20685","KWALE","LUNGA LUNGA","16",2463,2381,4844
"20686","KWALE","LUNGA LUNGA","17",2393,2092,4485
"20687","KWALE","LUNGA LUNGA","18",2140,1935,4075
"20688","KWALE","LUNGA LUNGA","19",2066,2143,4209
"20689","KWALE","LUNGA LUNGA","15-19",11785,11107,22892
"20690","KWALE","LUNGA LUNGA","20",1870,2136,4006
"20691","KWALE","LUNGA LUNGA","21",1221,1393,2614
"20692","KWALE","LUNGA LUNGA","22",1223,1536,2759
"20693","KWALE","LUNGA LUNGA","23",1183,1477,2660
"20694","KWALE","LUNGA LUNGA","24",1070,1323,2393
"20695","KWALE","LUNGA LUNGA","20-24",6567,7865,14432
"20696","KWALE","LUNGA LUNGA","25",1390,1650,3040
"20697","KWALE","LUNGA LUNGA","26",1043,1438,2481
"20698","KWALE","LUNGA LUNGA","27",1039,1241,2280
"20699","KWALE","LUNGA LUNGA","28",881,1252,2133
"20700","KWALE","LUNGA LUNGA","29",911,1340,2251
"20701","KWALE","LUNGA LUNGA","25-29",5264,6921,12185
"20702","KWALE","LUNGA LUNGA","30",1370,1968,3338
"20703","KWALE","LUNGA LUNGA","31",727,995,1722
"20704","KWALE","LUNGA LUNGA","32",1013,1164,2177
"20705","KWALE","LUNGA LUNGA","33",840,940,1780
"20706","KWALE","LUNGA LUNGA","34",757,817,1574
"20707","KWALE","LUNGA LUNGA","30-34",4707,5884,10591
"20708","KWALE","LUNGA LUNGA","35",1206,1438,2644
"20709","KWALE","LUNGA LUNGA","36",751,825,1576
"20710","KWALE","LUNGA LUNGA","37",694,792,1486
"20711","KWALE","LUNGA LUNGA","38",555,643,1198
"20712","KWALE","LUNGA LUNGA","39",670,717,1387
"20713","KWALE","LUNGA LUNGA","35-39",3876,4415,8291
"20714","KWALE","LUNGA LUNGA","40",1021,1242,2263
"20715","KWALE","LUNGA LUNGA","41",753,856,1609
"20716","KWALE","LUNGA LUNGA","42",863,984,1847
"20717","KWALE","LUNGA LUNGA","43",665,825,1490
"20718","KWALE","LUNGA LUNGA","44",561,595,1156
"20719","KWALE","LUNGA LUNGA","40-44",3863,4502,8365
"20720","KWALE","LUNGA LUNGA","45",1000,975,1975
"20721","KWALE","LUNGA LUNGA","46",521,569,1090
"20722","KWALE","LUNGA LUNGA","47",632,601,1233
"20723","KWALE","LUNGA LUNGA","48",439,474,913
"20724","KWALE","LUNGA LUNGA","49",457,431,888
"20725","KWALE","LUNGA LUNGA","45-49",3049,3050,6099
"20726","KWALE","LUNGA LUNGA","50",878,909,1787
"20727","KWALE","LUNGA LUNGA","51",493,380,873
"20728","KWALE","LUNGA LUNGA","52",387,296,683
"20729","KWALE","LUNGA LUNGA","53",260,161,421
"20730","KWALE","LUNGA LUNGA","54",302,226,528
"20731","KWALE","LUNGA LUNGA","50-54",2320,1972,4292
"20732","KWALE","LUNGA LUNGA","55",424,351,775
"20733","KWALE","LUNGA LUNGA","56",434,376,810
"20734","KWALE","LUNGA LUNGA","57",392,368,760
"20735","KWALE","LUNGA LUNGA","58",326,295,621
"20736","KWALE","LUNGA LUNGA","59",404,476,880
"20737","KWALE","LUNGA LUNGA","55-59",1980,1866,3846
"20738","KWALE","LUNGA LUNGA","60",570,870,1440
"20739","KWALE","LUNGA LUNGA","61",278,357,635
"20740","KWALE","LUNGA LUNGA","62",310,291,601
"20741","KWALE","LUNGA LUNGA","63",272,308,580
"20742","KWALE","LUNGA LUNGA","64",228,227,455
"20743","KWALE","LUNGA LUNGA","60-64",1658,2053,3711
"20744","KWALE","LUNGA LUNGA","65",451,504,955
"20745","KWALE","LUNGA LUNGA","66",239,218,457
"20746","KWALE","LUNGA LUNGA","67",339,302,641
"20747","KWALE","LUNGA LUNGA","68",209,211,420
"20748","KWALE","LUNGA LUNGA","69",273,344,617
"20749","KWALE","LUNGA LUNGA","65-69",1511,1579,3090
"20750","KWALE","LUNGA LUNGA","70",512,673,1185
"20751","KWALE","LUNGA LUNGA","71",147,166,313
"20752","KWALE","LUNGA LUNGA","72",157,194,351
"20753","KWALE","LUNGA LUNGA","73",116,105,221
"20754","KWALE","LUNGA LUNGA","74",148,149,297
"20755","KWALE","LUNGA LUNGA","70-74",1080,1287,2367
"20756","KWALE","LUNGA LUNGA","75",183,189,372
"20757","KWALE","LUNGA LUNGA","76",86,69,155
"20758","KWALE","LUNGA LUNGA","77",103,97,200
"20759","KWALE","LUNGA LUNGA","78",86,81,167
"20760","KWALE","LUNGA LUNGA","79",110,144,254
"20761","KWALE","LUNGA LUNGA","75-79",568,580,1148
"20762","KWALE","LUNGA LUNGA","80",161,249,410
"20763","KWALE","LUNGA LUNGA","81",56,49,105
"20764","KWALE","LUNGA LUNGA","82",52,48,100
"20765","KWALE","LUNGA LUNGA","83",33,59,92
"20766","KWALE","LUNGA LUNGA","84",44,49,93
"20767","KWALE","LUNGA LUNGA","80-84",346,454,800
"20768","KWALE","LUNGA LUNGA","85",64,73,137
"20769","KWALE","LUNGA LUNGA","86",27,24,51
"20770","KWALE","LUNGA LUNGA","87",31,40,71
"20771","KWALE","LUNGA LUNGA","88",22,26,48
"20772","KWALE","LUNGA LUNGA","89",53,62,115
"20773","KWALE","LUNGA LUNGA","85-89",197,225,422
"20774","KWALE","LUNGA LUNGA","90",30,74,104
"20775","KWALE","LUNGA LUNGA","91",9,14,23
"20776","KWALE","LUNGA LUNGA","92",11,7,18
"20777","KWALE","LUNGA LUNGA","93",7,7,14
"20778","KWALE","LUNGA LUNGA","94",10,9,19
"20779","KWALE","LUNGA LUNGA","90-94",67,111,178
"20780","KWALE","LUNGA LUNGA","95",8,11,19
"20781","KWALE","LUNGA LUNGA","96",2,7,9
"20782","KWALE","LUNGA LUNGA","97",6,3,9
"20783","KWALE","LUNGA LUNGA","98",1,8,9
"20784","KWALE","LUNGA LUNGA","99",15,15,30
"20785","KWALE","LUNGA LUNGA","95-99",32,44,76
"20786","KWALE","LUNGA LUNGA","100+",24,45,69
"20787","KWALE","LUNGA LUNGA","Not Stated",NA,NA,NA
"20788","KWALE","MATUGA","Total",95831,98419,194250
"20789","KWALE","MATUGA","0",2469,2478,4947
"20790","KWALE","MATUGA","1",2600,2538,5138
"20791","KWALE","MATUGA","2",2661,2600,5261
"20792","KWALE","MATUGA","3",2686,2722,5408
"20793","KWALE","MATUGA","4",2905,2752,5657
"20794","KWALE","MATUGA","0 - 4",13321,13090,26411
"20795","KWALE","MATUGA","5",3097,2898,5995
"20796","KWALE","MATUGA","6",2974,2784,5758
"20797","KWALE","MATUGA","7",2808,2596,5404
"20798","KWALE","MATUGA","8",2659,2550,5209
"20799","KWALE","MATUGA","9",2742,2581,5323
"20800","KWALE","MATUGA","5-9",14280,13409,27689
"20801","KWALE","MATUGA","10",2835,2771,5606
"20802","KWALE","MATUGA","11",2524,2547,5071
"20803","KWALE","MATUGA","12",2763,2762,5525
"20804","KWALE","MATUGA","13",3056,3025,6081
"20805","KWALE","MATUGA","14",2635,2577,5212
"20806","KWALE","MATUGA","10 -14",13813,13682,27495
"20807","KWALE","MATUGA","15",2476,2415,4891
"20808","KWALE","MATUGA","16",2295,2284,4579
"20809","KWALE","MATUGA","17",2413,2243,4656
"20810","KWALE","MATUGA","18",2193,2055,4248
"20811","KWALE","MATUGA","19",2131,2134,4265
"20812","KWALE","MATUGA","15-19",11508,11131,22639
"20813","KWALE","MATUGA","20",1906,2096,4002
"20814","KWALE","MATUGA","21",1388,1547,2935
"20815","KWALE","MATUGA","22",1486,1752,3238
"20816","KWALE","MATUGA","23",1444,1713,3157
"20817","KWALE","MATUGA","24",1306,1555,2861
"20818","KWALE","MATUGA","20-24",7530,8663,16193
"20819","KWALE","MATUGA","25",1596,1767,3363
"20820","KWALE","MATUGA","26",1325,1552,2877
"20821","KWALE","MATUGA","27",1262,1455,2717
"20822","KWALE","MATUGA","28",1101,1381,2482
"20823","KWALE","MATUGA","29",1043,1332,2375
"20824","KWALE","MATUGA","25-29",6327,7487,13814
"20825","KWALE","MATUGA","30",1527,1879,3406
"20826","KWALE","MATUGA","31",1015,1141,2156
"20827","KWALE","MATUGA","32",1187,1401,2588
"20828","KWALE","MATUGA","33",975,1207,2182
"20829","KWALE","MATUGA","34",990,1103,2093
"20830","KWALE","MATUGA","30-34",5694,6731,12425
"20831","KWALE","MATUGA","35",1278,1410,2688
"20832","KWALE","MATUGA","36",900,963,1863
"20833","KWALE","MATUGA","37",892,854,1746
"20834","KWALE","MATUGA","38",679,700,1379
"20835","KWALE","MATUGA","39",791,776,1567
"20836","KWALE","MATUGA","35-39",4540,4703,9243
"20837","KWALE","MATUGA","40",1148,1137,2285
"20838","KWALE","MATUGA","41",894,951,1845
"20839","KWALE","MATUGA","42",861,976,1837
"20840","KWALE","MATUGA","43",736,861,1597
"20841","KWALE","MATUGA","44",638,659,1297
"20842","KWALE","MATUGA","40-44",4277,4584,8861
"20843","KWALE","MATUGA","45",1126,1078,2204
"20844","KWALE","MATUGA","46",649,755,1404
"20845","KWALE","MATUGA","47",728,700,1428
"20846","KWALE","MATUGA","48",562,523,1085
"20847","KWALE","MATUGA","49",624,531,1155
"20848","KWALE","MATUGA","45-49",3689,3587,7276
"20849","KWALE","MATUGA","50",932,881,1813
"20850","KWALE","MATUGA","51",582,515,1097
"20851","KWALE","MATUGA","52",440,373,813
"20852","KWALE","MATUGA","53",304,254,558
"20853","KWALE","MATUGA","54",403,299,702
"20854","KWALE","MATUGA","50-54",2661,2322,4983
"20855","KWALE","MATUGA","55",449,365,814
"20856","KWALE","MATUGA","56",525,484,1009
"20857","KWALE","MATUGA","57",410,434,844
"20858","KWALE","MATUGA","58",399,343,742
"20859","KWALE","MATUGA","59",424,503,927
"20860","KWALE","MATUGA","55-59",2207,2129,4336
"20861","KWALE","MATUGA","60",650,843,1493
"20862","KWALE","MATUGA","61",360,461,821
"20863","KWALE","MATUGA","62",366,372,738
"20864","KWALE","MATUGA","63",390,456,846
"20865","KWALE","MATUGA","64",321,329,650
"20866","KWALE","MATUGA","60-64",2087,2461,4548
"20867","KWALE","MATUGA","65",459,538,997
"20868","KWALE","MATUGA","66",286,232,518
"20869","KWALE","MATUGA","67",360,348,708
"20870","KWALE","MATUGA","68",205,212,417
"20871","KWALE","MATUGA","69",257,368,625
"20872","KWALE","MATUGA","65-69",1567,1698,3265
"20873","KWALE","MATUGA","70",381,680,1061
"20874","KWALE","MATUGA","71",195,195,390
"20875","KWALE","MATUGA","72",192,167,359
"20876","KWALE","MATUGA","73",157,109,266
"20877","KWALE","MATUGA","74",148,164,312
"20878","KWALE","MATUGA","70-74",1073,1315,2388
"20879","KWALE","MATUGA","75",191,188,379
"20880","KWALE","MATUGA","76",80,93,173
"20881","KWALE","MATUGA","77",113,100,213
"20882","KWALE","MATUGA","78",103,60,163
"20883","KWALE","MATUGA","79",107,123,230
"20884","KWALE","MATUGA","75-79",594,564,1158
"20885","KWALE","MATUGA","80",133,250,383
"20886","KWALE","MATUGA","81",64,57,121
"20887","KWALE","MATUGA","82",48,42,90
"20888","KWALE","MATUGA","83",58,49,107
"20889","KWALE","MATUGA","84",51,75,126
"20890","KWALE","MATUGA","80-84",354,473,827
"20891","KWALE","MATUGA","85",49,79,128
"20892","KWALE","MATUGA","86",30,26,56
"20893","KWALE","MATUGA","87",27,32,59
"20894","KWALE","MATUGA","88",21,18,39
"20895","KWALE","MATUGA","89",37,63,100
"20896","KWALE","MATUGA","85-89",164,218,382
"20897","KWALE","MATUGA","90",33,61,94
"20898","KWALE","MATUGA","91",12,15,27
"20899","KWALE","MATUGA","92",16,12,28
"20900","KWALE","MATUGA","93",6,6,12
"20901","KWALE","MATUGA","94",13,10,23
"20902","KWALE","MATUGA","90-94",80,104,184
"20903","KWALE","MATUGA","95",11,9,20
"20904","KWALE","MATUGA","96",7,5,12
"20905","KWALE","MATUGA","97",4,4,8
"20906","KWALE","MATUGA","98",10,4,14
"20907","KWALE","MATUGA","99",8,7,15
"20908","KWALE","MATUGA","95-99",40,29,69
"20909","KWALE","MATUGA","100+",25,36,61
"20910","KWALE","MATUGA","Not Stated",NA,3,3
"20911","KWALE","MSAMBWENI","Total",89206,88480,177686
"20912","KWALE","MSAMBWENI","0",2283,2197,4480
"20913","KWALE","MSAMBWENI","1",2283,2189,4472
"20914","KWALE","MSAMBWENI","2",2211,2224,4435
"20915","KWALE","MSAMBWENI","3",2259,2154,4413
"20916","KWALE","MSAMBWENI","4",2485,2436,4921
"20917","KWALE","MSAMBWENI","0 - 4",11521,11200,22721
"20918","KWALE","MSAMBWENI","5",2503,2494,4997
"20919","KWALE","MSAMBWENI","6",2240,2175,4415
"20920","KWALE","MSAMBWENI","7",2181,2146,4327
"20921","KWALE","MSAMBWENI","8",1899,2012,3911
"20922","KWALE","MSAMBWENI","9",2107,2123,4230
"20923","KWALE","MSAMBWENI","5-9",10930,10950,21880
"20924","KWALE","MSAMBWENI","10",2166,2081,4247
"20925","KWALE","MSAMBWENI","11",1876,1943,3819
"20926","KWALE","MSAMBWENI","12",2014,2090,4104
"20927","KWALE","MSAMBWENI","13",2138,2225,4363
"20928","KWALE","MSAMBWENI","14",2056,2001,4057
"20929","KWALE","MSAMBWENI","10 -14",10250,10340,20590
"20930","KWALE","MSAMBWENI","15",1832,1803,3635
"20931","KWALE","MSAMBWENI","16",1737,1745,3482
"20932","KWALE","MSAMBWENI","17",1780,1743,3523
"20933","KWALE","MSAMBWENI","18",1728,1693,3421
"20934","KWALE","MSAMBWENI","19",1776,1899,3675
"20935","KWALE","MSAMBWENI","15-19",8853,8883,17736
"20936","KWALE","MSAMBWENI","20",1819,2083,3902
"20937","KWALE","MSAMBWENI","21",1453,1726,3179
"20938","KWALE","MSAMBWENI","22",1709,1992,3701
"20939","KWALE","MSAMBWENI","23",1693,1974,3667
"20940","KWALE","MSAMBWENI","24",1692,1886,3578
"20941","KWALE","MSAMBWENI","20-24",8366,9661,18027
"20942","KWALE","MSAMBWENI","25",2031,2110,4141
"20943","KWALE","MSAMBWENI","26",1700,1844,3544
"20944","KWALE","MSAMBWENI","27",1719,1781,3500
"20945","KWALE","MSAMBWENI","28",1449,1618,3067
"20946","KWALE","MSAMBWENI","29",1377,1615,2992
"20947","KWALE","MSAMBWENI","25-29",8276,8968,17244
"20948","KWALE","MSAMBWENI","30",2061,2167,4228
"20949","KWALE","MSAMBWENI","31",1243,1264,2507
"20950","KWALE","MSAMBWENI","32",1537,1596,3133
"20951","KWALE","MSAMBWENI","33",1229,1358,2587
"20952","KWALE","MSAMBWENI","34",1174,1221,2395
"20953","KWALE","MSAMBWENI","30-34",7244,7606,14850
"20954","KWALE","MSAMBWENI","35",1658,1491,3149
"20955","KWALE","MSAMBWENI","36",1088,1058,2146
"20956","KWALE","MSAMBWENI","37",1100,1014,2114
"20957","KWALE","MSAMBWENI","38",876,842,1718
"20958","KWALE","MSAMBWENI","39",882,775,1657
"20959","KWALE","MSAMBWENI","35-39",5604,5180,10784
"20960","KWALE","MSAMBWENI","40",1355,1225,2580
"20961","KWALE","MSAMBWENI","41",983,905,1888
"20962","KWALE","MSAMBWENI","42",1005,897,1902
"20963","KWALE","MSAMBWENI","43",805,778,1583
"20964","KWALE","MSAMBWENI","44",783,672,1455
"20965","KWALE","MSAMBWENI","40-44",4931,4477,9408
"20966","KWALE","MSAMBWENI","45",1223,965,2188
"20967","KWALE","MSAMBWENI","46",730,625,1355
"20968","KWALE","MSAMBWENI","47",781,619,1400
"20969","KWALE","MSAMBWENI","48",582,460,1042
"20970","KWALE","MSAMBWENI","49",693,429,1122
"20971","KWALE","MSAMBWENI","45-49",4009,3098,7107
"20972","KWALE","MSAMBWENI","50",1005,873,1878
"20973","KWALE","MSAMBWENI","51",596,429,1025
"20974","KWALE","MSAMBWENI","52",511,323,834
"20975","KWALE","MSAMBWENI","53",348,224,572
"20976","KWALE","MSAMBWENI","54",441,218,659
"20977","KWALE","MSAMBWENI","50-54",2901,2067,4968
"20978","KWALE","MSAMBWENI","55",453,301,754
"20979","KWALE","MSAMBWENI","56",524,373,897
"20980","KWALE","MSAMBWENI","57",427,328,755
"20981","KWALE","MSAMBWENI","58",311,276,587
"20982","KWALE","MSAMBWENI","59",341,350,691
"20983","KWALE","MSAMBWENI","55-59",2056,1628,3684
"20984","KWALE","MSAMBWENI","60",524,618,1142
"20985","KWALE","MSAMBWENI","61",243,274,517
"20986","KWALE","MSAMBWENI","62",257,226,483
"20987","KWALE","MSAMBWENI","63",251,264,515
"20988","KWALE","MSAMBWENI","64",220,179,399
"20989","KWALE","MSAMBWENI","60-64",1495,1561,3056
"20990","KWALE","MSAMBWENI","65",356,347,703
"20991","KWALE","MSAMBWENI","66",214,173,387
"20992","KWALE","MSAMBWENI","67",324,228,552
"20993","KWALE","MSAMBWENI","68",170,123,293
"20994","KWALE","MSAMBWENI","69",181,212,393
"20995","KWALE","MSAMBWENI","65-69",1245,1083,2328
"20996","KWALE","MSAMBWENI","70",295,455,750
"20997","KWALE","MSAMBWENI","71",131,131,262
"20998","KWALE","MSAMBWENI","72",132,107,239
"20999","KWALE","MSAMBWENI","73",112,90,202
"21000","KWALE","MSAMBWENI","74",99,100,199
"21001","KWALE","MSAMBWENI","70-74",769,883,1652
"21002","KWALE","MSAMBWENI","75",133,116,249
"21003","KWALE","MSAMBWENI","76",70,57,127
"21004","KWALE","MSAMBWENI","77",58,71,129
"21005","KWALE","MSAMBWENI","78",47,50,97
"21006","KWALE","MSAMBWENI","79",60,80,140
"21007","KWALE","MSAMBWENI","75-79",368,374,742
"21008","KWALE","MSAMBWENI","80",104,165,269
"21009","KWALE","MSAMBWENI","81",37,45,82
"21010","KWALE","MSAMBWENI","82",34,36,70
"21011","KWALE","MSAMBWENI","83",23,34,57
"21012","KWALE","MSAMBWENI","84",33,34,67
"21013","KWALE","MSAMBWENI","80-84",231,314,545
"21014","KWALE","MSAMBWENI","85",24,39,63
"21015","KWALE","MSAMBWENI","86",30,17,47
"21016","KWALE","MSAMBWENI","87",21,15,36
"21017","KWALE","MSAMBWENI","88",10,15,25
"21018","KWALE","MSAMBWENI","89",14,27,41
"21019","KWALE","MSAMBWENI","85-89",99,113,212
"21020","KWALE","MSAMBWENI","90",17,45,62
"21021","KWALE","MSAMBWENI","91",9,5,14
"21022","KWALE","MSAMBWENI","92",5,1,6
"21023","KWALE","MSAMBWENI","93",1,1,2
"21024","KWALE","MSAMBWENI","94",3,4,7
"21025","KWALE","MSAMBWENI","90-94",35,56,91
"21026","KWALE","MSAMBWENI","95",4,4,8
"21027","KWALE","MSAMBWENI","96",3,3,6
"21028","KWALE","MSAMBWENI","97",1,4,5
"21029","KWALE","MSAMBWENI","98",1,3,4
"21030","KWALE","MSAMBWENI","99",2,5,7
"21031","KWALE","MSAMBWENI","95-99",11,19,30
"21032","KWALE","MSAMBWENI","100+",11,18,29
"21033","KWALE","MSAMBWENI","Not Stated",1,1,2
"21034","KWALE","SAMBURU","Total",97497,104731,202228
"21035","KWALE","SAMBURU","0",3143,3241,6384
"21036","KWALE","SAMBURU","1",3228,3146,6374
"21037","KWALE","SAMBURU","2",3451,3393,6844
"21038","KWALE","SAMBURU","3",3449,3388,6837
"21039","KWALE","SAMBURU","4",3462,3499,6961
"21040","KWALE","SAMBURU","0 - 4",16733,16667,33400
"21041","KWALE","SAMBURU","5",3746,3603,7349
"21042","KWALE","SAMBURU","6",3294,3264,6558
"21043","KWALE","SAMBURU","7",3300,3169,6469
"21044","KWALE","SAMBURU","8",3057,3101,6158
"21045","KWALE","SAMBURU","9",3288,3172,6460
"21046","KWALE","SAMBURU","5-9",16685,16309,32994
"21047","KWALE","SAMBURU","10",3184,3303,6487
"21048","KWALE","SAMBURU","11",3051,3130,6181
"21049","KWALE","SAMBURU","12",3401,3099,6500
"21050","KWALE","SAMBURU","13",3170,3181,6351
"21051","KWALE","SAMBURU","14",2795,2748,5543
"21052","KWALE","SAMBURU","10 -14",15601,15461,31062
"21053","KWALE","SAMBURU","15",2583,2484,5067
"21054","KWALE","SAMBURU","16",2481,2373,4854
"21055","KWALE","SAMBURU","17",2372,2190,4562
"21056","KWALE","SAMBURU","18",2148,2034,4182
"21057","KWALE","SAMBURU","19",1975,2095,4070
"21058","KWALE","SAMBURU","15-19",11559,11176,22735
"21059","KWALE","SAMBURU","20",1935,2182,4117
"21060","KWALE","SAMBURU","21",1376,1691,3067
"21061","KWALE","SAMBURU","22",1401,1791,3192
"21062","KWALE","SAMBURU","23",1328,1795,3123
"21063","KWALE","SAMBURU","24",1259,1587,2846
"21064","KWALE","SAMBURU","20-24",7299,9046,16345
"21065","KWALE","SAMBURU","25",1546,1869,3415
"21066","KWALE","SAMBURU","26",1189,1528,2717
"21067","KWALE","SAMBURU","27",1255,1566,2821
"21068","KWALE","SAMBURU","28",1085,1396,2481
"21069","KWALE","SAMBURU","29",1057,1419,2476
"21070","KWALE","SAMBURU","25-29",6132,7778,13910
"21071","KWALE","SAMBURU","30",1326,2036,3362
"21072","KWALE","SAMBURU","31",920,1352,2272
"21073","KWALE","SAMBURU","32",1062,1564,2626
"21074","KWALE","SAMBURU","33",855,1248,2103
"21075","KWALE","SAMBURU","34",931,1200,2131
"21076","KWALE","SAMBURU","30-34",5094,7400,12494
"21077","KWALE","SAMBURU","35",1124,1374,2498
"21078","KWALE","SAMBURU","36",778,940,1718
"21079","KWALE","SAMBURU","37",689,795,1484
"21080","KWALE","SAMBURU","38",554,631,1185
"21081","KWALE","SAMBURU","39",594,640,1234
"21082","KWALE","SAMBURU","35-39",3739,4380,8119
"21083","KWALE","SAMBURU","40",874,966,1840
"21084","KWALE","SAMBURU","41",705,763,1468
"21085","KWALE","SAMBURU","42",783,892,1675
"21086","KWALE","SAMBURU","43",674,744,1418
"21087","KWALE","SAMBURU","44",606,633,1239
"21088","KWALE","SAMBURU","40-44",3642,3998,7640
"21089","KWALE","SAMBURU","45",793,877,1670
"21090","KWALE","SAMBURU","46",561,558,1119
"21091","KWALE","SAMBURU","47",597,521,1118
"21092","KWALE","SAMBURU","48",412,389,801
"21093","KWALE","SAMBURU","49",484,367,851
"21094","KWALE","SAMBURU","45-49",2847,2712,5559
"21095","KWALE","SAMBURU","50",638,627,1265
"21096","KWALE","SAMBURU","51",460,279,739
"21097","KWALE","SAMBURU","52",315,267,582
"21098","KWALE","SAMBURU","53",193,166,359
"21099","KWALE","SAMBURU","54",242,204,446
"21100","KWALE","SAMBURU","50-54",1848,1543,3391
"21101","KWALE","SAMBURU","55",299,250,549
"21102","KWALE","SAMBURU","56",367,385,752
"21103","KWALE","SAMBURU","57",305,388,693
"21104","KWALE","SAMBURU","58",277,283,560
"21105","KWALE","SAMBURU","59",354,532,886
"21106","KWALE","SAMBURU","55-59",1602,1838,3440
"21107","KWALE","SAMBURU","60",440,776,1216
"21108","KWALE","SAMBURU","61",287,444,731
"21109","KWALE","SAMBURU","62",273,339,612
"21110","KWALE","SAMBURU","63",309,405,714
"21111","KWALE","SAMBURU","64",217,280,497
"21112","KWALE","SAMBURU","60-64",1526,2244,3770
"21113","KWALE","SAMBURU","65",353,423,776
"21114","KWALE","SAMBURU","66",233,177,410
"21115","KWALE","SAMBURU","67",295,292,587
"21116","KWALE","SAMBURU","68",161,158,319
"21117","KWALE","SAMBURU","69",279,412,691
"21118","KWALE","SAMBURU","65-69",1321,1462,2783
"21119","KWALE","SAMBURU","70",324,523,847
"21120","KWALE","SAMBURU","71",113,210,323
"21121","KWALE","SAMBURU","72",111,158,269
"21122","KWALE","SAMBURU","73",137,150,287
"21123","KWALE","SAMBURU","74",148,191,339
"21124","KWALE","SAMBURU","70-74",833,1232,2065
"21125","KWALE","SAMBURU","75",142,172,314
"21126","KWALE","SAMBURU","76",92,110,202
"21127","KWALE","SAMBURU","77",85,117,202
"21128","KWALE","SAMBURU","78",67,63,130
"21129","KWALE","SAMBURU","79",101,147,248
"21130","KWALE","SAMBURU","75-79",487,609,1096
"21131","KWALE","SAMBURU","80",111,212,323
"21132","KWALE","SAMBURU","81",39,66,105
"21133","KWALE","SAMBURU","82",37,50,87
"21134","KWALE","SAMBURU","83",44,65,109
"21135","KWALE","SAMBURU","84",41,63,104
"21136","KWALE","SAMBURU","80-84",272,456,728
"21137","KWALE","SAMBURU","85",41,73,114
"21138","KWALE","SAMBURU","86",20,19,39
"21139","KWALE","SAMBURU","87",35,41,76
"21140","KWALE","SAMBURU","88",18,14,32
"21141","KWALE","SAMBURU","89",41,79,120
"21142","KWALE","SAMBURU","85-89",155,226,381
"21143","KWALE","SAMBURU","90",31,50,81
"21144","KWALE","SAMBURU","91",12,18,30
"21145","KWALE","SAMBURU","92",6,7,13
"21146","KWALE","SAMBURU","93",6,8,14
"21147","KWALE","SAMBURU","94",9,13,22
"21148","KWALE","SAMBURU","90-94",64,96,160
"21149","KWALE","SAMBURU","95",7,14,21
"21150","KWALE","SAMBURU","96",6,6,12
"21151","KWALE","SAMBURU","97",4,12,16
"21152","KWALE","SAMBURU","98",3,7,10
"21153","KWALE","SAMBURU","99",9,20,29
"21154","KWALE","SAMBURU","95-99",29,59,88
"21155","KWALE","SAMBURU","100+",24,37,61
"21156","KWALE","SAMBURU","Not Stated",5,2,7
"21157","LAIKIPIA","ALL","Total",259440,259102,518542
"21158","LAIKIPIA","ALL","0",6618,6446,13064
"21159","LAIKIPIA","ALL","1",6219,6071,12290
"21160","LAIKIPIA","ALL","2",6542,6395,12937
"21161","LAIKIPIA","ALL","3",6975,6811,13786
"21162","LAIKIPIA","ALL","4",6802,6662,13464
"21163","LAIKIPIA","ALL","0 - 4",33156,32385,65541
"21164","LAIKIPIA","ALL","5",6533,6421,12954
"21165","LAIKIPIA","ALL","6",6665,6464,13129
"21166","LAIKIPIA","ALL","7",6496,6481,12977
"21167","LAIKIPIA","ALL","8",6440,6217,12657
"21168","LAIKIPIA","ALL","9",6296,6231,12527
"21169","LAIKIPIA","ALL","5-9",32430,31814,64244
"21170","LAIKIPIA","ALL","10",7208,6962,14170
"21171","LAIKIPIA","ALL","11",5901,5808,11709
"21172","LAIKIPIA","ALL","12",7011,6412,13423
"21173","LAIKIPIA","ALL","13",6758,6627,13385
"21174","LAIKIPIA","ALL","14",6494,6116,12610
"21175","LAIKIPIA","ALL","10 -14",33372,31925,65297
"21176","LAIKIPIA","ALL","15",6614,6067,12681
"21177","LAIKIPIA","ALL","16",5944,5746,11690
"21178","LAIKIPIA","ALL","17",6358,5675,12033
"21179","LAIKIPIA","ALL","18",5241,4776,10017
"21180","LAIKIPIA","ALL","19",5108,4931,10039
"21181","LAIKIPIA","ALL","15-19",29265,27195,56460
"21182","LAIKIPIA","ALL","20",4794,5032,9826
"21183","LAIKIPIA","ALL","21",4134,4299,8433
"21184","LAIKIPIA","ALL","22",4106,4587,8693
"21185","LAIKIPIA","ALL","23",4200,4502,8702
"21186","LAIKIPIA","ALL","24",3835,4081,7916
"21187","LAIKIPIA","ALL","20-24",21069,22501,43570
"21188","LAIKIPIA","ALL","25",4386,4406,8792
"21189","LAIKIPIA","ALL","26",3428,3791,7219
"21190","LAIKIPIA","ALL","27",3658,3771,7429
"21191","LAIKIPIA","ALL","28",3269,3502,6771
"21192","LAIKIPIA","ALL","29",3464,3598,7062
"21193","LAIKIPIA","ALL","25-29",18205,19068,37273
"21194","LAIKIPIA","ALL","30",4468,4993,9461
"21195","LAIKIPIA","ALL","31",3235,3361,6596
"21196","LAIKIPIA","ALL","32",3910,4249,8159
"21197","LAIKIPIA","ALL","33",3230,3449,6679
"21198","LAIKIPIA","ALL","34",3049,3283,6332
"21199","LAIKIPIA","ALL","30-34",17892,19335,37227
"21200","LAIKIPIA","ALL","35",4414,4392,8806
"21201","LAIKIPIA","ALL","36",2989,2837,5826
"21202","LAIKIPIA","ALL","37",2941,2694,5635
"21203","LAIKIPIA","ALL","38",2608,2364,4972
"21204","LAIKIPIA","ALL","39",2724,2657,5381
"21205","LAIKIPIA","ALL","35-39",15676,14944,30620
"21206","LAIKIPIA","ALL","40",3704,3328,7032
"21207","LAIKIPIA","ALL","41",2830,2773,5603
"21208","LAIKIPIA","ALL","42",2827,2709,5536
"21209","LAIKIPIA","ALL","43",2374,2305,4679
"21210","LAIKIPIA","ALL","44",1933,1969,3902
"21211","LAIKIPIA","ALL","40-44",13668,13084,26752
"21212","LAIKIPIA","ALL","45",3134,2906,6040
"21213","LAIKIPIA","ALL","46",2265,2266,4531
"21214","LAIKIPIA","ALL","47",2230,2186,4416
"21215","LAIKIPIA","ALL","48",1745,1647,3392
"21216","LAIKIPIA","ALL","49",1945,1915,3860
"21217","LAIKIPIA","ALL","45-49",11319,10920,22239
"21218","LAIKIPIA","ALL","50",2501,2559,5060
"21219","LAIKIPIA","ALL","51",1891,1730,3621
"21220","LAIKIPIA","ALL","52",1880,1838,3718
"21221","LAIKIPIA","ALL","53",1286,1349,2635
"21222","LAIKIPIA","ALL","54",1621,1605,3226
"21223","LAIKIPIA","ALL","50-54",9179,9081,18260
"21224","LAIKIPIA","ALL","55",1830,1685,3515
"21225","LAIKIPIA","ALL","56",1742,1673,3415
"21226","LAIKIPIA","ALL","57",1392,1548,2940
"21227","LAIKIPIA","ALL","58",1174,1341,2515
"21228","LAIKIPIA","ALL","59",1400,1467,2867
"21229","LAIKIPIA","ALL","55-59",7538,7714,15252
"21230","LAIKIPIA","ALL","60",1638,1834,3472
"21231","LAIKIPIA","ALL","61",1063,1142,2205
"21232","LAIKIPIA","ALL","62",1003,979,1982
"21233","LAIKIPIA","ALL","63",811,890,1701
"21234","LAIKIPIA","ALL","64",586,621,1207
"21235","LAIKIPIA","ALL","60-64",5101,5466,10567
"21236","LAIKIPIA","ALL","65",1006,1105,2111
"21237","LAIKIPIA","ALL","66",658,710,1368
"21238","LAIKIPIA","ALL","67",1090,1262,2352
"21239","LAIKIPIA","ALL","68",509,557,1066
"21240","LAIKIPIA","ALL","69",796,871,1667
"21241","LAIKIPIA","ALL","65-69",4059,4505,8564
"21242","LAIKIPIA","ALL","70",1105,1346,2451
"21243","LAIKIPIA","ALL","71",673,789,1462
"21244","LAIKIPIA","ALL","72",706,602,1308
"21245","LAIKIPIA","ALL","73",536,490,1026
"21246","LAIKIPIA","ALL","74",461,529,990
"21247","LAIKIPIA","ALL","70-74",3481,3756,7237
"21248","LAIKIPIA","ALL","75",457,577,1034
"21249","LAIKIPIA","ALL","76",471,767,1238
"21250","LAIKIPIA","ALL","77",352,402,754
"21251","LAIKIPIA","ALL","78",278,247,525
"21252","LAIKIPIA","ALL","79",306,385,691
"21253","LAIKIPIA","ALL","75-79",1864,2378,4242
"21254","LAIKIPIA","ALL","80",422,554,976
"21255","LAIKIPIA","ALL","81",194,275,469
"21256","LAIKIPIA","ALL","82",176,179,355
"21257","LAIKIPIA","ALL","83",196,200,396
"21258","LAIKIPIA","ALL","84",173,214,387
"21259","LAIKIPIA","ALL","80-84",1161,1422,2583
"21260","LAIKIPIA","ALL","85",149,181,330
"21261","LAIKIPIA","ALL","86",116,189,305
"21262","LAIKIPIA","ALL","87",122,131,253
"21263","LAIKIPIA","ALL","88",60,72,132
"21264","LAIKIPIA","ALL","89",139,222,361
"21265","LAIKIPIA","ALL","85-89",586,795,1381
"21266","LAIKIPIA","ALL","90",76,164,240
"21267","LAIKIPIA","ALL","91",84,115,199
"21268","LAIKIPIA","ALL","92",40,49,89
"21269","LAIKIPIA","ALL","93",24,43,67
"21270","LAIKIPIA","ALL","94",22,50,72
"21271","LAIKIPIA","ALL","90-94",246,421,667
"21272","LAIKIPIA","ALL","95",37,75,112
"21273","LAIKIPIA","ALL","96",15,35,50
"21274","LAIKIPIA","ALL","97",23,43,66
"21275","LAIKIPIA","ALL","98",17,24,41
"21276","LAIKIPIA","ALL","99",21,60,81
"21277","LAIKIPIA","ALL","95-99",113,237,350
"21278","LAIKIPIA","ALL","100+",57,154,211
"21279","LAIKIPIA","ALL","Not Stated",3,2,5
"21280","LAIKIPIA","LAIKIPIA CENTRAL","Total",47888,47705,95593
"21281","LAIKIPIA","LAIKIPIA CENTRAL","0",1031,986,2017
"21282","LAIKIPIA","LAIKIPIA CENTRAL","1",1049,1006,2055
"21283","LAIKIPIA","LAIKIPIA CENTRAL","2",1020,966,1986
"21284","LAIKIPIA","LAIKIPIA CENTRAL","3",1095,1062,2157
"21285","LAIKIPIA","LAIKIPIA CENTRAL","4",1098,1034,2132
"21286","LAIKIPIA","LAIKIPIA CENTRAL","0 - 4",5293,5054,10347
"21287","LAIKIPIA","LAIKIPIA CENTRAL","5",1037,1021,2058
"21288","LAIKIPIA","LAIKIPIA CENTRAL","6",1097,971,2068
"21289","LAIKIPIA","LAIKIPIA CENTRAL","7",1124,1037,2161
"21290","LAIKIPIA","LAIKIPIA CENTRAL","8",1029,1055,2084
"21291","LAIKIPIA","LAIKIPIA CENTRAL","9",1189,1109,2298
"21292","LAIKIPIA","LAIKIPIA CENTRAL","5-9",5476,5193,10669
"21293","LAIKIPIA","LAIKIPIA CENTRAL","10",1137,1042,2179
"21294","LAIKIPIA","LAIKIPIA CENTRAL","11",1026,1020,2046
"21295","LAIKIPIA","LAIKIPIA CENTRAL","12",1177,1094,2271
"21296","LAIKIPIA","LAIKIPIA CENTRAL","13",1207,1194,2401
"21297","LAIKIPIA","LAIKIPIA CENTRAL","14",1079,1037,2116
"21298","LAIKIPIA","LAIKIPIA CENTRAL","10 -14",5626,5387,11013
"21299","LAIKIPIA","LAIKIPIA CENTRAL","15",1140,1001,2141
"21300","LAIKIPIA","LAIKIPIA CENTRAL","16",1050,1039,2089
"21301","LAIKIPIA","LAIKIPIA CENTRAL","17",1188,962,2150
"21302","LAIKIPIA","LAIKIPIA CENTRAL","18",903,790,1693
"21303","LAIKIPIA","LAIKIPIA CENTRAL","19",867,768,1635
"21304","LAIKIPIA","LAIKIPIA CENTRAL","15-19",5148,4560,9708
"21305","LAIKIPIA","LAIKIPIA CENTRAL","20",764,785,1549
"21306","LAIKIPIA","LAIKIPIA CENTRAL","21",676,718,1394
"21307","LAIKIPIA","LAIKIPIA CENTRAL","22",651,700,1351
"21308","LAIKIPIA","LAIKIPIA CENTRAL","23",756,754,1510
"21309","LAIKIPIA","LAIKIPIA CENTRAL","24",621,731,1352
"21310","LAIKIPIA","LAIKIPIA CENTRAL","20-24",3468,3688,7156
"21311","LAIKIPIA","LAIKIPIA CENTRAL","25",676,735,1411
"21312","LAIKIPIA","LAIKIPIA CENTRAL","26",606,686,1292
"21313","LAIKIPIA","LAIKIPIA CENTRAL","27",663,679,1342
"21314","LAIKIPIA","LAIKIPIA CENTRAL","28",591,606,1197
"21315","LAIKIPIA","LAIKIPIA CENTRAL","29",636,670,1306
"21316","LAIKIPIA","LAIKIPIA CENTRAL","25-29",3172,3376,6548
"21317","LAIKIPIA","LAIKIPIA CENTRAL","30",794,926,1720
"21318","LAIKIPIA","LAIKIPIA CENTRAL","31",599,594,1193
"21319","LAIKIPIA","LAIKIPIA CENTRAL","32",734,825,1559
"21320","LAIKIPIA","LAIKIPIA CENTRAL","33",642,657,1299
"21321","LAIKIPIA","LAIKIPIA CENTRAL","34",588,676,1264
"21322","LAIKIPIA","LAIKIPIA CENTRAL","30-34",3357,3678,7035
"21323","LAIKIPIA","LAIKIPIA CENTRAL","35",878,885,1763
"21324","LAIKIPIA","LAIKIPIA CENTRAL","36",640,616,1256
"21325","LAIKIPIA","LAIKIPIA CENTRAL","37",597,609,1206
"21326","LAIKIPIA","LAIKIPIA CENTRAL","38",605,530,1135
"21327","LAIKIPIA","LAIKIPIA CENTRAL","39",585,603,1188
"21328","LAIKIPIA","LAIKIPIA CENTRAL","35-39",3305,3243,6548
"21329","LAIKIPIA","LAIKIPIA CENTRAL","40",712,657,1369
"21330","LAIKIPIA","LAIKIPIA CENTRAL","41",579,592,1171
"21331","LAIKIPIA","LAIKIPIA CENTRAL","42",601,554,1155
"21332","LAIKIPIA","LAIKIPIA CENTRAL","43",509,493,1002
"21333","LAIKIPIA","LAIKIPIA CENTRAL","44",497,443,940
"21334","LAIKIPIA","LAIKIPIA CENTRAL","40-44",2898,2739,5637
"21335","LAIKIPIA","LAIKIPIA CENTRAL","45",684,647,1331
"21336","LAIKIPIA","LAIKIPIA CENTRAL","46",487,528,1015
"21337","LAIKIPIA","LAIKIPIA CENTRAL","47",519,457,976
"21338","LAIKIPIA","LAIKIPIA CENTRAL","48",412,427,839
"21339","LAIKIPIA","LAIKIPIA CENTRAL","49",449,460,909
"21340","LAIKIPIA","LAIKIPIA CENTRAL","45-49",2551,2519,5070
"21341","LAIKIPIA","LAIKIPIA CENTRAL","50",508,601,1109
"21342","LAIKIPIA","LAIKIPIA CENTRAL","51",430,408,838
"21343","LAIKIPIA","LAIKIPIA CENTRAL","52",423,443,866
"21344","LAIKIPIA","LAIKIPIA CENTRAL","53",295,344,639
"21345","LAIKIPIA","LAIKIPIA CENTRAL","54",373,389,762
"21346","LAIKIPIA","LAIKIPIA CENTRAL","50-54",2029,2185,4214
"21347","LAIKIPIA","LAIKIPIA CENTRAL","55",419,419,838
"21348","LAIKIPIA","LAIKIPIA CENTRAL","56",414,422,836
"21349","LAIKIPIA","LAIKIPIA CENTRAL","57",326,389,715
"21350","LAIKIPIA","LAIKIPIA CENTRAL","58",263,300,563
"21351","LAIKIPIA","LAIKIPIA CENTRAL","59",331,344,675
"21352","LAIKIPIA","LAIKIPIA CENTRAL","55-59",1753,1874,3627
"21353","LAIKIPIA","LAIKIPIA CENTRAL","60",380,380,760
"21354","LAIKIPIA","LAIKIPIA CENTRAL","61",236,295,531
"21355","LAIKIPIA","LAIKIPIA CENTRAL","62",258,215,473
"21356","LAIKIPIA","LAIKIPIA CENTRAL","63",189,202,391
"21357","LAIKIPIA","LAIKIPIA CENTRAL","64",108,138,246
"21358","LAIKIPIA","LAIKIPIA CENTRAL","60-64",1171,1230,2401
"21359","LAIKIPIA","LAIKIPIA CENTRAL","65",207,239,446
"21360","LAIKIPIA","LAIKIPIA CENTRAL","66",181,166,347
"21361","LAIKIPIA","LAIKIPIA CENTRAL","67",267,308,575
"21362","LAIKIPIA","LAIKIPIA CENTRAL","68",130,135,265
"21363","LAIKIPIA","LAIKIPIA CENTRAL","69",185,167,352
"21364","LAIKIPIA","LAIKIPIA CENTRAL","65-69",970,1015,1985
"21365","LAIKIPIA","LAIKIPIA CENTRAL","70",260,266,526
"21366","LAIKIPIA","LAIKIPIA CENTRAL","71",158,181,339
"21367","LAIKIPIA","LAIKIPIA CENTRAL","72",194,170,364
"21368","LAIKIPIA","LAIKIPIA CENTRAL","73",137,102,239
"21369","LAIKIPIA","LAIKIPIA CENTRAL","74",94,115,209
"21370","LAIKIPIA","LAIKIPIA CENTRAL","70-74",843,834,1677
"21371","LAIKIPIA","LAIKIPIA CENTRAL","75",97,127,224
"21372","LAIKIPIA","LAIKIPIA CENTRAL","76",108,180,288
"21373","LAIKIPIA","LAIKIPIA CENTRAL","77",72,88,160
"21374","LAIKIPIA","LAIKIPIA CENTRAL","78",62,56,118
"21375","LAIKIPIA","LAIKIPIA CENTRAL","79",67,71,138
"21376","LAIKIPIA","LAIKIPIA CENTRAL","75-79",406,522,928
"21377","LAIKIPIA","LAIKIPIA CENTRAL","80",87,113,200
"21378","LAIKIPIA","LAIKIPIA CENTRAL","81",31,44,75
"21379","LAIKIPIA","LAIKIPIA CENTRAL","82",37,41,78
"21380","LAIKIPIA","LAIKIPIA CENTRAL","83",47,42,89
"21381","LAIKIPIA","LAIKIPIA CENTRAL","84",41,40,81
"21382","LAIKIPIA","LAIKIPIA CENTRAL","80-84",243,280,523
"21383","LAIKIPIA","LAIKIPIA CENTRAL","85",31,26,57
"21384","LAIKIPIA","LAIKIPIA CENTRAL","86",21,41,62
"21385","LAIKIPIA","LAIKIPIA CENTRAL","87",26,25,51
"21386","LAIKIPIA","LAIKIPIA CENTRAL","88",6,16,22
"21387","LAIKIPIA","LAIKIPIA CENTRAL","89",27,37,64
"21388","LAIKIPIA","LAIKIPIA CENTRAL","85-89",111,145,256
"21389","LAIKIPIA","LAIKIPIA CENTRAL","90",11,44,55
"21390","LAIKIPIA","LAIKIPIA CENTRAL","91",11,30,41
"21391","LAIKIPIA","LAIKIPIA CENTRAL","92",7,6,13
"21392","LAIKIPIA","LAIKIPIA CENTRAL","93",5,8,13
"21393","LAIKIPIA","LAIKIPIA CENTRAL","94",2,10,12
"21394","LAIKIPIA","LAIKIPIA CENTRAL","90-94",36,98,134
"21395","LAIKIPIA","LAIKIPIA CENTRAL","95",8,13,21
"21396","LAIKIPIA","LAIKIPIA CENTRAL","96",1,12,13
"21397","LAIKIPIA","LAIKIPIA CENTRAL","97",2,9,11
"21398","LAIKIPIA","LAIKIPIA CENTRAL","98",4,6,10
"21399","LAIKIPIA","LAIKIPIA CENTRAL","99",2,12,14
"21400","LAIKIPIA","LAIKIPIA CENTRAL","95-99",17,52,69
"21401","LAIKIPIA","LAIKIPIA CENTRAL","100+",14,31,45
"21402","LAIKIPIA","LAIKIPIA CENTRAL","Not Stated",1,2,3
"21403","LAIKIPIA","LAIKIPIA EAST","Total",52078,50732,102810
"21404","LAIKIPIA","LAIKIPIA EAST","0",1210,1179,2389
"21405","LAIKIPIA","LAIKIPIA EAST","1",1286,1238,2524
"21406","LAIKIPIA","LAIKIPIA EAST","2",1214,1168,2382
"21407","LAIKIPIA","LAIKIPIA EAST","3",1276,1267,2543
"21408","LAIKIPIA","LAIKIPIA EAST","4",1186,1227,2413
"21409","LAIKIPIA","LAIKIPIA EAST","0 - 4",6172,6079,12251
"21410","LAIKIPIA","LAIKIPIA EAST","5",1185,1135,2320
"21411","LAIKIPIA","LAIKIPIA EAST","6",1116,1124,2240
"21412","LAIKIPIA","LAIKIPIA EAST","7",1138,1225,2363
"21413","LAIKIPIA","LAIKIPIA EAST","8",1126,1100,2226
"21414","LAIKIPIA","LAIKIPIA EAST","9",1078,1124,2202
"21415","LAIKIPIA","LAIKIPIA EAST","5-9",5643,5708,11351
"21416","LAIKIPIA","LAIKIPIA EAST","10",1196,1222,2418
"21417","LAIKIPIA","LAIKIPIA EAST","11",1018,1030,2048
"21418","LAIKIPIA","LAIKIPIA EAST","12",1212,1075,2287
"21419","LAIKIPIA","LAIKIPIA EAST","13",1169,1164,2333
"21420","LAIKIPIA","LAIKIPIA EAST","14",1134,1093,2227
"21421","LAIKIPIA","LAIKIPIA EAST","10 -14",5729,5584,11313
"21422","LAIKIPIA","LAIKIPIA EAST","15",1120,1042,2162
"21423","LAIKIPIA","LAIKIPIA EAST","16",987,1065,2052
"21424","LAIKIPIA","LAIKIPIA EAST","17",1169,1067,2236
"21425","LAIKIPIA","LAIKIPIA EAST","18",974,919,1893
"21426","LAIKIPIA","LAIKIPIA EAST","19",903,955,1858
"21427","LAIKIPIA","LAIKIPIA EAST","15-19",5153,5048,10201
"21428","LAIKIPIA","LAIKIPIA EAST","20",852,999,1851
"21429","LAIKIPIA","LAIKIPIA EAST","21",881,959,1840
"21430","LAIKIPIA","LAIKIPIA EAST","22",948,997,1945
"21431","LAIKIPIA","LAIKIPIA EAST","23",979,1067,2046
"21432","LAIKIPIA","LAIKIPIA EAST","24",943,1023,1966
"21433","LAIKIPIA","LAIKIPIA EAST","20-24",4603,5045,9648
"21434","LAIKIPIA","LAIKIPIA EAST","25",1164,1016,2180
"21435","LAIKIPIA","LAIKIPIA EAST","26",872,936,1808
"21436","LAIKIPIA","LAIKIPIA EAST","27",910,883,1793
"21437","LAIKIPIA","LAIKIPIA EAST","28",856,885,1741
"21438","LAIKIPIA","LAIKIPIA EAST","29",903,849,1752
"21439","LAIKIPIA","LAIKIPIA EAST","25-29",4705,4569,9274
"21440","LAIKIPIA","LAIKIPIA EAST","30",1098,1108,2206
"21441","LAIKIPIA","LAIKIPIA EAST","31",851,804,1655
"21442","LAIKIPIA","LAIKIPIA EAST","32",985,1023,2008
"21443","LAIKIPIA","LAIKIPIA EAST","33",802,806,1608
"21444","LAIKIPIA","LAIKIPIA EAST","34",758,768,1526
"21445","LAIKIPIA","LAIKIPIA EAST","30-34",4494,4509,9003
"21446","LAIKIPIA","LAIKIPIA EAST","35",1035,915,1950
"21447","LAIKIPIA","LAIKIPIA EAST","36",747,644,1391
"21448","LAIKIPIA","LAIKIPIA EAST","37",728,601,1329
"21449","LAIKIPIA","LAIKIPIA EAST","38",637,536,1173
"21450","LAIKIPIA","LAIKIPIA EAST","39",654,601,1255
"21451","LAIKIPIA","LAIKIPIA EAST","35-39",3801,3297,7098
"21452","LAIKIPIA","LAIKIPIA EAST","40",899,740,1639
"21453","LAIKIPIA","LAIKIPIA EAST","41",596,570,1166
"21454","LAIKIPIA","LAIKIPIA EAST","42",633,593,1226
"21455","LAIKIPIA","LAIKIPIA EAST","43",524,471,995
"21456","LAIKIPIA","LAIKIPIA EAST","44",427,365,792
"21457","LAIKIPIA","LAIKIPIA EAST","40-44",3079,2739,5818
"21458","LAIKIPIA","LAIKIPIA EAST","45",680,598,1278
"21459","LAIKIPIA","LAIKIPIA EAST","46",509,396,905
"21460","LAIKIPIA","LAIKIPIA EAST","47",484,447,931
"21461","LAIKIPIA","LAIKIPIA EAST","48",385,302,687
"21462","LAIKIPIA","LAIKIPIA EAST","49",418,389,807
"21463","LAIKIPIA","LAIKIPIA EAST","45-49",2476,2132,4608
"21464","LAIKIPIA","LAIKIPIA EAST","50",532,444,976
"21465","LAIKIPIA","LAIKIPIA EAST","51",389,276,665
"21466","LAIKIPIA","LAIKIPIA EAST","52",343,331,674
"21467","LAIKIPIA","LAIKIPIA EAST","53",302,247,549
"21468","LAIKIPIA","LAIKIPIA EAST","54",327,292,619
"21469","LAIKIPIA","LAIKIPIA EAST","50-54",1893,1590,3483
"21470","LAIKIPIA","LAIKIPIA EAST","55",368,269,637
"21471","LAIKIPIA","LAIKIPIA EAST","56",359,304,663
"21472","LAIKIPIA","LAIKIPIA EAST","57",292,252,544
"21473","LAIKIPIA","LAIKIPIA EAST","58",245,220,465
"21474","LAIKIPIA","LAIKIPIA EAST","59",260,252,512
"21475","LAIKIPIA","LAIKIPIA EAST","55-59",1524,1297,2821
"21476","LAIKIPIA","LAIKIPIA EAST","60",290,331,621
"21477","LAIKIPIA","LAIKIPIA EAST","61",195,180,375
"21478","LAIKIPIA","LAIKIPIA EAST","62",181,167,348
"21479","LAIKIPIA","LAIKIPIA EAST","63",145,172,317
"21480","LAIKIPIA","LAIKIPIA EAST","64",115,101,216
"21481","LAIKIPIA","LAIKIPIA EAST","60-64",926,951,1877
"21482","LAIKIPIA","LAIKIPIA EAST","65",169,175,344
"21483","LAIKIPIA","LAIKIPIA EAST","66",128,116,244
"21484","LAIKIPIA","LAIKIPIA EAST","67",191,192,383
"21485","LAIKIPIA","LAIKIPIA EAST","68",76,102,178
"21486","LAIKIPIA","LAIKIPIA EAST","69",139,140,279
"21487","LAIKIPIA","LAIKIPIA EAST","65-69",703,725,1428
"21488","LAIKIPIA","LAIKIPIA EAST","70",184,241,425
"21489","LAIKIPIA","LAIKIPIA EAST","71",105,131,236
"21490","LAIKIPIA","LAIKIPIA EAST","72",126,101,227
"21491","LAIKIPIA","LAIKIPIA EAST","73",82,82,164
"21492","LAIKIPIA","LAIKIPIA EAST","74",82,74,156
"21493","LAIKIPIA","LAIKIPIA EAST","70-74",579,629,1208
"21494","LAIKIPIA","LAIKIPIA EAST","75",74,63,137
"21495","LAIKIPIA","LAIKIPIA EAST","76",66,107,173
"21496","LAIKIPIA","LAIKIPIA EAST","77",66,54,120
"21497","LAIKIPIA","LAIKIPIA EAST","78",41,36,77
"21498","LAIKIPIA","LAIKIPIA EAST","79",32,55,87
"21499","LAIKIPIA","LAIKIPIA EAST","75-79",279,315,594
"21500","LAIKIPIA","LAIKIPIA EAST","80",69,98,167
"21501","LAIKIPIA","LAIKIPIA EAST","81",22,33,55
"21502","LAIKIPIA","LAIKIPIA EAST","82",32,34,66
"21503","LAIKIPIA","LAIKIPIA EAST","83",24,33,57
"21504","LAIKIPIA","LAIKIPIA EAST","84",26,35,61
"21505","LAIKIPIA","LAIKIPIA EAST","80-84",173,233,406
"21506","LAIKIPIA","LAIKIPIA EAST","85",21,32,53
"21507","LAIKIPIA","LAIKIPIA EAST","86",20,30,50
"21508","LAIKIPIA","LAIKIPIA EAST","87",16,18,34
"21509","LAIKIPIA","LAIKIPIA EAST","88",8,18,26
"21510","LAIKIPIA","LAIKIPIA EAST","89",23,36,59
"21511","LAIKIPIA","LAIKIPIA EAST","85-89",88,134,222
"21512","LAIKIPIA","LAIKIPIA EAST","90",16,25,41
"21513","LAIKIPIA","LAIKIPIA EAST","91",17,18,35
"21514","LAIKIPIA","LAIKIPIA EAST","92",4,12,16
"21515","LAIKIPIA","LAIKIPIA EAST","93",NA,10,10
"21516","LAIKIPIA","LAIKIPIA EAST","94",1,9,10
"21517","LAIKIPIA","LAIKIPIA EAST","90-94",38,74,112
"21518","LAIKIPIA","LAIKIPIA EAST","95",5,18,23
"21519","LAIKIPIA","LAIKIPIA EAST","96",2,3,5
"21520","LAIKIPIA","LAIKIPIA EAST","97",3,8,11
"21521","LAIKIPIA","LAIKIPIA EAST","98",1,4,5
"21522","LAIKIPIA","LAIKIPIA EAST","99",1,14,15
"21523","LAIKIPIA","LAIKIPIA EAST","95-99",12,47,59
"21524","LAIKIPIA","LAIKIPIA EAST","100+",7,27,34
"21525","LAIKIPIA","LAIKIPIA EAST","Not Stated",1,NA,1
"21526","LAIKIPIA","LAIKIPIA NORTH","Total",18067,18116,36183
"21527","LAIKIPIA","LAIKIPIA NORTH","0",643,636,1279
"21528","LAIKIPIA","LAIKIPIA NORTH","1",517,509,1026
"21529","LAIKIPIA","LAIKIPIA NORTH","2",628,635,1263
"21530","LAIKIPIA","LAIKIPIA NORTH","3",719,665,1384
"21531","LAIKIPIA","LAIKIPIA NORTH","4",761,784,1545
"21532","LAIKIPIA","LAIKIPIA NORTH","0 - 4",3268,3229,6497
"21533","LAIKIPIA","LAIKIPIA NORTH","5",695,687,1382
"21534","LAIKIPIA","LAIKIPIA NORTH","6",734,649,1383
"21535","LAIKIPIA","LAIKIPIA NORTH","7",575,581,1156
"21536","LAIKIPIA","LAIKIPIA NORTH","8",645,636,1281
"21537","LAIKIPIA","LAIKIPIA NORTH","9",501,475,976
"21538","LAIKIPIA","LAIKIPIA NORTH","5-9",3150,3028,6178
"21539","LAIKIPIA","LAIKIPIA NORTH","10",769,732,1501
"21540","LAIKIPIA","LAIKIPIA NORTH","11",461,430,891
"21541","LAIKIPIA","LAIKIPIA NORTH","12",654,575,1229
"21542","LAIKIPIA","LAIKIPIA NORTH","13",551,461,1012
"21543","LAIKIPIA","LAIKIPIA NORTH","14",530,464,994
"21544","LAIKIPIA","LAIKIPIA NORTH","10 -14",2965,2662,5627
"21545","LAIKIPIA","LAIKIPIA NORTH","15",576,502,1078
"21546","LAIKIPIA","LAIKIPIA NORTH","16",430,373,803
"21547","LAIKIPIA","LAIKIPIA NORTH","17",422,345,767
"21548","LAIKIPIA","LAIKIPIA NORTH","18",376,380,756
"21549","LAIKIPIA","LAIKIPIA NORTH","19",333,331,664
"21550","LAIKIPIA","LAIKIPIA NORTH","15-19",2137,1931,4068
"21551","LAIKIPIA","LAIKIPIA NORTH","20",414,473,887
"21552","LAIKIPIA","LAIKIPIA NORTH","21",276,314,590
"21553","LAIKIPIA","LAIKIPIA NORTH","22",260,407,667
"21554","LAIKIPIA","LAIKIPIA NORTH","23",248,311,559
"21555","LAIKIPIA","LAIKIPIA NORTH","24",263,277,540
"21556","LAIKIPIA","LAIKIPIA NORTH","20-24",1461,1782,3243
"21557","LAIKIPIA","LAIKIPIA NORTH","25",309,364,673
"21558","LAIKIPIA","LAIKIPIA NORTH","26",224,231,455
"21559","LAIKIPIA","LAIKIPIA NORTH","27",239,286,525
"21560","LAIKIPIA","LAIKIPIA NORTH","28",212,225,437
"21561","LAIKIPIA","LAIKIPIA NORTH","29",175,226,401
"21562","LAIKIPIA","LAIKIPIA NORTH","25-29",1159,1332,2491
"21563","LAIKIPIA","LAIKIPIA NORTH","30",310,383,693
"21564","LAIKIPIA","LAIKIPIA NORTH","31",175,249,424
"21565","LAIKIPIA","LAIKIPIA NORTH","32",201,235,436
"21566","LAIKIPIA","LAIKIPIA NORTH","33",135,162,297
"21567","LAIKIPIA","LAIKIPIA NORTH","34",138,129,267
"21568","LAIKIPIA","LAIKIPIA NORTH","30-34",959,1158,2117
"21569","LAIKIPIA","LAIKIPIA NORTH","35",262,222,484
"21570","LAIKIPIA","LAIKIPIA NORTH","36",99,67,166
"21571","LAIKIPIA","LAIKIPIA NORTH","37",98,82,180
"21572","LAIKIPIA","LAIKIPIA NORTH","38",66,57,123
"21573","LAIKIPIA","LAIKIPIA NORTH","39",71,62,133
"21574","LAIKIPIA","LAIKIPIA NORTH","35-39",596,490,1086
"21575","LAIKIPIA","LAIKIPIA NORTH","40",194,181,375
"21576","LAIKIPIA","LAIKIPIA NORTH","41",128,120,248
"21577","LAIKIPIA","LAIKIPIA NORTH","42",147,202,349
"21578","LAIKIPIA","LAIKIPIA NORTH","43",69,90,159
"21579","LAIKIPIA","LAIKIPIA NORTH","44",51,42,93
"21580","LAIKIPIA","LAIKIPIA NORTH","40-44",589,635,1224
"21581","LAIKIPIA","LAIKIPIA NORTH","45",142,157,299
"21582","LAIKIPIA","LAIKIPIA NORTH","46",99,101,200
"21583","LAIKIPIA","LAIKIPIA NORTH","47",84,76,160
"21584","LAIKIPIA","LAIKIPIA NORTH","48",62,50,112
"21585","LAIKIPIA","LAIKIPIA NORTH","49",49,83,132
"21586","LAIKIPIA","LAIKIPIA NORTH","45-49",436,467,903
"21587","LAIKIPIA","LAIKIPIA NORTH","50",116,149,265
"21588","LAIKIPIA","LAIKIPIA NORTH","51",66,78,144
"21589","LAIKIPIA","LAIKIPIA NORTH","52",71,50,121
"21590","LAIKIPIA","LAIKIPIA NORTH","53",50,32,82
"21591","LAIKIPIA","LAIKIPIA NORTH","54",60,49,109
"21592","LAIKIPIA","LAIKIPIA NORTH","50-54",363,358,721
"21593","LAIKIPIA","LAIKIPIA NORTH","55",90,72,162
"21594","LAIKIPIA","LAIKIPIA NORTH","56",49,40,89
"21595","LAIKIPIA","LAIKIPIA NORTH","57",43,26,69
"21596","LAIKIPIA","LAIKIPIA NORTH","58",33,26,59
"21597","LAIKIPIA","LAIKIPIA NORTH","59",52,58,110
"21598","LAIKIPIA","LAIKIPIA NORTH","55-59",267,222,489
"21599","LAIKIPIA","LAIKIPIA NORTH","60",108,151,259
"21600","LAIKIPIA","LAIKIPIA NORTH","61",58,42,100
"21601","LAIKIPIA","LAIKIPIA NORTH","62",33,39,72
"21602","LAIKIPIA","LAIKIPIA NORTH","63",45,40,85
"21603","LAIKIPIA","LAIKIPIA NORTH","64",24,29,53
"21604","LAIKIPIA","LAIKIPIA NORTH","60-64",268,301,569
"21605","LAIKIPIA","LAIKIPIA NORTH","65",56,54,110
"21606","LAIKIPIA","LAIKIPIA NORTH","66",19,12,31
"21607","LAIKIPIA","LAIKIPIA NORTH","67",32,35,67
"21608","LAIKIPIA","LAIKIPIA NORTH","68",20,23,43
"21609","LAIKIPIA","LAIKIPIA NORTH","69",37,52,89
"21610","LAIKIPIA","LAIKIPIA NORTH","65-69",164,176,340
"21611","LAIKIPIA","LAIKIPIA NORTH","70",51,77,128
"21612","LAIKIPIA","LAIKIPIA NORTH","71",17,33,50
"21613","LAIKIPIA","LAIKIPIA NORTH","72",17,20,37
"21614","LAIKIPIA","LAIKIPIA NORTH","73",9,10,19
"21615","LAIKIPIA","LAIKIPIA NORTH","74",10,24,34
"21616","LAIKIPIA","LAIKIPIA NORTH","70-74",104,164,268
"21617","LAIKIPIA","LAIKIPIA NORTH","75",25,31,56
"21618","LAIKIPIA","LAIKIPIA NORTH","76",8,9,17
"21619","LAIKIPIA","LAIKIPIA NORTH","77",13,12,25
"21620","LAIKIPIA","LAIKIPIA NORTH","78",13,10,23
"21621","LAIKIPIA","LAIKIPIA NORTH","79",12,15,27
"21622","LAIKIPIA","LAIKIPIA NORTH","75-79",71,77,148
"21623","LAIKIPIA","LAIKIPIA NORTH","80",29,22,51
"21624","LAIKIPIA","LAIKIPIA NORTH","81",11,13,24
"21625","LAIKIPIA","LAIKIPIA NORTH","82",4,3,7
"21626","LAIKIPIA","LAIKIPIA NORTH","83",6,2,8
"21627","LAIKIPIA","LAIKIPIA NORTH","84",3,8,11
"21628","LAIKIPIA","LAIKIPIA NORTH","80-84",53,48,101
"21629","LAIKIPIA","LAIKIPIA NORTH","85",10,9,19
"21630","LAIKIPIA","LAIKIPIA NORTH","86",2,2,4
"21631","LAIKIPIA","LAIKIPIA NORTH","87",4,2,6
"21632","LAIKIPIA","LAIKIPIA NORTH","88",3,2,5
"21633","LAIKIPIA","LAIKIPIA NORTH","89",6,4,10
"21634","LAIKIPIA","LAIKIPIA NORTH","85-89",25,19,44
"21635","LAIKIPIA","LAIKIPIA NORTH","90",7,12,19
"21636","LAIKIPIA","LAIKIPIA NORTH","91",5,3,8
"21637","LAIKIPIA","LAIKIPIA NORTH","92",2,NA,2
"21638","LAIKIPIA","LAIKIPIA NORTH","93",1,1,2
"21639","LAIKIPIA","LAIKIPIA NORTH","94",1,2,3
"21640","LAIKIPIA","LAIKIPIA NORTH","90-94",16,18,34
"21641","LAIKIPIA","LAIKIPIA NORTH","95",4,5,9
"21642","LAIKIPIA","LAIKIPIA NORTH","96",1,NA,1
"21643","LAIKIPIA","LAIKIPIA NORTH","97",2,2,4
"21644","LAIKIPIA","LAIKIPIA NORTH","98",NA,2,2
"21645","LAIKIPIA","LAIKIPIA NORTH","99",2,3,5
"21646","LAIKIPIA","LAIKIPIA NORTH","95-99",9,12,21
"21647","LAIKIPIA","LAIKIPIA NORTH","100+",7,7,14
"21648","LAIKIPIA","LAIKIPIA NORTH","Not Stated",NA,NA,NA
"21649","LAIKIPIA","LAIKIPIA WEST","Total",65158,64102,129260
"21650","LAIKIPIA","LAIKIPIA WEST","0",1892,1786,3678
"21651","LAIKIPIA","LAIKIPIA WEST","1",1688,1635,3323
"21652","LAIKIPIA","LAIKIPIA WEST","2",1943,1918,3861
"21653","LAIKIPIA","LAIKIPIA WEST","3",1962,1975,3937
"21654","LAIKIPIA","LAIKIPIA WEST","4",1898,1818,3716
"21655","LAIKIPIA","LAIKIPIA WEST","0 - 4",9383,9132,18515
"21656","LAIKIPIA","LAIKIPIA WEST","5",1853,1834,3687
"21657","LAIKIPIA","LAIKIPIA WEST","6",1949,1863,3812
"21658","LAIKIPIA","LAIKIPIA WEST","7",1787,1767,3554
"21659","LAIKIPIA","LAIKIPIA WEST","8",1843,1740,3583
"21660","LAIKIPIA","LAIKIPIA WEST","9",1676,1559,3235
"21661","LAIKIPIA","LAIKIPIA WEST","5-9",9108,8763,17871
"21662","LAIKIPIA","LAIKIPIA WEST","10",2072,2012,4084
"21663","LAIKIPIA","LAIKIPIA WEST","11",1616,1609,3225
"21664","LAIKIPIA","LAIKIPIA WEST","12",1950,1741,3691
"21665","LAIKIPIA","LAIKIPIA WEST","13",1826,1739,3565
"21666","LAIKIPIA","LAIKIPIA WEST","14",1750,1620,3370
"21667","LAIKIPIA","LAIKIPIA WEST","10 -14",9214,8721,17935
"21668","LAIKIPIA","LAIKIPIA WEST","15",1840,1663,3503
"21669","LAIKIPIA","LAIKIPIA WEST","16",1569,1379,2948
"21670","LAIKIPIA","LAIKIPIA WEST","17",1628,1418,3046
"21671","LAIKIPIA","LAIKIPIA WEST","18",1373,1180,2553
"21672","LAIKIPIA","LAIKIPIA WEST","19",1267,1236,2503
"21673","LAIKIPIA","LAIKIPIA WEST","15-19",7677,6876,14553
"21674","LAIKIPIA","LAIKIPIA WEST","20",1238,1319,2557
"21675","LAIKIPIA","LAIKIPIA WEST","21",994,968,1962
"21676","LAIKIPIA","LAIKIPIA WEST","22",977,1094,2071
"21677","LAIKIPIA","LAIKIPIA WEST","23",971,1051,2022
"21678","LAIKIPIA","LAIKIPIA WEST","24",851,873,1724
"21679","LAIKIPIA","LAIKIPIA WEST","20-24",5031,5305,10336
"21680","LAIKIPIA","LAIKIPIA WEST","25",1058,1080,2138
"21681","LAIKIPIA","LAIKIPIA WEST","26",799,821,1620
"21682","LAIKIPIA","LAIKIPIA WEST","27",807,831,1638
"21683","LAIKIPIA","LAIKIPIA WEST","28",718,767,1485
"21684","LAIKIPIA","LAIKIPIA WEST","29",755,779,1534
"21685","LAIKIPIA","LAIKIPIA WEST","25-29",4137,4278,8415
"21686","LAIKIPIA","LAIKIPIA WEST","30",1100,1247,2347
"21687","LAIKIPIA","LAIKIPIA WEST","31",708,760,1468
"21688","LAIKIPIA","LAIKIPIA WEST","32",868,925,1793
"21689","LAIKIPIA","LAIKIPIA WEST","33",679,748,1427
"21690","LAIKIPIA","LAIKIPIA WEST","34",663,679,1342
"21691","LAIKIPIA","LAIKIPIA WEST","30-34",4018,4359,8377
"21692","LAIKIPIA","LAIKIPIA WEST","35",1002,1033,2035
"21693","LAIKIPIA","LAIKIPIA WEST","36",604,572,1176
"21694","LAIKIPIA","LAIKIPIA WEST","37",607,504,1111
"21695","LAIKIPIA","LAIKIPIA WEST","38",526,454,980
"21696","LAIKIPIA","LAIKIPIA WEST","39",561,493,1054
"21697","LAIKIPIA","LAIKIPIA WEST","35-39",3300,3056,6356
"21698","LAIKIPIA","LAIKIPIA WEST","40",860,744,1604
"21699","LAIKIPIA","LAIKIPIA WEST","41",656,589,1245
"21700","LAIKIPIA","LAIKIPIA WEST","42",633,538,1171
"21701","LAIKIPIA","LAIKIPIA WEST","43",546,487,1033
"21702","LAIKIPIA","LAIKIPIA WEST","44",394,436,830
"21703","LAIKIPIA","LAIKIPIA WEST","40-44",3089,2794,5883
"21704","LAIKIPIA","LAIKIPIA WEST","45",723,612,1335
"21705","LAIKIPIA","LAIKIPIA WEST","46",481,487,968
"21706","LAIKIPIA","LAIKIPIA WEST","47",501,435,936
"21707","LAIKIPIA","LAIKIPIA WEST","48",360,312,672
"21708","LAIKIPIA","LAIKIPIA WEST","49",401,372,773
"21709","LAIKIPIA","LAIKIPIA WEST","45-49",2466,2218,4684
"21710","LAIKIPIA","LAIKIPIA WEST","50",574,563,1137
"21711","LAIKIPIA","LAIKIPIA WEST","51",353,351,704
"21712","LAIKIPIA","LAIKIPIA WEST","52",382,371,753
"21713","LAIKIPIA","LAIKIPIA WEST","53",233,277,510
"21714","LAIKIPIA","LAIKIPIA WEST","54",327,355,682
"21715","LAIKIPIA","LAIKIPIA WEST","50-54",1869,1917,3786
"21716","LAIKIPIA","LAIKIPIA WEST","55",402,386,788
"21717","LAIKIPIA","LAIKIPIA WEST","56",372,369,741
"21718","LAIKIPIA","LAIKIPIA WEST","57",265,342,607
"21719","LAIKIPIA","LAIKIPIA WEST","58",247,287,534
"21720","LAIKIPIA","LAIKIPIA WEST","59",293,325,618
"21721","LAIKIPIA","LAIKIPIA WEST","55-59",1579,1709,3288
"21722","LAIKIPIA","LAIKIPIA WEST","60",365,457,822
"21723","LAIKIPIA","LAIKIPIA WEST","61",243,262,505
"21724","LAIKIPIA","LAIKIPIA WEST","62",224,232,456
"21725","LAIKIPIA","LAIKIPIA WEST","63",199,200,399
"21726","LAIKIPIA","LAIKIPIA WEST","64",143,176,319
"21727","LAIKIPIA","LAIKIPIA WEST","60-64",1174,1327,2501
"21728","LAIKIPIA","LAIKIPIA WEST","65",266,300,566
"21729","LAIKIPIA","LAIKIPIA WEST","66",159,189,348
"21730","LAIKIPIA","LAIKIPIA WEST","67",278,313,591
"21731","LAIKIPIA","LAIKIPIA WEST","68",121,131,252
"21732","LAIKIPIA","LAIKIPIA WEST","69",195,261,456
"21733","LAIKIPIA","LAIKIPIA WEST","65-69",1019,1194,2213
"21734","LAIKIPIA","LAIKIPIA WEST","70",325,383,708
"21735","LAIKIPIA","LAIKIPIA WEST","71",182,212,394
"21736","LAIKIPIA","LAIKIPIA WEST","72",165,135,300
"21737","LAIKIPIA","LAIKIPIA WEST","73",133,117,250
"21738","LAIKIPIA","LAIKIPIA WEST","74",127,144,271
"21739","LAIKIPIA","LAIKIPIA WEST","70-74",932,991,1923
"21740","LAIKIPIA","LAIKIPIA WEST","75",119,158,277
"21741","LAIKIPIA","LAIKIPIA WEST","76",126,179,305
"21742","LAIKIPIA","LAIKIPIA WEST","77",100,108,208
"21743","LAIKIPIA","LAIKIPIA WEST","78",88,64,152
"21744","LAIKIPIA","LAIKIPIA WEST","79",82,114,196
"21745","LAIKIPIA","LAIKIPIA WEST","75-79",515,623,1138
"21746","LAIKIPIA","LAIKIPIA WEST","80",140,160,300
"21747","LAIKIPIA","LAIKIPIA WEST","81",65,91,156
"21748","LAIKIPIA","LAIKIPIA WEST","82",47,49,96
"21749","LAIKIPIA","LAIKIPIA WEST","83",54,64,118
"21750","LAIKIPIA","LAIKIPIA WEST","84",42,52,94
"21751","LAIKIPIA","LAIKIPIA WEST","80-84",348,416,764
"21752","LAIKIPIA","LAIKIPIA WEST","85",38,49,87
"21753","LAIKIPIA","LAIKIPIA WEST","86",35,53,88
"21754","LAIKIPIA","LAIKIPIA WEST","87",25,36,61
"21755","LAIKIPIA","LAIKIPIA WEST","88",19,16,35
"21756","LAIKIPIA","LAIKIPIA WEST","89",44,75,119
"21757","LAIKIPIA","LAIKIPIA WEST","85-89",161,229,390
"21758","LAIKIPIA","LAIKIPIA WEST","90",20,41,61
"21759","LAIKIPIA","LAIKIPIA WEST","91",24,25,49
"21760","LAIKIPIA","LAIKIPIA WEST","92",14,16,30
"21761","LAIKIPIA","LAIKIPIA WEST","93",7,11,18
"21762","LAIKIPIA","LAIKIPIA WEST","94",9,8,17
"21763","LAIKIPIA","LAIKIPIA WEST","90-94",74,101,175
"21764","LAIKIPIA","LAIKIPIA WEST","95",11,16,27
"21765","LAIKIPIA","LAIKIPIA WEST","96",6,10,16
"21766","LAIKIPIA","LAIKIPIA WEST","97",11,13,24
"21767","LAIKIPIA","LAIKIPIA WEST","98",8,3,11
"21768","LAIKIPIA","LAIKIPIA WEST","99",9,14,23
"21769","LAIKIPIA","LAIKIPIA WEST","95-99",45,56,101
"21770","LAIKIPIA","LAIKIPIA WEST","100+",18,37,55
"21771","LAIKIPIA","LAIKIPIA WEST","Not Stated",1,NA,1
"21772","LAIKIPIA","NYAHURURU","Total",76249,78447,154696
"21773","LAIKIPIA","NYAHURURU","0",1842,1859,3701
"21774","LAIKIPIA","NYAHURURU","1",1679,1683,3362
"21775","LAIKIPIA","NYAHURURU","2",1737,1708,3445
"21776","LAIKIPIA","NYAHURURU","3",1923,1842,3765
"21777","LAIKIPIA","NYAHURURU","4",1859,1799,3658
"21778","LAIKIPIA","NYAHURURU","0 - 4",9040,8891,17931
"21779","LAIKIPIA","NYAHURURU","5",1763,1744,3507
"21780","LAIKIPIA","NYAHURURU","6",1769,1857,3626
"21781","LAIKIPIA","NYAHURURU","7",1872,1871,3743
"21782","LAIKIPIA","NYAHURURU","8",1797,1686,3483
"21783","LAIKIPIA","NYAHURURU","9",1852,1964,3816
"21784","LAIKIPIA","NYAHURURU","5-9",9053,9122,18175
"21785","LAIKIPIA","NYAHURURU","10",2034,1954,3988
"21786","LAIKIPIA","NYAHURURU","11",1780,1719,3499
"21787","LAIKIPIA","NYAHURURU","12",2018,1927,3945
"21788","LAIKIPIA","NYAHURURU","13",2005,2069,4074
"21789","LAIKIPIA","NYAHURURU","14",2001,1902,3903
"21790","LAIKIPIA","NYAHURURU","10 -14",9838,9571,19409
"21791","LAIKIPIA","NYAHURURU","15",1938,1859,3797
"21792","LAIKIPIA","NYAHURURU","16",1908,1890,3798
"21793","LAIKIPIA","NYAHURURU","17",1951,1883,3834
"21794","LAIKIPIA","NYAHURURU","18",1615,1507,3122
"21795","LAIKIPIA","NYAHURURU","19",1738,1641,3379
"21796","LAIKIPIA","NYAHURURU","15-19",9150,8780,17930
"21797","LAIKIPIA","NYAHURURU","20",1526,1456,2982
"21798","LAIKIPIA","NYAHURURU","21",1307,1340,2647
"21799","LAIKIPIA","NYAHURURU","22",1270,1389,2659
"21800","LAIKIPIA","NYAHURURU","23",1246,1319,2565
"21801","LAIKIPIA","NYAHURURU","24",1157,1177,2334
"21802","LAIKIPIA","NYAHURURU","20-24",6506,6681,13187
"21803","LAIKIPIA","NYAHURURU","25",1179,1211,2390
"21804","LAIKIPIA","NYAHURURU","26",927,1117,2044
"21805","LAIKIPIA","NYAHURURU","27",1039,1092,2131
"21806","LAIKIPIA","NYAHURURU","28",892,1019,1911
"21807","LAIKIPIA","NYAHURURU","29",995,1074,2069
"21808","LAIKIPIA","NYAHURURU","25-29",5032,5513,10545
"21809","LAIKIPIA","NYAHURURU","30",1166,1329,2495
"21810","LAIKIPIA","NYAHURURU","31",902,954,1856
"21811","LAIKIPIA","NYAHURURU","32",1122,1241,2363
"21812","LAIKIPIA","NYAHURURU","33",972,1076,2048
"21813","LAIKIPIA","NYAHURURU","34",902,1031,1933
"21814","LAIKIPIA","NYAHURURU","30-34",5064,5631,10695
"21815","LAIKIPIA","NYAHURURU","35",1237,1337,2574
"21816","LAIKIPIA","NYAHURURU","36",899,938,1837
"21817","LAIKIPIA","NYAHURURU","37",911,898,1809
"21818","LAIKIPIA","NYAHURURU","38",774,787,1561
"21819","LAIKIPIA","NYAHURURU","39",853,898,1751
"21820","LAIKIPIA","NYAHURURU","35-39",4674,4858,9532
"21821","LAIKIPIA","NYAHURURU","40",1039,1006,2045
"21822","LAIKIPIA","NYAHURURU","41",871,902,1773
"21823","LAIKIPIA","NYAHURURU","42",813,822,1635
"21824","LAIKIPIA","NYAHURURU","43",726,764,1490
"21825","LAIKIPIA","NYAHURURU","44",564,683,1247
"21826","LAIKIPIA","NYAHURURU","40-44",4013,4177,8190
"21827","LAIKIPIA","NYAHURURU","45",905,892,1797
"21828","LAIKIPIA","NYAHURURU","46",689,754,1443
"21829","LAIKIPIA","NYAHURURU","47",642,771,1413
"21830","LAIKIPIA","NYAHURURU","48",526,556,1082
"21831","LAIKIPIA","NYAHURURU","49",628,611,1239
"21832","LAIKIPIA","NYAHURURU","45-49",3390,3584,6974
"21833","LAIKIPIA","NYAHURURU","50",771,802,1573
"21834","LAIKIPIA","NYAHURURU","51",653,617,1270
"21835","LAIKIPIA","NYAHURURU","52",661,643,1304
"21836","LAIKIPIA","NYAHURURU","53",406,449,855
"21837","LAIKIPIA","NYAHURURU","54",534,520,1054
"21838","LAIKIPIA","NYAHURURU","50-54",3025,3031,6056
"21839","LAIKIPIA","NYAHURURU","55",551,539,1090
"21840","LAIKIPIA","NYAHURURU","56",548,538,1086
"21841","LAIKIPIA","NYAHURURU","57",466,539,1005
"21842","LAIKIPIA","NYAHURURU","58",386,508,894
"21843","LAIKIPIA","NYAHURURU","59",464,488,952
"21844","LAIKIPIA","NYAHURURU","55-59",2415,2612,5027
"21845","LAIKIPIA","NYAHURURU","60",495,515,1010
"21846","LAIKIPIA","NYAHURURU","61",331,363,694
"21847","LAIKIPIA","NYAHURURU","62",307,326,633
"21848","LAIKIPIA","NYAHURURU","63",233,276,509
"21849","LAIKIPIA","NYAHURURU","64",196,177,373
"21850","LAIKIPIA","NYAHURURU","60-64",1562,1657,3219
"21851","LAIKIPIA","NYAHURURU","65",308,337,645
"21852","LAIKIPIA","NYAHURURU","66",171,227,398
"21853","LAIKIPIA","NYAHURURU","67",322,414,736
"21854","LAIKIPIA","NYAHURURU","68",162,166,328
"21855","LAIKIPIA","NYAHURURU","69",240,251,491
"21856","LAIKIPIA","NYAHURURU","65-69",1203,1395,2598
"21857","LAIKIPIA","NYAHURURU","70",285,379,664
"21858","LAIKIPIA","NYAHURURU","71",211,232,443
"21859","LAIKIPIA","NYAHURURU","72",204,176,380
"21860","LAIKIPIA","NYAHURURU","73",175,179,354
"21861","LAIKIPIA","NYAHURURU","74",148,172,320
"21862","LAIKIPIA","NYAHURURU","70-74",1023,1138,2161
"21863","LAIKIPIA","NYAHURURU","75",142,198,340
"21864","LAIKIPIA","NYAHURURU","76",163,292,455
"21865","LAIKIPIA","NYAHURURU","77",101,140,241
"21866","LAIKIPIA","NYAHURURU","78",74,81,155
"21867","LAIKIPIA","NYAHURURU","79",113,130,243
"21868","LAIKIPIA","NYAHURURU","75-79",593,841,1434
"21869","LAIKIPIA","NYAHURURU","80",97,161,258
"21870","LAIKIPIA","NYAHURURU","81",65,94,159
"21871","LAIKIPIA","NYAHURURU","82",56,52,108
"21872","LAIKIPIA","NYAHURURU","83",65,59,124
"21873","LAIKIPIA","NYAHURURU","84",61,79,140
"21874","LAIKIPIA","NYAHURURU","80-84",344,445,789
"21875","LAIKIPIA","NYAHURURU","85",49,65,114
"21876","LAIKIPIA","NYAHURURU","86",38,63,101
"21877","LAIKIPIA","NYAHURURU","87",51,50,101
"21878","LAIKIPIA","NYAHURURU","88",24,20,44
"21879","LAIKIPIA","NYAHURURU","89",39,70,109
"21880","LAIKIPIA","NYAHURURU","85-89",201,268,469
"21881","LAIKIPIA","NYAHURURU","90",22,42,64
"21882","LAIKIPIA","NYAHURURU","91",27,39,66
"21883","LAIKIPIA","NYAHURURU","92",13,15,28
"21884","LAIKIPIA","NYAHURURU","93",11,13,24
"21885","LAIKIPIA","NYAHURURU","94",9,21,30
"21886","LAIKIPIA","NYAHURURU","90-94",82,130,212
"21887","LAIKIPIA","NYAHURURU","95",9,23,32
"21888","LAIKIPIA","NYAHURURU","96",5,10,15
"21889","LAIKIPIA","NYAHURURU","97",5,11,16
"21890","LAIKIPIA","NYAHURURU","98",4,9,13
"21891","LAIKIPIA","NYAHURURU","99",7,17,24
"21892","LAIKIPIA","NYAHURURU","95-99",30,70,100
"21893","LAIKIPIA","NYAHURURU","100+",11,52,63
"21894","LAIKIPIA","NYAHURURU","Not Stated",NA,NA,NA
"21895","LAMU","ALL","Total",76103,67813,143916
"21896","LAMU","ALL","0",1824,1765,3589
"21897","LAMU","ALL","1",1808,1750,3558
"21898","LAMU","ALL","2",1949,1867,3816
"21899","LAMU","ALL","3",1968,1869,3837
"21900","LAMU","ALL","4",2055,1883,3938
"21901","LAMU","ALL","0 - 4",9604,9134,18738
"21902","LAMU","ALL","5",2014,1908,3922
"21903","LAMU","ALL","6",1949,1853,3802
"21904","LAMU","ALL","7",1810,1823,3633
"21905","LAMU","ALL","8",1901,1880,3781
"21906","LAMU","ALL","9",1831,1777,3608
"21907","LAMU","ALL","5-9",9505,9241,18746
"21908","LAMU","ALL","10",1962,1873,3835
"21909","LAMU","ALL","11",1740,1686,3426
"21910","LAMU","ALL","12",1995,1817,3812
"21911","LAMU","ALL","13",2024,1972,3996
"21912","LAMU","ALL","14",1771,1633,3404
"21913","LAMU","ALL","10 -14",9492,8981,18473
"21914","LAMU","ALL","15",1673,1594,3267
"21915","LAMU","ALL","16",1613,1508,3121
"21916","LAMU","ALL","17",1678,1439,3117
"21917","LAMU","ALL","18",1497,1351,2848
"21918","LAMU","ALL","19",1462,1337,2799
"21919","LAMU","ALL","15-19",7923,7229,15152
"21920","LAMU","ALL","20",1473,1423,2896
"21921","LAMU","ALL","21",1251,1073,2324
"21922","LAMU","ALL","22",1555,1273,2828
"21923","LAMU","ALL","23",1421,1213,2634
"21924","LAMU","ALL","24",1434,1054,2488
"21925","LAMU","ALL","20-24",7134,6036,13170
"21926","LAMU","ALL","25",1613,1191,2804
"21927","LAMU","ALL","26",1387,1139,2526
"21928","LAMU","ALL","27",1328,1037,2365
"21929","LAMU","ALL","28",1119,882,2001
"21930","LAMU","ALL","29",1106,834,1940
"21931","LAMU","ALL","25-29",6553,5083,11636
"21932","LAMU","ALL","30",1397,1223,2620
"21933","LAMU","ALL","31",1130,941,2071
"21934","LAMU","ALL","32",1258,1078,2336
"21935","LAMU","ALL","33",980,849,1829
"21936","LAMU","ALL","34",909,791,1700
"21937","LAMU","ALL","30-34",5674,4882,10556
"21938","LAMU","ALL","35",1184,1017,2201
"21939","LAMU","ALL","36",929,791,1720
"21940","LAMU","ALL","37",852,718,1570
"21941","LAMU","ALL","38",629,534,1163
"21942","LAMU","ALL","39",707,500,1207
"21943","LAMU","ALL","35-39",4301,3560,7861
"21944","LAMU","ALL","40",1000,740,1740
"21945","LAMU","ALL","41",1037,933,1970
"21946","LAMU","ALL","42",769,632,1401
"21947","LAMU","ALL","43",606,480,1086
"21948","LAMU","ALL","44",484,405,889
"21949","LAMU","ALL","40-44",3896,3190,7086
"21950","LAMU","ALL","45",1008,932,1940
"21951","LAMU","ALL","46",647,507,1154
"21952","LAMU","ALL","47",617,402,1019
"21953","LAMU","ALL","48",478,346,824
"21954","LAMU","ALL","49",523,410,933
"21955","LAMU","ALL","45-49",3273,2597,5870
"21956","LAMU","ALL","50",749,623,1372
"21957","LAMU","ALL","51",514,395,909
"21958","LAMU","ALL","52",424,352,776
"21959","LAMU","ALL","53",289,233,522
"21960","LAMU","ALL","54",350,244,594
"21961","LAMU","ALL","50-54",2326,1847,4173
"21962","LAMU","ALL","55",417,292,709
"21963","LAMU","ALL","56",434,399,833
"21964","LAMU","ALL","57",365,364,729
"21965","LAMU","ALL","58",359,340,699
"21966","LAMU","ALL","59",397,401,798
"21967","LAMU","ALL","55-59",1972,1796,3768
"21968","LAMU","ALL","60",461,482,943
"21969","LAMU","ALL","61",277,348,625
"21970","LAMU","ALL","62",279,220,499
"21971","LAMU","ALL","63",286,230,516
"21972","LAMU","ALL","64",224,171,395
"21973","LAMU","ALL","60-64",1527,1451,2978
"21974","LAMU","ALL","65",314,327,641
"21975","LAMU","ALL","66",193,217,410
"21976","LAMU","ALL","67",264,195,459
"21977","LAMU","ALL","68",163,135,298
"21978","LAMU","ALL","69",220,169,389
"21979","LAMU","ALL","65-69",1154,1043,2197
"21980","LAMU","ALL","70",300,360,660
"21981","LAMU","ALL","71",169,218,387
"21982","LAMU","ALL","72",175,102,277
"21983","LAMU","ALL","73",139,79,218
"21984","LAMU","ALL","74",109,87,196
"21985","LAMU","ALL","70-74",892,846,1738
"21986","LAMU","ALL","75",121,125,246
"21987","LAMU","ALL","76",101,99,200
"21988","LAMU","ALL","77",80,45,125
"21989","LAMU","ALL","78",65,36,101
"21990","LAMU","ALL","79",68,60,128
"21991","LAMU","ALL","75-79",435,365,800
"21992","LAMU","ALL","80",94,137,231
"21993","LAMU","ALL","81",48,59,107
"21994","LAMU","ALL","82",28,24,52
"21995","LAMU","ALL","83",40,21,61
"21996","LAMU","ALL","84",39,27,66
"21997","LAMU","ALL","80-84",249,268,517
"21998","LAMU","ALL","85",30,32,62
"21999","LAMU","ALL","86",21,32,53
"22000","LAMU","ALL","87",28,19,47
"22001","LAMU","ALL","88",15,11,26
"22002","LAMU","ALL","89",15,23,38
"22003","LAMU","ALL","85-89",109,117,226
"22004","LAMU","ALL","90",19,39,58
"22005","LAMU","ALL","91",7,17,24
"22006","LAMU","ALL","92",10,5,15
"22007","LAMU","ALL","93",3,7,10
"22008","LAMU","ALL","94",10,8,18
"22009","LAMU","ALL","90-94",49,76,125
"22010","LAMU","ALL","95",6,8,14
"22011","LAMU","ALL","96",3,8,11
"22012","LAMU","ALL","97",4,5,9
"22013","LAMU","ALL","98",2,2,4
"22014","LAMU","ALL","99",3,12,15
"22015","LAMU","ALL","95-99",18,35,53
"22016","LAMU","ALL","100+",14,35,49
"22017","LAMU","ALL","Not Stated",3,1,4
"22018","LAMU","LAMU EAST","Total",11675,10583,22258
"22019","LAMU","LAMU EAST","0",239,249,488
"22020","LAMU","LAMU EAST","1",256,216,472
"22021","LAMU","LAMU EAST","2",333,283,616
"22022","LAMU","LAMU EAST","3",294,283,577
"22023","LAMU","LAMU EAST","4",347,289,636
"22024","LAMU","LAMU EAST","0 - 4",1469,1320,2789
"22025","LAMU","LAMU EAST","5",310,303,613
"22026","LAMU","LAMU EAST","6",269,243,512
"22027","LAMU","LAMU EAST","7",281,300,581
"22028","LAMU","LAMU EAST","8",280,303,583
"22029","LAMU","LAMU EAST","9",286,262,548
"22030","LAMU","LAMU EAST","5-9",1426,1411,2837
"22031","LAMU","LAMU EAST","10",287,259,546
"22032","LAMU","LAMU EAST","11",271,249,520
"22033","LAMU","LAMU EAST","12",297,288,585
"22034","LAMU","LAMU EAST","13",312,295,607
"22035","LAMU","LAMU EAST","14",283,274,557
"22036","LAMU","LAMU EAST","10 -14",1450,1365,2815
"22037","LAMU","LAMU EAST","15",231,271,502
"22038","LAMU","LAMU EAST","16",243,264,507
"22039","LAMU","LAMU EAST","17",245,188,433
"22040","LAMU","LAMU EAST","18",222,233,455
"22041","LAMU","LAMU EAST","19",192,173,365
"22042","LAMU","LAMU EAST","15-19",1133,1129,2262
"22043","LAMU","LAMU EAST","20",224,176,400
"22044","LAMU","LAMU EAST","21",158,157,315
"22045","LAMU","LAMU EAST","22",221,179,400
"22046","LAMU","LAMU EAST","23",206,170,376
"22047","LAMU","LAMU EAST","24",211,131,342
"22048","LAMU","LAMU EAST","20-24",1020,813,1833
"22049","LAMU","LAMU EAST","25",231,143,374
"22050","LAMU","LAMU EAST","26",246,168,414
"22051","LAMU","LAMU EAST","27",222,123,345
"22052","LAMU","LAMU EAST","28",160,104,264
"22053","LAMU","LAMU EAST","29",153,106,259
"22054","LAMU","LAMU EAST","25-29",1012,644,1656
"22055","LAMU","LAMU EAST","30",212,146,358
"22056","LAMU","LAMU EAST","31",194,139,333
"22057","LAMU","LAMU EAST","32",208,154,362
"22058","LAMU","LAMU EAST","33",196,126,322
"22059","LAMU","LAMU EAST","34",103,105,208
"22060","LAMU","LAMU EAST","30-34",913,670,1583
"22061","LAMU","LAMU EAST","35",177,131,308
"22062","LAMU","LAMU EAST","36",161,169,330
"22063","LAMU","LAMU EAST","37",162,140,302
"22064","LAMU","LAMU EAST","38",75,67,142
"22065","LAMU","LAMU EAST","39",97,53,150
"22066","LAMU","LAMU EAST","35-39",672,560,1232
"22067","LAMU","LAMU EAST","40",150,105,255
"22068","LAMU","LAMU EAST","41",224,276,500
"22069","LAMU","LAMU EAST","42",95,85,180
"22070","LAMU","LAMU EAST","43",47,35,82
"22071","LAMU","LAMU EAST","44",41,37,78
"22072","LAMU","LAMU EAST","40-44",557,538,1095
"22073","LAMU","LAMU EAST","45",170,198,368
"22074","LAMU","LAMU EAST","46",99,88,187
"22075","LAMU","LAMU EAST","47",62,43,105
"22076","LAMU","LAMU EAST","48",49,27,76
"22077","LAMU","LAMU EAST","49",78,91,169
"22078","LAMU","LAMU EAST","45-49",458,447,905
"22079","LAMU","LAMU EAST","50",97,74,171
"22080","LAMU","LAMU EAST","51",95,111,206
"22081","LAMU","LAMU EAST","52",67,51,118
"22082","LAMU","LAMU EAST","53",34,27,61
"22083","LAMU","LAMU EAST","54",32,31,63
"22084","LAMU","LAMU EAST","50-54",325,294,619
"22085","LAMU","LAMU EAST","55",62,51,113
"22086","LAMU","LAMU EAST","56",80,134,214
"22087","LAMU","LAMU EAST","57",69,78,147
"22088","LAMU","LAMU EAST","58",62,63,125
"22089","LAMU","LAMU EAST","59",82,111,193
"22090","LAMU","LAMU EAST","55-59",355,437,792
"22091","LAMU","LAMU EAST","60",83,130,213
"22092","LAMU","LAMU EAST","61",51,84,135
"22093","LAMU","LAMU EAST","62",54,44,98
"22094","LAMU","LAMU EAST","63",56,50,106
"22095","LAMU","LAMU EAST","64",45,34,79
"22096","LAMU","LAMU EAST","60-64",289,342,631
"22097","LAMU","LAMU EAST","65",50,83,133
"22098","LAMU","LAMU EAST","66",49,52,101
"22099","LAMU","LAMU EAST","67",29,30,59
"22100","LAMU","LAMU EAST","68",23,23,46
"22101","LAMU","LAMU EAST","69",41,39,80
"22102","LAMU","LAMU EAST","65-69",192,227,419
"22103","LAMU","LAMU EAST","70",77,94,171
"22104","LAMU","LAMU EAST","71",42,76,118
"22105","LAMU","LAMU EAST","72",36,13,49
"22106","LAMU","LAMU EAST","73",30,14,44
"22107","LAMU","LAMU EAST","74",24,21,45
"22108","LAMU","LAMU EAST","70-74",209,218,427
"22109","LAMU","LAMU EAST","75",29,33,62
"22110","LAMU","LAMU EAST","76",19,17,36
"22111","LAMU","LAMU EAST","77",25,8,33
"22112","LAMU","LAMU EAST","78",16,6,22
"22113","LAMU","LAMU EAST","79",14,14,28
"22114","LAMU","LAMU EAST","75-79",103,78,181
"22115","LAMU","LAMU EAST","80",26,24,50
"22116","LAMU","LAMU EAST","81",12,10,22
"22117","LAMU","LAMU EAST","82",4,5,9
"22118","LAMU","LAMU EAST","83",4,4,8
"22119","LAMU","LAMU EAST","84",10,5,15
"22120","LAMU","LAMU EAST","80-84",56,48,104
"22121","LAMU","LAMU EAST","85",3,11,14
"22122","LAMU","LAMU EAST","86",5,5,10
"22123","LAMU","LAMU EAST","87",4,2,6
"22124","LAMU","LAMU EAST","88",4,1,5
"22125","LAMU","LAMU EAST","89",6,3,9
"22126","LAMU","LAMU EAST","85-89",22,22,44
"22127","LAMU","LAMU EAST","90",4,7,11
"22128","LAMU","LAMU EAST","91",3,3,6
"22129","LAMU","LAMU EAST","92",NA,NA,NA
"22130","LAMU","LAMU EAST","93",1,NA,1
"22131","LAMU","LAMU EAST","94",2,3,5
"22132","LAMU","LAMU EAST","90-94",10,13,23
"22133","LAMU","LAMU EAST","95",1,NA,1
"22134","LAMU","LAMU EAST","96",1,NA,1
"22135","LAMU","LAMU EAST","97",NA,1,1
"22136","LAMU","LAMU EAST","98",NA,NA,NA
"22137","LAMU","LAMU EAST","99",NA,NA,NA
"22138","LAMU","LAMU EAST","95-99",2,1,3
"22139","LAMU","LAMU EAST","100+",2,6,8
"22140","LAMU","LAMU EAST","Not Stated",NA,NA,NA
"22141","LAMU","LAMU WEST","Total",64428,57230,121658
"22142","LAMU","LAMU WEST","0",1585,1516,3101
"22143","LAMU","LAMU WEST","1",1552,1534,3086
"22144","LAMU","LAMU WEST","2",1616,1584,3200
"22145","LAMU","LAMU WEST","3",1674,1586,3260
"22146","LAMU","LAMU WEST","4",1708,1594,3302
"22147","LAMU","LAMU WEST","0 - 4",8135,7814,15949
"22148","LAMU","LAMU WEST","5",1704,1605,3309
"22149","LAMU","LAMU WEST","6",1680,1610,3290
"22150","LAMU","LAMU WEST","7",1529,1523,3052
"22151","LAMU","LAMU WEST","8",1621,1577,3198
"22152","LAMU","LAMU WEST","9",1545,1515,3060
"22153","LAMU","LAMU WEST","5-9",8079,7830,15909
"22154","LAMU","LAMU WEST","10",1675,1614,3289
"22155","LAMU","LAMU WEST","11",1469,1437,2906
"22156","LAMU","LAMU WEST","12",1698,1529,3227
"22157","LAMU","LAMU WEST","13",1712,1677,3389
"22158","LAMU","LAMU WEST","14",1488,1359,2847
"22159","LAMU","LAMU WEST","10 -14",8042,7616,15658
"22160","LAMU","LAMU WEST","15",1442,1323,2765
"22161","LAMU","LAMU WEST","16",1370,1244,2614
"22162","LAMU","LAMU WEST","17",1433,1251,2684
"22163","LAMU","LAMU WEST","18",1275,1118,2393
"22164","LAMU","LAMU WEST","19",1270,1164,2434
"22165","LAMU","LAMU WEST","15-19",6790,6100,12890
"22166","LAMU","LAMU WEST","20",1249,1247,2496
"22167","LAMU","LAMU WEST","21",1093,916,2009
"22168","LAMU","LAMU WEST","22",1334,1094,2428
"22169","LAMU","LAMU WEST","23",1215,1043,2258
"22170","LAMU","LAMU WEST","24",1223,923,2146
"22171","LAMU","LAMU WEST","20-24",6114,5223,11337
"22172","LAMU","LAMU WEST","25",1382,1048,2430
"22173","LAMU","LAMU WEST","26",1141,971,2112
"22174","LAMU","LAMU WEST","27",1106,914,2020
"22175","LAMU","LAMU WEST","28",959,778,1737
"22176","LAMU","LAMU WEST","29",953,728,1681
"22177","LAMU","LAMU WEST","25-29",5541,4439,9980
"22178","LAMU","LAMU WEST","30",1185,1077,2262
"22179","LAMU","LAMU WEST","31",936,802,1738
"22180","LAMU","LAMU WEST","32",1050,924,1974
"22181","LAMU","LAMU WEST","33",784,723,1507
"22182","LAMU","LAMU WEST","34",806,686,1492
"22183","LAMU","LAMU WEST","30-34",4761,4212,8973
"22184","LAMU","LAMU WEST","35",1007,886,1893
"22185","LAMU","LAMU WEST","36",768,622,1390
"22186","LAMU","LAMU WEST","37",690,578,1268
"22187","LAMU","LAMU WEST","38",554,467,1021
"22188","LAMU","LAMU WEST","39",610,447,1057
"22189","LAMU","LAMU WEST","35-39",3629,3000,6629
"22190","LAMU","LAMU WEST","40",850,635,1485
"22191","LAMU","LAMU WEST","41",813,657,1470
"22192","LAMU","LAMU WEST","42",674,547,1221
"22193","LAMU","LAMU WEST","43",559,445,1004
"22194","LAMU","LAMU WEST","44",443,368,811
"22195","LAMU","LAMU WEST","40-44",3339,2652,5991
"22196","LAMU","LAMU WEST","45",838,734,1572
"22197","LAMU","LAMU WEST","46",548,419,967
"22198","LAMU","LAMU WEST","47",555,359,914
"22199","LAMU","LAMU WEST","48",429,319,748
"22200","LAMU","LAMU WEST","49",445,319,764
"22201","LAMU","LAMU WEST","45-49",2815,2150,4965
"22202","LAMU","LAMU WEST","50",652,549,1201
"22203","LAMU","LAMU WEST","51",419,284,703
"22204","LAMU","LAMU WEST","52",357,301,658
"22205","LAMU","LAMU WEST","53",255,206,461
"22206","LAMU","LAMU WEST","54",318,213,531
"22207","LAMU","LAMU WEST","50-54",2001,1553,3554
"22208","LAMU","LAMU WEST","55",355,241,596
"22209","LAMU","LAMU WEST","56",354,265,619
"22210","LAMU","LAMU WEST","57",296,286,582
"22211","LAMU","LAMU WEST","58",297,277,574
"22212","LAMU","LAMU WEST","59",315,290,605
"22213","LAMU","LAMU WEST","55-59",1617,1359,2976
"22214","LAMU","LAMU WEST","60",378,352,730
"22215","LAMU","LAMU WEST","61",226,264,490
"22216","LAMU","LAMU WEST","62",225,176,401
"22217","LAMU","LAMU WEST","63",230,180,410
"22218","LAMU","LAMU WEST","64",179,137,316
"22219","LAMU","LAMU WEST","60-64",1238,1109,2347
"22220","LAMU","LAMU WEST","65",264,244,508
"22221","LAMU","LAMU WEST","66",144,165,309
"22222","LAMU","LAMU WEST","67",235,165,400
"22223","LAMU","LAMU WEST","68",140,112,252
"22224","LAMU","LAMU WEST","69",179,130,309
"22225","LAMU","LAMU WEST","65-69",962,816,1778
"22226","LAMU","LAMU WEST","70",223,266,489
"22227","LAMU","LAMU WEST","71",127,142,269
"22228","LAMU","LAMU WEST","72",139,89,228
"22229","LAMU","LAMU WEST","73",109,65,174
"22230","LAMU","LAMU WEST","74",85,66,151
"22231","LAMU","LAMU WEST","70-74",683,628,1311
"22232","LAMU","LAMU WEST","75",92,92,184
"22233","LAMU","LAMU WEST","76",82,82,164
"22234","LAMU","LAMU WEST","77",55,37,92
"22235","LAMU","LAMU WEST","78",49,30,79
"22236","LAMU","LAMU WEST","79",54,46,100
"22237","LAMU","LAMU WEST","75-79",332,287,619
"22238","LAMU","LAMU WEST","80",68,113,181
"22239","LAMU","LAMU WEST","81",36,49,85
"22240","LAMU","LAMU WEST","82",24,19,43
"22241","LAMU","LAMU WEST","83",36,17,53
"22242","LAMU","LAMU WEST","84",29,22,51
"22243","LAMU","LAMU WEST","80-84",193,220,413
"22244","LAMU","LAMU WEST","85",27,21,48
"22245","LAMU","LAMU WEST","86",16,27,43
"22246","LAMU","LAMU WEST","87",24,17,41
"22247","LAMU","LAMU WEST","88",11,10,21
"22248","LAMU","LAMU WEST","89",9,20,29
"22249","LAMU","LAMU WEST","85-89",87,95,182
"22250","LAMU","LAMU WEST","90",15,32,47
"22251","LAMU","LAMU WEST","91",4,14,18
"22252","LAMU","LAMU WEST","92",10,5,15
"22253","LAMU","LAMU WEST","93",2,7,9
"22254","LAMU","LAMU WEST","94",8,5,13
"22255","LAMU","LAMU WEST","90-94",39,63,102
"22256","LAMU","LAMU WEST","95",5,8,13
"22257","LAMU","LAMU WEST","96",2,8,10
"22258","LAMU","LAMU WEST","97",4,4,8
"22259","LAMU","LAMU WEST","98",2,2,4
"22260","LAMU","LAMU WEST","99",3,12,15
"22261","LAMU","LAMU WEST","95-99",16,34,50
"22262","LAMU","LAMU WEST","100+",12,29,41
"22263","LAMU","LAMU WEST","Not Stated",3,1,4
"22264","MACHAKOS","ALL","Total",710707,711191,1421898
"22265","MACHAKOS","ALL","0",14385,14242,28627
"22266","MACHAKOS","ALL","1",14904,14608,29512
"22267","MACHAKOS","ALL","2",14554,14456,29010
"22268","MACHAKOS","ALL","3",14960,15046,30006
"22269","MACHAKOS","ALL","4",15285,14418,29703
"22270","MACHAKOS","ALL","0 - 4",74088,72770,146858
"22271","MACHAKOS","ALL","5",15162,14387,29549
"22272","MACHAKOS","ALL","6",14601,14560,29161
"22273","MACHAKOS","ALL","7",15155,14587,29742
"22274","MACHAKOS","ALL","8",15064,14991,30055
"22275","MACHAKOS","ALL","9",16489,15564,32053
"22276","MACHAKOS","ALL","5-9",76471,74089,150560
"22277","MACHAKOS","ALL","10",16593,16154,32747
"22278","MACHAKOS","ALL","11",16136,16566,32702
"22279","MACHAKOS","ALL","12",17420,16925,34345
"22280","MACHAKOS","ALL","13",17169,16729,33898
"22281","MACHAKOS","ALL","14",16763,15760,32523
"22282","MACHAKOS","ALL","10 -14",84081,82134,166215
"22283","MACHAKOS","ALL","15",16131,15871,32002
"22284","MACHAKOS","ALL","16",15551,15167,30718
"22285","MACHAKOS","ALL","17",16348,15386,31734
"22286","MACHAKOS","ALL","18",12994,12200,25194
"22287","MACHAKOS","ALL","19",14256,13216,27472
"22288","MACHAKOS","ALL","15-19",75280,71840,147120
"22289","MACHAKOS","ALL","20",13669,13442,27111
"22290","MACHAKOS","ALL","21",13007,12834,25841
"22291","MACHAKOS","ALL","22",12155,12459,24614
"22292","MACHAKOS","ALL","23",13643,14376,28019
"22293","MACHAKOS","ALL","24",12742,12864,25606
"22294","MACHAKOS","ALL","20-24",65216,65975,131191
"22295","MACHAKOS","ALL","25",13185,12885,26070
"22296","MACHAKOS","ALL","26",11167,11549,22716
"22297","MACHAKOS","ALL","27",11826,11635,23461
"22298","MACHAKOS","ALL","28",10112,10672,20784
"22299","MACHAKOS","ALL","29",11928,12028,23956
"22300","MACHAKOS","ALL","25-29",58218,58769,116987
"22301","MACHAKOS","ALL","30",13403,13997,27400
"22302","MACHAKOS","ALL","31",10300,10078,20378
"22303","MACHAKOS","ALL","32",12353,12719,25072
"22304","MACHAKOS","ALL","33",10558,11161,21719
"22305","MACHAKOS","ALL","34",9778,9828,19606
"22306","MACHAKOS","ALL","30-34",56392,57783,114175
"22307","MACHAKOS","ALL","35",12078,11964,24042
"22308","MACHAKOS","ALL","36",9407,9300,18707
"22309","MACHAKOS","ALL","37",9982,9170,19152
"22310","MACHAKOS","ALL","38",7780,7501,15281
"22311","MACHAKOS","ALL","39",9563,9092,18655
"22312","MACHAKOS","ALL","35-39",48810,47027,95837
"22313","MACHAKOS","ALL","40",9973,9286,19259
"22314","MACHAKOS","ALL","41",9593,8954,18547
"22315","MACHAKOS","ALL","42",8344,7859,16203
"22316","MACHAKOS","ALL","43",7406,7795,15201
"22317","MACHAKOS","ALL","44",6349,6152,12501
"22318","MACHAKOS","ALL","40-44",41665,40046,81711
"22319","MACHAKOS","ALL","45",8897,7973,16870
"22320","MACHAKOS","ALL","46",6796,6015,12811
"22321","MACHAKOS","ALL","47",6872,6073,12945
"22322","MACHAKOS","ALL","48",4954,4743,9697
"22323","MACHAKOS","ALL","49",6495,6072,12567
"22324","MACHAKOS","ALL","45-49",34014,30876,64890
"22325","MACHAKOS","ALL","50",6323,6502,12825
"22326","MACHAKOS","ALL","51",5348,5288,10636
"22327","MACHAKOS","ALL","52",4381,4200,8581
"22328","MACHAKOS","ALL","53",3602,3500,7102
"22329","MACHAKOS","ALL","54",4290,4072,8362
"22330","MACHAKOS","ALL","50-54",23944,23562,47506
"22331","MACHAKOS","ALL","55",4566,4211,8777
"22332","MACHAKOS","ALL","56",5096,5065,10161
"22333","MACHAKOS","ALL","57",3967,4621,8588
"22334","MACHAKOS","ALL","58",3028,3279,6307
"22335","MACHAKOS","ALL","59",4298,4455,8753
"22336","MACHAKOS","ALL","55-59",20955,21631,42586
"22337","MACHAKOS","ALL","60",4889,5114,10003
"22338","MACHAKOS","ALL","61",4218,4214,8432
"22339","MACHAKOS","ALL","62",3331,3240,6571
"22340","MACHAKOS","ALL","63",3420,3523,6943
"22341","MACHAKOS","ALL","64",2319,2458,4777
"22342","MACHAKOS","ALL","60-64",18177,18549,36726
"22343","MACHAKOS","ALL","65",3213,3521,6734
"22344","MACHAKOS","ALL","66",2106,2404,4510
"22345","MACHAKOS","ALL","67",3791,4589,8380
"22346","MACHAKOS","ALL","68",1494,1769,3263
"22347","MACHAKOS","ALL","69",2227,2967,5194
"22348","MACHAKOS","ALL","65-69",12831,15250,28081
"22349","MACHAKOS","ALL","70",2671,3456,6127
"22350","MACHAKOS","ALL","71",2069,2649,4718
"22351","MACHAKOS","ALL","72",1533,1550,3083
"22352","MACHAKOS","ALL","73",1397,1585,2982
"22353","MACHAKOS","ALL","74",1309,1753,3062
"22354","MACHAKOS","ALL","70-74",8979,10993,19972
"22355","MACHAKOS","ALL","75",1006,1400,2406
"22356","MACHAKOS","ALL","76",776,1319,2095
"22357","MACHAKOS","ALL","77",1000,1678,2678
"22358","MACHAKOS","ALL","78",680,779,1459
"22359","MACHAKOS","ALL","79",705,1738,2443
"22360","MACHAKOS","ALL","75-79",4167,6914,11081
"22361","MACHAKOS","ALL","80",1067,1839,2906
"22362","MACHAKOS","ALL","81",708,1044,1752
"22363","MACHAKOS","ALL","82",606,643,1249
"22364","MACHAKOS","ALL","83",661,910,1571
"22365","MACHAKOS","ALL","84",530,928,1458
"22366","MACHAKOS","ALL","80-84",3572,5364,8936
"22367","MACHAKOS","ALL","85",440,701,1141
"22368","MACHAKOS","ALL","86",320,344,664
"22369","MACHAKOS","ALL","87",431,714,1145
"22370","MACHAKOS","ALL","88",207,259,466
"22371","MACHAKOS","ALL","89",401,1249,1650
"22372","MACHAKOS","ALL","85-89",1799,3267,5066
"22373","MACHAKOS","ALL","90",313,754,1067
"22374","MACHAKOS","ALL","91",429,890,1319
"22375","MACHAKOS","ALL","92",179,314,493
"22376","MACHAKOS","ALL","93",133,263,396
"22377","MACHAKOS","ALL","94",121,289,410
"22378","MACHAKOS","ALL","90-94",1175,2510,3685
"22379","MACHAKOS","ALL","95",185,380,565
"22380","MACHAKOS","ALL","96",98,156,254
"22381","MACHAKOS","ALL","97",117,145,262
"22382","MACHAKOS","ALL","98",73,138,211
"22383","MACHAKOS","ALL","99",106,374,480
"22384","MACHAKOS","ALL","95-99",579,1193,1772
"22385","MACHAKOS","ALL","100+",282,643,925
"22386","MACHAKOS","ALL","Not Stated",12,6,18
"22387","MACHAKOS","ATHI RIVER","Total",164322,158172,322494
"22388","MACHAKOS","ATHI RIVER","0",4100,4017,8117
"22389","MACHAKOS","ATHI RIVER","1",4092,3946,8038
"22390","MACHAKOS","ATHI RIVER","2",3838,3785,7623
"22391","MACHAKOS","ATHI RIVER","3",3726,3790,7516
"22392","MACHAKOS","ATHI RIVER","4",3577,3366,6943
"22393","MACHAKOS","ATHI RIVER","0 - 4",19333,18904,38237
"22394","MACHAKOS","ATHI RIVER","5",3355,3255,6610
"22395","MACHAKOS","ATHI RIVER","6",3225,3343,6568
"22396","MACHAKOS","ATHI RIVER","7",3232,3154,6386
"22397","MACHAKOS","ATHI RIVER","8",2975,3006,5981
"22398","MACHAKOS","ATHI RIVER","9",3096,3025,6121
"22399","MACHAKOS","ATHI RIVER","5-9",15883,15783,31666
"22400","MACHAKOS","ATHI RIVER","10",3070,3084,6154
"22401","MACHAKOS","ATHI RIVER","11",2741,2835,5576
"22402","MACHAKOS","ATHI RIVER","12",2826,2909,5735
"22403","MACHAKOS","ATHI RIVER","13",2815,2776,5591
"22404","MACHAKOS","ATHI RIVER","14",2454,2489,4943
"22405","MACHAKOS","ATHI RIVER","10 -14",13906,14093,27999
"22406","MACHAKOS","ATHI RIVER","15",2277,2421,4698
"22407","MACHAKOS","ATHI RIVER","16",2197,2387,4584
"22408","MACHAKOS","ATHI RIVER","17",2347,2644,4991
"22409","MACHAKOS","ATHI RIVER","18",2082,2542,4624
"22410","MACHAKOS","ATHI RIVER","19",2642,3377,6019
"22411","MACHAKOS","ATHI RIVER","15-19",11545,13371,24916
"22412","MACHAKOS","ATHI RIVER","20",3009,3860,6869
"22413","MACHAKOS","ATHI RIVER","21",3414,4175,7589
"22414","MACHAKOS","ATHI RIVER","22",3540,4329,7869
"22415","MACHAKOS","ATHI RIVER","23",4215,5157,9372
"22416","MACHAKOS","ATHI RIVER","24",4297,4766,9063
"22417","MACHAKOS","ATHI RIVER","20-24",18475,22287,40762
"22418","MACHAKOS","ATHI RIVER","25",4658,4806,9464
"22419","MACHAKOS","ATHI RIVER","26",4143,4333,8476
"22420","MACHAKOS","ATHI RIVER","27",4286,4192,8478
"22421","MACHAKOS","ATHI RIVER","28",3525,3743,7268
"22422","MACHAKOS","ATHI RIVER","29",4092,3912,8004
"22423","MACHAKOS","ATHI RIVER","25-29",20704,20986,41690
"22424","MACHAKOS","ATHI RIVER","30",4665,4527,9192
"22425","MACHAKOS","ATHI RIVER","31",3283,3005,6288
"22426","MACHAKOS","ATHI RIVER","32",4091,3897,7988
"22427","MACHAKOS","ATHI RIVER","33",3258,3071,6329
"22428","MACHAKOS","ATHI RIVER","34",3081,2806,5887
"22429","MACHAKOS","ATHI RIVER","30-34",18378,17306,35684
"22430","MACHAKOS","ATHI RIVER","35",3695,3250,6945
"22431","MACHAKOS","ATHI RIVER","36",2894,2503,5397
"22432","MACHAKOS","ATHI RIVER","37",2776,2297,5073
"22433","MACHAKOS","ATHI RIVER","38",2412,2182,4594
"22434","MACHAKOS","ATHI RIVER","39",2538,2119,4657
"22435","MACHAKOS","ATHI RIVER","35-39",14315,12351,26666
"22436","MACHAKOS","ATHI RIVER","40",2892,2282,5174
"22437","MACHAKOS","ATHI RIVER","41",2356,1924,4280
"22438","MACHAKOS","ATHI RIVER","42",2249,1710,3959
"22439","MACHAKOS","ATHI RIVER","43",1870,1460,3330
"22440","MACHAKOS","ATHI RIVER","44",1522,1270,2792
"22441","MACHAKOS","ATHI RIVER","40-44",10889,8646,19535
"22442","MACHAKOS","ATHI RIVER","45",2335,1547,3882
"22443","MACHAKOS","ATHI RIVER","46",1638,1151,2789
"22444","MACHAKOS","ATHI RIVER","47",1636,1109,2745
"22445","MACHAKOS","ATHI RIVER","48",1232,868,2100
"22446","MACHAKOS","ATHI RIVER","49",1431,933,2364
"22447","MACHAKOS","ATHI RIVER","45-49",8272,5608,13880
"22448","MACHAKOS","ATHI RIVER","50",1497,971,2468
"22449","MACHAKOS","ATHI RIVER","51",1145,711,1856
"22450","MACHAKOS","ATHI RIVER","52",966,660,1626
"22451","MACHAKOS","ATHI RIVER","53",748,534,1282
"22452","MACHAKOS","ATHI RIVER","54",874,512,1386
"22453","MACHAKOS","ATHI RIVER","50-54",5230,3388,8618
"22454","MACHAKOS","ATHI RIVER","55",816,469,1285
"22455","MACHAKOS","ATHI RIVER","56",826,538,1364
"22456","MACHAKOS","ATHI RIVER","57",678,475,1153
"22457","MACHAKOS","ATHI RIVER","58",476,332,808
"22458","MACHAKOS","ATHI RIVER","59",567,384,951
"22459","MACHAKOS","ATHI RIVER","55-59",3363,2198,5561
"22460","MACHAKOS","ATHI RIVER","60",600,416,1016
"22461","MACHAKOS","ATHI RIVER","61",465,309,774
"22462","MACHAKOS","ATHI RIVER","62",375,260,635
"22463","MACHAKOS","ATHI RIVER","63",350,209,559
"22464","MACHAKOS","ATHI RIVER","64",244,196,440
"22465","MACHAKOS","ATHI RIVER","60-64",2034,1390,3424
"22466","MACHAKOS","ATHI RIVER","65",300,200,500
"22467","MACHAKOS","ATHI RIVER","66",183,149,332
"22468","MACHAKOS","ATHI RIVER","67",272,233,505
"22469","MACHAKOS","ATHI RIVER","68",133,106,239
"22470","MACHAKOS","ATHI RIVER","69",141,124,265
"22471","MACHAKOS","ATHI RIVER","65-69",1029,812,1841
"22472","MACHAKOS","ATHI RIVER","70",193,158,351
"22473","MACHAKOS","ATHI RIVER","71",129,102,231
"22474","MACHAKOS","ATHI RIVER","72",113,74,187
"22475","MACHAKOS","ATHI RIVER","73",68,62,130
"22476","MACHAKOS","ATHI RIVER","74",64,49,113
"22477","MACHAKOS","ATHI RIVER","70-74",567,445,1012
"22478","MACHAKOS","ATHI RIVER","75",47,53,100
"22479","MACHAKOS","ATHI RIVER","76",41,52,93
"22480","MACHAKOS","ATHI RIVER","77",50,52,102
"22481","MACHAKOS","ATHI RIVER","78",20,22,42
"22482","MACHAKOS","ATHI RIVER","79",17,50,67
"22483","MACHAKOS","ATHI RIVER","75-79",175,229,404
"22484","MACHAKOS","ATHI RIVER","80",43,50,93
"22485","MACHAKOS","ATHI RIVER","81",19,25,44
"22486","MACHAKOS","ATHI RIVER","82",16,29,45
"22487","MACHAKOS","ATHI RIVER","83",21,24,45
"22488","MACHAKOS","ATHI RIVER","84",14,21,35
"22489","MACHAKOS","ATHI RIVER","80-84",113,149,262
"22490","MACHAKOS","ATHI RIVER","85",18,26,44
"22491","MACHAKOS","ATHI RIVER","86",13,22,35
"22492","MACHAKOS","ATHI RIVER","87",7,21,28
"22493","MACHAKOS","ATHI RIVER","88",6,10,16
"22494","MACHAKOS","ATHI RIVER","89",11,35,46
"22495","MACHAKOS","ATHI RIVER","85-89",55,114,169
"22496","MACHAKOS","ATHI RIVER","90",8,22,30
"22497","MACHAKOS","ATHI RIVER","91",7,10,17
"22498","MACHAKOS","ATHI RIVER","92",4,8,12
"22499","MACHAKOS","ATHI RIVER","93",6,4,10
"22500","MACHAKOS","ATHI RIVER","94",3,11,14
"22501","MACHAKOS","ATHI RIVER","90-94",28,55,83
"22502","MACHAKOS","ATHI RIVER","95",5,11,16
"22503","MACHAKOS","ATHI RIVER","96",4,4,8
"22504","MACHAKOS","ATHI RIVER","97",3,7,10
"22505","MACHAKOS","ATHI RIVER","98",3,4,7
"22506","MACHAKOS","ATHI RIVER","99",2,8,10
"22507","MACHAKOS","ATHI RIVER","95-99",17,34,51
"22508","MACHAKOS","ATHI RIVER","100+",6,19,25
"22509","MACHAKOS","ATHI RIVER","Not Stated",5,4,9
"22510","MACHAKOS","KALAMA","Total",26764,27692,54456
"22511","MACHAKOS","KALAMA","0",455,433,888
"22512","MACHAKOS","KALAMA","1",531,503,1034
"22513","MACHAKOS","KALAMA","2",465,479,944
"22514","MACHAKOS","KALAMA","3",526,518,1044
"22515","MACHAKOS","KALAMA","4",552,521,1073
"22516","MACHAKOS","KALAMA","0 - 4",2529,2454,4983
"22517","MACHAKOS","KALAMA","5",589,549,1138
"22518","MACHAKOS","KALAMA","6",544,533,1077
"22519","MACHAKOS","KALAMA","7",607,511,1118
"22520","MACHAKOS","KALAMA","8",625,607,1232
"22521","MACHAKOS","KALAMA","9",649,628,1277
"22522","MACHAKOS","KALAMA","5-9",3014,2828,5842
"22523","MACHAKOS","KALAMA","10",738,662,1400
"22524","MACHAKOS","KALAMA","11",688,710,1398
"22525","MACHAKOS","KALAMA","12",783,708,1491
"22526","MACHAKOS","KALAMA","13",743,711,1454
"22527","MACHAKOS","KALAMA","14",733,687,1420
"22528","MACHAKOS","KALAMA","10 -14",3685,3478,7163
"22529","MACHAKOS","KALAMA","15",715,731,1446
"22530","MACHAKOS","KALAMA","16",677,673,1350
"22531","MACHAKOS","KALAMA","17",683,657,1340
"22532","MACHAKOS","KALAMA","18",551,523,1074
"22533","MACHAKOS","KALAMA","19",512,459,971
"22534","MACHAKOS","KALAMA","15-19",3138,3043,6181
"22535","MACHAKOS","KALAMA","20",484,433,917
"22536","MACHAKOS","KALAMA","21",443,377,820
"22537","MACHAKOS","KALAMA","22",360,358,718
"22538","MACHAKOS","KALAMA","23",399,412,811
"22539","MACHAKOS","KALAMA","24",409,311,720
"22540","MACHAKOS","KALAMA","20-24",2095,1891,3986
"22541","MACHAKOS","KALAMA","25",340,355,695
"22542","MACHAKOS","KALAMA","26",344,317,661
"22543","MACHAKOS","KALAMA","27",312,339,651
"22544","MACHAKOS","KALAMA","28",301,322,623
"22545","MACHAKOS","KALAMA","29",364,374,738
"22546","MACHAKOS","KALAMA","25-29",1661,1707,3368
"22547","MACHAKOS","KALAMA","30",414,433,847
"22548","MACHAKOS","KALAMA","31",313,337,650
"22549","MACHAKOS","KALAMA","32",407,387,794
"22550","MACHAKOS","KALAMA","33",330,368,698
"22551","MACHAKOS","KALAMA","34",316,267,583
"22552","MACHAKOS","KALAMA","30-34",1780,1792,3572
"22553","MACHAKOS","KALAMA","35",409,393,802
"22554","MACHAKOS","KALAMA","36",267,319,586
"22555","MACHAKOS","KALAMA","37",313,329,642
"22556","MACHAKOS","KALAMA","38",206,244,450
"22557","MACHAKOS","KALAMA","39",337,347,684
"22558","MACHAKOS","KALAMA","35-39",1532,1632,3164
"22559","MACHAKOS","KALAMA","40",297,338,635
"22560","MACHAKOS","KALAMA","41",323,313,636
"22561","MACHAKOS","KALAMA","42",286,309,595
"22562","MACHAKOS","KALAMA","43",268,313,581
"22563","MACHAKOS","KALAMA","44",230,260,490
"22564","MACHAKOS","KALAMA","40-44",1404,1533,2937
"22565","MACHAKOS","KALAMA","45",324,299,623
"22566","MACHAKOS","KALAMA","46",284,255,539
"22567","MACHAKOS","KALAMA","47",233,270,503
"22568","MACHAKOS","KALAMA","48",154,225,379
"22569","MACHAKOS","KALAMA","49",248,283,531
"22570","MACHAKOS","KALAMA","45-49",1243,1332,2575
"22571","MACHAKOS","KALAMA","50",221,292,513
"22572","MACHAKOS","KALAMA","51",202,285,487
"22573","MACHAKOS","KALAMA","52",162,204,366
"22574","MACHAKOS","KALAMA","53",158,154,312
"22575","MACHAKOS","KALAMA","54",171,199,370
"22576","MACHAKOS","KALAMA","50-54",914,1134,2048
"22577","MACHAKOS","KALAMA","55",196,209,405
"22578","MACHAKOS","KALAMA","56",238,227,465
"22579","MACHAKOS","KALAMA","57",169,215,384
"22580","MACHAKOS","KALAMA","58",136,167,303
"22581","MACHAKOS","KALAMA","59",237,250,487
"22582","MACHAKOS","KALAMA","55-59",976,1068,2044
"22583","MACHAKOS","KALAMA","60",242,256,498
"22584","MACHAKOS","KALAMA","61",179,262,441
"22585","MACHAKOS","KALAMA","62",126,167,293
"22586","MACHAKOS","KALAMA","63",161,188,349
"22587","MACHAKOS","KALAMA","64",112,125,237
"22588","MACHAKOS","KALAMA","60-64",820,998,1818
"22589","MACHAKOS","KALAMA","65",160,172,332
"22590","MACHAKOS","KALAMA","66",108,148,256
"22591","MACHAKOS","KALAMA","67",190,243,433
"22592","MACHAKOS","KALAMA","68",78,91,169
"22593","MACHAKOS","KALAMA","69",125,189,314
"22594","MACHAKOS","KALAMA","65-69",661,843,1504
"22595","MACHAKOS","KALAMA","70",162,199,361
"22596","MACHAKOS","KALAMA","71",132,171,303
"22597","MACHAKOS","KALAMA","72",84,82,166
"22598","MACHAKOS","KALAMA","73",108,105,213
"22599","MACHAKOS","KALAMA","74",82,106,188
"22600","MACHAKOS","KALAMA","70-74",568,663,1231
"22601","MACHAKOS","KALAMA","75",58,83,141
"22602","MACHAKOS","KALAMA","76",55,63,118
"22603","MACHAKOS","KALAMA","77",64,134,198
"22604","MACHAKOS","KALAMA","78",42,36,78
"22605","MACHAKOS","KALAMA","79",45,117,162
"22606","MACHAKOS","KALAMA","75-79",264,433,697
"22607","MACHAKOS","KALAMA","80",74,115,189
"22608","MACHAKOS","KALAMA","81",49,50,99
"22609","MACHAKOS","KALAMA","82",39,31,70
"22610","MACHAKOS","KALAMA","83",38,56,94
"22611","MACHAKOS","KALAMA","84",43,73,116
"22612","MACHAKOS","KALAMA","80-84",243,325,568
"22613","MACHAKOS","KALAMA","85",25,40,65
"22614","MACHAKOS","KALAMA","86",14,18,32
"22615","MACHAKOS","KALAMA","87",25,30,55
"22616","MACHAKOS","KALAMA","88",10,15,25
"22617","MACHAKOS","KALAMA","89",31,114,145
"22618","MACHAKOS","KALAMA","85-89",105,217,322
"22619","MACHAKOS","KALAMA","90",30,66,96
"22620","MACHAKOS","KALAMA","91",20,67,87
"22621","MACHAKOS","KALAMA","92",18,22,40
"22622","MACHAKOS","KALAMA","93",14,22,36
"22623","MACHAKOS","KALAMA","94",7,16,23
"22624","MACHAKOS","KALAMA","90-94",89,193,282
"22625","MACHAKOS","KALAMA","95",12,30,42
"22626","MACHAKOS","KALAMA","96",3,6,9
"22627","MACHAKOS","KALAMA","97",3,8,11
"22628","MACHAKOS","KALAMA","98",NA,4,4
"22629","MACHAKOS","KALAMA","99",6,33,39
"22630","MACHAKOS","KALAMA","95-99",24,81,105
"22631","MACHAKOS","KALAMA","100+",19,47,66
"22632","MACHAKOS","KALAMA","Not Stated",NA,NA,NA
"22633","MACHAKOS","KANGUNDO","Total",48697,49219,97916
"22634","MACHAKOS","KANGUNDO","0",831,771,1602
"22635","MACHAKOS","KANGUNDO","1",911,909,1820
"22636","MACHAKOS","KANGUNDO","2",911,892,1803
"22637","MACHAKOS","KANGUNDO","3",978,930,1908
"22638","MACHAKOS","KANGUNDO","4",975,929,1904
"22639","MACHAKOS","KANGUNDO","0 - 4",4606,4431,9037
"22640","MACHAKOS","KANGUNDO","5",957,985,1942
"22641","MACHAKOS","KANGUNDO","6",975,959,1934
"22642","MACHAKOS","KANGUNDO","7",1048,1008,2056
"22643","MACHAKOS","KANGUNDO","8",1054,1004,2058
"22644","MACHAKOS","KANGUNDO","9",1183,1078,2261
"22645","MACHAKOS","KANGUNDO","5-9",5217,5034,10251
"22646","MACHAKOS","KANGUNDO","10",1189,1157,2346
"22647","MACHAKOS","KANGUNDO","11",1121,1164,2285
"22648","MACHAKOS","KANGUNDO","12",1278,1214,2492
"22649","MACHAKOS","KANGUNDO","13",1316,1253,2569
"22650","MACHAKOS","KANGUNDO","14",1289,1164,2453
"22651","MACHAKOS","KANGUNDO","10 -14",6193,5952,12145
"22652","MACHAKOS","KANGUNDO","15",1204,1141,2345
"22653","MACHAKOS","KANGUNDO","16",1130,1080,2210
"22654","MACHAKOS","KANGUNDO","17",1300,1078,2378
"22655","MACHAKOS","KANGUNDO","18",879,748,1627
"22656","MACHAKOS","KANGUNDO","19",993,785,1778
"22657","MACHAKOS","KANGUNDO","15-19",5506,4832,10338
"22658","MACHAKOS","KANGUNDO","20",818,691,1509
"22659","MACHAKOS","KANGUNDO","21",766,657,1423
"22660","MACHAKOS","KANGUNDO","22",660,592,1252
"22661","MACHAKOS","KANGUNDO","23",716,684,1400
"22662","MACHAKOS","KANGUNDO","24",625,613,1238
"22663","MACHAKOS","KANGUNDO","20-24",3585,3237,6822
"22664","MACHAKOS","KANGUNDO","25",641,574,1215
"22665","MACHAKOS","KANGUNDO","26",553,500,1053
"22666","MACHAKOS","KANGUNDO","27",534,543,1077
"22667","MACHAKOS","KANGUNDO","28",528,517,1045
"22668","MACHAKOS","KANGUNDO","29",594,615,1209
"22669","MACHAKOS","KANGUNDO","25-29",2850,2749,5599
"22670","MACHAKOS","KANGUNDO","30",671,743,1414
"22671","MACHAKOS","KANGUNDO","31",539,539,1078
"22672","MACHAKOS","KANGUNDO","32",695,758,1453
"22673","MACHAKOS","KANGUNDO","33",629,741,1370
"22674","MACHAKOS","KANGUNDO","34",602,658,1260
"22675","MACHAKOS","KANGUNDO","30-34",3136,3439,6575
"22676","MACHAKOS","KANGUNDO","35",736,747,1483
"22677","MACHAKOS","KANGUNDO","36",642,593,1235
"22678","MACHAKOS","KANGUNDO","37",702,676,1378
"22679","MACHAKOS","KANGUNDO","38",510,544,1054
"22680","MACHAKOS","KANGUNDO","39",728,627,1355
"22681","MACHAKOS","KANGUNDO","35-39",3318,3187,6505
"22682","MACHAKOS","KANGUNDO","40",674,704,1378
"22683","MACHAKOS","KANGUNDO","41",660,694,1354
"22684","MACHAKOS","KANGUNDO","42",578,628,1206
"22685","MACHAKOS","KANGUNDO","43",579,637,1216
"22686","MACHAKOS","KANGUNDO","44",481,451,932
"22687","MACHAKOS","KANGUNDO","40-44",2972,3114,6086
"22688","MACHAKOS","KANGUNDO","45",608,628,1236
"22689","MACHAKOS","KANGUNDO","46",486,431,917
"22690","MACHAKOS","KANGUNDO","47",490,481,971
"22691","MACHAKOS","KANGUNDO","48",373,348,721
"22692","MACHAKOS","KANGUNDO","49",502,501,1003
"22693","MACHAKOS","KANGUNDO","45-49",2459,2389,4848
"22694","MACHAKOS","KANGUNDO","50",447,547,994
"22695","MACHAKOS","KANGUNDO","51",433,476,909
"22696","MACHAKOS","KANGUNDO","52",336,346,682
"22697","MACHAKOS","KANGUNDO","53",291,328,619
"22698","MACHAKOS","KANGUNDO","54",320,358,678
"22699","MACHAKOS","KANGUNDO","50-54",1827,2055,3882
"22700","MACHAKOS","KANGUNDO","55",392,420,812
"22701","MACHAKOS","KANGUNDO","56",464,445,909
"22702","MACHAKOS","KANGUNDO","57",350,442,792
"22703","MACHAKOS","KANGUNDO","58",267,316,583
"22704","MACHAKOS","KANGUNDO","59",414,426,840
"22705","MACHAKOS","KANGUNDO","55-59",1887,2049,3936
"22706","MACHAKOS","KANGUNDO","60",460,505,965
"22707","MACHAKOS","KANGUNDO","61",399,431,830
"22708","MACHAKOS","KANGUNDO","62",341,320,661
"22709","MACHAKOS","KANGUNDO","63",364,360,724
"22710","MACHAKOS","KANGUNDO","64",249,252,501
"22711","MACHAKOS","KANGUNDO","60-64",1813,1868,3681
"22712","MACHAKOS","KANGUNDO","65",324,342,666
"22713","MACHAKOS","KANGUNDO","66",202,267,469
"22714","MACHAKOS","KANGUNDO","67",326,419,745
"22715","MACHAKOS","KANGUNDO","68",146,172,318
"22716","MACHAKOS","KANGUNDO","69",207,291,498
"22717","MACHAKOS","KANGUNDO","65-69",1205,1491,2696
"22718","MACHAKOS","KANGUNDO","70",260,359,619
"22719","MACHAKOS","KANGUNDO","71",219,298,517
"22720","MACHAKOS","KANGUNDO","72",143,163,306
"22721","MACHAKOS","KANGUNDO","73",137,160,297
"22722","MACHAKOS","KANGUNDO","74",154,187,341
"22723","MACHAKOS","KANGUNDO","70-74",913,1167,2080
"22724","MACHAKOS","KANGUNDO","75",108,142,250
"22725","MACHAKOS","KANGUNDO","76",77,131,208
"22726","MACHAKOS","KANGUNDO","77",103,195,298
"22727","MACHAKOS","KANGUNDO","78",61,100,161
"22728","MACHAKOS","KANGUNDO","79",81,211,292
"22729","MACHAKOS","KANGUNDO","75-79",430,779,1209
"22730","MACHAKOS","KANGUNDO","80",111,170,281
"22731","MACHAKOS","KANGUNDO","81",85,127,212
"22732","MACHAKOS","KANGUNDO","82",64,63,127
"22733","MACHAKOS","KANGUNDO","83",69,112,181
"22734","MACHAKOS","KANGUNDO","84",67,123,190
"22735","MACHAKOS","KANGUNDO","80-84",396,595,991
"22736","MACHAKOS","KANGUNDO","85",33,83,116
"22737","MACHAKOS","KANGUNDO","86",37,35,72
"22738","MACHAKOS","KANGUNDO","87",61,106,167
"22739","MACHAKOS","KANGUNDO","88",17,38,55
"22740","MACHAKOS","KANGUNDO","89",41,141,182
"22741","MACHAKOS","KANGUNDO","85-89",189,403,592
"22742","MACHAKOS","KANGUNDO","90",23,88,111
"22743","MACHAKOS","KANGUNDO","91",52,77,129
"22744","MACHAKOS","KANGUNDO","92",14,22,36
"22745","MACHAKOS","KANGUNDO","93",10,32,42
"22746","MACHAKOS","KANGUNDO","94",12,37,49
"22747","MACHAKOS","KANGUNDO","90-94",111,256,367
"22748","MACHAKOS","KANGUNDO","95",18,43,61
"22749","MACHAKOS","KANGUNDO","96",10,21,31
"22750","MACHAKOS","KANGUNDO","97",14,12,26
"22751","MACHAKOS","KANGUNDO","98",7,9,16
"22752","MACHAKOS","KANGUNDO","99",4,40,44
"22753","MACHAKOS","KANGUNDO","95-99",53,125,178
"22754","MACHAKOS","KANGUNDO","100+",31,67,98
"22755","MACHAKOS","KANGUNDO","Not Stated",NA,NA,NA
"22756","MACHAKOS","KATHIANI","Total",54910,56976,111886
"22757","MACHAKOS","KATHIANI","0",989,953,1942
"22758","MACHAKOS","KATHIANI","1",1030,1074,2104
"22759","MACHAKOS","KATHIANI","2",1134,1028,2162
"22760","MACHAKOS","KATHIANI","3",1170,1135,2305
"22761","MACHAKOS","KATHIANI","4",1212,1127,2339
"22762","MACHAKOS","KATHIANI","0 - 4",5535,5317,10852
"22763","MACHAKOS","KATHIANI","5",1225,1176,2401
"22764","MACHAKOS","KATHIANI","6",1250,1205,2455
"22765","MACHAKOS","KATHIANI","7",1304,1296,2600
"22766","MACHAKOS","KATHIANI","8",1326,1301,2627
"22767","MACHAKOS","KATHIANI","9",1421,1294,2715
"22768","MACHAKOS","KATHIANI","5-9",6526,6272,12798
"22769","MACHAKOS","KATHIANI","10",1423,1376,2799
"22770","MACHAKOS","KATHIANI","11",1461,1411,2872
"22771","MACHAKOS","KATHIANI","12",1624,1518,3142
"22772","MACHAKOS","KATHIANI","13",1584,1495,3079
"22773","MACHAKOS","KATHIANI","14",1518,1425,2943
"22774","MACHAKOS","KATHIANI","10 -14",7610,7225,14835
"22775","MACHAKOS","KATHIANI","15",1395,1397,2792
"22776","MACHAKOS","KATHIANI","16",1443,1341,2784
"22777","MACHAKOS","KATHIANI","17",1419,1307,2726
"22778","MACHAKOS","KATHIANI","18",1192,1008,2200
"22779","MACHAKOS","KATHIANI","19",1229,979,2208
"22780","MACHAKOS","KATHIANI","15-19",6678,6032,12710
"22781","MACHAKOS","KATHIANI","20",1005,880,1885
"22782","MACHAKOS","KATHIANI","21",916,786,1702
"22783","MACHAKOS","KATHIANI","22",822,681,1503
"22784","MACHAKOS","KATHIANI","23",786,839,1625
"22785","MACHAKOS","KATHIANI","24",794,751,1545
"22786","MACHAKOS","KATHIANI","20-24",4323,3937,8260
"22787","MACHAKOS","KATHIANI","25",750,726,1476
"22788","MACHAKOS","KATHIANI","26",584,701,1285
"22789","MACHAKOS","KATHIANI","27",662,711,1373
"22790","MACHAKOS","KATHIANI","28",590,673,1263
"22791","MACHAKOS","KATHIANI","29",711,751,1462
"22792","MACHAKOS","KATHIANI","25-29",3297,3562,6859
"22793","MACHAKOS","KATHIANI","30",729,894,1623
"22794","MACHAKOS","KATHIANI","31",658,704,1362
"22795","MACHAKOS","KATHIANI","32",794,870,1664
"22796","MACHAKOS","KATHIANI","33",675,836,1511
"22797","MACHAKOS","KATHIANI","34",644,718,1362
"22798","MACHAKOS","KATHIANI","30-34",3500,4022,7522
"22799","MACHAKOS","KATHIANI","35",819,880,1699
"22800","MACHAKOS","KATHIANI","36",579,666,1245
"22801","MACHAKOS","KATHIANI","37",653,641,1294
"22802","MACHAKOS","KATHIANI","38",515,519,1034
"22803","MACHAKOS","KATHIANI","39",620,698,1318
"22804","MACHAKOS","KATHIANI","35-39",3186,3404,6590
"22805","MACHAKOS","KATHIANI","40",668,705,1373
"22806","MACHAKOS","KATHIANI","41",741,741,1482
"22807","MACHAKOS","KATHIANI","42",544,630,1174
"22808","MACHAKOS","KATHIANI","43",549,667,1216
"22809","MACHAKOS","KATHIANI","44",490,525,1015
"22810","MACHAKOS","KATHIANI","40-44",2992,3268,6260
"22811","MACHAKOS","KATHIANI","45",583,742,1325
"22812","MACHAKOS","KATHIANI","46",504,551,1055
"22813","MACHAKOS","KATHIANI","47",464,507,971
"22814","MACHAKOS","KATHIANI","48",371,414,785
"22815","MACHAKOS","KATHIANI","49",489,513,1002
"22816","MACHAKOS","KATHIANI","45-49",2411,2727,5138
"22817","MACHAKOS","KATHIANI","50",461,611,1072
"22818","MACHAKOS","KATHIANI","51",435,474,909
"22819","MACHAKOS","KATHIANI","52",292,349,641
"22820","MACHAKOS","KATHIANI","53",271,312,583
"22821","MACHAKOS","KATHIANI","54",343,342,685
"22822","MACHAKOS","KATHIANI","50-54",1802,2088,3890
"22823","MACHAKOS","KATHIANI","55",386,378,764
"22824","MACHAKOS","KATHIANI","56",412,437,849
"22825","MACHAKOS","KATHIANI","57",336,470,806
"22826","MACHAKOS","KATHIANI","58",246,331,577
"22827","MACHAKOS","KATHIANI","59",432,471,903
"22828","MACHAKOS","KATHIANI","55-59",1812,2087,3899
"22829","MACHAKOS","KATHIANI","60",487,542,1029
"22830","MACHAKOS","KATHIANI","61",389,445,834
"22831","MACHAKOS","KATHIANI","62",319,329,648
"22832","MACHAKOS","KATHIANI","63",363,376,739
"22833","MACHAKOS","KATHIANI","64",217,245,462
"22834","MACHAKOS","KATHIANI","60-64",1775,1937,3712
"22835","MACHAKOS","KATHIANI","65",330,385,715
"22836","MACHAKOS","KATHIANI","66",219,249,468
"22837","MACHAKOS","KATHIANI","67",394,502,896
"22838","MACHAKOS","KATHIANI","68",150,188,338
"22839","MACHAKOS","KATHIANI","69",246,360,606
"22840","MACHAKOS","KATHIANI","65-69",1339,1684,3023
"22841","MACHAKOS","KATHIANI","70",254,382,636
"22842","MACHAKOS","KATHIANI","71",205,295,500
"22843","MACHAKOS","KATHIANI","72",163,177,340
"22844","MACHAKOS","KATHIANI","73",158,168,326
"22845","MACHAKOS","KATHIANI","74",146,203,349
"22846","MACHAKOS","KATHIANI","70-74",926,1225,2151
"22847","MACHAKOS","KATHIANI","75",94,147,241
"22848","MACHAKOS","KATHIANI","76",87,147,234
"22849","MACHAKOS","KATHIANI","77",87,163,250
"22850","MACHAKOS","KATHIANI","78",87,85,172
"22851","MACHAKOS","KATHIANI","79",87,215,302
"22852","MACHAKOS","KATHIANI","75-79",442,757,1199
"22853","MACHAKOS","KATHIANI","80",112,196,308
"22854","MACHAKOS","KATHIANI","81",80,134,214
"22855","MACHAKOS","KATHIANI","82",66,79,145
"22856","MACHAKOS","KATHIANI","83",67,120,187
"22857","MACHAKOS","KATHIANI","84",36,104,140
"22858","MACHAKOS","KATHIANI","80-84",361,633,994
"22859","MACHAKOS","KATHIANI","85",53,75,128
"22860","MACHAKOS","KATHIANI","86",40,38,78
"22861","MACHAKOS","KATHIANI","87",52,71,123
"22862","MACHAKOS","KATHIANI","88",15,23,38
"22863","MACHAKOS","KATHIANI","89",40,151,191
"22864","MACHAKOS","KATHIANI","85-89",200,358,558
"22865","MACHAKOS","KATHIANI","90",23,76,99
"22866","MACHAKOS","KATHIANI","91",47,103,150
"22867","MACHAKOS","KATHIANI","92",17,28,45
"22868","MACHAKOS","KATHIANI","93",12,18,30
"22869","MACHAKOS","KATHIANI","94",13,26,39
"22870","MACHAKOS","KATHIANI","90-94",112,251,363
"22871","MACHAKOS","KATHIANI","95",15,33,48
"22872","MACHAKOS","KATHIANI","96",12,12,24
"22873","MACHAKOS","KATHIANI","97",7,14,21
"22874","MACHAKOS","KATHIANI","98",7,17,24
"22875","MACHAKOS","KATHIANI","99",11,39,50
"22876","MACHAKOS","KATHIANI","95-99",52,115,167
"22877","MACHAKOS","KATHIANI","100+",31,74,105
"22878","MACHAKOS","KATHIANI","Not Stated",NA,1,1
"22879","MACHAKOS","MACHAKOS","Total",85486,85114,170600
"22880","MACHAKOS","MACHAKOS","0",1828,1777,3605
"22881","MACHAKOS","MACHAKOS","1",1707,1730,3437
"22882","MACHAKOS","MACHAKOS","2",1662,1645,3307
"22883","MACHAKOS","MACHAKOS","3",1621,1668,3289
"22884","MACHAKOS","MACHAKOS","4",1697,1654,3351
"22885","MACHAKOS","MACHAKOS","0 - 4",8515,8474,16989
"22886","MACHAKOS","MACHAKOS","5",1750,1584,3334
"22887","MACHAKOS","MACHAKOS","6",1569,1589,3158
"22888","MACHAKOS","MACHAKOS","7",1604,1636,3240
"22889","MACHAKOS","MACHAKOS","8",1563,1542,3105
"22890","MACHAKOS","MACHAKOS","9",1744,1703,3447
"22891","MACHAKOS","MACHAKOS","5-9",8230,8054,16284
"22892","MACHAKOS","MACHAKOS","10",1731,1758,3489
"22893","MACHAKOS","MACHAKOS","11",1672,1635,3307
"22894","MACHAKOS","MACHAKOS","12",1708,1722,3430
"22895","MACHAKOS","MACHAKOS","13",1726,1726,3452
"22896","MACHAKOS","MACHAKOS","14",1736,1599,3335
"22897","MACHAKOS","MACHAKOS","10 -14",8573,8440,17013
"22898","MACHAKOS","MACHAKOS","15",1665,1614,3279
"22899","MACHAKOS","MACHAKOS","16",1548,1508,3056
"22900","MACHAKOS","MACHAKOS","17",1737,1640,3377
"22901","MACHAKOS","MACHAKOS","18",1352,1304,2656
"22902","MACHAKOS","MACHAKOS","19",1595,1538,3133
"22903","MACHAKOS","MACHAKOS","15-19",7897,7604,15501
"22904","MACHAKOS","MACHAKOS","20",1620,1709,3329
"22905","MACHAKOS","MACHAKOS","21",1597,1714,3311
"22906","MACHAKOS","MACHAKOS","22",1661,1726,3387
"22907","MACHAKOS","MACHAKOS","23",1867,2081,3948
"22908","MACHAKOS","MACHAKOS","24",1780,1832,3612
"22909","MACHAKOS","MACHAKOS","20-24",8525,9062,17587
"22910","MACHAKOS","MACHAKOS","25",1896,1812,3708
"22911","MACHAKOS","MACHAKOS","26",1579,1545,3124
"22912","MACHAKOS","MACHAKOS","27",1658,1565,3223
"22913","MACHAKOS","MACHAKOS","28",1423,1466,2889
"22914","MACHAKOS","MACHAKOS","29",1638,1615,3253
"22915","MACHAKOS","MACHAKOS","25-29",8194,8003,16197
"22916","MACHAKOS","MACHAKOS","30",1855,1846,3701
"22917","MACHAKOS","MACHAKOS","31",1406,1300,2706
"22918","MACHAKOS","MACHAKOS","32",1685,1630,3315
"22919","MACHAKOS","MACHAKOS","33",1414,1356,2770
"22920","MACHAKOS","MACHAKOS","34",1287,1249,2536
"22921","MACHAKOS","MACHAKOS","30-34",7647,7381,15028
"22922","MACHAKOS","MACHAKOS","35",1566,1430,2996
"22923","MACHAKOS","MACHAKOS","36",1230,1160,2390
"22924","MACHAKOS","MACHAKOS","37",1258,1221,2479
"22925","MACHAKOS","MACHAKOS","38",1018,964,1982
"22926","MACHAKOS","MACHAKOS","39",1282,1158,2440
"22927","MACHAKOS","MACHAKOS","35-39",6354,5933,12287
"22928","MACHAKOS","MACHAKOS","40",1315,1155,2470
"22929","MACHAKOS","MACHAKOS","41",1251,1084,2335
"22930","MACHAKOS","MACHAKOS","42",1113,1002,2115
"22931","MACHAKOS","MACHAKOS","43",929,902,1831
"22932","MACHAKOS","MACHAKOS","44",767,724,1491
"22933","MACHAKOS","MACHAKOS","40-44",5375,4867,10242
"22934","MACHAKOS","MACHAKOS","45",1115,989,2104
"22935","MACHAKOS","MACHAKOS","46",810,709,1519
"22936","MACHAKOS","MACHAKOS","47",854,783,1637
"22937","MACHAKOS","MACHAKOS","48",687,589,1276
"22938","MACHAKOS","MACHAKOS","49",857,757,1614
"22939","MACHAKOS","MACHAKOS","45-49",4323,3827,8150
"22940","MACHAKOS","MACHAKOS","50",820,840,1660
"22941","MACHAKOS","MACHAKOS","51",654,603,1257
"22942","MACHAKOS","MACHAKOS","52",617,548,1165
"22943","MACHAKOS","MACHAKOS","53",508,433,941
"22944","MACHAKOS","MACHAKOS","54",541,563,1104
"22945","MACHAKOS","MACHAKOS","50-54",3140,2987,6127
"22946","MACHAKOS","MACHAKOS","55",590,577,1167
"22947","MACHAKOS","MACHAKOS","56",619,611,1230
"22948","MACHAKOS","MACHAKOS","57",515,604,1119
"22949","MACHAKOS","MACHAKOS","58",391,422,813
"22950","MACHAKOS","MACHAKOS","59",518,574,1092
"22951","MACHAKOS","MACHAKOS","55-59",2633,2788,5421
"22952","MACHAKOS","MACHAKOS","60",586,668,1254
"22953","MACHAKOS","MACHAKOS","61",490,554,1044
"22954","MACHAKOS","MACHAKOS","62",426,391,817
"22955","MACHAKOS","MACHAKOS","63",403,448,851
"22956","MACHAKOS","MACHAKOS","64",285,293,578
"22957","MACHAKOS","MACHAKOS","60-64",2190,2354,4544
"22958","MACHAKOS","MACHAKOS","65",408,484,892
"22959","MACHAKOS","MACHAKOS","66",282,271,553
"22960","MACHAKOS","MACHAKOS","67",422,571,993
"22961","MACHAKOS","MACHAKOS","68",201,222,423
"22962","MACHAKOS","MACHAKOS","69",267,352,619
"22963","MACHAKOS","MACHAKOS","65-69",1580,1900,3480
"22964","MACHAKOS","MACHAKOS","70",317,430,747
"22965","MACHAKOS","MACHAKOS","71",239,299,538
"22966","MACHAKOS","MACHAKOS","72",181,182,363
"22967","MACHAKOS","MACHAKOS","73",160,171,331
"22968","MACHAKOS","MACHAKOS","74",181,211,392
"22969","MACHAKOS","MACHAKOS","70-74",1078,1293,2371
"22970","MACHAKOS","MACHAKOS","75",136,146,282
"22971","MACHAKOS","MACHAKOS","76",108,147,255
"22972","MACHAKOS","MACHAKOS","77",110,175,285
"22973","MACHAKOS","MACHAKOS","78",79,95,174
"22974","MACHAKOS","MACHAKOS","79",77,183,260
"22975","MACHAKOS","MACHAKOS","75-79",510,746,1256
"22976","MACHAKOS","MACHAKOS","80",104,213,317
"22977","MACHAKOS","MACHAKOS","81",82,138,220
"22978","MACHAKOS","MACHAKOS","82",61,80,141
"22979","MACHAKOS","MACHAKOS","83",69,108,177
"22980","MACHAKOS","MACHAKOS","84",63,103,166
"22981","MACHAKOS","MACHAKOS","80-84",379,642,1021
"22982","MACHAKOS","MACHAKOS","85",56,72,128
"22983","MACHAKOS","MACHAKOS","86",31,43,74
"22984","MACHAKOS","MACHAKOS","87",39,68,107
"22985","MACHAKOS","MACHAKOS","88",14,27,41
"22986","MACHAKOS","MACHAKOS","89",39,129,168
"22987","MACHAKOS","MACHAKOS","85-89",179,339,518
"22988","MACHAKOS","MACHAKOS","90",25,68,93
"22989","MACHAKOS","MACHAKOS","91",39,88,127
"22990","MACHAKOS","MACHAKOS","92",16,35,51
"22991","MACHAKOS","MACHAKOS","93",10,19,29
"22992","MACHAKOS","MACHAKOS","94",11,28,39
"22993","MACHAKOS","MACHAKOS","90-94",101,238,339
"22994","MACHAKOS","MACHAKOS","95",9,32,41
"22995","MACHAKOS","MACHAKOS","96",4,19,23
"22996","MACHAKOS","MACHAKOS","97",11,16,27
"22997","MACHAKOS","MACHAKOS","98",5,14,19
"22998","MACHAKOS","MACHAKOS","99",9,36,45
"22999","MACHAKOS","MACHAKOS","95-99",38,117,155
"23000","MACHAKOS","MACHAKOS","100+",23,65,88
"23001","MACHAKOS","MACHAKOS","Not Stated",2,NA,2
"23002","MACHAKOS","MASINGA","Total",73519,75001,148520
"23003","MACHAKOS","MASINGA","0",1478,1434,2912
"23004","MACHAKOS","MASINGA","1",1588,1595,3183
"23005","MACHAKOS","MASINGA","2",1583,1590,3173
"23006","MACHAKOS","MASINGA","3",1640,1729,3369
"23007","MACHAKOS","MASINGA","4",1789,1598,3387
"23008","MACHAKOS","MASINGA","0 - 4",8078,7946,16024
"23009","MACHAKOS","MASINGA","5",1757,1657,3414
"23010","MACHAKOS","MASINGA","6",1722,1659,3381
"23011","MACHAKOS","MASINGA","7",1765,1629,3394
"23012","MACHAKOS","MASINGA","8",1840,1813,3653
"23013","MACHAKOS","MASINGA","9",2044,1887,3931
"23014","MACHAKOS","MASINGA","5-9",9128,8645,17773
"23015","MACHAKOS","MASINGA","10",2032,1901,3933
"23016","MACHAKOS","MASINGA","11",2034,2135,4169
"23017","MACHAKOS","MASINGA","12",2210,2125,4335
"23018","MACHAKOS","MASINGA","13",2207,2079,4286
"23019","MACHAKOS","MASINGA","14",2108,2027,4135
"23020","MACHAKOS","MASINGA","10 -14",10591,10267,20858
"23021","MACHAKOS","MASINGA","15",2227,2031,4258
"23022","MACHAKOS","MASINGA","16",1965,1900,3865
"23023","MACHAKOS","MASINGA","17",2075,1823,3898
"23024","MACHAKOS","MASINGA","18",1640,1408,3048
"23025","MACHAKOS","MASINGA","19",1643,1341,2984
"23026","MACHAKOS","MASINGA","15-19",9550,8503,18053
"23027","MACHAKOS","MASINGA","20",1519,1333,2852
"23028","MACHAKOS","MASINGA","21",1247,1088,2335
"23029","MACHAKOS","MASINGA","22",1019,1018,2037
"23030","MACHAKOS","MASINGA","23",1110,1143,2253
"23031","MACHAKOS","MASINGA","24",922,961,1883
"23032","MACHAKOS","MASINGA","20-24",5817,5543,11360
"23033","MACHAKOS","MASINGA","25",936,990,1926
"23034","MACHAKOS","MASINGA","26",839,920,1759
"23035","MACHAKOS","MASINGA","27",904,958,1862
"23036","MACHAKOS","MASINGA","28",758,906,1664
"23037","MACHAKOS","MASINGA","29",903,1022,1925
"23038","MACHAKOS","MASINGA","25-29",4340,4796,9136
"23039","MACHAKOS","MASINGA","30",1088,1204,2292
"23040","MACHAKOS","MASINGA","31",877,930,1807
"23041","MACHAKOS","MASINGA","32",1001,1071,2072
"23042","MACHAKOS","MASINGA","33",865,1038,1903
"23043","MACHAKOS","MASINGA","34",783,865,1648
"23044","MACHAKOS","MASINGA","30-34",4614,5108,9722
"23045","MACHAKOS","MASINGA","35",1090,1175,2265
"23046","MACHAKOS","MASINGA","36",805,883,1688
"23047","MACHAKOS","MASINGA","37",898,877,1775
"23048","MACHAKOS","MASINGA","38",639,615,1254
"23049","MACHAKOS","MASINGA","39",811,861,1672
"23050","MACHAKOS","MASINGA","35-39",4243,4411,8654
"23051","MACHAKOS","MASINGA","40",866,849,1715
"23052","MACHAKOS","MASINGA","41",842,923,1765
"23053","MACHAKOS","MASINGA","42",696,743,1439
"23054","MACHAKOS","MASINGA","43",598,789,1387
"23055","MACHAKOS","MASINGA","44",580,582,1162
"23056","MACHAKOS","MASINGA","40-44",3582,3886,7468
"23057","MACHAKOS","MASINGA","45",839,860,1699
"23058","MACHAKOS","MASINGA","46",653,634,1287
"23059","MACHAKOS","MASINGA","47",687,620,1307
"23060","MACHAKOS","MASINGA","48",417,484,901
"23061","MACHAKOS","MASINGA","49",594,691,1285
"23062","MACHAKOS","MASINGA","45-49",3190,3289,6479
"23063","MACHAKOS","MASINGA","50",576,673,1249
"23064","MACHAKOS","MASINGA","51",508,626,1134
"23065","MACHAKOS","MASINGA","52",402,420,822
"23066","MACHAKOS","MASINGA","53",345,362,707
"23067","MACHAKOS","MASINGA","54",426,428,854
"23068","MACHAKOS","MASINGA","50-54",2257,2509,4766
"23069","MACHAKOS","MASINGA","55",459,429,888
"23070","MACHAKOS","MASINGA","56",545,608,1153
"23071","MACHAKOS","MASINGA","57",366,513,879
"23072","MACHAKOS","MASINGA","58",283,364,647
"23073","MACHAKOS","MASINGA","59",428,499,927
"23074","MACHAKOS","MASINGA","55-59",2081,2413,4494
"23075","MACHAKOS","MASINGA","60",497,488,985
"23076","MACHAKOS","MASINGA","61",499,466,965
"23077","MACHAKOS","MASINGA","62",345,359,704
"23078","MACHAKOS","MASINGA","63",370,406,776
"23079","MACHAKOS","MASINGA","64",251,287,538
"23080","MACHAKOS","MASINGA","60-64",1962,2006,3968
"23081","MACHAKOS","MASINGA","65",353,407,760
"23082","MACHAKOS","MASINGA","66",238,297,535
"23083","MACHAKOS","MASINGA","67",499,642,1141
"23084","MACHAKOS","MASINGA","68",193,244,437
"23085","MACHAKOS","MASINGA","69",282,348,630
"23086","MACHAKOS","MASINGA","65-69",1565,1938,3503
"23087","MACHAKOS","MASINGA","70",297,443,740
"23088","MACHAKOS","MASINGA","71",247,375,622
"23089","MACHAKOS","MASINGA","72",196,198,394
"23090","MACHAKOS","MASINGA","73",160,195,355
"23091","MACHAKOS","MASINGA","74",146,220,366
"23092","MACHAKOS","MASINGA","70-74",1046,1431,2477
"23093","MACHAKOS","MASINGA","75",109,176,285
"23094","MACHAKOS","MASINGA","76",85,173,258
"23095","MACHAKOS","MASINGA","77",118,191,309
"23096","MACHAKOS","MASINGA","78",91,103,194
"23097","MACHAKOS","MASINGA","79",99,204,303
"23098","MACHAKOS","MASINGA","75-79",502,847,1349
"23099","MACHAKOS","MASINGA","80",142,231,373
"23100","MACHAKOS","MASINGA","81",90,115,205
"23101","MACHAKOS","MASINGA","82",72,82,154
"23102","MACHAKOS","MASINGA","83",86,86,172
"23103","MACHAKOS","MASINGA","84",76,87,163
"23104","MACHAKOS","MASINGA","80-84",466,601,1067
"23105","MACHAKOS","MASINGA","85",45,71,116
"23106","MACHAKOS","MASINGA","86",48,47,95
"23107","MACHAKOS","MASINGA","87",62,80,142
"23108","MACHAKOS","MASINGA","88",38,22,60
"23109","MACHAKOS","MASINGA","89",56,141,197
"23110","MACHAKOS","MASINGA","85-89",249,361,610
"23111","MACHAKOS","MASINGA","90",42,66,108
"23112","MACHAKOS","MASINGA","91",47,107,154
"23113","MACHAKOS","MASINGA","92",21,42,63
"23114","MACHAKOS","MASINGA","93",18,39,57
"23115","MACHAKOS","MASINGA","94",14,26,40
"23116","MACHAKOS","MASINGA","90-94",142,280,422
"23117","MACHAKOS","MASINGA","95",18,42,60
"23118","MACHAKOS","MASINGA","96",10,15,25
"23119","MACHAKOS","MASINGA","97",23,15,38
"23120","MACHAKOS","MASINGA","98",14,16,30
"23121","MACHAKOS","MASINGA","99",18,55,73
"23122","MACHAKOS","MASINGA","95-99",83,143,226
"23123","MACHAKOS","MASINGA","100+",33,78,111
"23124","MACHAKOS","MASINGA","Not Stated",NA,NA,NA
"23125","MACHAKOS","MATUNGULU","Total",81145,80407,161552
"23126","MACHAKOS","MATUNGULU","0",1554,1625,3179
"23127","MACHAKOS","MATUNGULU","1",1594,1567,3161
"23128","MACHAKOS","MATUNGULU","2",1613,1601,3214
"23129","MACHAKOS","MATUNGULU","3",1663,1702,3365
"23130","MACHAKOS","MATUNGULU","4",1754,1699,3453
"23131","MACHAKOS","MATUNGULU","0 - 4",8178,8194,16372
"23132","MACHAKOS","MATUNGULU","5",1707,1647,3354
"23133","MACHAKOS","MATUNGULU","6",1668,1639,3307
"23134","MACHAKOS","MATUNGULU","7",1724,1626,3350
"23135","MACHAKOS","MATUNGULU","8",1743,1772,3515
"23136","MACHAKOS","MATUNGULU","9",1968,1876,3844
"23137","MACHAKOS","MATUNGULU","5-9",8810,8560,17370
"23138","MACHAKOS","MATUNGULU","10",1992,1906,3898
"23139","MACHAKOS","MATUNGULU","11",1889,1939,3828
"23140","MACHAKOS","MATUNGULU","12",2079,2017,4096
"23141","MACHAKOS","MATUNGULU","13",2088,2084,4172
"23142","MACHAKOS","MATUNGULU","14",2015,1918,3933
"23143","MACHAKOS","MATUNGULU","10 -14",10063,9864,19927
"23144","MACHAKOS","MATUNGULU","15",1888,1838,3726
"23145","MACHAKOS","MATUNGULU","16",1897,1773,3670
"23146","MACHAKOS","MATUNGULU","17",1941,1808,3749
"23147","MACHAKOS","MATUNGULU","18",1535,1372,2907
"23148","MACHAKOS","MATUNGULU","19",1620,1524,3144
"23149","MACHAKOS","MATUNGULU","15-19",8881,8315,17196
"23150","MACHAKOS","MATUNGULU","20",1520,1379,2899
"23151","MACHAKOS","MATUNGULU","21",1388,1233,2621
"23152","MACHAKOS","MATUNGULU","22",1185,1188,2373
"23153","MACHAKOS","MATUNGULU","23",1387,1300,2687
"23154","MACHAKOS","MATUNGULU","24",1245,1225,2470
"23155","MACHAKOS","MATUNGULU","20-24",6725,6325,13050
"23156","MACHAKOS","MATUNGULU","25",1268,1214,2482
"23157","MACHAKOS","MATUNGULU","26",1087,1096,2183
"23158","MACHAKOS","MATUNGULU","27",1189,1085,2274
"23159","MACHAKOS","MATUNGULU","28",1027,1023,2050
"23160","MACHAKOS","MATUNGULU","29",1201,1187,2388
"23161","MACHAKOS","MATUNGULU","25-29",5772,5605,11377
"23162","MACHAKOS","MATUNGULU","30",1313,1415,2728
"23163","MACHAKOS","MATUNGULU","31",1129,1079,2208
"23164","MACHAKOS","MATUNGULU","32",1266,1347,2613
"23165","MACHAKOS","MATUNGULU","33",1178,1256,2434
"23166","MACHAKOS","MATUNGULU","34",1017,1110,2127
"23167","MACHAKOS","MATUNGULU","30-34",5903,6207,12110
"23168","MACHAKOS","MATUNGULU","35",1272,1377,2649
"23169","MACHAKOS","MATUNGULU","36",1078,1071,2149
"23170","MACHAKOS","MATUNGULU","37",1204,1028,2232
"23171","MACHAKOS","MATUNGULU","38",895,905,1800
"23172","MACHAKOS","MATUNGULU","39",1127,1072,2199
"23173","MACHAKOS","MATUNGULU","35-39",5576,5453,11029
"23174","MACHAKOS","MATUNGULU","40",1189,1124,2313
"23175","MACHAKOS","MATUNGULU","41",1175,1049,2224
"23176","MACHAKOS","MATUNGULU","42",1037,934,1971
"23177","MACHAKOS","MATUNGULU","43",924,931,1855
"23178","MACHAKOS","MATUNGULU","44",794,724,1518
"23179","MACHAKOS","MATUNGULU","40-44",5119,4762,9881
"23180","MACHAKOS","MATUNGULU","45",1057,929,1986
"23181","MACHAKOS","MATUNGULU","46",872,743,1615
"23182","MACHAKOS","MATUNGULU","47",876,758,1634
"23183","MACHAKOS","MATUNGULU","48",597,570,1167
"23184","MACHAKOS","MATUNGULU","49",777,714,1491
"23185","MACHAKOS","MATUNGULU","45-49",4179,3714,7893
"23186","MACHAKOS","MATUNGULU","50",773,784,1557
"23187","MACHAKOS","MATUNGULU","51",640,629,1269
"23188","MACHAKOS","MATUNGULU","52",573,499,1072
"23189","MACHAKOS","MATUNGULU","53",428,414,842
"23190","MACHAKOS","MATUNGULU","54",558,514,1072
"23191","MACHAKOS","MATUNGULU","50-54",2972,2840,5812
"23192","MACHAKOS","MATUNGULU","55",561,543,1104
"23193","MACHAKOS","MATUNGULU","56",672,689,1361
"23194","MACHAKOS","MATUNGULU","57",481,543,1024
"23195","MACHAKOS","MATUNGULU","58",397,397,794
"23196","MACHAKOS","MATUNGULU","59",517,542,1059
"23197","MACHAKOS","MATUNGULU","55-59",2628,2714,5342
"23198","MACHAKOS","MATUNGULU","60",602,666,1268
"23199","MACHAKOS","MATUNGULU","61",537,524,1061
"23200","MACHAKOS","MATUNGULU","62",417,459,876
"23201","MACHAKOS","MATUNGULU","63",418,470,888
"23202","MACHAKOS","MATUNGULU","64",290,363,653
"23203","MACHAKOS","MATUNGULU","60-64",2264,2482,4746
"23204","MACHAKOS","MATUNGULU","65",408,442,850
"23205","MACHAKOS","MATUNGULU","66",282,298,580
"23206","MACHAKOS","MATUNGULU","67",495,563,1058
"23207","MACHAKOS","MATUNGULU","68",179,216,395
"23208","MACHAKOS","MATUNGULU","69",284,315,599
"23209","MACHAKOS","MATUNGULU","65-69",1648,1834,3482
"23210","MACHAKOS","MATUNGULU","70",315,368,683
"23211","MACHAKOS","MATUNGULU","71",267,297,564
"23212","MACHAKOS","MATUNGULU","72",193,201,394
"23213","MACHAKOS","MATUNGULU","73",181,195,376
"23214","MACHAKOS","MATUNGULU","74",132,204,336
"23215","MACHAKOS","MATUNGULU","70-74",1088,1265,2353
"23216","MACHAKOS","MATUNGULU","75",122,177,299
"23217","MACHAKOS","MATUNGULU","76",104,144,248
"23218","MACHAKOS","MATUNGULU","77",142,191,333
"23219","MACHAKOS","MATUNGULU","78",79,103,182
"23220","MACHAKOS","MATUNGULU","79",73,155,228
"23221","MACHAKOS","MATUNGULU","75-79",520,770,1290
"23222","MACHAKOS","MATUNGULU","80",113,232,345
"23223","MACHAKOS","MATUNGULU","81",81,119,200
"23224","MACHAKOS","MATUNGULU","82",83,73,156
"23225","MACHAKOS","MATUNGULU","83",80,110,190
"23226","MACHAKOS","MATUNGULU","84",63,97,160
"23227","MACHAKOS","MATUNGULU","80-84",420,631,1051
"23228","MACHAKOS","MATUNGULU","85",51,82,133
"23229","MACHAKOS","MATUNGULU","86",35,46,81
"23230","MACHAKOS","MATUNGULU","87",44,96,140
"23231","MACHAKOS","MATUNGULU","88",33,40,73
"23232","MACHAKOS","MATUNGULU","89",35,103,138
"23233","MACHAKOS","MATUNGULU","85-89",198,367,565
"23234","MACHAKOS","MATUNGULU","90",27,69,96
"23235","MACHAKOS","MATUNGULU","91",36,105,141
"23236","MACHAKOS","MATUNGULU","92",16,43,59
"23237","MACHAKOS","MATUNGULU","93",17,24,41
"23238","MACHAKOS","MATUNGULU","94",15,50,65
"23239","MACHAKOS","MATUNGULU","90-94",111,291,402
"23240","MACHAKOS","MATUNGULU","95",24,40,64
"23241","MACHAKOS","MATUNGULU","96",9,23,32
"23242","MACHAKOS","MATUNGULU","97",8,11,19
"23243","MACHAKOS","MATUNGULU","98",10,21,31
"23244","MACHAKOS","MATUNGULU","99",8,44,52
"23245","MACHAKOS","MATUNGULU","95-99",59,139,198
"23246","MACHAKOS","MATUNGULU","100+",31,74,105
"23247","MACHAKOS","MATUNGULU","Not Stated",NA,1,1
"23248","MACHAKOS","MWALA","Total",90427,91466,181893
"23249","MACHAKOS","MWALA","0",1540,1536,3076
"23250","MACHAKOS","MWALA","1",1684,1598,3282
"23251","MACHAKOS","MWALA","2",1672,1653,3325
"23252","MACHAKOS","MWALA","3",1772,1776,3548
"23253","MACHAKOS","MWALA","4",1845,1715,3560
"23254","MACHAKOS","MWALA","0 - 4",8513,8278,16791
"23255","MACHAKOS","MWALA","5",1918,1724,3642
"23256","MACHAKOS","MWALA","6",1816,1808,3624
"23257","MACHAKOS","MWALA","7",2011,1861,3872
"23258","MACHAKOS","MWALA","8",2009,1964,3973
"23259","MACHAKOS","MWALA","9",2236,2108,4344
"23260","MACHAKOS","MWALA","5-9",9990,9465,19455
"23261","MACHAKOS","MWALA","10",2231,2146,4377
"23262","MACHAKOS","MWALA","11",2316,2367,4683
"23263","MACHAKOS","MWALA","12",2552,2391,4943
"23264","MACHAKOS","MWALA","13",2442,2320,4762
"23265","MACHAKOS","MWALA","14",2539,2216,4755
"23266","MACHAKOS","MWALA","10 -14",12080,11440,23520
"23267","MACHAKOS","MWALA","15",2488,2417,4905
"23268","MACHAKOS","MWALA","16",2403,2230,4633
"23269","MACHAKOS","MWALA","17",2570,2352,4922
"23270","MACHAKOS","MWALA","18",1959,1664,3623
"23271","MACHAKOS","MWALA","19",2071,1615,3686
"23272","MACHAKOS","MWALA","15-19",11491,10278,21769
"23273","MACHAKOS","MWALA","20",1826,1417,3243
"23274","MACHAKOS","MWALA","21",1569,1293,2862
"23275","MACHAKOS","MWALA","22",1337,1152,2489
"23276","MACHAKOS","MWALA","23",1423,1219,2642
"23277","MACHAKOS","MWALA","24",1247,1082,2329
"23278","MACHAKOS","MWALA","20-24",7402,6163,13565
"23279","MACHAKOS","MWALA","25",1308,1144,2452
"23280","MACHAKOS","MWALA","26",996,991,1987
"23281","MACHAKOS","MWALA","27",1135,1068,2203
"23282","MACHAKOS","MWALA","28",958,969,1927
"23283","MACHAKOS","MWALA","29",1208,1219,2427
"23284","MACHAKOS","MWALA","25-29",5605,5391,10996
"23285","MACHAKOS","MWALA","30",1325,1447,2772
"23286","MACHAKOS","MWALA","31",1042,1089,2131
"23287","MACHAKOS","MWALA","32",1206,1381,2587
"23288","MACHAKOS","MWALA","33",1133,1237,2370
"23289","MACHAKOS","MWALA","34",1045,1078,2123
"23290","MACHAKOS","MWALA","30-34",5751,6232,11983
"23291","MACHAKOS","MWALA","35",1274,1353,2627
"23292","MACHAKOS","MWALA","36",969,1083,2052
"23293","MACHAKOS","MWALA","37",1096,1097,2193
"23294","MACHAKOS","MWALA","38",829,774,1603
"23295","MACHAKOS","MWALA","39",1073,1144,2217
"23296","MACHAKOS","MWALA","35-39",5241,5451,10692
"23297","MACHAKOS","MWALA","40",1022,1110,2132
"23298","MACHAKOS","MWALA","41",1157,1180,2337
"23299","MACHAKOS","MWALA","42",928,1037,1965
"23300","MACHAKOS","MWALA","43",910,1205,2115
"23301","MACHAKOS","MWALA","44",789,915,1704
"23302","MACHAKOS","MWALA","40-44",4806,5447,10253
"23303","MACHAKOS","MWALA","45",1077,1097,2174
"23304","MACHAKOS","MWALA","46",799,820,1619
"23305","MACHAKOS","MWALA","47",867,834,1701
"23306","MACHAKOS","MWALA","48",614,663,1277
"23307","MACHAKOS","MWALA","49",845,930,1775
"23308","MACHAKOS","MWALA","45-49",4202,4344,8546
"23309","MACHAKOS","MWALA","50",829,1016,1845
"23310","MACHAKOS","MWALA","51",752,826,1578
"23311","MACHAKOS","MWALA","52",552,659,1211
"23312","MACHAKOS","MWALA","53",467,571,1038
"23313","MACHAKOS","MWALA","54",591,664,1255
"23314","MACHAKOS","MWALA","50-54",3191,3736,6927
"23315","MACHAKOS","MWALA","55",656,686,1342
"23316","MACHAKOS","MWALA","56",716,808,1524
"23317","MACHAKOS","MWALA","57",603,809,1412
"23318","MACHAKOS","MWALA","58",486,528,1014
"23319","MACHAKOS","MWALA","59",638,724,1362
"23320","MACHAKOS","MWALA","55-59",3099,3555,6654
"23321","MACHAKOS","MWALA","60",778,902,1680
"23322","MACHAKOS","MWALA","61",724,685,1409
"23323","MACHAKOS","MWALA","62",556,509,1065
"23324","MACHAKOS","MWALA","63",539,605,1144
"23325","MACHAKOS","MWALA","64",376,404,780
"23326","MACHAKOS","MWALA","60-64",2973,3105,6078
"23327","MACHAKOS","MWALA","65",540,610,1150
"23328","MACHAKOS","MWALA","66",331,402,733
"23329","MACHAKOS","MWALA","67",643,724,1367
"23330","MACHAKOS","MWALA","68",230,298,528
"23331","MACHAKOS","MWALA","69",387,527,914
"23332","MACHAKOS","MWALA","65-69",2131,2561,4692
"23333","MACHAKOS","MWALA","70",506,604,1110
"23334","MACHAKOS","MWALA","71",361,430,791
"23335","MACHAKOS","MWALA","72",271,279,550
"23336","MACHAKOS","MWALA","73",262,289,551
"23337","MACHAKOS","MWALA","74",221,328,549
"23338","MACHAKOS","MWALA","70-74",1621,1930,3551
"23339","MACHAKOS","MWALA","75",195,277,472
"23340","MACHAKOS","MWALA","76",127,285,412
"23341","MACHAKOS","MWALA","77",179,331,510
"23342","MACHAKOS","MWALA","78",119,150,269
"23343","MACHAKOS","MWALA","79",127,350,477
"23344","MACHAKOS","MWALA","75-79",747,1393,2140
"23345","MACHAKOS","MWALA","80",220,365,585
"23346","MACHAKOS","MWALA","81",136,193,329
"23347","MACHAKOS","MWALA","82",116,107,223
"23348","MACHAKOS","MWALA","83",133,163,296
"23349","MACHAKOS","MWALA","84",86,185,271
"23350","MACHAKOS","MWALA","80-84",691,1013,1704
"23351","MACHAKOS","MWALA","85",81,164,245
"23352","MACHAKOS","MWALA","86",55,57,112
"23353","MACHAKOS","MWALA","87",82,138,220
"23354","MACHAKOS","MWALA","88",42,48,90
"23355","MACHAKOS","MWALA","89",91,272,363
"23356","MACHAKOS","MWALA","85-89",351,679,1030
"23357","MACHAKOS","MWALA","90",90,183,273
"23358","MACHAKOS","MWALA","91",119,210,329
"23359","MACHAKOS","MWALA","92",44,75,119
"23360","MACHAKOS","MWALA","93",28,60,88
"23361","MACHAKOS","MWALA","94",28,65,93
"23362","MACHAKOS","MWALA","90-94",309,593,902
"23363","MACHAKOS","MWALA","95",55,98,153
"23364","MACHAKOS","MWALA","96",27,39,66
"23365","MACHAKOS","MWALA","97",32,37,69
"23366","MACHAKOS","MWALA","98",16,40,56
"23367","MACHAKOS","MWALA","99",31,72,103
"23368","MACHAKOS","MWALA","95-99",161,286,447
"23369","MACHAKOS","MWALA","100+",70,126,196
"23370","MACHAKOS","MWALA","Not Stated",2,NA,2
"23371","MACHAKOS","YATTA","Total",85437,87144,172581
"23372","MACHAKOS","YATTA","0",1610,1696,3306
"23373","MACHAKOS","YATTA","1",1767,1686,3453
"23374","MACHAKOS","YATTA","2",1676,1783,3459
"23375","MACHAKOS","YATTA","3",1864,1798,3662
"23376","MACHAKOS","YATTA","4",1884,1809,3693
"23377","MACHAKOS","YATTA","0 - 4",8801,8772,17573
"23378","MACHAKOS","YATTA","5",1904,1810,3714
"23379","MACHAKOS","YATTA","6",1832,1825,3657
"23380","MACHAKOS","YATTA","7",1860,1866,3726
"23381","MACHAKOS","YATTA","8",1929,1982,3911
"23382","MACHAKOS","YATTA","9",2148,1965,4113
"23383","MACHAKOS","YATTA","5-9",9673,9448,19121
"23384","MACHAKOS","YATTA","10",2187,2164,4351
"23385","MACHAKOS","YATTA","11",2214,2370,4584
"23386","MACHAKOS","YATTA","12",2360,2321,4681
"23387","MACHAKOS","YATTA","13",2248,2285,4533
"23388","MACHAKOS","YATTA","14",2371,2235,4606
"23389","MACHAKOS","YATTA","10 -14",11380,11375,22755
"23390","MACHAKOS","YATTA","15",2272,2281,4553
"23391","MACHAKOS","YATTA","16",2291,2275,4566
"23392","MACHAKOS","YATTA","17",2276,2077,4353
"23393","MACHAKOS","YATTA","18",1804,1631,3435
"23394","MACHAKOS","YATTA","19",1951,1598,3549
"23395","MACHAKOS","YATTA","15-19",10594,9862,20456
"23396","MACHAKOS","YATTA","20",1868,1740,3608
"23397","MACHAKOS","YATTA","21",1667,1511,3178
"23398","MACHAKOS","YATTA","22",1571,1415,2986
"23399","MACHAKOS","YATTA","23",1740,1541,3281
"23400","MACHAKOS","YATTA","24",1423,1323,2746
"23401","MACHAKOS","YATTA","20-24",8269,7530,15799
"23402","MACHAKOS","YATTA","25",1388,1264,2652
"23403","MACHAKOS","YATTA","26",1042,1146,2188
"23404","MACHAKOS","YATTA","27",1146,1174,2320
"23405","MACHAKOS","YATTA","28",1002,1053,2055
"23406","MACHAKOS","YATTA","29",1217,1333,2550
"23407","MACHAKOS","YATTA","25-29",5795,5970,11765
"23408","MACHAKOS","YATTA","30",1343,1488,2831
"23409","MACHAKOS","YATTA","31",1053,1095,2148
"23410","MACHAKOS","YATTA","32",1208,1378,2586
"23411","MACHAKOS","YATTA","33",1076,1258,2334
"23412","MACHAKOS","YATTA","34",1003,1077,2080
"23413","MACHAKOS","YATTA","30-34",5683,6296,11979
"23414","MACHAKOS","YATTA","35",1217,1359,2576
"23415","MACHAKOS","YATTA","36",943,1022,1965
"23416","MACHAKOS","YATTA","37",1082,1004,2086
"23417","MACHAKOS","YATTA","38",756,754,1510
"23418","MACHAKOS","YATTA","39",1047,1066,2113
"23419","MACHAKOS","YATTA","35-39",5045,5205,10250
"23420","MACHAKOS","YATTA","40",1050,1019,2069
"23421","MACHAKOS","YATTA","41",1088,1046,2134
"23422","MACHAKOS","YATTA","42",913,866,1779
"23423","MACHAKOS","YATTA","43",779,891,1670
"23424","MACHAKOS","YATTA","44",696,701,1397
"23425","MACHAKOS","YATTA","40-44",4526,4523,9049
"23426","MACHAKOS","YATTA","45",959,882,1841
"23427","MACHAKOS","YATTA","46",750,721,1471
"23428","MACHAKOS","YATTA","47",765,711,1476
"23429","MACHAKOS","YATTA","48",509,582,1091
"23430","MACHAKOS","YATTA","49",752,750,1502
"23431","MACHAKOS","YATTA","45-49",3735,3646,7381
"23432","MACHAKOS","YATTA","50",699,768,1467
"23433","MACHAKOS","YATTA","51",579,658,1237
"23434","MACHAKOS","YATTA","52",481,515,996
"23435","MACHAKOS","YATTA","53",386,392,778
"23436","MACHAKOS","YATTA","54",466,492,958
"23437","MACHAKOS","YATTA","50-54",2611,2825,5436
"23438","MACHAKOS","YATTA","55",510,500,1010
"23439","MACHAKOS","YATTA","56",604,702,1306
"23440","MACHAKOS","YATTA","57",469,550,1019
"23441","MACHAKOS","YATTA","58",346,422,768
"23442","MACHAKOS","YATTA","59",547,585,1132
"23443","MACHAKOS","YATTA","55-59",2476,2759,5235
"23444","MACHAKOS","YATTA","60",637,671,1308
"23445","MACHAKOS","YATTA","61",536,538,1074
"23446","MACHAKOS","YATTA","62",426,446,872
"23447","MACHAKOS","YATTA","63",452,461,913
"23448","MACHAKOS","YATTA","64",295,293,588
"23449","MACHAKOS","YATTA","60-64",2346,2409,4755
"23450","MACHAKOS","YATTA","65",390,479,869
"23451","MACHAKOS","YATTA","66",261,323,584
"23452","MACHAKOS","YATTA","67",550,692,1242
"23453","MACHAKOS","YATTA","68",184,232,416
"23454","MACHAKOS","YATTA","69",288,461,749
"23455","MACHAKOS","YATTA","65-69",1673,2187,3860
"23456","MACHAKOS","YATTA","70",367,513,880
"23457","MACHAKOS","YATTA","71",270,382,652
"23458","MACHAKOS","YATTA","72",189,194,383
"23459","MACHAKOS","YATTA","73",163,240,403
"23460","MACHAKOS","YATTA","74",183,245,428
"23461","MACHAKOS","YATTA","70-74",1172,1574,2746
"23462","MACHAKOS","YATTA","75",137,199,336
"23463","MACHAKOS","YATTA","76",92,177,269
"23464","MACHAKOS","YATTA","77",147,246,393
"23465","MACHAKOS","YATTA","78",102,85,187
"23466","MACHAKOS","YATTA","79",99,253,352
"23467","MACHAKOS","YATTA","75-79",577,960,1537
"23468","MACHAKOS","YATTA","80",148,267,415
"23469","MACHAKOS","YATTA","81",86,143,229
"23470","MACHAKOS","YATTA","82",89,99,188
"23471","MACHAKOS","YATTA","83",98,131,229
"23472","MACHAKOS","YATTA","84",82,135,217
"23473","MACHAKOS","YATTA","80-84",503,775,1278
"23474","MACHAKOS","YATTA","85",78,88,166
"23475","MACHAKOS","YATTA","86",47,38,85
"23476","MACHAKOS","YATTA","87",59,104,163
"23477","MACHAKOS","YATTA","88",32,36,68
"23478","MACHAKOS","YATTA","89",57,163,220
"23479","MACHAKOS","YATTA","85-89",273,429,702
"23480","MACHAKOS","YATTA","90",45,116,161
"23481","MACHAKOS","YATTA","91",62,123,185
"23482","MACHAKOS","YATTA","92",29,39,68
"23483","MACHAKOS","YATTA","93",18,45,63
"23484","MACHAKOS","YATTA","94",18,30,48
"23485","MACHAKOS","YATTA","90-94",172,353,525
"23486","MACHAKOS","YATTA","95",29,51,80
"23487","MACHAKOS","YATTA","96",19,17,36
"23488","MACHAKOS","YATTA","97",16,25,41
"23489","MACHAKOS","YATTA","98",11,13,24
"23490","MACHAKOS","YATTA","99",17,47,64
"23491","MACHAKOS","YATTA","95-99",92,153,245
"23492","MACHAKOS","YATTA","100+",38,93,131
"23493","MACHAKOS","YATTA","Not Stated",3,NA,3
"23494","MAKUENI","ALL","Total",489691,497942,987633
"23495","MAKUENI","ALL","0",8826,8890,17716
"23496","MAKUENI","ALL","1",9757,9531,19288
"23497","MAKUENI","ALL","2",9579,9516,19095
"23498","MAKUENI","ALL","3",10166,9706,19872
"23499","MAKUENI","ALL","4",10405,10049,20454
"23500","MAKUENI","ALL","0 - 4",48733,47692,96425
"23501","MAKUENI","ALL","5",10825,10326,21151
"23502","MAKUENI","ALL","6",10491,10290,20781
"23503","MAKUENI","ALL","7",11042,10716,21758
"23504","MAKUENI","ALL","8",11657,11316,22973
"23505","MAKUENI","ALL","9",12544,12195,24739
"23506","MAKUENI","ALL","5-9",56559,54843,111402
"23507","MAKUENI","ALL","10",13093,12890,25983
"23508","MAKUENI","ALL","11",13252,13439,26691
"23509","MAKUENI","ALL","12",14555,13874,28429
"23510","MAKUENI","ALL","13",14056,13982,28038
"23511","MAKUENI","ALL","14",13988,13264,27252
"23512","MAKUENI","ALL","10 -14",68944,67449,136393
"23513","MAKUENI","ALL","15",14111,13563,27674
"23514","MAKUENI","ALL","16",13345,12993,26338
"23515","MAKUENI","ALL","17",14065,12908,26973
"23516","MAKUENI","ALL","18",10939,9672,20611
"23517","MAKUENI","ALL","19",11472,9791,21263
"23518","MAKUENI","ALL","15-19",63932,58927,122859
"23519","MAKUENI","ALL","20",10050,8849,18899
"23520","MAKUENI","ALL","21",8561,7912,16473
"23521","MAKUENI","ALL","22",7515,7016,14531
"23522","MAKUENI","ALL","23",7877,7830,15707
"23523","MAKUENI","ALL","24",7255,6910,14165
"23524","MAKUENI","ALL","20-24",41258,38517,79775
"23525","MAKUENI","ALL","25",7787,7452,15239
"23526","MAKUENI","ALL","26",6349,6686,13035
"23527","MAKUENI","ALL","27",6706,6489,13195
"23528","MAKUENI","ALL","28",5412,5611,11023
"23529","MAKUENI","ALL","29",6583,6809,13392
"23530","MAKUENI","ALL","25-29",32837,33047,65884
"23531","MAKUENI","ALL","30",7524,8235,15759
"23532","MAKUENI","ALL","31",5764,6059,11823
"23533","MAKUENI","ALL","32",6750,7396,14146
"23534","MAKUENI","ALL","33",6283,6947,13230
"23535","MAKUENI","ALL","34",5360,5941,11301
"23536","MAKUENI","ALL","30-34",31681,34578,66259
"23537","MAKUENI","ALL","35",7375,7598,14973
"23538","MAKUENI","ALL","36",5225,5393,10618
"23539","MAKUENI","ALL","37",5834,5585,11419
"23540","MAKUENI","ALL","38",4069,4257,8326
"23541","MAKUENI","ALL","39",5528,5663,11191
"23542","MAKUENI","ALL","35-39",28031,28496,56527
"23543","MAKUENI","ALL","40",5689,5649,11338
"23544","MAKUENI","ALL","41",5690,5431,11121
"23545","MAKUENI","ALL","42",4868,4621,9489
"23546","MAKUENI","ALL","43",4366,4874,9240
"23547","MAKUENI","ALL","44",4144,4596,8740
"23548","MAKUENI","ALL","40-44",24757,25171,49928
"23549","MAKUENI","ALL","45",6093,6594,12687
"23550","MAKUENI","ALL","46",4393,4756,9149
"23551","MAKUENI","ALL","47",4515,4825,9340
"23552","MAKUENI","ALL","48",3168,3294,6462
"23553","MAKUENI","ALL","49",4377,4840,9217
"23554","MAKUENI","ALL","45-49",22546,24309,46855
"23555","MAKUENI","ALL","50",4139,4404,8543
"23556","MAKUENI","ALL","51",3629,3687,7316
"23557","MAKUENI","ALL","52",2856,2949,5805
"23558","MAKUENI","ALL","53",2440,2473,4913
"23559","MAKUENI","ALL","54",3064,2919,5983
"23560","MAKUENI","ALL","50-54",16128,16432,32560
"23561","MAKUENI","ALL","55",3018,2967,5985
"23562","MAKUENI","ALL","56",2974,3354,6328
"23563","MAKUENI","ALL","57",2783,3497,6280
"23564","MAKUENI","ALL","58",2025,2288,4313
"23565","MAKUENI","ALL","59",2976,3361,6337
"23566","MAKUENI","ALL","55-59",13776,15467,29243
"23567","MAKUENI","ALL","60",3328,3843,7171
"23568","MAKUENI","ALL","61",2863,3212,6075
"23569","MAKUENI","ALL","62",2257,2491,4748
"23570","MAKUENI","ALL","63",2436,2766,5202
"23571","MAKUENI","ALL","64",1721,1907,3628
"23572","MAKUENI","ALL","60-64",12605,14219,26824
"23573","MAKUENI","ALL","65",2555,3182,5737
"23574","MAKUENI","ALL","66",1626,1777,3403
"23575","MAKUENI","ALL","67",2982,3732,6714
"23576","MAKUENI","ALL","68",1214,1554,2768
"23577","MAKUENI","ALL","69",1899,2478,4377
"23578","MAKUENI","ALL","65-69",10276,12723,22999
"23579","MAKUENI","ALL","70",2223,3049,5272
"23580","MAKUENI","ALL","71",1695,2137,3832
"23581","MAKUENI","ALL","72",1270,1230,2500
"23582","MAKUENI","ALL","73",1186,1475,2661
"23583","MAKUENI","ALL","74",1104,1660,2764
"23584","MAKUENI","ALL","70-74",7478,9551,17029
"23585","MAKUENI","ALL","75",856,1280,2136
"23586","MAKUENI","ALL","76",630,861,1491
"23587","MAKUENI","ALL","77",922,1358,2280
"23588","MAKUENI","ALL","78",580,667,1247
"23589","MAKUENI","ALL","79",692,1525,2217
"23590","MAKUENI","ALL","75-79",3680,5691,9371
"23591","MAKUENI","ALL","80",927,1632,2559
"23592","MAKUENI","ALL","81",548,781,1329
"23593","MAKUENI","ALL","82",466,514,980
"23594","MAKUENI","ALL","83",579,703,1282
"23595","MAKUENI","ALL","84",454,803,1257
"23596","MAKUENI","ALL","80-84",2974,4433,7407
"23597","MAKUENI","ALL","85",368,517,885
"23598","MAKUENI","ALL","86",248,277,525
"23599","MAKUENI","ALL","87",352,542,894
"23600","MAKUENI","ALL","88",174,213,387
"23601","MAKUENI","ALL","89",409,1065,1474
"23602","MAKUENI","ALL","85-89",1551,2614,4165
"23603","MAKUENI","ALL","90",311,772,1083
"23604","MAKUENI","ALL","91",288,752,1040
"23605","MAKUENI","ALL","92",204,320,524
"23606","MAKUENI","ALL","93",116,294,410
"23607","MAKUENI","ALL","94",111,240,351
"23608","MAKUENI","ALL","90-94",1030,2378,3408
"23609","MAKUENI","ALL","95",196,285,481
"23610","MAKUENI","ALL","96",70,96,166
"23611","MAKUENI","ALL","97",113,108,221
"23612","MAKUENI","ALL","98",75,95,170
"23613","MAKUENI","ALL","99",149,272,421
"23614","MAKUENI","ALL","95-99",603,856,1459
"23615","MAKUENI","ALL","100+",308,545,853
"23616","MAKUENI","ALL","Not Stated",4,4,8
"23617","MAKUENI","KATHONZWENI","Total",39335,40442,79777
"23618","MAKUENI","KATHONZWENI","0",696,717,1413
"23619","MAKUENI","KATHONZWENI","1",767,756,1523
"23620","MAKUENI","KATHONZWENI","2",716,745,1461
"23621","MAKUENI","KATHONZWENI","3",814,745,1559
"23622","MAKUENI","KATHONZWENI","4",799,791,1590
"23623","MAKUENI","KATHONZWENI","0 - 4",3792,3754,7546
"23624","MAKUENI","KATHONZWENI","5",834,829,1663
"23625","MAKUENI","KATHONZWENI","6",800,783,1583
"23626","MAKUENI","KATHONZWENI","7",906,863,1769
"23627","MAKUENI","KATHONZWENI","8",907,929,1836
"23628","MAKUENI","KATHONZWENI","9",1030,991,2021
"23629","MAKUENI","KATHONZWENI","5-9",4477,4395,8872
"23630","MAKUENI","KATHONZWENI","10",1054,1008,2062
"23631","MAKUENI","KATHONZWENI","11",1150,1171,2321
"23632","MAKUENI","KATHONZWENI","12",1211,1167,2378
"23633","MAKUENI","KATHONZWENI","13",1227,1107,2334
"23634","MAKUENI","KATHONZWENI","14",1141,1114,2255
"23635","MAKUENI","KATHONZWENI","10 -14",5783,5567,11350
"23636","MAKUENI","KATHONZWENI","15",1262,1163,2425
"23637","MAKUENI","KATHONZWENI","16",1212,1161,2373
"23638","MAKUENI","KATHONZWENI","17",1252,1186,2438
"23639","MAKUENI","KATHONZWENI","18",1039,876,1915
"23640","MAKUENI","KATHONZWENI","19",966,800,1766
"23641","MAKUENI","KATHONZWENI","15-19",5731,5186,10917
"23642","MAKUENI","KATHONZWENI","20",869,754,1623
"23643","MAKUENI","KATHONZWENI","21",642,609,1251
"23644","MAKUENI","KATHONZWENI","22",573,490,1063
"23645","MAKUENI","KATHONZWENI","23",590,600,1190
"23646","MAKUENI","KATHONZWENI","24",570,493,1063
"23647","MAKUENI","KATHONZWENI","20-24",3244,2946,6190
"23648","MAKUENI","KATHONZWENI","25",603,566,1169
"23649","MAKUENI","KATHONZWENI","26",446,481,927
"23650","MAKUENI","KATHONZWENI","27",502,505,1007
"23651","MAKUENI","KATHONZWENI","28",373,390,763
"23652","MAKUENI","KATHONZWENI","29",522,488,1010
"23653","MAKUENI","KATHONZWENI","25-29",2446,2430,4876
"23654","MAKUENI","KATHONZWENI","30",566,583,1149
"23655","MAKUENI","KATHONZWENI","31",392,466,858
"23656","MAKUENI","KATHONZWENI","32",480,563,1043
"23657","MAKUENI","KATHONZWENI","33",418,571,989
"23658","MAKUENI","KATHONZWENI","34",386,446,832
"23659","MAKUENI","KATHONZWENI","30-34",2242,2629,4871
"23660","MAKUENI","KATHONZWENI","35",526,632,1158
"23661","MAKUENI","KATHONZWENI","36",383,418,801
"23662","MAKUENI","KATHONZWENI","37",454,436,890
"23663","MAKUENI","KATHONZWENI","38",308,341,649
"23664","MAKUENI","KATHONZWENI","39",419,518,937
"23665","MAKUENI","KATHONZWENI","35-39",2090,2345,4435
"23666","MAKUENI","KATHONZWENI","40",441,462,903
"23667","MAKUENI","KATHONZWENI","41",412,497,909
"23668","MAKUENI","KATHONZWENI","42",325,360,685
"23669","MAKUENI","KATHONZWENI","43",313,395,708
"23670","MAKUENI","KATHONZWENI","44",318,390,708
"23671","MAKUENI","KATHONZWENI","40-44",1809,2104,3913
"23672","MAKUENI","KATHONZWENI","45",541,584,1125
"23673","MAKUENI","KATHONZWENI","46",353,387,740
"23674","MAKUENI","KATHONZWENI","47",365,362,727
"23675","MAKUENI","KATHONZWENI","48",258,263,521
"23676","MAKUENI","KATHONZWENI","49",354,424,778
"23677","MAKUENI","KATHONZWENI","45-49",1871,2020,3891
"23678","MAKUENI","KATHONZWENI","50",353,369,722
"23679","MAKUENI","KATHONZWENI","51",330,319,649
"23680","MAKUENI","KATHONZWENI","52",221,264,485
"23681","MAKUENI","KATHONZWENI","53",211,195,406
"23682","MAKUENI","KATHONZWENI","54",218,241,459
"23683","MAKUENI","KATHONZWENI","50-54",1333,1388,2721
"23684","MAKUENI","KATHONZWENI","55",251,265,516
"23685","MAKUENI","KATHONZWENI","56",247,248,495
"23686","MAKUENI","KATHONZWENI","57",202,259,461
"23687","MAKUENI","KATHONZWENI","58",137,175,312
"23688","MAKUENI","KATHONZWENI","59",218,227,445
"23689","MAKUENI","KATHONZWENI","55-59",1055,1174,2229
"23690","MAKUENI","KATHONZWENI","60",259,302,561
"23691","MAKUENI","KATHONZWENI","61",203,240,443
"23692","MAKUENI","KATHONZWENI","62",185,188,373
"23693","MAKUENI","KATHONZWENI","63",166,176,342
"23694","MAKUENI","KATHONZWENI","64",120,134,254
"23695","MAKUENI","KATHONZWENI","60-64",933,1040,1973
"23696","MAKUENI","KATHONZWENI","65",191,245,436
"23697","MAKUENI","KATHONZWENI","66",99,133,232
"23698","MAKUENI","KATHONZWENI","67",233,356,589
"23699","MAKUENI","KATHONZWENI","68",117,141,258
"23700","MAKUENI","KATHONZWENI","69",124,218,342
"23701","MAKUENI","KATHONZWENI","65-69",764,1093,1857
"23702","MAKUENI","KATHONZWENI","70",197,279,476
"23703","MAKUENI","KATHONZWENI","71",133,208,341
"23704","MAKUENI","KATHONZWENI","72",120,110,230
"23705","MAKUENI","KATHONZWENI","73",106,133,239
"23706","MAKUENI","KATHONZWENI","74",118,172,290
"23707","MAKUENI","KATHONZWENI","70-74",674,902,1576
"23708","MAKUENI","KATHONZWENI","75",97,122,219
"23709","MAKUENI","KATHONZWENI","76",68,81,149
"23710","MAKUENI","KATHONZWENI","77",100,133,233
"23711","MAKUENI","KATHONZWENI","78",65,64,129
"23712","MAKUENI","KATHONZWENI","79",68,121,189
"23713","MAKUENI","KATHONZWENI","75-79",398,521,919
"23714","MAKUENI","KATHONZWENI","80",109,169,278
"23715","MAKUENI","KATHONZWENI","81",58,53,111
"23716","MAKUENI","KATHONZWENI","82",45,44,89
"23717","MAKUENI","KATHONZWENI","83",54,67,121
"23718","MAKUENI","KATHONZWENI","84",41,67,108
"23719","MAKUENI","KATHONZWENI","80-84",307,400,707
"23720","MAKUENI","KATHONZWENI","85",43,39,82
"23721","MAKUENI","KATHONZWENI","86",24,22,46
"23722","MAKUENI","KATHONZWENI","87",38,37,75
"23723","MAKUENI","KATHONZWENI","88",12,15,27
"23724","MAKUENI","KATHONZWENI","89",47,66,113
"23725","MAKUENI","KATHONZWENI","85-89",164,179,343
"23726","MAKUENI","KATHONZWENI","90",52,77,129
"23727","MAKUENI","KATHONZWENI","91",40,77,117
"23728","MAKUENI","KATHONZWENI","92",19,24,43
"23729","MAKUENI","KATHONZWENI","93",16,41,57
"23730","MAKUENI","KATHONZWENI","94",8,21,29
"23731","MAKUENI","KATHONZWENI","90-94",135,240,375
"23732","MAKUENI","KATHONZWENI","95",14,22,36
"23733","MAKUENI","KATHONZWENI","96",3,4,7
"23734","MAKUENI","KATHONZWENI","97",11,13,24
"23735","MAKUENI","KATHONZWENI","98",6,10,16
"23736","MAKUENI","KATHONZWENI","99",19,22,41
"23737","MAKUENI","KATHONZWENI","95-99",53,71,124
"23738","MAKUENI","KATHONZWENI","100+",34,58,92
"23739","MAKUENI","KATHONZWENI","Not Stated",NA,NA,NA
"23740","MAKUENI","KIBWEZI","Total",98477,98517,196994
"23741","MAKUENI","KIBWEZI","0",1774,1790,3564
"23742","MAKUENI","KIBWEZI","1",2025,1870,3895
"23743","MAKUENI","KIBWEZI","2",2021,1888,3909
"23744","MAKUENI","KIBWEZI","3",2102,1935,4037
"23745","MAKUENI","KIBWEZI","4",2179,2180,4359
"23746","MAKUENI","KIBWEZI","0 - 4",10101,9663,19764
"23747","MAKUENI","KIBWEZI","5",2309,2254,4563
"23748","MAKUENI","KIBWEZI","6",2141,2228,4369
"23749","MAKUENI","KIBWEZI","7",2354,2277,4631
"23750","MAKUENI","KIBWEZI","8",2516,2391,4907
"23751","MAKUENI","KIBWEZI","9",2689,2610,5299
"23752","MAKUENI","KIBWEZI","5-9",12009,11760,23769
"23753","MAKUENI","KIBWEZI","10",2815,2823,5638
"23754","MAKUENI","KIBWEZI","11",2828,2850,5678
"23755","MAKUENI","KIBWEZI","12",3090,2855,5945
"23756","MAKUENI","KIBWEZI","13",2934,2930,5864
"23757","MAKUENI","KIBWEZI","14",3092,2757,5849
"23758","MAKUENI","KIBWEZI","10 -14",14759,14215,28974
"23759","MAKUENI","KIBWEZI","15",2998,2928,5926
"23760","MAKUENI","KIBWEZI","16",2816,2726,5542
"23761","MAKUENI","KIBWEZI","17",2982,2687,5669
"23762","MAKUENI","KIBWEZI","18",2294,2007,4301
"23763","MAKUENI","KIBWEZI","19",2361,2002,4363
"23764","MAKUENI","KIBWEZI","15-19",13451,12350,25801
"23765","MAKUENI","KIBWEZI","20",1897,1696,3593
"23766","MAKUENI","KIBWEZI","21",1611,1527,3138
"23767","MAKUENI","KIBWEZI","22",1422,1413,2835
"23768","MAKUENI","KIBWEZI","23",1478,1526,3004
"23769","MAKUENI","KIBWEZI","24",1279,1337,2616
"23770","MAKUENI","KIBWEZI","20-24",7687,7499,15186
"23771","MAKUENI","KIBWEZI","25",1484,1443,2927
"23772","MAKUENI","KIBWEZI","26",1230,1273,2503
"23773","MAKUENI","KIBWEZI","27",1332,1306,2638
"23774","MAKUENI","KIBWEZI","28",1037,1143,2180
"23775","MAKUENI","KIBWEZI","29",1304,1364,2668
"23776","MAKUENI","KIBWEZI","25-29",6387,6529,12916
"23777","MAKUENI","KIBWEZI","30",1511,1605,3116
"23778","MAKUENI","KIBWEZI","31",1157,1188,2345
"23779","MAKUENI","KIBWEZI","32",1361,1526,2887
"23780","MAKUENI","KIBWEZI","33",1185,1354,2539
"23781","MAKUENI","KIBWEZI","34",1087,1255,2342
"23782","MAKUENI","KIBWEZI","30-34",6301,6928,13229
"23783","MAKUENI","KIBWEZI","35",1481,1462,2943
"23784","MAKUENI","KIBWEZI","36",978,990,1968
"23785","MAKUENI","KIBWEZI","37",1129,1065,2194
"23786","MAKUENI","KIBWEZI","38",792,755,1547
"23787","MAKUENI","KIBWEZI","39",1080,1050,2130
"23788","MAKUENI","KIBWEZI","35-39",5460,5322,10782
"23789","MAKUENI","KIBWEZI","40",1101,1078,2179
"23790","MAKUENI","KIBWEZI","41",1166,1071,2237
"23791","MAKUENI","KIBWEZI","42",1003,857,1860
"23792","MAKUENI","KIBWEZI","43",826,879,1705
"23793","MAKUENI","KIBWEZI","44",836,899,1735
"23794","MAKUENI","KIBWEZI","40-44",4932,4784,9716
"23795","MAKUENI","KIBWEZI","45",1195,1283,2478
"23796","MAKUENI","KIBWEZI","46",929,854,1783
"23797","MAKUENI","KIBWEZI","47",924,894,1818
"23798","MAKUENI","KIBWEZI","48",620,591,1211
"23799","MAKUENI","KIBWEZI","49",880,946,1826
"23800","MAKUENI","KIBWEZI","45-49",4548,4568,9116
"23801","MAKUENI","KIBWEZI","50",806,838,1644
"23802","MAKUENI","KIBWEZI","51",696,622,1318
"23803","MAKUENI","KIBWEZI","52",574,525,1099
"23804","MAKUENI","KIBWEZI","53",455,410,865
"23805","MAKUENI","KIBWEZI","54",565,532,1097
"23806","MAKUENI","KIBWEZI","50-54",3096,2927,6023
"23807","MAKUENI","KIBWEZI","55",525,517,1042
"23808","MAKUENI","KIBWEZI","56",580,644,1224
"23809","MAKUENI","KIBWEZI","57",459,577,1036
"23810","MAKUENI","KIBWEZI","58",359,396,755
"23811","MAKUENI","KIBWEZI","59",506,621,1127
"23812","MAKUENI","KIBWEZI","55-59",2429,2755,5184
"23813","MAKUENI","KIBWEZI","60",612,672,1284
"23814","MAKUENI","KIBWEZI","61",483,618,1101
"23815","MAKUENI","KIBWEZI","62",386,448,834
"23816","MAKUENI","KIBWEZI","63",413,546,959
"23817","MAKUENI","KIBWEZI","64",320,369,689
"23818","MAKUENI","KIBWEZI","60-64",2214,2653,4867
"23819","MAKUENI","KIBWEZI","65",450,595,1045
"23820","MAKUENI","KIBWEZI","66",334,335,669
"23821","MAKUENI","KIBWEZI","67",577,744,1321
"23822","MAKUENI","KIBWEZI","68",236,276,512
"23823","MAKUENI","KIBWEZI","69",350,432,782
"23824","MAKUENI","KIBWEZI","65-69",1947,2382,4329
"23825","MAKUENI","KIBWEZI","70",409,557,966
"23826","MAKUENI","KIBWEZI","71",314,378,692
"23827","MAKUENI","KIBWEZI","72",245,228,473
"23828","MAKUENI","KIBWEZI","73",234,271,505
"23829","MAKUENI","KIBWEZI","74",190,290,480
"23830","MAKUENI","KIBWEZI","70-74",1392,1724,3116
"23831","MAKUENI","KIBWEZI","75",172,184,356
"23832","MAKUENI","KIBWEZI","76",125,146,271
"23833","MAKUENI","KIBWEZI","77",176,236,412
"23834","MAKUENI","KIBWEZI","78",101,112,213
"23835","MAKUENI","KIBWEZI","79",119,220,339
"23836","MAKUENI","KIBWEZI","75-79",693,898,1591
"23837","MAKUENI","KIBWEZI","80",178,251,429
"23838","MAKUENI","KIBWEZI","81",90,109,199
"23839","MAKUENI","KIBWEZI","82",86,68,154
"23840","MAKUENI","KIBWEZI","83",105,102,207
"23841","MAKUENI","KIBWEZI","84",95,119,214
"23842","MAKUENI","KIBWEZI","80-84",554,649,1203
"23843","MAKUENI","KIBWEZI","85",65,77,142
"23844","MAKUENI","KIBWEZI","86",36,46,82
"23845","MAKUENI","KIBWEZI","87",66,83,149
"23846","MAKUENI","KIBWEZI","88",39,31,70
"23847","MAKUENI","KIBWEZI","89",58,166,224
"23848","MAKUENI","KIBWEZI","85-89",264,403,667
"23849","MAKUENI","KIBWEZI","90",36,98,134
"23850","MAKUENI","KIBWEZI","91",40,96,136
"23851","MAKUENI","KIBWEZI","92",19,39,58
"23852","MAKUENI","KIBWEZI","93",18,41,59
"23853","MAKUENI","KIBWEZI","94",14,28,42
"23854","MAKUENI","KIBWEZI","90-94",127,302,429
"23855","MAKUENI","KIBWEZI","95",39,34,73
"23856","MAKUENI","KIBWEZI","96",10,19,29
"23857","MAKUENI","KIBWEZI","97",13,17,30
"23858","MAKUENI","KIBWEZI","98",10,5,15
"23859","MAKUENI","KIBWEZI","99",21,36,57
"23860","MAKUENI","KIBWEZI","95-99",93,111,204
"23861","MAKUENI","KIBWEZI","100+",33,93,126
"23862","MAKUENI","KIBWEZI","Not Stated",NA,2,2
"23863","MAKUENI","KILUNGU","Total",29019,31932,60951
"23864","MAKUENI","KILUNGU","0",527,580,1107
"23865","MAKUENI","KILUNGU","1",636,575,1211
"23866","MAKUENI","KILUNGU","2",574,579,1153
"23867","MAKUENI","KILUNGU","3",619,629,1248
"23868","MAKUENI","KILUNGU","4",693,635,1328
"23869","MAKUENI","KILUNGU","0 - 4",3049,2998,6047
"23870","MAKUENI","KILUNGU","5",703,699,1402
"23871","MAKUENI","KILUNGU","6",654,689,1343
"23872","MAKUENI","KILUNGU","7",743,694,1437
"23873","MAKUENI","KILUNGU","8",693,747,1440
"23874","MAKUENI","KILUNGU","9",803,793,1596
"23875","MAKUENI","KILUNGU","5-9",3596,3622,7218
"23876","MAKUENI","KILUNGU","10",840,876,1716
"23877","MAKUENI","KILUNGU","11",832,876,1708
"23878","MAKUENI","KILUNGU","12",907,956,1863
"23879","MAKUENI","KILUNGU","13",878,942,1820
"23880","MAKUENI","KILUNGU","14",914,896,1810
"23881","MAKUENI","KILUNGU","10 -14",4371,4546,8917
"23882","MAKUENI","KILUNGU","15",889,863,1752
"23883","MAKUENI","KILUNGU","16",834,844,1678
"23884","MAKUENI","KILUNGU","17",839,842,1681
"23885","MAKUENI","KILUNGU","18",640,584,1224
"23886","MAKUENI","KILUNGU","19",666,631,1297
"23887","MAKUENI","KILUNGU","15-19",3868,3764,7632
"23888","MAKUENI","KILUNGU","20",593,533,1126
"23889","MAKUENI","KILUNGU","21",483,475,958
"23890","MAKUENI","KILUNGU","22",457,439,896
"23891","MAKUENI","KILUNGU","23",450,401,851
"23892","MAKUENI","KILUNGU","24",407,434,841
"23893","MAKUENI","KILUNGU","20-24",2390,2282,4672
"23894","MAKUENI","KILUNGU","25",384,400,784
"23895","MAKUENI","KILUNGU","26",313,389,702
"23896","MAKUENI","KILUNGU","27",306,337,643
"23897","MAKUENI","KILUNGU","28",274,279,553
"23898","MAKUENI","KILUNGU","29",329,368,697
"23899","MAKUENI","KILUNGU","25-29",1606,1773,3379
"23900","MAKUENI","KILUNGU","30",376,463,839
"23901","MAKUENI","KILUNGU","31",294,355,649
"23902","MAKUENI","KILUNGU","32",332,400,732
"23903","MAKUENI","KILUNGU","33",316,364,680
"23904","MAKUENI","KILUNGU","34",261,316,577
"23905","MAKUENI","KILUNGU","30-34",1579,1898,3477
"23906","MAKUENI","KILUNGU","35",362,445,807
"23907","MAKUENI","KILUNGU","36",278,337,615
"23908","MAKUENI","KILUNGU","37",299,322,621
"23909","MAKUENI","KILUNGU","38",226,261,487
"23910","MAKUENI","KILUNGU","39",305,328,633
"23911","MAKUENI","KILUNGU","35-39",1470,1693,3163
"23912","MAKUENI","KILUNGU","40",309,345,654
"23913","MAKUENI","KILUNGU","41",275,306,581
"23914","MAKUENI","KILUNGU","42",262,237,499
"23915","MAKUENI","KILUNGU","43",279,294,573
"23916","MAKUENI","KILUNGU","44",200,235,435
"23917","MAKUENI","KILUNGU","40-44",1325,1417,2742
"23918","MAKUENI","KILUNGU","45",296,382,678
"23919","MAKUENI","KILUNGU","46",225,307,532
"23920","MAKUENI","KILUNGU","47",227,324,551
"23921","MAKUENI","KILUNGU","48",159,223,382
"23922","MAKUENI","KILUNGU","49",214,295,509
"23923","MAKUENI","KILUNGU","45-49",1121,1531,2652
"23924","MAKUENI","KILUNGU","50",230,293,523
"23925","MAKUENI","KILUNGU","51",197,269,466
"23926","MAKUENI","KILUNGU","52",173,198,371
"23927","MAKUENI","KILUNGU","53",157,206,363
"23928","MAKUENI","KILUNGU","54",181,205,386
"23929","MAKUENI","KILUNGU","50-54",938,1171,2109
"23930","MAKUENI","KILUNGU","55",169,199,368
"23931","MAKUENI","KILUNGU","56",182,241,423
"23932","MAKUENI","KILUNGU","57",177,258,435
"23933","MAKUENI","KILUNGU","58",122,157,279
"23934","MAKUENI","KILUNGU","59",177,247,424
"23935","MAKUENI","KILUNGU","55-59",827,1102,1929
"23936","MAKUENI","KILUNGU","60",211,288,499
"23937","MAKUENI","KILUNGU","61",184,253,437
"23938","MAKUENI","KILUNGU","62",137,195,332
"23939","MAKUENI","KILUNGU","63",192,222,414
"23940","MAKUENI","KILUNGU","64",117,124,241
"23941","MAKUENI","KILUNGU","60-64",841,1082,1923
"23942","MAKUENI","KILUNGU","65",162,236,398
"23943","MAKUENI","KILUNGU","66",141,133,274
"23944","MAKUENI","KILUNGU","67",220,265,485
"23945","MAKUENI","KILUNGU","68",95,120,215
"23946","MAKUENI","KILUNGU","69",129,168,297
"23947","MAKUENI","KILUNGU","65-69",747,922,1669
"23948","MAKUENI","KILUNGU","70",159,220,379
"23949","MAKUENI","KILUNGU","71",106,166,272
"23950","MAKUENI","KILUNGU","72",96,97,193
"23951","MAKUENI","KILUNGU","73",89,118,207
"23952","MAKUENI","KILUNGU","74",69,109,178
"23953","MAKUENI","KILUNGU","70-74",519,710,1229
"23954","MAKUENI","KILUNGU","75",71,107,178
"23955","MAKUENI","KILUNGU","76",47,82,129
"23956","MAKUENI","KILUNGU","77",76,122,198
"23957","MAKUENI","KILUNGU","78",52,65,117
"23958","MAKUENI","KILUNGU","79",47,133,180
"23959","MAKUENI","KILUNGU","75-79",293,509,802
"23960","MAKUENI","KILUNGU","80",60,109,169
"23961","MAKUENI","KILUNGU","81",30,77,107
"23962","MAKUENI","KILUNGU","82",43,36,79
"23963","MAKUENI","KILUNGU","83",44,48,92
"23964","MAKUENI","KILUNGU","84",34,50,84
"23965","MAKUENI","KILUNGU","80-84",211,320,531
"23966","MAKUENI","KILUNGU","85",39,41,80
"23967","MAKUENI","KILUNGU","86",12,15,27
"23968","MAKUENI","KILUNGU","87",35,51,86
"23969","MAKUENI","KILUNGU","88",5,33,38
"23970","MAKUENI","KILUNGU","89",40,127,167
"23971","MAKUENI","KILUNGU","85-89",131,267,398
"23972","MAKUENI","KILUNGU","90",20,87,107
"23973","MAKUENI","KILUNGU","91",10,55,65
"23974","MAKUENI","KILUNGU","92",17,20,37
"23975","MAKUENI","KILUNGU","93",6,25,31
"23976","MAKUENI","KILUNGU","94",8,18,26
"23977","MAKUENI","KILUNGU","90-94",61,205,266
"23978","MAKUENI","KILUNGU","95",10,23,33
"23979","MAKUENI","KILUNGU","96",4,9,13
"23980","MAKUENI","KILUNGU","97",8,4,12
"23981","MAKUENI","KILUNGU","98",4,11,15
"23982","MAKUENI","KILUNGU","99",20,28,48
"23983","MAKUENI","KILUNGU","95-99",46,75,121
"23984","MAKUENI","KILUNGU","100+",29,44,73
"23985","MAKUENI","KILUNGU","Not Stated",1,1,2
"23986","MAKUENI","MAKINDU","Total",42204,42742,84946
"23987","MAKUENI","MAKINDU","0",814,767,1581
"23988","MAKUENI","MAKINDU","1",833,856,1689
"23989","MAKUENI","MAKINDU","2",836,876,1712
"23990","MAKUENI","MAKINDU","3",869,871,1740
"23991","MAKUENI","MAKINDU","4",960,873,1833
"23992","MAKUENI","MAKINDU","0 - 4",4312,4243,8555
"23993","MAKUENI","MAKINDU","5",992,832,1824
"23994","MAKUENI","MAKINDU","6",957,897,1854
"23995","MAKUENI","MAKINDU","7",917,857,1774
"23996","MAKUENI","MAKINDU","8",1064,927,1991
"23997","MAKUENI","MAKINDU","9",1078,1050,2128
"23998","MAKUENI","MAKINDU","5-9",5008,4563,9571
"23999","MAKUENI","MAKINDU","10",1100,1093,2193
"24000","MAKUENI","MAKINDU","11",1208,1235,2443
"24001","MAKUENI","MAKINDU","12",1290,1196,2486
"24002","MAKUENI","MAKINDU","13",1242,1311,2553
"24003","MAKUENI","MAKINDU","14",1198,1150,2348
"24004","MAKUENI","MAKINDU","10 -14",6038,5985,12023
"24005","MAKUENI","MAKINDU","15",1268,1222,2490
"24006","MAKUENI","MAKINDU","16",1051,1091,2142
"24007","MAKUENI","MAKINDU","17",1166,1081,2247
"24008","MAKUENI","MAKINDU","18",919,873,1792
"24009","MAKUENI","MAKINDU","19",899,892,1791
"24010","MAKUENI","MAKINDU","15-19",5303,5159,10462
"24011","MAKUENI","MAKINDU","20",853,816,1669
"24012","MAKUENI","MAKINDU","21",713,723,1436
"24013","MAKUENI","MAKINDU","22",631,675,1306
"24014","MAKUENI","MAKINDU","23",741,740,1481
"24015","MAKUENI","MAKINDU","24",667,675,1342
"24016","MAKUENI","MAKINDU","20-24",3605,3629,7234
"24017","MAKUENI","MAKINDU","25",732,752,1484
"24018","MAKUENI","MAKINDU","26",565,675,1240
"24019","MAKUENI","MAKINDU","27",611,633,1244
"24020","MAKUENI","MAKINDU","28",462,553,1015
"24021","MAKUENI","MAKINDU","29",597,619,1216
"24022","MAKUENI","MAKINDU","25-29",2967,3232,6199
"24023","MAKUENI","MAKINDU","30",699,744,1443
"24024","MAKUENI","MAKINDU","31",529,597,1126
"24025","MAKUENI","MAKINDU","32",638,695,1333
"24026","MAKUENI","MAKINDU","33",616,674,1290
"24027","MAKUENI","MAKINDU","34",489,558,1047
"24028","MAKUENI","MAKINDU","30-34",2971,3268,6239
"24029","MAKUENI","MAKINDU","35",657,702,1359
"24030","MAKUENI","MAKINDU","36",453,516,969
"24031","MAKUENI","MAKINDU","37",528,526,1054
"24032","MAKUENI","MAKINDU","38",384,407,791
"24033","MAKUENI","MAKINDU","39",505,472,977
"24034","MAKUENI","MAKINDU","35-39",2527,2623,5150
"24035","MAKUENI","MAKINDU","40",539,508,1047
"24036","MAKUENI","MAKINDU","41",533,455,988
"24037","MAKUENI","MAKINDU","42",454,458,912
"24038","MAKUENI","MAKINDU","43",387,422,809
"24039","MAKUENI","MAKINDU","44",394,459,853
"24040","MAKUENI","MAKINDU","40-44",2307,2302,4609
"24041","MAKUENI","MAKINDU","45",557,544,1101
"24042","MAKUENI","MAKINDU","46",380,381,761
"24043","MAKUENI","MAKINDU","47",393,345,738
"24044","MAKUENI","MAKINDU","48",274,248,522
"24045","MAKUENI","MAKINDU","49",382,360,742
"24046","MAKUENI","MAKINDU","45-49",1986,1878,3864
"24047","MAKUENI","MAKINDU","50",342,356,698
"24048","MAKUENI","MAKINDU","51",277,283,560
"24049","MAKUENI","MAKINDU","52",243,205,448
"24050","MAKUENI","MAKINDU","53",196,177,373
"24051","MAKUENI","MAKINDU","54",237,226,463
"24052","MAKUENI","MAKINDU","50-54",1295,1247,2542
"24053","MAKUENI","MAKINDU","55",265,211,476
"24054","MAKUENI","MAKINDU","56",255,251,506
"24055","MAKUENI","MAKINDU","57",214,229,443
"24056","MAKUENI","MAKINDU","58",133,151,284
"24057","MAKUENI","MAKINDU","59",241,230,471
"24058","MAKUENI","MAKINDU","55-59",1108,1072,2180
"24059","MAKUENI","MAKINDU","60",243,275,518
"24060","MAKUENI","MAKINDU","61",200,238,438
"24061","MAKUENI","MAKINDU","62",179,195,374
"24062","MAKUENI","MAKINDU","63",156,181,337
"24063","MAKUENI","MAKINDU","64",123,160,283
"24064","MAKUENI","MAKINDU","60-64",901,1049,1950
"24065","MAKUENI","MAKINDU","65",185,230,415
"24066","MAKUENI","MAKINDU","66",101,128,229
"24067","MAKUENI","MAKINDU","67",220,262,482
"24068","MAKUENI","MAKINDU","68",96,107,203
"24069","MAKUENI","MAKINDU","69",125,168,293
"24070","MAKUENI","MAKINDU","65-69",727,895,1622
"24071","MAKUENI","MAKINDU","70",174,201,375
"24072","MAKUENI","MAKINDU","71",125,137,262
"24073","MAKUENI","MAKINDU","72",61,88,149
"24074","MAKUENI","MAKINDU","73",73,90,163
"24075","MAKUENI","MAKINDU","74",81,79,160
"24076","MAKUENI","MAKINDU","70-74",514,595,1109
"24077","MAKUENI","MAKINDU","75",65,75,140
"24078","MAKUENI","MAKINDU","76",27,55,82
"24079","MAKUENI","MAKINDU","77",60,90,150
"24080","MAKUENI","MAKINDU","78",45,54,99
"24081","MAKUENI","MAKINDU","79",48,101,149
"24082","MAKUENI","MAKINDU","75-79",245,375,620
"24083","MAKUENI","MAKINDU","80",66,102,168
"24084","MAKUENI","MAKINDU","81",35,48,83
"24085","MAKUENI","MAKINDU","82",36,34,70
"24086","MAKUENI","MAKINDU","83",31,42,73
"24087","MAKUENI","MAKINDU","84",28,51,79
"24088","MAKUENI","MAKINDU","80-84",196,277,473
"24089","MAKUENI","MAKINDU","85",14,34,48
"24090","MAKUENI","MAKINDU","86",15,14,29
"24091","MAKUENI","MAKINDU","87",20,25,45
"24092","MAKUENI","MAKINDU","88",11,14,25
"24093","MAKUENI","MAKINDU","89",26,51,77
"24094","MAKUENI","MAKINDU","85-89",86,138,224
"24095","MAKUENI","MAKINDU","90",20,44,64
"24096","MAKUENI","MAKINDU","91",15,37,52
"24097","MAKUENI","MAKINDU","92",13,14,27
"24098","MAKUENI","MAKINDU","93",12,13,25
"24099","MAKUENI","MAKINDU","94",8,15,23
"24100","MAKUENI","MAKINDU","90-94",68,123,191
"24101","MAKUENI","MAKINDU","95",10,19,29
"24102","MAKUENI","MAKINDU","96",2,8,10
"24103","MAKUENI","MAKINDU","97",8,8,16
"24104","MAKUENI","MAKINDU","98",4,5,9
"24105","MAKUENI","MAKINDU","99",1,12,13
"24106","MAKUENI","MAKINDU","95-99",25,52,77
"24107","MAKUENI","MAKINDU","100+",15,36,51
"24108","MAKUENI","MAKINDU","Not Stated",NA,1,1
"24109","MAKUENI","MAKUENI","Total",65418,64955,130373
"24110","MAKUENI","MAKUENI","0",1154,1184,2338
"24111","MAKUENI","MAKUENI","1",1298,1302,2600
"24112","MAKUENI","MAKUENI","2",1257,1256,2513
"24113","MAKUENI","MAKUENI","3",1285,1217,2502
"24114","MAKUENI","MAKUENI","4",1326,1205,2531
"24115","MAKUENI","MAKUENI","0 - 4",6320,6164,12484
"24116","MAKUENI","MAKUENI","5",1348,1229,2577
"24117","MAKUENI","MAKUENI","6",1268,1159,2427
"24118","MAKUENI","MAKUENI","7",1306,1277,2583
"24119","MAKUENI","MAKUENI","8",1406,1366,2772
"24120","MAKUENI","MAKUENI","9",1435,1380,2815
"24121","MAKUENI","MAKUENI","5-9",6763,6411,13174
"24122","MAKUENI","MAKUENI","10",1514,1559,3073
"24123","MAKUENI","MAKUENI","11",1513,1546,3059
"24124","MAKUENI","MAKUENI","12",1724,1619,3343
"24125","MAKUENI","MAKUENI","13",1619,1639,3258
"24126","MAKUENI","MAKUENI","14",1638,1582,3220
"24127","MAKUENI","MAKUENI","10 -14",8008,7945,15953
"24128","MAKUENI","MAKUENI","15",1583,1501,3084
"24129","MAKUENI","MAKUENI","16",1556,1486,3042
"24130","MAKUENI","MAKUENI","17",1615,1577,3192
"24131","MAKUENI","MAKUENI","18",1285,1180,2465
"24132","MAKUENI","MAKUENI","19",1486,1337,2823
"24133","MAKUENI","MAKUENI","15-19",7525,7081,14606
"24134","MAKUENI","MAKUENI","20",1383,1294,2677
"24135","MAKUENI","MAKUENI","21",1230,1296,2526
"24136","MAKUENI","MAKUENI","22",1128,1136,2264
"24137","MAKUENI","MAKUENI","23",1283,1279,2562
"24138","MAKUENI","MAKUENI","24",1184,1076,2260
"24139","MAKUENI","MAKUENI","20-24",6208,6081,12289
"24140","MAKUENI","MAKUENI","25",1364,1209,2573
"24141","MAKUENI","MAKUENI","26",1094,1015,2109
"24142","MAKUENI","MAKUENI","27",1079,938,2017
"24143","MAKUENI","MAKUENI","28",883,782,1665
"24144","MAKUENI","MAKUENI","29",1016,994,2010
"24145","MAKUENI","MAKUENI","25-29",5436,4938,10374
"24146","MAKUENI","MAKUENI","30",1166,1241,2407
"24147","MAKUENI","MAKUENI","31",895,809,1704
"24148","MAKUENI","MAKUENI","32",1039,1026,2065
"24149","MAKUENI","MAKUENI","33",998,986,1984
"24150","MAKUENI","MAKUENI","34",841,813,1654
"24151","MAKUENI","MAKUENI","30-34",4939,4875,9814
"24152","MAKUENI","MAKUENI","35",1105,1048,2153
"24153","MAKUENI","MAKUENI","36",800,772,1572
"24154","MAKUENI","MAKUENI","37",863,783,1646
"24155","MAKUENI","MAKUENI","38",589,596,1185
"24156","MAKUENI","MAKUENI","39",768,797,1565
"24157","MAKUENI","MAKUENI","35-39",4125,3996,8121
"24158","MAKUENI","MAKUENI","40",789,752,1541
"24159","MAKUENI","MAKUENI","41",815,728,1543
"24160","MAKUENI","MAKUENI","42",701,659,1360
"24161","MAKUENI","MAKUENI","43",611,660,1271
"24162","MAKUENI","MAKUENI","44",580,598,1178
"24163","MAKUENI","MAKUENI","40-44",3496,3397,6893
"24164","MAKUENI","MAKUENI","45",847,890,1737
"24165","MAKUENI","MAKUENI","46",600,615,1215
"24166","MAKUENI","MAKUENI","47",607,632,1239
"24167","MAKUENI","MAKUENI","48",436,407,843
"24168","MAKUENI","MAKUENI","49",628,580,1208
"24169","MAKUENI","MAKUENI","45-49",3118,3124,6242
"24170","MAKUENI","MAKUENI","50",560,584,1144
"24171","MAKUENI","MAKUENI","51",511,481,992
"24172","MAKUENI","MAKUENI","52",373,425,798
"24173","MAKUENI","MAKUENI","53",329,328,657
"24174","MAKUENI","MAKUENI","54",425,392,817
"24175","MAKUENI","MAKUENI","50-54",2198,2210,4408
"24176","MAKUENI","MAKUENI","55",467,411,878
"24177","MAKUENI","MAKUENI","56",408,426,834
"24178","MAKUENI","MAKUENI","57",365,502,867
"24179","MAKUENI","MAKUENI","58",286,331,617
"24180","MAKUENI","MAKUENI","59",431,433,864
"24181","MAKUENI","MAKUENI","55-59",1957,2103,4060
"24182","MAKUENI","MAKUENI","60",486,465,951
"24183","MAKUENI","MAKUENI","61",422,418,840
"24184","MAKUENI","MAKUENI","62",320,311,631
"24185","MAKUENI","MAKUENI","63",362,342,704
"24186","MAKUENI","MAKUENI","64",237,253,490
"24187","MAKUENI","MAKUENI","60-64",1827,1789,3616
"24188","MAKUENI","MAKUENI","65",352,380,732
"24189","MAKUENI","MAKUENI","66",208,221,429
"24190","MAKUENI","MAKUENI","67",415,440,855
"24191","MAKUENI","MAKUENI","68",150,201,351
"24192","MAKUENI","MAKUENI","69",241,313,554
"24193","MAKUENI","MAKUENI","65-69",1366,1555,2921
"24194","MAKUENI","MAKUENI","70",265,390,655
"24195","MAKUENI","MAKUENI","71",218,251,469
"24196","MAKUENI","MAKUENI","72",147,138,285
"24197","MAKUENI","MAKUENI","73",140,197,337
"24198","MAKUENI","MAKUENI","74",132,181,313
"24199","MAKUENI","MAKUENI","70-74",902,1157,2059
"24200","MAKUENI","MAKUENI","75",94,155,249
"24201","MAKUENI","MAKUENI","76",91,114,205
"24202","MAKUENI","MAKUENI","77",110,174,284
"24203","MAKUENI","MAKUENI","78",63,72,135
"24204","MAKUENI","MAKUENI","79",92,178,270
"24205","MAKUENI","MAKUENI","75-79",450,693,1143
"24206","MAKUENI","MAKUENI","80",109,210,319
"24207","MAKUENI","MAKUENI","81",73,96,169
"24208","MAKUENI","MAKUENI","82",53,66,119
"24209","MAKUENI","MAKUENI","83",81,95,176
"24210","MAKUENI","MAKUENI","84",48,91,139
"24211","MAKUENI","MAKUENI","80-84",364,558,922
"24212","MAKUENI","MAKUENI","85",33,61,94
"24213","MAKUENI","MAKUENI","86",35,44,79
"24214","MAKUENI","MAKUENI","87",38,59,97
"24215","MAKUENI","MAKUENI","88",22,24,46
"24216","MAKUENI","MAKUENI","89",37,129,166
"24217","MAKUENI","MAKUENI","85-89",165,317,482
"24218","MAKUENI","MAKUENI","90",28,102,130
"24219","MAKUENI","MAKUENI","91",45,114,159
"24220","MAKUENI","MAKUENI","92",35,71,106
"24221","MAKUENI","MAKUENI","93",16,45,61
"24222","MAKUENI","MAKUENI","94",11,42,53
"24223","MAKUENI","MAKUENI","90-94",135,374,509
"24224","MAKUENI","MAKUENI","95",27,51,78
"24225","MAKUENI","MAKUENI","96",7,22,29
"24226","MAKUENI","MAKUENI","97",18,15,33
"24227","MAKUENI","MAKUENI","98",10,12,22
"24228","MAKUENI","MAKUENI","99",13,34,47
"24229","MAKUENI","MAKUENI","95-99",75,134,209
"24230","MAKUENI","MAKUENI","100+",41,53,94
"24231","MAKUENI","MAKUENI","Not Stated",NA,NA,NA
"24232","MAKUENI","MBOONI EAST","Total",48152,49601,97753
"24233","MAKUENI","MBOONI EAST","0",852,857,1709
"24234","MAKUENI","MBOONI EAST","1",906,914,1820
"24235","MAKUENI","MBOONI EAST","2",917,873,1790
"24236","MAKUENI","MBOONI EAST","3",1040,986,2026
"24237","MAKUENI","MBOONI EAST","4",1031,944,1975
"24238","MAKUENI","MBOONI EAST","0 - 4",4746,4574,9320
"24239","MAKUENI","MBOONI EAST","5",1037,959,1996
"24240","MAKUENI","MBOONI EAST","6",1036,1000,2036
"24241","MAKUENI","MBOONI EAST","7",1063,1039,2102
"24242","MAKUENI","MBOONI EAST","8",1185,1038,2223
"24243","MAKUENI","MBOONI EAST","9",1191,1186,2377
"24244","MAKUENI","MBOONI EAST","5-9",5512,5222,10734
"24245","MAKUENI","MBOONI EAST","10",1265,1155,2420
"24246","MAKUENI","MBOONI EAST","11",1341,1235,2576
"24247","MAKUENI","MBOONI EAST","12",1430,1418,2848
"24248","MAKUENI","MBOONI EAST","13",1393,1374,2767
"24249","MAKUENI","MBOONI EAST","14",1378,1238,2616
"24250","MAKUENI","MBOONI EAST","10 -14",6807,6420,13227
"24251","MAKUENI","MBOONI EAST","15",1374,1365,2739
"24252","MAKUENI","MBOONI EAST","16",1389,1350,2739
"24253","MAKUENI","MBOONI EAST","17",1499,1302,2801
"24254","MAKUENI","MBOONI EAST","18",1161,983,2144
"24255","MAKUENI","MBOONI EAST","19",1152,945,2097
"24256","MAKUENI","MBOONI EAST","15-19",6575,5945,12520
"24257","MAKUENI","MBOONI EAST","20",1046,833,1879
"24258","MAKUENI","MBOONI EAST","21",850,685,1535
"24259","MAKUENI","MBOONI EAST","22",707,581,1288
"24260","MAKUENI","MBOONI EAST","23",720,698,1418
"24261","MAKUENI","MBOONI EAST","24",671,588,1259
"24262","MAKUENI","MBOONI EAST","20-24",3994,3385,7379
"24263","MAKUENI","MBOONI EAST","25",639,657,1296
"24264","MAKUENI","MBOONI EAST","26",555,588,1143
"24265","MAKUENI","MBOONI EAST","27",638,587,1225
"24266","MAKUENI","MBOONI EAST","28",497,552,1049
"24267","MAKUENI","MBOONI EAST","29",595,605,1200
"24268","MAKUENI","MBOONI EAST","25-29",2924,2989,5913
"24269","MAKUENI","MBOONI EAST","30",664,797,1461
"24270","MAKUENI","MBOONI EAST","31",536,562,1098
"24271","MAKUENI","MBOONI EAST","32",610,722,1332
"24272","MAKUENI","MBOONI EAST","33",597,708,1305
"24273","MAKUENI","MBOONI EAST","34",450,549,999
"24274","MAKUENI","MBOONI EAST","30-34",2857,3338,6195
"24275","MAKUENI","MBOONI EAST","35",716,778,1494
"24276","MAKUENI","MBOONI EAST","36",523,520,1043
"24277","MAKUENI","MBOONI EAST","37",586,535,1121
"24278","MAKUENI","MBOONI EAST","38",361,434,795
"24279","MAKUENI","MBOONI EAST","39",560,536,1096
"24280","MAKUENI","MBOONI EAST","35-39",2746,2803,5549
"24281","MAKUENI","MBOONI EAST","40",567,575,1142
"24282","MAKUENI","MBOONI EAST","41",553,561,1114
"24283","MAKUENI","MBOONI EAST","42",421,511,932
"24284","MAKUENI","MBOONI EAST","43",418,537,955
"24285","MAKUENI","MBOONI EAST","44",391,473,864
"24286","MAKUENI","MBOONI EAST","40-44",2350,2657,5007
"24287","MAKUENI","MBOONI EAST","45",586,722,1308
"24288","MAKUENI","MBOONI EAST","46",416,517,933
"24289","MAKUENI","MBOONI EAST","47",442,517,959
"24290","MAKUENI","MBOONI EAST","48",343,342,685
"24291","MAKUENI","MBOONI EAST","49",460,524,984
"24292","MAKUENI","MBOONI EAST","45-49",2247,2622,4869
"24293","MAKUENI","MBOONI EAST","50",412,495,907
"24294","MAKUENI","MBOONI EAST","51",371,392,763
"24295","MAKUENI","MBOONI EAST","52",249,316,565
"24296","MAKUENI","MBOONI EAST","53",219,283,502
"24297","MAKUENI","MBOONI EAST","54",324,317,641
"24298","MAKUENI","MBOONI EAST","50-54",1575,1803,3378
"24299","MAKUENI","MBOONI EAST","55",293,343,636
"24300","MAKUENI","MBOONI EAST","56",281,379,660
"24301","MAKUENI","MBOONI EAST","57",321,389,710
"24302","MAKUENI","MBOONI EAST","58",240,237,477
"24303","MAKUENI","MBOONI EAST","59",292,348,640
"24304","MAKUENI","MBOONI EAST","55-59",1427,1696,3123
"24305","MAKUENI","MBOONI EAST","60",341,432,773
"24306","MAKUENI","MBOONI EAST","61",321,339,660
"24307","MAKUENI","MBOONI EAST","62",231,263,494
"24308","MAKUENI","MBOONI EAST","63",246,282,528
"24309","MAKUENI","MBOONI EAST","64",199,217,416
"24310","MAKUENI","MBOONI EAST","60-64",1338,1533,2871
"24311","MAKUENI","MBOONI EAST","65",248,360,608
"24312","MAKUENI","MBOONI EAST","66",184,192,376
"24313","MAKUENI","MBOONI EAST","67",284,373,657
"24314","MAKUENI","MBOONI EAST","68",124,212,336
"24315","MAKUENI","MBOONI EAST","69",207,291,498
"24316","MAKUENI","MBOONI EAST","65-69",1047,1428,2475
"24317","MAKUENI","MBOONI EAST","70",231,330,561
"24318","MAKUENI","MBOONI EAST","71",196,226,422
"24319","MAKUENI","MBOONI EAST","72",152,138,290
"24320","MAKUENI","MBOONI EAST","73",147,164,311
"24321","MAKUENI","MBOONI EAST","74",105,201,306
"24322","MAKUENI","MBOONI EAST","70-74",831,1059,1890
"24323","MAKUENI","MBOONI EAST","75",76,230,306
"24324","MAKUENI","MBOONI EAST","76",63,83,146
"24325","MAKUENI","MBOONI EAST","77",96,145,241
"24326","MAKUENI","MBOONI EAST","78",67,73,140
"24327","MAKUENI","MBOONI EAST","79",90,203,293
"24328","MAKUENI","MBOONI EAST","75-79",392,734,1126
"24329","MAKUENI","MBOONI EAST","80",108,190,298
"24330","MAKUENI","MBOONI EAST","81",83,108,191
"24331","MAKUENI","MBOONI EAST","82",48,65,113
"24332","MAKUENI","MBOONI EAST","83",47,88,135
"24333","MAKUENI","MBOONI EAST","84",41,96,137
"24334","MAKUENI","MBOONI EAST","80-84",327,547,874
"24335","MAKUENI","MBOONI EAST","85",57,69,126
"24336","MAKUENI","MBOONI EAST","86",33,48,81
"24337","MAKUENI","MBOONI EAST","87",45,93,138
"24338","MAKUENI","MBOONI EAST","88",17,23,40
"24339","MAKUENI","MBOONI EAST","89",52,124,176
"24340","MAKUENI","MBOONI EAST","85-89",204,357,561
"24341","MAKUENI","MBOONI EAST","90",46,93,139
"24342","MAKUENI","MBOONI EAST","91",40,115,155
"24343","MAKUENI","MBOONI EAST","92",22,52,74
"24344","MAKUENI","MBOONI EAST","93",16,43,59
"24345","MAKUENI","MBOONI EAST","94",18,24,42
"24346","MAKUENI","MBOONI EAST","90-94",142,327,469
"24347","MAKUENI","MBOONI EAST","95",26,49,75
"24348","MAKUENI","MBOONI EAST","96",14,6,20
"24349","MAKUENI","MBOONI EAST","97",21,9,30
"24350","MAKUENI","MBOONI EAST","98",8,15,23
"24351","MAKUENI","MBOONI EAST","99",16,26,42
"24352","MAKUENI","MBOONI EAST","95-99",85,105,190
"24353","MAKUENI","MBOONI EAST","100+",25,57,82
"24354","MAKUENI","MBOONI EAST","Not Stated",1,NA,1
"24355","MAKUENI","MBOONI WEST","Total",49434,53159,102593
"24356","MAKUENI","MBOONI WEST","0",874,892,1766
"24357","MAKUENI","MBOONI WEST","1",993,1052,2045
"24358","MAKUENI","MBOONI WEST","2",1006,1020,2026
"24359","MAKUENI","MBOONI WEST","3",1104,1030,2134
"24360","MAKUENI","MBOONI WEST","4",1064,1048,2112
"24361","MAKUENI","MBOONI WEST","0 - 4",5041,5042,10083
"24362","MAKUENI","MBOONI WEST","5",1084,1112,2196
"24363","MAKUENI","MBOONI WEST","6",1166,1081,2247
"24364","MAKUENI","MBOONI WEST","7",1163,1156,2319
"24365","MAKUENI","MBOONI WEST","8",1278,1221,2499
"24366","MAKUENI","MBOONI WEST","9",1371,1322,2693
"24367","MAKUENI","MBOONI WEST","5-9",6062,5892,11954
"24368","MAKUENI","MBOONI WEST","10",1467,1386,2853
"24369","MAKUENI","MBOONI WEST","11",1375,1397,2772
"24370","MAKUENI","MBOONI WEST","12",1621,1479,3100
"24371","MAKUENI","MBOONI WEST","13",1493,1470,2963
"24372","MAKUENI","MBOONI WEST","14",1486,1483,2969
"24373","MAKUENI","MBOONI WEST","10 -14",7442,7215,14657
"24374","MAKUENI","MBOONI WEST","15",1565,1440,3005
"24375","MAKUENI","MBOONI WEST","16",1398,1381,2779
"24376","MAKUENI","MBOONI WEST","17",1460,1363,2823
"24377","MAKUENI","MBOONI WEST","18",1123,993,2116
"24378","MAKUENI","MBOONI WEST","19",1139,975,2114
"24379","MAKUENI","MBOONI WEST","15-19",6685,6152,12837
"24380","MAKUENI","MBOONI WEST","20",995,862,1857
"24381","MAKUENI","MBOONI WEST","21",830,748,1578
"24382","MAKUENI","MBOONI WEST","22",755,692,1447
"24383","MAKUENI","MBOONI WEST","23",714,740,1454
"24384","MAKUENI","MBOONI WEST","24",647,670,1317
"24385","MAKUENI","MBOONI WEST","20-24",3941,3712,7653
"24386","MAKUENI","MBOONI WEST","25",626,673,1299
"24387","MAKUENI","MBOONI WEST","26",540,618,1158
"24388","MAKUENI","MBOONI WEST","27",569,614,1183
"24389","MAKUENI","MBOONI WEST","28",465,557,1022
"24390","MAKUENI","MBOONI WEST","29",566,692,1258
"24391","MAKUENI","MBOONI WEST","25-29",2766,3154,5920
"24392","MAKUENI","MBOONI WEST","30",634,866,1500
"24393","MAKUENI","MBOONI WEST","31",519,637,1156
"24394","MAKUENI","MBOONI WEST","32",612,717,1329
"24395","MAKUENI","MBOONI WEST","33",546,732,1278
"24396","MAKUENI","MBOONI WEST","34",492,621,1113
"24397","MAKUENI","MBOONI WEST","30-34",2803,3573,6376
"24398","MAKUENI","MBOONI WEST","35",676,763,1439
"24399","MAKUENI","MBOONI WEST","36",483,538,1021
"24400","MAKUENI","MBOONI WEST","37",535,577,1112
"24401","MAKUENI","MBOONI WEST","38",354,411,765
"24402","MAKUENI","MBOONI WEST","39",529,570,1099
"24403","MAKUENI","MBOONI WEST","35-39",2577,2859,5436
"24404","MAKUENI","MBOONI WEST","40",549,603,1152
"24405","MAKUENI","MBOONI WEST","41",514,558,1072
"24406","MAKUENI","MBOONI WEST","42",438,440,878
"24407","MAKUENI","MBOONI WEST","43",389,478,867
"24408","MAKUENI","MBOONI WEST","44",364,432,796
"24409","MAKUENI","MBOONI WEST","40-44",2254,2511,4765
"24410","MAKUENI","MBOONI WEST","45",537,641,1178
"24411","MAKUENI","MBOONI WEST","46",464,616,1080
"24412","MAKUENI","MBOONI WEST","47",401,586,987
"24413","MAKUENI","MBOONI WEST","48",311,458,769
"24414","MAKUENI","MBOONI WEST","49",416,549,965
"24415","MAKUENI","MBOONI WEST","45-49",2129,2850,4979
"24416","MAKUENI","MBOONI WEST","50",369,427,796
"24417","MAKUENI","MBOONI WEST","51",363,369,732
"24418","MAKUENI","MBOONI WEST","52",245,296,541
"24419","MAKUENI","MBOONI WEST","53",203,245,448
"24420","MAKUENI","MBOONI WEST","54",311,366,677
"24421","MAKUENI","MBOONI WEST","50-54",1491,1703,3194
"24422","MAKUENI","MBOONI WEST","55",293,320,613
"24423","MAKUENI","MBOONI WEST","56",326,391,717
"24424","MAKUENI","MBOONI WEST","57",342,461,803
"24425","MAKUENI","MBOONI WEST","58",216,320,536
"24426","MAKUENI","MBOONI WEST","59",364,473,837
"24427","MAKUENI","MBOONI WEST","55-59",1541,1965,3506
"24428","MAKUENI","MBOONI WEST","60",394,512,906
"24429","MAKUENI","MBOONI WEST","61",356,415,771
"24430","MAKUENI","MBOONI WEST","62",250,301,551
"24431","MAKUENI","MBOONI WEST","63",269,386,655
"24432","MAKUENI","MBOONI WEST","64",181,239,420
"24433","MAKUENI","MBOONI WEST","60-64",1450,1853,3303
"24434","MAKUENI","MBOONI WEST","65",303,382,685
"24435","MAKUENI","MBOONI WEST","66",184,215,399
"24436","MAKUENI","MBOONI WEST","67",352,452,804
"24437","MAKUENI","MBOONI WEST","68",134,159,293
"24438","MAKUENI","MBOONI WEST","69",239,312,551
"24439","MAKUENI","MBOONI WEST","65-69",1212,1520,2732
"24440","MAKUENI","MBOONI WEST","70",257,384,641
"24441","MAKUENI","MBOONI WEST","71",213,281,494
"24442","MAKUENI","MBOONI WEST","72",153,148,301
"24443","MAKUENI","MBOONI WEST","73",136,182,318
"24444","MAKUENI","MBOONI WEST","74",137,201,338
"24445","MAKUENI","MBOONI WEST","70-74",896,1196,2092
"24446","MAKUENI","MBOONI WEST","75",82,154,236
"24447","MAKUENI","MBOONI WEST","76",66,112,178
"24448","MAKUENI","MBOONI WEST","77",102,156,258
"24449","MAKUENI","MBOONI WEST","78",71,79,150
"24450","MAKUENI","MBOONI WEST","79",79,196,275
"24451","MAKUENI","MBOONI WEST","75-79",400,697,1097
"24452","MAKUENI","MBOONI WEST","80",101,201,302
"24453","MAKUENI","MBOONI WEST","81",71,131,202
"24454","MAKUENI","MBOONI WEST","82",39,84,123
"24455","MAKUENI","MBOONI WEST","83",78,85,163
"24456","MAKUENI","MBOONI WEST","84",50,90,140
"24457","MAKUENI","MBOONI WEST","80-84",339,591,930
"24458","MAKUENI","MBOONI WEST","85",36,69,105
"24459","MAKUENI","MBOONI WEST","86",31,33,64
"24460","MAKUENI","MBOONI WEST","87",41,65,106
"24461","MAKUENI","MBOONI WEST","88",24,19,43
"24462","MAKUENI","MBOONI WEST","89",44,109,153
"24463","MAKUENI","MBOONI WEST","85-89",176,295,471
"24464","MAKUENI","MBOONI WEST","90",35,80,115
"24465","MAKUENI","MBOONI WEST","91",28,61,89
"24466","MAKUENI","MBOONI WEST","92",26,38,64
"24467","MAKUENI","MBOONI WEST","93",12,24,36
"24468","MAKUENI","MBOONI WEST","94",10,24,34
"24469","MAKUENI","MBOONI WEST","90-94",111,227,338
"24470","MAKUENI","MBOONI WEST","95",23,25,48
"24471","MAKUENI","MBOONI WEST","96",13,11,24
"24472","MAKUENI","MBOONI WEST","97",15,19,34
"24473","MAKUENI","MBOONI WEST","98",12,11,23
"24474","MAKUENI","MBOONI WEST","99",14,32,46
"24475","MAKUENI","MBOONI WEST","95-99",77,98,175
"24476","MAKUENI","MBOONI WEST","100+",41,54,95
"24477","MAKUENI","MBOONI WEST","Not Stated",NA,NA,NA
"24478","MAKUENI","MUKAA","Total",54481,53068,107549
"24479","MAKUENI","MUKAA","0",971,981,1952
"24480","MAKUENI","MUKAA","1",1039,1026,2065
"24481","MAKUENI","MUKAA","2",1031,1076,2107
"24482","MAKUENI","MUKAA","3",1036,1032,2068
"24483","MAKUENI","MUKAA","4",1059,1062,2121
"24484","MAKUENI","MUKAA","0 - 4",5136,5177,10313
"24485","MAKUENI","MUKAA","5",1142,1073,2215
"24486","MAKUENI","MUKAA","6",1103,1140,2243
"24487","MAKUENI","MUKAA","7",1223,1148,2371
"24488","MAKUENI","MUKAA","8",1158,1268,2426
"24489","MAKUENI","MUKAA","9",1338,1273,2611
"24490","MAKUENI","MUKAA","5-9",5964,5902,11866
"24491","MAKUENI","MUKAA","10",1346,1252,2598
"24492","MAKUENI","MUKAA","11",1280,1408,2688
"24493","MAKUENI","MUKAA","12",1460,1362,2822
"24494","MAKUENI","MUKAA","13",1434,1352,2786
"24495","MAKUENI","MUKAA","14",1378,1342,2720
"24496","MAKUENI","MUKAA","10 -14",6898,6716,13614
"24497","MAKUENI","MUKAA","15",1322,1329,2651
"24498","MAKUENI","MUKAA","16",1299,1281,2580
"24499","MAKUENI","MUKAA","17",1437,1260,2697
"24500","MAKUENI","MUKAA","18",1058,965,2023
"24501","MAKUENI","MUKAA","19",1244,946,2190
"24502","MAKUENI","MUKAA","15-19",6360,5781,12141
"24503","MAKUENI","MUKAA","20",1103,901,2004
"24504","MAKUENI","MUKAA","21",990,869,1859
"24505","MAKUENI","MUKAA","22",854,742,1596
"24506","MAKUENI","MUKAA","23",916,851,1767
"24507","MAKUENI","MUKAA","24",877,732,1609
"24508","MAKUENI","MUKAA","20-24",4740,4095,8835
"24509","MAKUENI","MUKAA","25",910,792,1702
"24510","MAKUENI","MUKAA","26",768,742,1510
"24511","MAKUENI","MUKAA","27",786,690,1476
"24512","MAKUENI","MUKAA","28",680,665,1345
"24513","MAKUENI","MUKAA","29",800,779,1579
"24514","MAKUENI","MUKAA","25-29",3944,3668,7612
"24515","MAKUENI","MUKAA","30",916,906,1822
"24516","MAKUENI","MUKAA","31",680,649,1329
"24517","MAKUENI","MUKAA","32",825,801,1626
"24518","MAKUENI","MUKAA","33",790,713,1503
"24519","MAKUENI","MUKAA","34",674,662,1336
"24520","MAKUENI","MUKAA","30-34",3885,3731,7616
"24521","MAKUENI","MUKAA","35",887,844,1731
"24522","MAKUENI","MUKAA","36",628,568,1196
"24523","MAKUENI","MUKAA","37",656,579,1235
"24524","MAKUENI","MUKAA","38",493,472,965
"24525","MAKUENI","MUKAA","39",610,619,1229
"24526","MAKUENI","MUKAA","35-39",3274,3082,6356
"24527","MAKUENI","MUKAA","40",658,613,1271
"24528","MAKUENI","MUKAA","41",620,555,1175
"24529","MAKUENI","MUKAA","42",593,491,1084
"24530","MAKUENI","MUKAA","43",498,527,1025
"24531","MAKUENI","MUKAA","44",509,433,942
"24532","MAKUENI","MUKAA","40-44",2878,2619,5497
"24533","MAKUENI","MUKAA","45",720,670,1390
"24534","MAKUENI","MUKAA","46",504,527,1031
"24535","MAKUENI","MUKAA","47",568,540,1108
"24536","MAKUENI","MUKAA","48",365,401,766
"24537","MAKUENI","MUKAA","49",495,609,1104
"24538","MAKUENI","MUKAA","45-49",2652,2747,5399
"24539","MAKUENI","MUKAA","50",554,503,1057
"24540","MAKUENI","MUKAA","51",417,451,868
"24541","MAKUENI","MUKAA","52",389,350,739
"24542","MAKUENI","MUKAA","53",338,305,643
"24543","MAKUENI","MUKAA","54",429,312,741
"24544","MAKUENI","MUKAA","50-54",2127,1921,4048
"24545","MAKUENI","MUKAA","55",398,365,763
"24546","MAKUENI","MUKAA","56",407,419,826
"24547","MAKUENI","MUKAA","57",335,392,727
"24548","MAKUENI","MUKAA","58",263,238,501
"24549","MAKUENI","MUKAA","59",362,360,722
"24550","MAKUENI","MUKAA","55-59",1765,1774,3539
"24551","MAKUENI","MUKAA","60",383,416,799
"24552","MAKUENI","MUKAA","61",330,338,668
"24553","MAKUENI","MUKAA","62",290,278,568
"24554","MAKUENI","MUKAA","63",324,296,620
"24555","MAKUENI","MUKAA","64",215,209,424
"24556","MAKUENI","MUKAA","60-64",1542,1537,3079
"24557","MAKUENI","MUKAA","65",332,365,697
"24558","MAKUENI","MUKAA","66",194,213,407
"24559","MAKUENI","MUKAA","67",328,368,696
"24560","MAKUENI","MUKAA","68",134,150,284
"24561","MAKUENI","MUKAA","69",248,254,502
"24562","MAKUENI","MUKAA","65-69",1236,1350,2586
"24563","MAKUENI","MUKAA","70",264,332,596
"24564","MAKUENI","MUKAA","71",199,240,439
"24565","MAKUENI","MUKAA","72",149,145,294
"24566","MAKUENI","MUKAA","73",132,154,286
"24567","MAKUENI","MUKAA","74",133,185,318
"24568","MAKUENI","MUKAA","70-74",877,1056,1933
"24569","MAKUENI","MUKAA","75",109,125,234
"24570","MAKUENI","MUKAA","76",76,96,172
"24571","MAKUENI","MUKAA","77",112,170,282
"24572","MAKUENI","MUKAA","78",58,82,140
"24573","MAKUENI","MUKAA","79",77,179,256
"24574","MAKUENI","MUKAA","75-79",432,652,1084
"24575","MAKUENI","MUKAA","80",94,170,264
"24576","MAKUENI","MUKAA","81",53,73,126
"24577","MAKUENI","MUKAA","82",64,66,130
"24578","MAKUENI","MUKAA","83",69,95,164
"24579","MAKUENI","MUKAA","84",55,115,170
"24580","MAKUENI","MUKAA","80-84",335,519,854
"24581","MAKUENI","MUKAA","85",43,70,113
"24582","MAKUENI","MUKAA","86",26,21,47
"24583","MAKUENI","MUKAA","87",36,62,98
"24584","MAKUENI","MUKAA","88",26,24,50
"24585","MAKUENI","MUKAA","89",58,146,204
"24586","MAKUENI","MUKAA","85-89",189,323,512
"24587","MAKUENI","MUKAA","90",40,97,137
"24588","MAKUENI","MUKAA","91",39,78,117
"24589","MAKUENI","MUKAA","92",19,22,41
"24590","MAKUENI","MUKAA","93",10,32,42
"24591","MAKUENI","MUKAA","94",18,31,49
"24592","MAKUENI","MUKAA","90-94",126,260,386
"24593","MAKUENI","MUKAA","95",25,31,56
"24594","MAKUENI","MUKAA","96",9,8,17
"24595","MAKUENI","MUKAA","97",10,13,23
"24596","MAKUENI","MUKAA","98",10,9,19
"24597","MAKUENI","MUKAA","99",20,33,53
"24598","MAKUENI","MUKAA","95-99",74,94,168
"24599","MAKUENI","MUKAA","100+",46,64,110
"24600","MAKUENI","MUKAA","Not Stated",1,NA,1
"24601","MAKUENI","NZAUI","Total",63171,63526,126697
"24602","MAKUENI","NZAUI","0",1164,1122,2286
"24603","MAKUENI","NZAUI","1",1260,1180,2440
"24604","MAKUENI","NZAUI","2",1221,1203,2424
"24605","MAKUENI","NZAUI","3",1297,1261,2558
"24606","MAKUENI","NZAUI","4",1294,1311,2605
"24607","MAKUENI","NZAUI","0 - 4",6236,6077,12313
"24608","MAKUENI","NZAUI","5",1376,1339,2715
"24609","MAKUENI","NZAUI","6",1366,1313,2679
"24610","MAKUENI","NZAUI","7",1367,1405,2772
"24611","MAKUENI","NZAUI","8",1450,1429,2879
"24612","MAKUENI","NZAUI","9",1609,1590,3199
"24613","MAKUENI","NZAUI","5-9",7168,7076,14244
"24614","MAKUENI","NZAUI","10",1692,1738,3430
"24615","MAKUENI","NZAUI","11",1725,1721,3446
"24616","MAKUENI","NZAUI","12",1822,1822,3644
"24617","MAKUENI","NZAUI","13",1836,1857,3693
"24618","MAKUENI","NZAUI","14",1763,1702,3465
"24619","MAKUENI","NZAUI","10 -14",8838,8840,17678
"24620","MAKUENI","NZAUI","15",1850,1752,3602
"24621","MAKUENI","NZAUI","16",1790,1673,3463
"24622","MAKUENI","NZAUI","17",1815,1610,3425
"24623","MAKUENI","NZAUI","18",1420,1211,2631
"24624","MAKUENI","NZAUI","19",1559,1263,2822
"24625","MAKUENI","NZAUI","15-19",8434,7509,15943
"24626","MAKUENI","NZAUI","20",1311,1160,2471
"24627","MAKUENI","NZAUI","21",1212,980,2192
"24628","MAKUENI","NZAUI","22",988,848,1836
"24629","MAKUENI","NZAUI","23",985,995,1980
"24630","MAKUENI","NZAUI","24",953,905,1858
"24631","MAKUENI","NZAUI","20-24",5449,4888,10337
"24632","MAKUENI","NZAUI","25",1045,960,2005
"24633","MAKUENI","NZAUI","26",838,905,1743
"24634","MAKUENI","NZAUI","27",883,879,1762
"24635","MAKUENI","NZAUI","28",741,690,1431
"24636","MAKUENI","NZAUI","29",854,900,1754
"24637","MAKUENI","NZAUI","25-29",4361,4334,8695
"24638","MAKUENI","NZAUI","30",992,1030,2022
"24639","MAKUENI","NZAUI","31",762,796,1558
"24640","MAKUENI","NZAUI","32",853,946,1799
"24641","MAKUENI","NZAUI","33",817,845,1662
"24642","MAKUENI","NZAUI","34",680,721,1401
"24643","MAKUENI","NZAUI","30-34",4104,4338,8442
"24644","MAKUENI","NZAUI","35",965,924,1889
"24645","MAKUENI","NZAUI","36",699,734,1433
"24646","MAKUENI","NZAUI","37",784,762,1546
"24647","MAKUENI","NZAUI","38",562,580,1142
"24648","MAKUENI","NZAUI","39",752,773,1525
"24649","MAKUENI","NZAUI","35-39",3762,3773,7535
"24650","MAKUENI","NZAUI","40",736,713,1449
"24651","MAKUENI","NZAUI","41",802,700,1502
"24652","MAKUENI","NZAUI","42",671,608,1279
"24653","MAKUENI","NZAUI","43",645,682,1327
"24654","MAKUENI","NZAUI","44",552,677,1229
"24655","MAKUENI","NZAUI","40-44",3406,3380,6786
"24656","MAKUENI","NZAUI","45",814,878,1692
"24657","MAKUENI","NZAUI","46",522,552,1074
"24658","MAKUENI","NZAUI","47",588,625,1213
"24659","MAKUENI","NZAUI","48",402,361,763
"24660","MAKUENI","NZAUI","49",548,553,1101
"24661","MAKUENI","NZAUI","45-49",2874,2969,5843
"24662","MAKUENI","NZAUI","50",513,539,1052
"24663","MAKUENI","NZAUI","51",467,501,968
"24664","MAKUENI","NZAUI","52",389,370,759
"24665","MAKUENI","NZAUI","53",332,324,656
"24666","MAKUENI","NZAUI","54",374,328,702
"24667","MAKUENI","NZAUI","50-54",2075,2062,4137
"24668","MAKUENI","NZAUI","55",357,336,693
"24669","MAKUENI","NZAUI","56",288,355,643
"24670","MAKUENI","NZAUI","57",368,430,798
"24671","MAKUENI","NZAUI","58",269,283,552
"24672","MAKUENI","NZAUI","59",385,422,807
"24673","MAKUENI","NZAUI","55-59",1667,1826,3493
"24674","MAKUENI","NZAUI","60",399,481,880
"24675","MAKUENI","NZAUI","61",364,353,717
"24676","MAKUENI","NZAUI","62",279,312,591
"24677","MAKUENI","NZAUI","63",308,335,643
"24678","MAKUENI","NZAUI","64",209,202,411
"24679","MAKUENI","NZAUI","60-64",1559,1683,3242
"24680","MAKUENI","NZAUI","65",332,389,721
"24681","MAKUENI","NZAUI","66",181,207,388
"24682","MAKUENI","NZAUI","67",353,472,825
"24683","MAKUENI","NZAUI","68",128,188,316
"24684","MAKUENI","NZAUI","69",236,322,558
"24685","MAKUENI","NZAUI","65-69",1230,1578,2808
"24686","MAKUENI","NZAUI","70",267,356,623
"24687","MAKUENI","NZAUI","71",191,250,441
"24688","MAKUENI","NZAUI","72",147,138,285
"24689","MAKUENI","NZAUI","73",129,166,295
"24690","MAKUENI","NZAUI","74",139,242,381
"24691","MAKUENI","NZAUI","70-74",873,1152,2025
"24692","MAKUENI","NZAUI","75",90,128,218
"24693","MAKUENI","NZAUI","76",67,92,159
"24694","MAKUENI","NZAUI","77",90,132,222
"24695","MAKUENI","NZAUI","78",58,66,124
"24696","MAKUENI","NZAUI","79",72,194,266
"24697","MAKUENI","NZAUI","75-79",377,612,989
"24698","MAKUENI","NZAUI","80",102,230,332
"24699","MAKUENI","NZAUI","81",55,86,141
"24700","MAKUENI","NZAUI","82",52,51,103
"24701","MAKUENI","NZAUI","83",70,81,151
"24702","MAKUENI","NZAUI","84",62,124,186
"24703","MAKUENI","NZAUI","80-84",341,572,913
"24704","MAKUENI","NZAUI","85",38,57,95
"24705","MAKUENI","NZAUI","86",36,34,70
"24706","MAKUENI","NZAUI","87",33,67,100
"24707","MAKUENI","NZAUI","88",18,30,48
"24708","MAKUENI","NZAUI","89",47,147,194
"24709","MAKUENI","NZAUI","85-89",172,335,507
"24710","MAKUENI","NZAUI","90",34,94,128
"24711","MAKUENI","NZAUI","91",31,119,150
"24712","MAKUENI","NZAUI","92",34,40,74
"24713","MAKUENI","NZAUI","93",10,30,40
"24714","MAKUENI","NZAUI","94",16,37,53
"24715","MAKUENI","NZAUI","90-94",125,320,445
"24716","MAKUENI","NZAUI","95",22,31,53
"24717","MAKUENI","NZAUI","96",8,9,17
"24718","MAKUENI","NZAUI","97",9,10,19
"24719","MAKUENI","NZAUI","98",11,17,28
"24720","MAKUENI","NZAUI","99",25,49,74
"24721","MAKUENI","NZAUI","95-99",75,116,191
"24722","MAKUENI","NZAUI","100+",44,86,130
"24723","MAKUENI","NZAUI","Not Stated",1,NA,1
"24724","MANDERA","ALL","Total",434976,432444,867420
"24725","MANDERA","ALL","0",8259,10068,18327
"24726","MANDERA","ALL","1",11893,13754,25647
"24727","MANDERA","ALL","2",20027,23132,43159
"24728","MANDERA","ALL","3",14134,16702,30836
"24729","MANDERA","ALL","4",20216,22906,43122
"24730","MANDERA","ALL","0 - 4",74529,86562,161091
"24731","MANDERA","ALL","5",13958,15754,29712
"24732","MANDERA","ALL","6",20270,22743,43013
"24733","MANDERA","ALL","7",12281,13635,25916
"24734","MANDERA","ALL","8",20671,21879,42550
"24735","MANDERA","ALL","9",11405,12563,23968
"24736","MANDERA","ALL","5-9",78585,86574,165159
"24737","MANDERA","ALL","10",22291,22264,44555
"24738","MANDERA","ALL","11",9700,11190,20890
"24739","MANDERA","ALL","12",19210,15366,34576
"24740","MANDERA","ALL","13",11764,9776,21540
"24741","MANDERA","ALL","14",15660,12252,27912
"24742","MANDERA","ALL","10 -14",78625,70848,149473
"24743","MANDERA","ALL","15",14630,11264,25894
"24744","MANDERA","ALL","16",14035,11332,25367
"24745","MANDERA","ALL","17",11257,9535,20792
"24746","MANDERA","ALL","18",12959,11411,24370
"24747","MANDERA","ALL","19",6034,5887,11921
"24748","MANDERA","ALL","15-19",58915,49429,108344
"24749","MANDERA","ALL","20",13722,12952,26674
"24750","MANDERA","ALL","21",5008,5049,10057
"24751","MANDERA","ALL","22",6873,7964,14837
"24752","MANDERA","ALL","23",5166,5417,10583
"24753","MANDERA","ALL","24",5112,5420,10532
"24754","MANDERA","ALL","20-24",35881,36802,72683
"24755","MANDERA","ALL","25",8519,8791,17310
"24756","MANDERA","ALL","26",4822,5106,9928
"24757","MANDERA","ALL","27",4276,4662,8938
"24758","MANDERA","ALL","28",5302,6173,11475
"24759","MANDERA","ALL","29",3516,3742,7258
"24760","MANDERA","ALL","25-29",26435,28474,54909
"24761","MANDERA","ALL","30",10118,9920,20038
"24762","MANDERA","ALL","31",2693,3209,5902
"24763","MANDERA","ALL","32",4344,4543,8887
"24764","MANDERA","ALL","33",2555,2864,5419
"24765","MANDERA","ALL","34",2353,2209,4562
"24766","MANDERA","ALL","30-34",22063,22745,44808
"24767","MANDERA","ALL","35",5085,5213,10298
"24768","MANDERA","ALL","36",2139,2607,4746
"24769","MANDERA","ALL","37",1848,2066,3914
"24770","MANDERA","ALL","38",2728,3160,5888
"24771","MANDERA","ALL","39",1953,2123,4076
"24772","MANDERA","ALL","35-39",13753,15169,28922
"24773","MANDERA","ALL","40",7343,6053,13396
"24774","MANDERA","ALL","41",2246,2364,4610
"24775","MANDERA","ALL","42",2347,1967,4314
"24776","MANDERA","ALL","43",1498,1262,2760
"24777","MANDERA","ALL","44",1053,799,1852
"24778","MANDERA","ALL","40-44",14487,12445,26932
"24779","MANDERA","ALL","45",3547,2739,6286
"24780","MANDERA","ALL","46",1177,941,2118
"24781","MANDERA","ALL","47",1190,992,2182
"24782","MANDERA","ALL","48",1321,1027,2348
"24783","MANDERA","ALL","49",1006,803,1809
"24784","MANDERA","ALL","45-49",8241,6502,14743
"24785","MANDERA","ALL","50",3675,2481,6156
"24786","MANDERA","ALL","51",731,632,1363
"24787","MANDERA","ALL","52",1234,832,2066
"24788","MANDERA","ALL","53",733,618,1351
"24789","MANDERA","ALL","54",914,644,1558
"24790","MANDERA","ALL","50-54",7287,5207,12494
"24791","MANDERA","ALL","55",1337,879,2216
"24792","MANDERA","ALL","56",827,595,1422
"24793","MANDERA","ALL","57",610,530,1140
"24794","MANDERA","ALL","58",708,580,1288
"24795","MANDERA","ALL","59",723,613,1336
"24796","MANDERA","ALL","55-59",4205,3197,7402
"24797","MANDERA","ALL","60",2451,1679,4130
"24798","MANDERA","ALL","61",547,542,1089
"24799","MANDERA","ALL","62",692,354,1046
"24800","MANDERA","ALL","63",511,354,865
"24801","MANDERA","ALL","64",458,254,712
"24802","MANDERA","ALL","60-64",4659,3183,7842
"24803","MANDERA","ALL","65",808,564,1372
"24804","MANDERA","ALL","66",304,258,562
"24805","MANDERA","ALL","67",408,249,657
"24806","MANDERA","ALL","68",304,221,525
"24807","MANDERA","ALL","69",442,234,676
"24808","MANDERA","ALL","65-69",2266,1526,3792
"24809","MANDERA","ALL","70",1312,1082,2394
"24810","MANDERA","ALL","71",257,331,588
"24811","MANDERA","ALL","72",334,187,521
"24812","MANDERA","ALL","73",157,90,247
"24813","MANDERA","ALL","74",186,99,285
"24814","MANDERA","ALL","70-74",2246,1789,4035
"24815","MANDERA","ALL","75",319,206,525
"24816","MANDERA","ALL","76",157,103,260
"24817","MANDERA","ALL","77",146,87,233
"24818","MANDERA","ALL","78",189,98,287
"24819","MANDERA","ALL","79",178,91,269
"24820","MANDERA","ALL","75-79",989,585,1574
"24821","MANDERA","ALL","80",601,547,1148
"24822","MANDERA","ALL","81",151,171,322
"24823","MANDERA","ALL","82",160,63,223
"24824","MANDERA","ALL","83",71,38,109
"24825","MANDERA","ALL","84",82,44,126
"24826","MANDERA","ALL","80-84",1065,863,1928
"24827","MANDERA","ALL","85",134,64,198
"24828","MANDERA","ALL","86",62,47,109
"24829","MANDERA","ALL","87",72,28,100
"24830","MANDERA","ALL","88",54,23,77
"24831","MANDERA","ALL","89",64,44,108
"24832","MANDERA","ALL","85-89",386,206,592
"24833","MANDERA","ALL","90",145,166,311
"24834","MANDERA","ALL","91",36,53,89
"24835","MANDERA","ALL","92",42,22,64
"24836","MANDERA","ALL","93",18,8,26
"24837","MANDERA","ALL","94",20,9,29
"24838","MANDERA","ALL","90-94",261,258,519
"24839","MANDERA","ALL","95",24,18,42
"24840","MANDERA","ALL","96",9,7,16
"24841","MANDERA","ALL","97",6,8,14
"24842","MANDERA","ALL","98",8,6,14
"24843","MANDERA","ALL","99",13,2,15
"24844","MANDERA","ALL","95-99",60,41,101
"24845","MANDERA","ALL","100+",35,39,74
"24846","MANDERA","ALL","Not Stated",3,NA,3
"24847","MANDERA","MANDERA WEST","Total",48166,50130,98296
"24848","MANDERA","MANDERA WEST","0",1090,1333,2423
"24849","MANDERA","MANDERA WEST","1",1534,1683,3217
"24850","MANDERA","MANDERA WEST","2",2655,2985,5640
"24851","MANDERA","MANDERA WEST","3",1731,2006,3737
"24852","MANDERA","MANDERA WEST","4",2695,3134,5829
"24853","MANDERA","MANDERA WEST","0 - 4",9705,11141,20846
"24854","MANDERA","MANDERA WEST","5",1606,1883,3489
"24855","MANDERA","MANDERA WEST","6",2657,3112,5769
"24856","MANDERA","MANDERA WEST","7",1411,1472,2883
"24857","MANDERA","MANDERA WEST","8",2740,2862,5602
"24858","MANDERA","MANDERA WEST","9",1170,1332,2502
"24859","MANDERA","MANDERA WEST","5-9",9584,10661,20245
"24860","MANDERA","MANDERA WEST","10",2610,2728,5338
"24861","MANDERA","MANDERA WEST","11",947,1127,2074
"24862","MANDERA","MANDERA WEST","12",2197,1944,4141
"24863","MANDERA","MANDERA WEST","13",1145,1070,2215
"24864","MANDERA","MANDERA WEST","14",1736,1438,3174
"24865","MANDERA","MANDERA WEST","10 -14",8635,8307,16942
"24866","MANDERA","MANDERA WEST","15",1371,1131,2502
"24867","MANDERA","MANDERA WEST","16",1492,1269,2761
"24868","MANDERA","MANDERA WEST","17",977,851,1828
"24869","MANDERA","MANDERA WEST","18",1335,1234,2569
"24870","MANDERA","MANDERA WEST","19",528,573,1101
"24871","MANDERA","MANDERA WEST","15-19",5703,5058,10761
"24872","MANDERA","MANDERA WEST","20",1300,1469,2769
"24873","MANDERA","MANDERA WEST","21",459,539,998
"24874","MANDERA","MANDERA WEST","22",721,974,1695
"24875","MANDERA","MANDERA WEST","23",445,578,1023
"24876","MANDERA","MANDERA WEST","24",472,632,1104
"24877","MANDERA","MANDERA WEST","20-24",3397,4192,7589
"24878","MANDERA","MANDERA WEST","25",825,1064,1889
"24879","MANDERA","MANDERA WEST","26",452,592,1044
"24880","MANDERA","MANDERA WEST","27",397,553,950
"24881","MANDERA","MANDERA WEST","28",593,709,1302
"24882","MANDERA","MANDERA WEST","29",318,363,681
"24883","MANDERA","MANDERA WEST","25-29",2585,3281,5866
"24884","MANDERA","MANDERA WEST","30",1096,1129,2225
"24885","MANDERA","MANDERA WEST","31",315,368,683
"24886","MANDERA","MANDERA WEST","32",460,458,918
"24887","MANDERA","MANDERA WEST","33",277,316,593
"24888","MANDERA","MANDERA WEST","34",281,257,538
"24889","MANDERA","MANDERA WEST","30-34",2429,2528,4957
"24890","MANDERA","MANDERA WEST","35",546,551,1097
"24891","MANDERA","MANDERA WEST","36",237,279,516
"24892","MANDERA","MANDERA WEST","37",158,214,372
"24893","MANDERA","MANDERA WEST","38",284,351,635
"24894","MANDERA","MANDERA WEST","39",160,179,339
"24895","MANDERA","MANDERA WEST","35-39",1385,1574,2959
"24896","MANDERA","MANDERA WEST","40",781,608,1389
"24897","MANDERA","MANDERA WEST","41",205,180,385
"24898","MANDERA","MANDERA WEST","42",269,215,484
"24899","MANDERA","MANDERA WEST","43",129,102,231
"24900","MANDERA","MANDERA WEST","44",92,86,178
"24901","MANDERA","MANDERA WEST","40-44",1476,1191,2667
"24902","MANDERA","MANDERA WEST","45",381,289,670
"24903","MANDERA","MANDERA WEST","46",109,98,207
"24904","MANDERA","MANDERA WEST","47",117,80,197
"24905","MANDERA","MANDERA WEST","48",113,103,216
"24906","MANDERA","MANDERA WEST","49",74,70,144
"24907","MANDERA","MANDERA WEST","45-49",794,640,1434
"24908","MANDERA","MANDERA WEST","50",388,238,626
"24909","MANDERA","MANDERA WEST","51",54,43,97
"24910","MANDERA","MANDERA WEST","52",134,80,214
"24911","MANDERA","MANDERA WEST","53",69,53,122
"24912","MANDERA","MANDERA WEST","54",93,66,159
"24913","MANDERA","MANDERA WEST","50-54",738,480,1218
"24914","MANDERA","MANDERA WEST","55",131,58,189
"24915","MANDERA","MANDERA WEST","56",79,42,121
"24916","MANDERA","MANDERA WEST","57",60,40,100
"24917","MANDERA","MANDERA WEST","58",66,59,125
"24918","MANDERA","MANDERA WEST","59",75,65,140
"24919","MANDERA","MANDERA WEST","55-59",411,264,675
"24920","MANDERA","MANDERA WEST","60",248,146,394
"24921","MANDERA","MANDERA WEST","61",56,50,106
"24922","MANDERA","MANDERA WEST","62",74,34,108
"24923","MANDERA","MANDERA WEST","63",54,50,104
"24924","MANDERA","MANDERA WEST","64",43,27,70
"24925","MANDERA","MANDERA WEST","60-64",475,307,782
"24926","MANDERA","MANDERA WEST","65",90,46,136
"24927","MANDERA","MANDERA WEST","66",46,29,75
"24928","MANDERA","MANDERA WEST","67",44,24,68
"24929","MANDERA","MANDERA WEST","68",30,21,51
"24930","MANDERA","MANDERA WEST","69",42,17,59
"24931","MANDERA","MANDERA WEST","65-69",252,137,389
"24932","MANDERA","MANDERA WEST","70",171,96,267
"24933","MANDERA","MANDERA WEST","71",26,46,72
"24934","MANDERA","MANDERA WEST","72",40,12,52
"24935","MANDERA","MANDERA WEST","73",14,9,23
"24936","MANDERA","MANDERA WEST","74",21,7,28
"24937","MANDERA","MANDERA WEST","70-74",272,170,442
"24938","MANDERA","MANDERA WEST","75",37,17,54
"24939","MANDERA","MANDERA WEST","76",24,9,33
"24940","MANDERA","MANDERA WEST","77",10,7,17
"24941","MANDERA","MANDERA WEST","78",15,11,26
"24942","MANDERA","MANDERA WEST","79",20,10,30
"24943","MANDERA","MANDERA WEST","75-79",106,54,160
"24944","MANDERA","MANDERA WEST","80",69,52,121
"24945","MANDERA","MANDERA WEST","81",25,25,50
"24946","MANDERA","MANDERA WEST","82",14,6,20
"24947","MANDERA","MANDERA WEST","83",5,4,9
"24948","MANDERA","MANDERA WEST","84",8,4,12
"24949","MANDERA","MANDERA WEST","80-84",121,91,212
"24950","MANDERA","MANDERA WEST","85",20,8,28
"24951","MANDERA","MANDERA WEST","86",5,5,10
"24952","MANDERA","MANDERA WEST","87",5,3,8
"24953","MANDERA","MANDERA WEST","88",11,3,14
"24954","MANDERA","MANDERA WEST","89",13,3,16
"24955","MANDERA","MANDERA WEST","85-89",54,22,76
"24956","MANDERA","MANDERA WEST","90",14,18,32
"24957","MANDERA","MANDERA WEST","91",7,10,17
"24958","MANDERA","MANDERA WEST","92",3,NA,3
"24959","MANDERA","MANDERA WEST","93",2,NA,2
"24960","MANDERA","MANDERA WEST","94",3,NA,3
"24961","MANDERA","MANDERA WEST","90-94",29,28,57
"24962","MANDERA","MANDERA WEST","95",4,2,6
"24963","MANDERA","MANDERA WEST","96",2,1,3
"24964","MANDERA","MANDERA WEST","97",NA,NA,NA
"24965","MANDERA","MANDERA WEST","98",NA,NA,NA
"24966","MANDERA","MANDERA WEST","99",2,NA,2
"24967","MANDERA","MANDERA WEST","95-99",8,3,11
"24968","MANDERA","MANDERA WEST","100+",6,1,7
"24969","MANDERA","MANDERA WEST","Not Stated",1,NA,1
"24970","MANDERA","BANISA","Total",78301,74288,152589
"24971","MANDERA","BANISA","0",1505,1759,3264
"24972","MANDERA","BANISA","1",1990,2272,4262
"24973","MANDERA","BANISA","2",4204,4676,8880
"24974","MANDERA","BANISA","3",2507,2815,5322
"24975","MANDERA","BANISA","4",4360,4779,9139
"24976","MANDERA","BANISA","0 - 4",14566,16301,30867
"24977","MANDERA","BANISA","5",2455,2573,5028
"24978","MANDERA","BANISA","6",4365,4705,9070
"24979","MANDERA","BANISA","7",2030,2120,4150
"24980","MANDERA","BANISA","8",4249,4219,8468
"24981","MANDERA","BANISA","9",1894,1926,3820
"24982","MANDERA","BANISA","5-9",14993,15543,30536
"24983","MANDERA","BANISA","10",4363,3922,8285
"24984","MANDERA","BANISA","11",1536,1709,3245
"24985","MANDERA","BANISA","12",3607,2425,6032
"24986","MANDERA","BANISA","13",1675,1162,2837
"24987","MANDERA","BANISA","14",2650,1751,4401
"24988","MANDERA","BANISA","10 -14",13831,10969,24800
"24989","MANDERA","BANISA","15",2185,1438,3623
"24990","MANDERA","BANISA","16",2314,1563,3877
"24991","MANDERA","BANISA","17",1208,938,2146
"24992","MANDERA","BANISA","18",2350,1873,4223
"24993","MANDERA","BANISA","19",773,849,1622
"24994","MANDERA","BANISA","15-19",8830,6661,15491
"24995","MANDERA","BANISA","20",2460,2293,4753
"24996","MANDERA","BANISA","21",703,750,1453
"24997","MANDERA","BANISA","22",1077,1290,2367
"24998","MANDERA","BANISA","23",684,817,1501
"24999","MANDERA","BANISA","24",815,1066,1881
"25000","MANDERA","BANISA","20-24",5739,6216,11955
"25001","MANDERA","BANISA","25",1389,1668,3057
"25002","MANDERA","BANISA","26",815,1044,1859
"25003","MANDERA","BANISA","27",615,770,1385
"25004","MANDERA","BANISA","28",1006,1446,2452
"25005","MANDERA","BANISA","29",540,736,1276
"25006","MANDERA","BANISA","25-29",4365,5664,10029
"25007","MANDERA","BANISA","30",2102,2150,4252
"25008","MANDERA","BANISA","31",429,501,930
"25009","MANDERA","BANISA","32",785,829,1614
"25010","MANDERA","BANISA","33",449,509,958
"25011","MANDERA","BANISA","34",457,430,887
"25012","MANDERA","BANISA","30-34",4222,4419,8641
"25013","MANDERA","BANISA","35",1005,1065,2070
"25014","MANDERA","BANISA","36",419,586,1005
"25015","MANDERA","BANISA","37",321,359,680
"25016","MANDERA","BANISA","38",611,681,1292
"25017","MANDERA","BANISA","39",340,411,751
"25018","MANDERA","BANISA","35-39",2696,3102,5798
"25019","MANDERA","BANISA","40",1797,1301,3098
"25020","MANDERA","BANISA","41",314,283,597
"25021","MANDERA","BANISA","42",470,326,796
"25022","MANDERA","BANISA","43",282,241,523
"25023","MANDERA","BANISA","44",183,146,329
"25024","MANDERA","BANISA","40-44",3046,2297,5343
"25025","MANDERA","BANISA","45",785,481,1266
"25026","MANDERA","BANISA","46",225,138,363
"25027","MANDERA","BANISA","47",200,129,329
"25028","MANDERA","BANISA","48",301,231,532
"25029","MANDERA","BANISA","49",179,123,302
"25030","MANDERA","BANISA","45-49",1690,1102,2792
"25031","MANDERA","BANISA","50",896,434,1330
"25032","MANDERA","BANISA","51",121,76,197
"25033","MANDERA","BANISA","52",243,120,363
"25034","MANDERA","BANISA","53",114,75,189
"25035","MANDERA","BANISA","54",164,72,236
"25036","MANDERA","BANISA","50-54",1538,777,2315
"25037","MANDERA","BANISA","55",246,101,347
"25038","MANDERA","BANISA","56",180,73,253
"25039","MANDERA","BANISA","57",81,42,123
"25040","MANDERA","BANISA","58",121,61,182
"25041","MANDERA","BANISA","59",88,52,140
"25042","MANDERA","BANISA","55-59",716,329,1045
"25043","MANDERA","BANISA","60",612,255,867
"25044","MANDERA","BANISA","61",65,49,114
"25045","MANDERA","BANISA","62",125,44,169
"25046","MANDERA","BANISA","63",77,33,110
"25047","MANDERA","BANISA","64",67,21,88
"25048","MANDERA","BANISA","60-64",946,402,1348
"25049","MANDERA","BANISA","65",139,66,205
"25050","MANDERA","BANISA","66",33,20,53
"25051","MANDERA","BANISA","67",62,12,74
"25052","MANDERA","BANISA","68",38,22,60
"25053","MANDERA","BANISA","69",61,19,80
"25054","MANDERA","BANISA","65-69",333,139,472
"25055","MANDERA","BANISA","70",266,134,400
"25056","MANDERA","BANISA","71",28,25,53
"25057","MANDERA","BANISA","72",59,14,73
"25058","MANDERA","BANISA","73",23,10,33
"25059","MANDERA","BANISA","74",20,8,28
"25060","MANDERA","BANISA","70-74",396,191,587
"25061","MANDERA","BANISA","75",60,15,75
"25062","MANDERA","BANISA","76",23,8,31
"25063","MANDERA","BANISA","77",12,5,17
"25064","MANDERA","BANISA","78",32,13,45
"25065","MANDERA","BANISA","79",22,13,35
"25066","MANDERA","BANISA","75-79",149,54,203
"25067","MANDERA","BANISA","80",105,54,159
"25068","MANDERA","BANISA","81",24,9,33
"25069","MANDERA","BANISA","82",24,7,31
"25070","MANDERA","BANISA","83",11,1,12
"25071","MANDERA","BANISA","84",8,5,13
"25072","MANDERA","BANISA","80-84",172,76,248
"25073","MANDERA","BANISA","85",15,7,22
"25074","MANDERA","BANISA","86",9,5,14
"25075","MANDERA","BANISA","87",4,1,5
"25076","MANDERA","BANISA","88",6,2,8
"25077","MANDERA","BANISA","89",1,5,6
"25078","MANDERA","BANISA","85-89",35,20,55
"25079","MANDERA","BANISA","90",24,16,40
"25080","MANDERA","BANISA","91",1,1,2
"25081","MANDERA","BANISA","92",3,NA,3
"25082","MANDERA","BANISA","93",2,NA,2
"25083","MANDERA","BANISA","94",1,NA,1
"25084","MANDERA","BANISA","90-94",31,17,48
"25085","MANDERA","BANISA","95",1,5,6
"25086","MANDERA","BANISA","96",2,NA,2
"25087","MANDERA","BANISA","97",NA,1,1
"25088","MANDERA","BANISA","98",1,1,2
"25089","MANDERA","BANISA","99",1,NA,1
"25090","MANDERA","BANISA","95-99",5,7,12
"25091","MANDERA","BANISA","100+",1,2,3
"25092","MANDERA","BANISA","Not Stated",1,NA,1
"25093","MANDERA","KOTULO","Total",35799,36593,72392
"25094","MANDERA","KOTULO","0",877,1214,2091
"25095","MANDERA","KOTULO","1",904,1183,2087
"25096","MANDERA","KOTULO","2",1627,2121,3748
"25097","MANDERA","KOTULO","3",1118,1465,2583
"25098","MANDERA","KOTULO","4",1559,2016,3575
"25099","MANDERA","KOTULO","0 - 4",6085,7999,14084
"25100","MANDERA","KOTULO","5",1147,1371,2518
"25101","MANDERA","KOTULO","6",1540,1982,3522
"25102","MANDERA","KOTULO","7",1003,1283,2286
"25103","MANDERA","KOTULO","8",1640,1887,3527
"25104","MANDERA","KOTULO","9",952,1206,2158
"25105","MANDERA","KOTULO","5-9",6282,7729,14011
"25106","MANDERA","KOTULO","10",1828,2054,3882
"25107","MANDERA","KOTULO","11",766,1058,1824
"25108","MANDERA","KOTULO","12",1717,1281,2998
"25109","MANDERA","KOTULO","13",1071,769,1840
"25110","MANDERA","KOTULO","14",1386,1001,2387
"25111","MANDERA","KOTULO","10 -14",6768,6163,12931
"25112","MANDERA","KOTULO","15",1290,896,2186
"25113","MANDERA","KOTULO","16",1199,894,2093
"25114","MANDERA","KOTULO","17",960,795,1755
"25115","MANDERA","KOTULO","18",1079,843,1922
"25116","MANDERA","KOTULO","19",387,365,752
"25117","MANDERA","KOTULO","15-19",4915,3793,8708
"25118","MANDERA","KOTULO","20",1034,976,2010
"25119","MANDERA","KOTULO","21",386,348,734
"25120","MANDERA","KOTULO","22",509,631,1140
"25121","MANDERA","KOTULO","23",342,383,725
"25122","MANDERA","KOTULO","24",414,415,829
"25123","MANDERA","KOTULO","20-24",2685,2753,5438
"25124","MANDERA","KOTULO","25",652,644,1296
"25125","MANDERA","KOTULO","26",427,486,913
"25126","MANDERA","KOTULO","27",364,373,737
"25127","MANDERA","KOTULO","28",472,494,966
"25128","MANDERA","KOTULO","29",300,264,564
"25129","MANDERA","KOTULO","25-29",2215,2261,4476
"25130","MANDERA","KOTULO","30",737,735,1472
"25131","MANDERA","KOTULO","31",225,290,515
"25132","MANDERA","KOTULO","32",381,411,792
"25133","MANDERA","KOTULO","33",257,256,513
"25134","MANDERA","KOTULO","34",195,187,382
"25135","MANDERA","KOTULO","30-34",1795,1879,3674
"25136","MANDERA","KOTULO","35",437,433,870
"25137","MANDERA","KOTULO","36",191,241,432
"25138","MANDERA","KOTULO","37",157,146,303
"25139","MANDERA","KOTULO","38",264,291,555
"25140","MANDERA","KOTULO","39",178,198,376
"25141","MANDERA","KOTULO","35-39",1227,1309,2536
"25142","MANDERA","KOTULO","40",545,421,966
"25143","MANDERA","KOTULO","41",187,204,391
"25144","MANDERA","KOTULO","42",183,202,385
"25145","MANDERA","KOTULO","43",151,124,275
"25146","MANDERA","KOTULO","44",109,47,156
"25147","MANDERA","KOTULO","40-44",1175,998,2173
"25148","MANDERA","KOTULO","45",315,204,519
"25149","MANDERA","KOTULO","46",100,85,185
"25150","MANDERA","KOTULO","47",86,69,155
"25151","MANDERA","KOTULO","48",122,90,212
"25152","MANDERA","KOTULO","49",93,65,158
"25153","MANDERA","KOTULO","45-49",716,513,1229
"25154","MANDERA","KOTULO","50",259,184,443
"25155","MANDERA","KOTULO","51",66,60,126
"25156","MANDERA","KOTULO","52",103,65,168
"25157","MANDERA","KOTULO","53",79,48,127
"25158","MANDERA","KOTULO","54",82,60,142
"25159","MANDERA","KOTULO","50-54",589,417,1006
"25160","MANDERA","KOTULO","55",121,51,172
"25161","MANDERA","KOTULO","56",70,56,126
"25162","MANDERA","KOTULO","57",50,45,95
"25163","MANDERA","KOTULO","58",65,39,104
"25164","MANDERA","KOTULO","59",54,28,82
"25165","MANDERA","KOTULO","55-59",360,219,579
"25166","MANDERA","KOTULO","60",174,109,283
"25167","MANDERA","KOTULO","61",50,58,108
"25168","MANDERA","KOTULO","62",51,26,77
"25169","MANDERA","KOTULO","63",47,31,78
"25170","MANDERA","KOTULO","64",45,18,63
"25171","MANDERA","KOTULO","60-64",367,242,609
"25172","MANDERA","KOTULO","65",87,34,121
"25173","MANDERA","KOTULO","66",18,17,35
"25174","MANDERA","KOTULO","67",34,22,56
"25175","MANDERA","KOTULO","68",28,14,42
"25176","MANDERA","KOTULO","69",36,11,47
"25177","MANDERA","KOTULO","65-69",203,98,301
"25178","MANDERA","KOTULO","70",95,54,149
"25179","MANDERA","KOTULO","71",31,33,64
"25180","MANDERA","KOTULO","72",26,15,41
"25181","MANDERA","KOTULO","73",18,4,22
"25182","MANDERA","KOTULO","74",9,5,14
"25183","MANDERA","KOTULO","70-74",179,111,290
"25184","MANDERA","KOTULO","75",26,12,38
"25185","MANDERA","KOTULO","76",18,7,25
"25186","MANDERA","KOTULO","77",12,5,17
"25187","MANDERA","KOTULO","78",11,4,15
"25188","MANDERA","KOTULO","79",20,4,24
"25189","MANDERA","KOTULO","75-79",87,32,119
"25190","MANDERA","KOTULO","80",47,24,71
"25191","MANDERA","KOTULO","81",15,9,24
"25192","MANDERA","KOTULO","82",13,4,17
"25193","MANDERA","KOTULO","83",6,2,8
"25194","MANDERA","KOTULO","84",8,1,9
"25195","MANDERA","KOTULO","80-84",89,40,129
"25196","MANDERA","KOTULO","85",12,6,18
"25197","MANDERA","KOTULO","86",6,2,8
"25198","MANDERA","KOTULO","87",8,3,11
"25199","MANDERA","KOTULO","88",7,NA,7
"25200","MANDERA","KOTULO","89",9,3,12
"25201","MANDERA","KOTULO","85-89",42,14,56
"25202","MANDERA","KOTULO","90",7,7,14
"25203","MANDERA","KOTULO","91",1,5,6
"25204","MANDERA","KOTULO","92",1,3,4
"25205","MANDERA","KOTULO","93",2,2,4
"25206","MANDERA","KOTULO","94",3,3,6
"25207","MANDERA","KOTULO","90-94",14,20,34
"25208","MANDERA","KOTULO","95",3,NA,3
"25209","MANDERA","KOTULO","96",NA,1,1
"25210","MANDERA","KOTULO","97",NA,1,1
"25211","MANDERA","KOTULO","98",NA,1,1
"25212","MANDERA","KOTULO","99",1,NA,1
"25213","MANDERA","KOTULO","95-99",4,3,7
"25214","MANDERA","KOTULO","100+",2,NA,2
"25215","MANDERA","KOTULO","Not Stated",NA,NA,NA
"25216","MANDERA","LAFEY","Total",40476,42976,83452
"25217","MANDERA","LAFEY","0",764,1055,1819
"25218","MANDERA","LAFEY","1",1105,1462,2567
"25219","MANDERA","LAFEY","2",1870,2156,4026
"25220","MANDERA","LAFEY","3",1282,1664,2946
"25221","MANDERA","LAFEY","4",1663,1978,3641
"25222","MANDERA","LAFEY","0 - 4",6684,8315,14999
"25223","MANDERA","LAFEY","5",1199,1537,2736
"25224","MANDERA","LAFEY","6",1594,1892,3486
"25225","MANDERA","LAFEY","7",1084,1330,2414
"25226","MANDERA","LAFEY","8",1507,1909,3416
"25227","MANDERA","LAFEY","9",1159,1320,2479
"25228","MANDERA","LAFEY","5-9",6543,7988,14531
"25229","MANDERA","LAFEY","10",1899,2087,3986
"25230","MANDERA","LAFEY","11",932,1134,2066
"25231","MANDERA","LAFEY","12",1574,1515,3089
"25232","MANDERA","LAFEY","13",1088,1092,2180
"25233","MANDERA","LAFEY","14",1331,1286,2617
"25234","MANDERA","LAFEY","10 -14",6824,7114,13938
"25235","MANDERA","LAFEY","15",1461,1399,2860
"25236","MANDERA","LAFEY","16",1355,1373,2728
"25237","MANDERA","LAFEY","17",1493,1672,3165
"25238","MANDERA","LAFEY","18",1269,1237,2506
"25239","MANDERA","LAFEY","19",839,862,1701
"25240","MANDERA","LAFEY","15-19",6417,6543,12960
"25241","MANDERA","LAFEY","20",1658,1459,3117
"25242","MANDERA","LAFEY","21",727,631,1358
"25243","MANDERA","LAFEY","22",656,660,1316
"25244","MANDERA","LAFEY","23",654,649,1303
"25245","MANDERA","LAFEY","24",488,469,957
"25246","MANDERA","LAFEY","20-24",4183,3868,8051
"25247","MANDERA","LAFEY","25",872,832,1704
"25248","MANDERA","LAFEY","26",455,372,827
"25249","MANDERA","LAFEY","27",353,308,661
"25250","MANDERA","LAFEY","28",424,474,898
"25251","MANDERA","LAFEY","29",461,457,918
"25252","MANDERA","LAFEY","25-29",2565,2443,5008
"25253","MANDERA","LAFEY","30",863,885,1748
"25254","MANDERA","LAFEY","31",272,316,588
"25255","MANDERA","LAFEY","32",422,415,837
"25256","MANDERA","LAFEY","33",243,304,547
"25257","MANDERA","LAFEY","34",260,216,476
"25258","MANDERA","LAFEY","30-34",2060,2136,4196
"25259","MANDERA","LAFEY","35",369,372,741
"25260","MANDERA","LAFEY","36",195,208,403
"25261","MANDERA","LAFEY","37",189,198,387
"25262","MANDERA","LAFEY","38",210,218,428
"25263","MANDERA","LAFEY","39",266,303,569
"25264","MANDERA","LAFEY","35-39",1229,1299,2528
"25265","MANDERA","LAFEY","40",541,471,1012
"25266","MANDERA","LAFEY","41",213,239,452
"25267","MANDERA","LAFEY","42",216,200,416
"25268","MANDERA","LAFEY","43",141,116,257
"25269","MANDERA","LAFEY","44",92,82,174
"25270","MANDERA","LAFEY","40-44",1203,1108,2311
"25271","MANDERA","LAFEY","45",202,158,360
"25272","MANDERA","LAFEY","46",97,70,167
"25273","MANDERA","LAFEY","47",100,78,178
"25274","MANDERA","LAFEY","48",106,73,179
"25275","MANDERA","LAFEY","49",111,110,221
"25276","MANDERA","LAFEY","45-49",616,489,1105
"25277","MANDERA","LAFEY","50",266,222,488
"25278","MANDERA","LAFEY","51",92,81,173
"25279","MANDERA","LAFEY","52",100,97,197
"25280","MANDERA","LAFEY","53",74,52,126
"25281","MANDERA","LAFEY","54",81,68,149
"25282","MANDERA","LAFEY","50-54",613,520,1133
"25283","MANDERA","LAFEY","55",101,68,169
"25284","MANDERA","LAFEY","56",54,45,99
"25285","MANDERA","LAFEY","57",63,54,117
"25286","MANDERA","LAFEY","58",58,55,113
"25287","MANDERA","LAFEY","59",103,78,181
"25288","MANDERA","LAFEY","55-59",379,300,679
"25289","MANDERA","LAFEY","60",196,165,361
"25290","MANDERA","LAFEY","61",60,64,124
"25291","MANDERA","LAFEY","62",59,33,92
"25292","MANDERA","LAFEY","63",44,29,73
"25293","MANDERA","LAFEY","64",39,17,56
"25294","MANDERA","LAFEY","60-64",398,308,706
"25295","MANDERA","LAFEY","65",51,41,92
"25296","MANDERA","LAFEY","66",30,20,50
"25297","MANDERA","LAFEY","67",40,22,62
"25298","MANDERA","LAFEY","68",24,20,44
"25299","MANDERA","LAFEY","69",51,37,88
"25300","MANDERA","LAFEY","65-69",196,140,336
"25301","MANDERA","LAFEY","70",134,125,259
"25302","MANDERA","LAFEY","71",37,24,61
"25303","MANDERA","LAFEY","72",32,17,49
"25304","MANDERA","LAFEY","73",11,10,21
"25305","MANDERA","LAFEY","74",32,7,39
"25306","MANDERA","LAFEY","70-74",246,183,429
"25307","MANDERA","LAFEY","75",26,20,46
"25308","MANDERA","LAFEY","76",12,5,17
"25309","MANDERA","LAFEY","77",20,11,31
"25310","MANDERA","LAFEY","78",26,12,38
"25311","MANDERA","LAFEY","79",25,15,40
"25312","MANDERA","LAFEY","75-79",109,63,172
"25313","MANDERA","LAFEY","80",59,64,123
"25314","MANDERA","LAFEY","81",11,13,24
"25315","MANDERA","LAFEY","82",17,8,25
"25316","MANDERA","LAFEY","83",11,5,16
"25317","MANDERA","LAFEY","84",14,7,21
"25318","MANDERA","LAFEY","80-84",112,97,209
"25319","MANDERA","LAFEY","85",16,10,26
"25320","MANDERA","LAFEY","86",5,1,6
"25321","MANDERA","LAFEY","87",13,7,20
"25322","MANDERA","LAFEY","88",4,2,6
"25323","MANDERA","LAFEY","89",11,8,19
"25324","MANDERA","LAFEY","85-89",49,28,77
"25325","MANDERA","LAFEY","90",12,19,31
"25326","MANDERA","LAFEY","91",7,2,9
"25327","MANDERA","LAFEY","92",10,1,11
"25328","MANDERA","LAFEY","93",NA,1,1
"25329","MANDERA","LAFEY","94",2,NA,2
"25330","MANDERA","LAFEY","90-94",31,23,54
"25331","MANDERA","LAFEY","95",3,NA,3
"25332","MANDERA","LAFEY","96",1,1,2
"25333","MANDERA","LAFEY","97",2,1,3
"25334","MANDERA","LAFEY","98",NA,2,2
"25335","MANDERA","LAFEY","99",1,2,3
"25336","MANDERA","LAFEY","95-99",7,6,13
"25337","MANDERA","LAFEY","100+",12,5,17
"25338","MANDERA","LAFEY","Not Stated",NA,NA,NA
"25339","MANDERA","MANDERA CENTRAL","Total",71688,85527,157215
"25340","MANDERA","MANDERA CENTRAL","0",1331,1867,3198
"25341","MANDERA","MANDERA CENTRAL","1",2057,2898,4955
"25342","MANDERA","MANDERA CENTRAL","2",3159,4595,7754
"25343","MANDERA","MANDERA CENTRAL","3",2504,3661,6165
"25344","MANDERA","MANDERA CENTRAL","4",3216,4450,7666
"25345","MANDERA","MANDERA CENTRAL","0 - 4",12267,17471,29738
"25346","MANDERA","MANDERA CENTRAL","5",2568,3538,6106
"25347","MANDERA","MANDERA CENTRAL","6",3215,4617,7832
"25348","MANDERA","MANDERA CENTRAL","7",2259,3066,5325
"25349","MANDERA","MANDERA CENTRAL","8",3331,4484,7815
"25350","MANDERA","MANDERA CENTRAL","9",2102,2727,4829
"25351","MANDERA","MANDERA CENTRAL","5-9",13475,18432,31907
"25352","MANDERA","MANDERA CENTRAL","10",3604,4616,8220
"25353","MANDERA","MANDERA CENTRAL","11",1698,2484,4182
"25354","MANDERA","MANDERA CENTRAL","12",3008,3124,6132
"25355","MANDERA","MANDERA CENTRAL","13",2206,2101,4307
"25356","MANDERA","MANDERA CENTRAL","14",2551,2583,5134
"25357","MANDERA","MANDERA CENTRAL","10 -14",13067,14908,27975
"25358","MANDERA","MANDERA CENTRAL","15",2712,2511,5223
"25359","MANDERA","MANDERA CENTRAL","16",2279,2402,4681
"25360","MANDERA","MANDERA CENTRAL","17",1941,2027,3968
"25361","MANDERA","MANDERA CENTRAL","18",2001,2370,4371
"25362","MANDERA","MANDERA CENTRAL","19",962,1123,2085
"25363","MANDERA","MANDERA CENTRAL","15-19",9895,10433,20328
"25364","MANDERA","MANDERA CENTRAL","20",2149,2455,4604
"25365","MANDERA","MANDERA CENTRAL","21",748,901,1649
"25366","MANDERA","MANDERA CENTRAL","22",1098,1483,2581
"25367","MANDERA","MANDERA CENTRAL","23",786,914,1700
"25368","MANDERA","MANDERA CENTRAL","24",779,944,1723
"25369","MANDERA","MANDERA CENTRAL","20-24",5560,6697,12257
"25370","MANDERA","MANDERA CENTRAL","25",1432,1632,3064
"25371","MANDERA","MANDERA CENTRAL","26",728,818,1546
"25372","MANDERA","MANDERA CENTRAL","27",813,998,1811
"25373","MANDERA","MANDERA CENTRAL","28",782,1010,1792
"25374","MANDERA","MANDERA CENTRAL","29",562,614,1176
"25375","MANDERA","MANDERA CENTRAL","25-29",4317,5072,9389
"25376","MANDERA","MANDERA CENTRAL","30",1588,1669,3257
"25377","MANDERA","MANDERA CENTRAL","31",419,556,975
"25378","MANDERA","MANDERA CENTRAL","32",696,833,1529
"25379","MANDERA","MANDERA CENTRAL","33",410,528,938
"25380","MANDERA","MANDERA CENTRAL","34",339,392,731
"25381","MANDERA","MANDERA CENTRAL","30-34",3452,3978,7430
"25382","MANDERA","MANDERA CENTRAL","35",884,895,1779
"25383","MANDERA","MANDERA CENTRAL","36",324,462,786
"25384","MANDERA","MANDERA CENTRAL","37",312,395,707
"25385","MANDERA","MANDERA CENTRAL","38",491,607,1098
"25386","MANDERA","MANDERA CENTRAL","39",326,369,695
"25387","MANDERA","MANDERA CENTRAL","35-39",2337,2728,5065
"25388","MANDERA","MANDERA CENTRAL","40",1088,942,2030
"25389","MANDERA","MANDERA CENTRAL","41",410,479,889
"25390","MANDERA","MANDERA CENTRAL","42",375,306,681
"25391","MANDERA","MANDERA CENTRAL","43",256,216,472
"25392","MANDERA","MANDERA CENTRAL","44",170,120,290
"25393","MANDERA","MANDERA CENTRAL","40-44",2299,2063,4362
"25394","MANDERA","MANDERA CENTRAL","45",619,460,1079
"25395","MANDERA","MANDERA CENTRAL","46",222,173,395
"25396","MANDERA","MANDERA CENTRAL","47",202,174,376
"25397","MANDERA","MANDERA CENTRAL","48",218,176,394
"25398","MANDERA","MANDERA CENTRAL","49",173,137,310
"25399","MANDERA","MANDERA CENTRAL","45-49",1434,1120,2554
"25400","MANDERA","MANDERA CENTRAL","50",481,359,840
"25401","MANDERA","MANDERA CENTRAL","51",127,123,250
"25402","MANDERA","MANDERA CENTRAL","52",224,100,324
"25403","MANDERA","MANDERA CENTRAL","53",103,85,188
"25404","MANDERA","MANDERA CENTRAL","54",156,111,267
"25405","MANDERA","MANDERA CENTRAL","50-54",1091,778,1869
"25406","MANDERA","MANDERA CENTRAL","55",203,128,331
"25407","MANDERA","MANDERA CENTRAL","56",129,105,234
"25408","MANDERA","MANDERA CENTRAL","57",93,73,166
"25409","MANDERA","MANDERA CENTRAL","58",115,92,207
"25410","MANDERA","MANDERA CENTRAL","59",102,105,207
"25411","MANDERA","MANDERA CENTRAL","55-59",642,503,1145
"25412","MANDERA","MANDERA CENTRAL","60",322,233,555
"25413","MANDERA","MANDERA CENTRAL","61",122,111,233
"25414","MANDERA","MANDERA CENTRAL","62",104,57,161
"25415","MANDERA","MANDERA CENTRAL","63",96,57,153
"25416","MANDERA","MANDERA CENTRAL","64",78,38,116
"25417","MANDERA","MANDERA CENTRAL","60-64",722,496,1218
"25418","MANDERA","MANDERA CENTRAL","65",120,83,203
"25419","MANDERA","MANDERA CENTRAL","66",52,49,101
"25420","MANDERA","MANDERA CENTRAL","67",54,46,100
"25421","MANDERA","MANDERA CENTRAL","68",59,39,98
"25422","MANDERA","MANDERA CENTRAL","69",82,39,121
"25423","MANDERA","MANDERA CENTRAL","65-69",367,256,623
"25424","MANDERA","MANDERA CENTRAL","70",178,114,292
"25425","MANDERA","MANDERA CENTRAL","71",46,90,136
"25426","MANDERA","MANDERA CENTRAL","72",49,40,89
"25427","MANDERA","MANDERA CENTRAL","73",27,16,43
"25428","MANDERA","MANDERA CENTRAL","74",30,17,47
"25429","MANDERA","MANDERA CENTRAL","70-74",330,277,607
"25430","MANDERA","MANDERA CENTRAL","75",42,40,82
"25431","MANDERA","MANDERA CENTRAL","76",26,27,53
"25432","MANDERA","MANDERA CENTRAL","77",14,21,35
"25433","MANDERA","MANDERA CENTRAL","78",38,12,50
"25434","MANDERA","MANDERA CENTRAL","79",28,8,36
"25435","MANDERA","MANDERA CENTRAL","75-79",148,108,256
"25436","MANDERA","MANDERA CENTRAL","80",76,56,132
"25437","MANDERA","MANDERA CENTRAL","81",33,42,75
"25438","MANDERA","MANDERA CENTRAL","82",29,10,39
"25439","MANDERA","MANDERA CENTRAL","83",15,12,27
"25440","MANDERA","MANDERA CENTRAL","84",8,7,15
"25441","MANDERA","MANDERA CENTRAL","80-84",161,127,288
"25442","MANDERA","MANDERA CENTRAL","85",21,6,27
"25443","MANDERA","MANDERA CENTRAL","86",11,14,25
"25444","MANDERA","MANDERA CENTRAL","87",15,6,21
"25445","MANDERA","MANDERA CENTRAL","88",9,2,11
"25446","MANDERA","MANDERA CENTRAL","89",16,4,20
"25447","MANDERA","MANDERA CENTRAL","85-89",72,32,104
"25448","MANDERA","MANDERA CENTRAL","90",14,15,29
"25449","MANDERA","MANDERA CENTRAL","91",10,13,23
"25450","MANDERA","MANDERA CENTRAL","92",5,5,10
"25451","MANDERA","MANDERA CENTRAL","93",2,1,3
"25452","MANDERA","MANDERA CENTRAL","94",4,4,8
"25453","MANDERA","MANDERA CENTRAL","90-94",35,38,73
"25454","MANDERA","MANDERA CENTRAL","95",3,3,6
"25455","MANDERA","MANDERA CENTRAL","96",2,NA,2
"25456","MANDERA","MANDERA CENTRAL","97",NA,1,1
"25457","MANDERA","MANDERA CENTRAL","98",3,1,4
"25458","MANDERA","MANDERA CENTRAL","99",3,NA,3
"25459","MANDERA","MANDERA CENTRAL","95-99",11,5,16
"25460","MANDERA","MANDERA CENTRAL","100+",6,5,11
"25461","MANDERA","MANDERA CENTRAL","Not Stated",NA,NA,NA
"25462","MANDERA","MANDERA EAST","Total",83538,76095,159633
"25463","MANDERA","MANDERA EAST","0",1642,1591,3233
"25464","MANDERA","MANDERA EAST","1",2375,2247,4622
"25465","MANDERA","MANDERA EAST","2",3318,3250,6568
"25466","MANDERA","MANDERA EAST","3",2746,2694,5440
"25467","MANDERA","MANDERA EAST","4",3216,3148,6364
"25468","MANDERA","MANDERA EAST","0 - 4",13297,12930,26227
"25469","MANDERA","MANDERA EAST","5",2679,2553,5232
"25470","MANDERA","MANDERA EAST","6",3261,2980,6241
"25471","MANDERA","MANDERA EAST","7",2422,2349,4771
"25472","MANDERA","MANDERA EAST","8",3249,2961,6210
"25473","MANDERA","MANDERA EAST","9",2115,2072,4187
"25474","MANDERA","MANDERA EAST","5-9",13726,12915,26641
"25475","MANDERA","MANDERA EAST","10",3479,3130,6609
"25476","MANDERA","MANDERA EAST","11",2052,1790,3842
"25477","MANDERA","MANDERA EAST","12",3118,2489,5607
"25478","MANDERA","MANDERA EAST","13",2381,2020,4401
"25479","MANDERA","MANDERA EAST","14",2726,2173,4899
"25480","MANDERA","MANDERA EAST","10 -14",13756,11602,25358
"25481","MANDERA","MANDERA EAST","15",2641,2150,4791
"25482","MANDERA","MANDERA EAST","16",2507,1960,4467
"25483","MANDERA","MANDERA EAST","17",2324,1762,4086
"25484","MANDERA","MANDERA EAST","18",2466,2111,4577
"25485","MANDERA","MANDERA EAST","19",1521,1350,2871
"25486","MANDERA","MANDERA EAST","15-19",11459,9333,20792
"25487","MANDERA","MANDERA EAST","20",2518,2322,4840
"25488","MANDERA","MANDERA EAST","21",1189,1144,2333
"25489","MANDERA","MANDERA EAST","22",1583,1699,3282
"25490","MANDERA","MANDERA EAST","23",1358,1270,2628
"25491","MANDERA","MANDERA EAST","24",1235,1099,2334
"25492","MANDERA","MANDERA EAST","20-24",7883,7534,15417
"25493","MANDERA","MANDERA EAST","25",1925,1684,3609
"25494","MANDERA","MANDERA EAST","26",1188,1084,2272
"25495","MANDERA","MANDERA EAST","27",1086,950,2036
"25496","MANDERA","MANDERA EAST","28",1139,1136,2275
"25497","MANDERA","MANDERA EAST","29",837,731,1568
"25498","MANDERA","MANDERA EAST","25-29",6175,5585,11760
"25499","MANDERA","MANDERA EAST","30",2029,1747,3776
"25500","MANDERA","MANDERA EAST","31",651,689,1340
"25501","MANDERA","MANDERA EAST","32",956,882,1838
"25502","MANDERA","MANDERA EAST","33",579,514,1093
"25503","MANDERA","MANDERA EAST","34",497,372,869
"25504","MANDERA","MANDERA EAST","30-34",4712,4204,8916
"25505","MANDERA","MANDERA EAST","35",1137,1100,2237
"25506","MANDERA","MANDERA EAST","36",437,472,909
"25507","MANDERA","MANDERA EAST","37",447,469,916
"25508","MANDERA","MANDERA EAST","38",502,547,1049
"25509","MANDERA","MANDERA EAST","39",406,353,759
"25510","MANDERA","MANDERA EAST","35-39",2929,2941,5870
"25511","MANDERA","MANDERA EAST","40",1446,1245,2691
"25512","MANDERA","MANDERA EAST","41",508,571,1079
"25513","MANDERA","MANDERA EAST","42",483,418,901
"25514","MANDERA","MANDERA EAST","43",288,255,543
"25515","MANDERA","MANDERA EAST","44",210,171,381
"25516","MANDERA","MANDERA EAST","40-44",2935,2660,5595
"25517","MANDERA","MANDERA EAST","45",700,635,1335
"25518","MANDERA","MANDERA EAST","46",252,210,462
"25519","MANDERA","MANDERA EAST","47",284,286,570
"25520","MANDERA","MANDERA EAST","48",254,171,425
"25521","MANDERA","MANDERA EAST","49",191,161,352
"25522","MANDERA","MANDERA EAST","45-49",1681,1463,3144
"25523","MANDERA","MANDERA EAST","50",684,581,1265
"25524","MANDERA","MANDERA EAST","51",153,158,311
"25525","MANDERA","MANDERA EAST","52",223,211,434
"25526","MANDERA","MANDERA EAST","53",161,181,342
"25527","MANDERA","MANDERA EAST","54",203,170,373
"25528","MANDERA","MANDERA EAST","50-54",1424,1301,2725
"25529","MANDERA","MANDERA EAST","55",322,308,630
"25530","MANDERA","MANDERA EAST","56",173,155,328
"25531","MANDERA","MANDERA EAST","57",166,195,361
"25532","MANDERA","MANDERA EAST","58",145,191,336
"25533","MANDERA","MANDERA EAST","59",182,172,354
"25534","MANDERA","MANDERA EAST","55-59",988,1021,2009
"25535","MANDERA","MANDERA EAST","60",496,483,979
"25536","MANDERA","MANDERA EAST","61",116,125,241
"25537","MANDERA","MANDERA EAST","62",155,101,256
"25538","MANDERA","MANDERA EAST","63",105,93,198
"25539","MANDERA","MANDERA EAST","64",112,69,181
"25540","MANDERA","MANDERA EAST","60-64",984,871,1855
"25541","MANDERA","MANDERA EAST","65",208,193,401
"25542","MANDERA","MANDERA EAST","66",67,73,140
"25543","MANDERA","MANDERA EAST","67",104,81,185
"25544","MANDERA","MANDERA EAST","68",67,68,135
"25545","MANDERA","MANDERA EAST","69",84,72,156
"25546","MANDERA","MANDERA EAST","65-69",530,487,1017
"25547","MANDERA","MANDERA EAST","70",263,400,663
"25548","MANDERA","MANDERA EAST","71",51,60,111
"25549","MANDERA","MANDERA EAST","72",65,42,107
"25550","MANDERA","MANDERA EAST","73",38,30,68
"25551","MANDERA","MANDERA EAST","74",33,39,72
"25552","MANDERA","MANDERA EAST","70-74",450,571,1021
"25553","MANDERA","MANDERA EAST","75",78,81,159
"25554","MANDERA","MANDERA EAST","76",28,27,55
"25555","MANDERA","MANDERA EAST","77",45,30,75
"25556","MANDERA","MANDERA EAST","78",37,27,64
"25557","MANDERA","MANDERA EAST","79",34,25,59
"25558","MANDERA","MANDERA EAST","75-79",222,190,412
"25559","MANDERA","MANDERA EAST","80",129,217,346
"25560","MANDERA","MANDERA EAST","81",20,38,58
"25561","MANDERA","MANDERA EAST","82",35,19,54
"25562","MANDERA","MANDERA EAST","83",14,11,25
"25563","MANDERA","MANDERA EAST","84",22,13,35
"25564","MANDERA","MANDERA EAST","80-84",220,298,518
"25565","MANDERA","MANDERA EAST","85",36,19,55
"25566","MANDERA","MANDERA EAST","86",13,14,27
"25567","MANDERA","MANDERA EAST","87",23,4,27
"25568","MANDERA","MANDERA EAST","88",13,12,25
"25569","MANDERA","MANDERA EAST","89",8,12,20
"25570","MANDERA","MANDERA EAST","85-89",93,61,154
"25571","MANDERA","MANDERA EAST","90",30,66,96
"25572","MANDERA","MANDERA EAST","91",3,14,17
"25573","MANDERA","MANDERA EAST","92",9,8,17
"25574","MANDERA","MANDERA EAST","93",5,4,9
"25575","MANDERA","MANDERA EAST","94",2,2,4
"25576","MANDERA","MANDERA EAST","90-94",49,94,143
"25577","MANDERA","MANDERA EAST","95",6,7,13
"25578","MANDERA","MANDERA EAST","96",1,3,4
"25579","MANDERA","MANDERA EAST","97",2,3,5
"25580","MANDERA","MANDERA EAST","98",4,1,5
"25581","MANDERA","MANDERA EAST","99",3,NA,3
"25582","MANDERA","MANDERA EAST","95-99",16,14,30
"25583","MANDERA","MANDERA EAST","100+",8,20,28
"25584","MANDERA","MANDERA EAST","Not Stated",1,NA,1
"25585","MANDERA","MANDERA NORTH","Total",77008,66835,143843
"25586","MANDERA","MANDERA NORTH","0",1050,1249,2299
"25587","MANDERA","MANDERA NORTH","1",1928,2009,3937
"25588","MANDERA","MANDERA NORTH","2",3194,3349,6543
"25589","MANDERA","MANDERA NORTH","3",2246,2397,4643
"25590","MANDERA","MANDERA NORTH","4",3507,3401,6908
"25591","MANDERA","MANDERA NORTH","0 - 4",11925,12405,24330
"25592","MANDERA","MANDERA NORTH","5",2304,2299,4603
"25593","MANDERA","MANDERA NORTH","6",3638,3455,7093
"25594","MANDERA","MANDERA NORTH","7",2072,2015,4087
"25595","MANDERA","MANDERA NORTH","8",3955,3557,7512
"25596","MANDERA","MANDERA NORTH","9",2013,1980,3993
"25597","MANDERA","MANDERA NORTH","5-9",13982,13306,27288
"25598","MANDERA","MANDERA NORTH","10",4508,3727,8235
"25599","MANDERA","MANDERA NORTH","11",1769,1888,3657
"25600","MANDERA","MANDERA NORTH","12",3989,2588,6577
"25601","MANDERA","MANDERA NORTH","13",2198,1562,3760
"25602","MANDERA","MANDERA NORTH","14",3280,2020,5300
"25603","MANDERA","MANDERA NORTH","10 -14",15744,11785,27529
"25604","MANDERA","MANDERA NORTH","15",2970,1739,4709
"25605","MANDERA","MANDERA NORTH","16",2889,1871,4760
"25606","MANDERA","MANDERA NORTH","17",2354,1490,3844
"25607","MANDERA","MANDERA NORTH","18",2459,1743,4202
"25608","MANDERA","MANDERA NORTH","19",1024,765,1789
"25609","MANDERA","MANDERA NORTH","15-19",11696,7608,19304
"25610","MANDERA","MANDERA NORTH","20",2603,1978,4581
"25611","MANDERA","MANDERA NORTH","21",796,736,1532
"25612","MANDERA","MANDERA NORTH","22",1229,1227,2456
"25613","MANDERA","MANDERA NORTH","23",897,806,1703
"25614","MANDERA","MANDERA NORTH","24",909,795,1704
"25615","MANDERA","MANDERA NORTH","20-24",6434,5542,11976
"25616","MANDERA","MANDERA NORTH","25",1424,1267,2691
"25617","MANDERA","MANDERA NORTH","26",757,710,1467
"25618","MANDERA","MANDERA NORTH","27",648,710,1358
"25619","MANDERA","MANDERA NORTH","28",886,904,1790
"25620","MANDERA","MANDERA NORTH","29",498,577,1075
"25621","MANDERA","MANDERA NORTH","25-29",4213,4168,8381
"25622","MANDERA","MANDERA NORTH","30",1703,1605,3308
"25623","MANDERA","MANDERA NORTH","31",382,489,871
"25624","MANDERA","MANDERA NORTH","32",644,715,1359
"25625","MANDERA","MANDERA NORTH","33",340,437,777
"25626","MANDERA","MANDERA NORTH","34",324,355,679
"25627","MANDERA","MANDERA NORTH","30-34",3393,3601,6994
"25628","MANDERA","MANDERA NORTH","35",707,797,1504
"25629","MANDERA","MANDERA NORTH","36",336,359,695
"25630","MANDERA","MANDERA NORTH","37",264,285,549
"25631","MANDERA","MANDERA NORTH","38",366,465,831
"25632","MANDERA","MANDERA NORTH","39",277,310,587
"25633","MANDERA","MANDERA NORTH","35-39",1950,2216,4166
"25634","MANDERA","MANDERA NORTH","40",1145,1065,2210
"25635","MANDERA","MANDERA NORTH","41",409,408,817
"25636","MANDERA","MANDERA NORTH","42",351,300,651
"25637","MANDERA","MANDERA NORTH","43",251,208,459
"25638","MANDERA","MANDERA NORTH","44",197,147,344
"25639","MANDERA","MANDERA NORTH","40-44",2353,2128,4481
"25640","MANDERA","MANDERA NORTH","45",545,512,1057
"25641","MANDERA","MANDERA NORTH","46",172,167,339
"25642","MANDERA","MANDERA NORTH","47",201,176,377
"25643","MANDERA","MANDERA NORTH","48",207,183,390
"25644","MANDERA","MANDERA NORTH","49",185,137,322
"25645","MANDERA","MANDERA NORTH","45-49",1310,1175,2485
"25646","MANDERA","MANDERA NORTH","50",701,463,1164
"25647","MANDERA","MANDERA NORTH","51",118,91,209
"25648","MANDERA","MANDERA NORTH","52",207,159,366
"25649","MANDERA","MANDERA NORTH","53",133,124,257
"25650","MANDERA","MANDERA NORTH","54",135,97,232
"25651","MANDERA","MANDERA NORTH","50-54",1294,934,2228
"25652","MANDERA","MANDERA NORTH","55",213,165,378
"25653","MANDERA","MANDERA NORTH","56",142,119,261
"25654","MANDERA","MANDERA NORTH","57",97,81,178
"25655","MANDERA","MANDERA NORTH","58",138,83,221
"25656","MANDERA","MANDERA NORTH","59",119,113,232
"25657","MANDERA","MANDERA NORTH","55-59",709,561,1270
"25658","MANDERA","MANDERA NORTH","60",403,288,691
"25659","MANDERA","MANDERA NORTH","61",78,85,163
"25660","MANDERA","MANDERA NORTH","62",124,59,183
"25661","MANDERA","MANDERA NORTH","63",88,61,149
"25662","MANDERA","MANDERA NORTH","64",74,64,138
"25663","MANDERA","MANDERA NORTH","60-64",767,557,1324
"25664","MANDERA","MANDERA NORTH","65",113,101,214
"25665","MANDERA","MANDERA NORTH","66",58,50,108
"25666","MANDERA","MANDERA NORTH","67",70,42,112
"25667","MANDERA","MANDERA NORTH","68",58,37,95
"25668","MANDERA","MANDERA NORTH","69",86,39,125
"25669","MANDERA","MANDERA NORTH","65-69",385,269,654
"25670","MANDERA","MANDERA NORTH","70",205,159,364
"25671","MANDERA","MANDERA NORTH","71",38,53,91
"25672","MANDERA","MANDERA NORTH","72",63,47,110
"25673","MANDERA","MANDERA NORTH","73",26,11,37
"25674","MANDERA","MANDERA NORTH","74",41,16,57
"25675","MANDERA","MANDERA NORTH","70-74",373,286,659
"25676","MANDERA","MANDERA NORTH","75",50,21,71
"25677","MANDERA","MANDERA NORTH","76",26,20,46
"25678","MANDERA","MANDERA NORTH","77",33,8,41
"25679","MANDERA","MANDERA NORTH","78",30,19,49
"25680","MANDERA","MANDERA NORTH","79",29,16,45
"25681","MANDERA","MANDERA NORTH","75-79",168,84,252
"25682","MANDERA","MANDERA NORTH","80",116,80,196
"25683","MANDERA","MANDERA NORTH","81",23,35,58
"25684","MANDERA","MANDERA NORTH","82",28,9,37
"25685","MANDERA","MANDERA NORTH","83",9,3,12
"25686","MANDERA","MANDERA NORTH","84",14,7,21
"25687","MANDERA","MANDERA NORTH","80-84",190,134,324
"25688","MANDERA","MANDERA NORTH","85",14,8,22
"25689","MANDERA","MANDERA NORTH","86",13,6,19
"25690","MANDERA","MANDERA NORTH","87",4,4,8
"25691","MANDERA","MANDERA NORTH","88",4,2,6
"25692","MANDERA","MANDERA NORTH","89",6,9,15
"25693","MANDERA","MANDERA NORTH","85-89",41,29,70
"25694","MANDERA","MANDERA NORTH","90",44,25,69
"25695","MANDERA","MANDERA NORTH","91",7,8,15
"25696","MANDERA","MANDERA NORTH","92",11,5,16
"25697","MANDERA","MANDERA NORTH","93",5,NA,5
"25698","MANDERA","MANDERA NORTH","94",5,NA,5
"25699","MANDERA","MANDERA NORTH","90-94",72,38,110
"25700","MANDERA","MANDERA NORTH","95",4,1,5
"25701","MANDERA","MANDERA NORTH","96",1,1,2
"25702","MANDERA","MANDERA NORTH","97",2,1,3
"25703","MANDERA","MANDERA NORTH","98",NA,NA,NA
"25704","MANDERA","MANDERA NORTH","99",2,NA,2
"25705","MANDERA","MANDERA NORTH","95-99",9,3,12
"25706","MANDERA","MANDERA NORTH","100+",NA,6,6
"25707","MANDERA","MANDERA NORTH","Not Stated",NA,NA,NA
"25708","MARSABIT","ALL","Total",243548,216219,459767
"25709","MARSABIT","ALL","0",5308,5244,10552
"25710","MARSABIT","ALL","1",6108,5906,12014
"25711","MARSABIT","ALL","2",7681,7409,15090
"25712","MARSABIT","ALL","3",7749,7520,15269
"25713","MARSABIT","ALL","4",8350,7885,16235
"25714","MARSABIT","ALL","0 - 4",35196,33964,69160
"25715","MARSABIT","ALL","5",8032,7705,15737
"25716","MARSABIT","ALL","6",8525,8122,16647
"25717","MARSABIT","ALL","7",7044,6726,13770
"25718","MARSABIT","ALL","8",8651,8575,17226
"25719","MARSABIT","ALL","9",5983,5853,11836
"25720","MARSABIT","ALL","5-9",38235,36981,75216
"25721","MARSABIT","ALL","10",10725,9901,20626
"25722","MARSABIT","ALL","11",4799,5290,10089
"25723","MARSABIT","ALL","12",9087,7101,16188
"25724","MARSABIT","ALL","13",6406,5464,11870
"25725","MARSABIT","ALL","14",6932,5726,12658
"25726","MARSABIT","ALL","10 -14",37949,33482,71431
"25727","MARSABIT","ALL","15",8790,6622,15412
"25728","MARSABIT","ALL","16",6410,5030,11440
"25729","MARSABIT","ALL","17",6708,4736,11444
"25730","MARSABIT","ALL","18",6531,5260,11791
"25731","MARSABIT","ALL","19",3919,3193,7112
"25732","MARSABIT","ALL","15-19",32358,24841,57199
"25733","MARSABIT","ALL","20",7731,6336,14067
"25734","MARSABIT","ALL","21",3544,3093,6637
"25735","MARSABIT","ALL","22",4078,3932,8010
"25736","MARSABIT","ALL","23",3783,3611,7394
"25737","MARSABIT","ALL","24",3609,3237,6846
"25738","MARSABIT","ALL","20-24",22745,20209,42954
"25739","MARSABIT","ALL","25",5900,5229,11129
"25740","MARSABIT","ALL","26",3236,2799,6035
"25741","MARSABIT","ALL","27",3135,2711,5846
"25742","MARSABIT","ALL","28",3503,2953,6456
"25743","MARSABIT","ALL","29",2798,2447,5245
"25744","MARSABIT","ALL","25-29",18572,16139,34711
"25745","MARSABIT","ALL","30",6351,4987,11338
"25746","MARSABIT","ALL","31",1938,2176,4114
"25747","MARSABIT","ALL","32",2679,2341,5020
"25748","MARSABIT","ALL","33",2005,1945,3950
"25749","MARSABIT","ALL","34",1770,1664,3434
"25750","MARSABIT","ALL","30-34",14743,13113,27856
"25751","MARSABIT","ALL","35",3421,2872,6293
"25752","MARSABIT","ALL","36",1756,1602,3358
"25753","MARSABIT","ALL","37",1644,1384,3028
"25754","MARSABIT","ALL","38",1477,1206,2683
"25755","MARSABIT","ALL","39",1174,893,2067
"25756","MARSABIT","ALL","35-39",9472,7957,17429
"25757","MARSABIT","ALL","40",3807,2588,6395
"25758","MARSABIT","ALL","41",1681,1696,3377
"25759","MARSABIT","ALL","42",1409,1032,2441
"25760","MARSABIT","ALL","43",1151,923,2074
"25761","MARSABIT","ALL","44",670,558,1228
"25762","MARSABIT","ALL","40-44",8718,6797,15515
"25763","MARSABIT","ALL","45",2406,2033,4439
"25764","MARSABIT","ALL","46",998,1004,2002
"25765","MARSABIT","ALL","47",991,850,1841
"25766","MARSABIT","ALL","48",857,677,1534
"25767","MARSABIT","ALL","49",714,645,1359
"25768","MARSABIT","ALL","45-49",5966,5209,11175
"25769","MARSABIT","ALL","50",2392,1927,4319
"25770","MARSABIT","ALL","51",655,703,1358
"25771","MARSABIT","ALL","52",917,764,1681
"25772","MARSABIT","ALL","53",539,485,1024
"25773","MARSABIT","ALL","54",738,611,1349
"25774","MARSABIT","ALL","50-54",5241,4490,9731
"25775","MARSABIT","ALL","55",999,829,1828
"25776","MARSABIT","ALL","56",711,576,1287
"25777","MARSABIT","ALL","57",602,560,1162
"25778","MARSABIT","ALL","58",642,612,1254
"25779","MARSABIT","ALL","59",612,750,1362
"25780","MARSABIT","ALL","55-59",3566,3327,6893
"25781","MARSABIT","ALL","60",1847,1430,3277
"25782","MARSABIT","ALL","61",484,570,1054
"25783","MARSABIT","ALL","62",453,409,862
"25784","MARSABIT","ALL","63",428,383,811
"25785","MARSABIT","ALL","64",314,286,600
"25786","MARSABIT","ALL","60-64",3526,3078,6604
"25787","MARSABIT","ALL","65",701,585,1286
"25788","MARSABIT","ALL","66",302,349,651
"25789","MARSABIT","ALL","67",389,292,681
"25790","MARSABIT","ALL","68",326,231,557
"25791","MARSABIT","ALL","69",375,463,838
"25792","MARSABIT","ALL","65-69",2093,1920,4013
"25793","MARSABIT","ALL","70",1317,1116,2433
"25794","MARSABIT","ALL","71",321,441,762
"25795","MARSABIT","ALL","72",334,253,587
"25796","MARSABIT","ALL","73",216,190,406
"25797","MARSABIT","ALL","74",234,194,428
"25798","MARSABIT","ALL","70-74",2422,2194,4616
"25799","MARSABIT","ALL","75",325,261,586
"25800","MARSABIT","ALL","76",173,153,326
"25801","MARSABIT","ALL","77",143,97,240
"25802","MARSABIT","ALL","78",140,105,245
"25803","MARSABIT","ALL","79",154,192,346
"25804","MARSABIT","ALL","75-79",935,808,1743
"25805","MARSABIT","ALL","80",549,512,1061
"25806","MARSABIT","ALL","81",139,197,336
"25807","MARSABIT","ALL","82",126,88,214
"25808","MARSABIT","ALL","83",66,62,128
"25809","MARSABIT","ALL","84",90,91,181
"25810","MARSABIT","ALL","80-84",970,950,1920
"25811","MARSABIT","ALL","85",109,86,195
"25812","MARSABIT","ALL","86",72,59,131
"25813","MARSABIT","ALL","87",62,52,114
"25814","MARSABIT","ALL","88",44,24,68
"25815","MARSABIT","ALL","89",78,99,177
"25816","MARSABIT","ALL","85-89",365,320,685
"25817","MARSABIT","ALL","90",194,160,354
"25818","MARSABIT","ALL","91",41,46,87
"25819","MARSABIT","ALL","92",44,28,72
"25820","MARSABIT","ALL","93",14,15,29
"25821","MARSABIT","ALL","94",21,19,40
"25822","MARSABIT","ALL","90-94",314,268,582
"25823","MARSABIT","ALL","95",26,31,57
"25824","MARSABIT","ALL","96",18,13,31
"25825","MARSABIT","ALL","97",12,7,19
"25826","MARSABIT","ALL","98",14,17,31
"25827","MARSABIT","ALL","99",14,12,26
"25828","MARSABIT","ALL","95-99",84,80,164
"25829","MARSABIT","ALL","100+",74,90,164
"25830","MARSABIT","ALL","Not Stated",4,2,6
"25831","MARSABIT","LOIYANGALANI","Total",17659,18051,35710
"25832","MARSABIT","LOIYANGALANI","0",519,504,1023
"25833","MARSABIT","LOIYANGALANI","1",622,598,1220
"25834","MARSABIT","LOIYANGALANI","2",737,720,1457
"25835","MARSABIT","LOIYANGALANI","3",793,679,1472
"25836","MARSABIT","LOIYANGALANI","4",724,721,1445
"25837","MARSABIT","LOIYANGALANI","0 - 4",3395,3222,6617
"25838","MARSABIT","LOIYANGALANI","5",767,773,1540
"25839","MARSABIT","LOIYANGALANI","6",713,732,1445
"25840","MARSABIT","LOIYANGALANI","7",581,616,1197
"25841","MARSABIT","LOIYANGALANI","8",671,686,1357
"25842","MARSABIT","LOIYANGALANI","9",453,450,903
"25843","MARSABIT","LOIYANGALANI","5-9",3185,3257,6442
"25844","MARSABIT","LOIYANGALANI","10",893,846,1739
"25845","MARSABIT","LOIYANGALANI","11",276,332,608
"25846","MARSABIT","LOIYANGALANI","12",654,597,1251
"25847","MARSABIT","LOIYANGALANI","13",412,418,830
"25848","MARSABIT","LOIYANGALANI","14",439,379,818
"25849","MARSABIT","LOIYANGALANI","10 -14",2674,2572,5246
"25850","MARSABIT","LOIYANGALANI","15",570,448,1018
"25851","MARSABIT","LOIYANGALANI","16",337,252,589
"25852","MARSABIT","LOIYANGALANI","17",319,218,537
"25853","MARSABIT","LOIYANGALANI","18",337,294,631
"25854","MARSABIT","LOIYANGALANI","19",215,203,418
"25855","MARSABIT","LOIYANGALANI","15-19",1778,1415,3193
"25856","MARSABIT","LOIYANGALANI","20",400,449,849
"25857","MARSABIT","LOIYANGALANI","21",177,226,403
"25858","MARSABIT","LOIYANGALANI","22",220,328,548
"25859","MARSABIT","LOIYANGALANI","23",210,302,512
"25860","MARSABIT","LOIYANGALANI","24",257,242,499
"25861","MARSABIT","LOIYANGALANI","20-24",1264,1547,2811
"25862","MARSABIT","LOIYANGALANI","25",377,445,822
"25863","MARSABIT","LOIYANGALANI","26",196,216,412
"25864","MARSABIT","LOIYANGALANI","27",157,211,368
"25865","MARSABIT","LOIYANGALANI","28",217,204,421
"25866","MARSABIT","LOIYANGALANI","29",229,296,525
"25867","MARSABIT","LOIYANGALANI","25-29",1176,1372,2548
"25868","MARSABIT","LOIYANGALANI","30",532,499,1031
"25869","MARSABIT","LOIYANGALANI","31",152,229,381
"25870","MARSABIT","LOIYANGALANI","32",189,224,413
"25871","MARSABIT","LOIYANGALANI","33",144,190,334
"25872","MARSABIT","LOIYANGALANI","34",146,185,331
"25873","MARSABIT","LOIYANGALANI","30-34",1163,1327,2490
"25874","MARSABIT","LOIYANGALANI","35",249,227,476
"25875","MARSABIT","LOIYANGALANI","36",114,171,285
"25876","MARSABIT","LOIYANGALANI","37",126,89,215
"25877","MARSABIT","LOIYANGALANI","38",89,77,166
"25878","MARSABIT","LOIYANGALANI","39",77,59,136
"25879","MARSABIT","LOIYANGALANI","35-39",655,623,1278
"25880","MARSABIT","LOIYANGALANI","40",248,200,448
"25881","MARSABIT","LOIYANGALANI","41",112,162,274
"25882","MARSABIT","LOIYANGALANI","42",92,107,199
"25883","MARSABIT","LOIYANGALANI","43",71,58,129
"25884","MARSABIT","LOIYANGALANI","44",38,25,63
"25885","MARSABIT","LOIYANGALANI","40-44",561,552,1113
"25886","MARSABIT","LOIYANGALANI","45",170,195,365
"25887","MARSABIT","LOIYANGALANI","46",75,127,202
"25888","MARSABIT","LOIYANGALANI","47",60,76,136
"25889","MARSABIT","LOIYANGALANI","48",37,64,101
"25890","MARSABIT","LOIYANGALANI","49",69,71,140
"25891","MARSABIT","LOIYANGALANI","45-49",411,533,944
"25892","MARSABIT","LOIYANGALANI","50",182,153,335
"25893","MARSABIT","LOIYANGALANI","51",52,115,167
"25894","MARSABIT","LOIYANGALANI","52",58,56,114
"25895","MARSABIT","LOIYANGALANI","53",25,24,49
"25896","MARSABIT","LOIYANGALANI","54",44,72,116
"25897","MARSABIT","LOIYANGALANI","50-54",361,420,781
"25898","MARSABIT","LOIYANGALANI","55",71,53,124
"25899","MARSABIT","LOIYANGALANI","56",49,50,99
"25900","MARSABIT","LOIYANGALANI","57",31,31,62
"25901","MARSABIT","LOIYANGALANI","58",50,44,94
"25902","MARSABIT","LOIYANGALANI","59",54,80,134
"25903","MARSABIT","LOIYANGALANI","55-59",255,258,513
"25904","MARSABIT","LOIYANGALANI","60",138,122,260
"25905","MARSABIT","LOIYANGALANI","61",31,51,82
"25906","MARSABIT","LOIYANGALANI","62",27,43,70
"25907","MARSABIT","LOIYANGALANI","63",37,42,79
"25908","MARSABIT","LOIYANGALANI","64",17,28,45
"25909","MARSABIT","LOIYANGALANI","60-64",250,286,536
"25910","MARSABIT","LOIYANGALANI","65",46,56,102
"25911","MARSABIT","LOIYANGALANI","66",18,22,40
"25912","MARSABIT","LOIYANGALANI","67",25,34,59
"25913","MARSABIT","LOIYANGALANI","68",15,16,31
"25914","MARSABIT","LOIYANGALANI","69",42,71,113
"25915","MARSABIT","LOIYANGALANI","65-69",146,199,345
"25916","MARSABIT","LOIYANGALANI","70",86,103,189
"25917","MARSABIT","LOIYANGALANI","71",34,56,90
"25918","MARSABIT","LOIYANGALANI","72",27,46,73
"25919","MARSABIT","LOIYANGALANI","73",28,34,62
"25920","MARSABIT","LOIYANGALANI","74",25,32,57
"25921","MARSABIT","LOIYANGALANI","70-74",200,271,471
"25922","MARSABIT","LOIYANGALANI","75",27,28,55
"25923","MARSABIT","LOIYANGALANI","76",13,16,29
"25924","MARSABIT","LOIYANGALANI","77",11,15,26
"25925","MARSABIT","LOIYANGALANI","78",8,10,18
"25926","MARSABIT","LOIYANGALANI","79",11,14,25
"25927","MARSABIT","LOIYANGALANI","75-79",70,83,153
"25928","MARSABIT","LOIYANGALANI","80",25,27,52
"25929","MARSABIT","LOIYANGALANI","81",7,10,17
"25930","MARSABIT","LOIYANGALANI","82",8,11,19
"25931","MARSABIT","LOIYANGALANI","83",5,3,8
"25932","MARSABIT","LOIYANGALANI","84",13,5,18
"25933","MARSABIT","LOIYANGALANI","80-84",58,56,114
"25934","MARSABIT","LOIYANGALANI","85",7,5,12
"25935","MARSABIT","LOIYANGALANI","86",3,7,10
"25936","MARSABIT","LOIYANGALANI","87",7,6,13
"25937","MARSABIT","LOIYANGALANI","88",4,NA,4
"25938","MARSABIT","LOIYANGALANI","89",12,14,26
"25939","MARSABIT","LOIYANGALANI","85-89",33,32,65
"25940","MARSABIT","LOIYANGALANI","90",5,13,18
"25941","MARSABIT","LOIYANGALANI","91",1,NA,1
"25942","MARSABIT","LOIYANGALANI","92",4,NA,4
"25943","MARSABIT","LOIYANGALANI","93",1,2,3
"25944","MARSABIT","LOIYANGALANI","94",2,3,5
"25945","MARSABIT","LOIYANGALANI","90-94",13,18,31
"25946","MARSABIT","LOIYANGALANI","95",4,2,6
"25947","MARSABIT","LOIYANGALANI","96",2,1,3
"25948","MARSABIT","LOIYANGALANI","97",2,1,3
"25949","MARSABIT","LOIYANGALANI","98",2,1,3
"25950","MARSABIT","LOIYANGALANI","99",1,1,2
"25951","MARSABIT","LOIYANGALANI","95-99",11,6,17
"25952","MARSABIT","LOIYANGALANI","100+",NA,2,2
"25953","MARSABIT","LOIYANGALANI","Not Stated",NA,NA,NA
"25954","MARSABIT","MARSABIT CENTRAL","Total",40956,38214,79170
"25955","MARSABIT","MARSABIT CENTRAL","0",908,931,1839
"25956","MARSABIT","MARSABIT CENTRAL","1",1105,1138,2243
"25957","MARSABIT","MARSABIT CENTRAL","2",1260,1252,2512
"25958","MARSABIT","MARSABIT CENTRAL","3",1263,1256,2519
"25959","MARSABIT","MARSABIT CENTRAL","4",1264,1218,2482
"25960","MARSABIT","MARSABIT CENTRAL","0 - 4",5800,5795,11595
"25961","MARSABIT","MARSABIT CENTRAL","5",1357,1284,2641
"25962","MARSABIT","MARSABIT CENTRAL","6",1264,1134,2398
"25963","MARSABIT","MARSABIT CENTRAL","7",1178,1112,2290
"25964","MARSABIT","MARSABIT CENTRAL","8",1233,1224,2457
"25965","MARSABIT","MARSABIT CENTRAL","9",976,951,1927
"25966","MARSABIT","MARSABIT CENTRAL","5-9",6008,5705,11713
"25967","MARSABIT","MARSABIT CENTRAL","10",1481,1418,2899
"25968","MARSABIT","MARSABIT CENTRAL","11",805,886,1691
"25969","MARSABIT","MARSABIT CENTRAL","12",1264,1161,2425
"25970","MARSABIT","MARSABIT CENTRAL","13",1143,1041,2184
"25971","MARSABIT","MARSABIT CENTRAL","14",1139,1038,2177
"25972","MARSABIT","MARSABIT CENTRAL","10 -14",5832,5544,11376
"25973","MARSABIT","MARSABIT CENTRAL","15",1332,1173,2505
"25974","MARSABIT","MARSABIT CENTRAL","16",1033,917,1950
"25975","MARSABIT","MARSABIT CENTRAL","17",1177,1145,2322
"25976","MARSABIT","MARSABIT CENTRAL","18",991,951,1942
"25977","MARSABIT","MARSABIT CENTRAL","19",697,675,1372
"25978","MARSABIT","MARSABIT CENTRAL","15-19",5230,4861,10091
"25979","MARSABIT","MARSABIT CENTRAL","20",1132,1155,2287
"25980","MARSABIT","MARSABIT CENTRAL","21",755,703,1458
"25981","MARSABIT","MARSABIT CENTRAL","22",721,783,1504
"25982","MARSABIT","MARSABIT CENTRAL","23",710,730,1440
"25983","MARSABIT","MARSABIT CENTRAL","24",632,652,1284
"25984","MARSABIT","MARSABIT CENTRAL","20-24",3950,4023,7973
"25985","MARSABIT","MARSABIT CENTRAL","25",1043,941,1984
"25986","MARSABIT","MARSABIT CENTRAL","26",637,520,1157
"25987","MARSABIT","MARSABIT CENTRAL","27",645,562,1207
"25988","MARSABIT","MARSABIT CENTRAL","28",657,576,1233
"25989","MARSABIT","MARSABIT CENTRAL","29",548,447,995
"25990","MARSABIT","MARSABIT CENTRAL","25-29",3530,3046,6576
"25991","MARSABIT","MARSABIT CENTRAL","30",1010,764,1774
"25992","MARSABIT","MARSABIT CENTRAL","31",393,386,779
"25993","MARSABIT","MARSABIT CENTRAL","32",531,413,944
"25994","MARSABIT","MARSABIT CENTRAL","33",419,393,812
"25995","MARSABIT","MARSABIT CENTRAL","34",352,287,639
"25996","MARSABIT","MARSABIT CENTRAL","30-34",2705,2243,4948
"25997","MARSABIT","MARSABIT CENTRAL","35",614,451,1065
"25998","MARSABIT","MARSABIT CENTRAL","36",373,300,673
"25999","MARSABIT","MARSABIT CENTRAL","37",358,309,667
"26000","MARSABIT","MARSABIT CENTRAL","38",241,209,450
"26001","MARSABIT","MARSABIT CENTRAL","39",225,142,367
"26002","MARSABIT","MARSABIT CENTRAL","35-39",1811,1411,3222
"26003","MARSABIT","MARSABIT CENTRAL","40",563,410,973
"26004","MARSABIT","MARSABIT CENTRAL","41",300,267,567
"26005","MARSABIT","MARSABIT CENTRAL","42",256,198,454
"26006","MARSABIT","MARSABIT CENTRAL","43",209,171,380
"26007","MARSABIT","MARSABIT CENTRAL","44",172,127,299
"26008","MARSABIT","MARSABIT CENTRAL","40-44",1500,1173,2673
"26009","MARSABIT","MARSABIT CENTRAL","45",477,385,862
"26010","MARSABIT","MARSABIT CENTRAL","46",190,170,360
"26011","MARSABIT","MARSABIT CENTRAL","47",229,195,424
"26012","MARSABIT","MARSABIT CENTRAL","48",169,131,300
"26013","MARSABIT","MARSABIT CENTRAL","49",128,112,240
"26014","MARSABIT","MARSABIT CENTRAL","45-49",1193,993,2186
"26015","MARSABIT","MARSABIT CENTRAL","50",320,331,651
"26016","MARSABIT","MARSABIT CENTRAL","51",136,138,274
"26017","MARSABIT","MARSABIT CENTRAL","52",164,154,318
"26018","MARSABIT","MARSABIT CENTRAL","53",87,93,180
"26019","MARSABIT","MARSABIT CENTRAL","54",152,126,278
"26020","MARSABIT","MARSABIT CENTRAL","50-54",859,842,1701
"26021","MARSABIT","MARSABIT CENTRAL","55",197,179,376
"26022","MARSABIT","MARSABIT CENTRAL","56",126,119,245
"26023","MARSABIT","MARSABIT CENTRAL","57",134,110,244
"26024","MARSABIT","MARSABIT CENTRAL","58",127,147,274
"26025","MARSABIT","MARSABIT CENTRAL","59",113,190,303
"26026","MARSABIT","MARSABIT CENTRAL","55-59",697,745,1442
"26027","MARSABIT","MARSABIT CENTRAL","60",267,241,508
"26028","MARSABIT","MARSABIT CENTRAL","61",95,112,207
"26029","MARSABIT","MARSABIT CENTRAL","62",85,84,169
"26030","MARSABIT","MARSABIT CENTRAL","63",80,69,149
"26031","MARSABIT","MARSABIT CENTRAL","64",58,65,123
"26032","MARSABIT","MARSABIT CENTRAL","60-64",585,571,1156
"26033","MARSABIT","MARSABIT CENTRAL","65",121,127,248
"26034","MARSABIT","MARSABIT CENTRAL","66",57,89,146
"26035","MARSABIT","MARSABIT CENTRAL","67",83,65,148
"26036","MARSABIT","MARSABIT CENTRAL","68",53,40,93
"26037","MARSABIT","MARSABIT CENTRAL","69",65,93,158
"26038","MARSABIT","MARSABIT CENTRAL","65-69",379,414,793
"26039","MARSABIT","MARSABIT CENTRAL","70",180,190,370
"26040","MARSABIT","MARSABIT CENTRAL","71",61,94,155
"26041","MARSABIT","MARSABIT CENTRAL","72",65,47,112
"26042","MARSABIT","MARSABIT CENTRAL","73",35,37,72
"26043","MARSABIT","MARSABIT CENTRAL","74",58,49,107
"26044","MARSABIT","MARSABIT CENTRAL","70-74",399,417,816
"26045","MARSABIT","MARSABIT CENTRAL","75",61,37,98
"26046","MARSABIT","MARSABIT CENTRAL","76",39,18,57
"26047","MARSABIT","MARSABIT CENTRAL","77",32,21,53
"26048","MARSABIT","MARSABIT CENTRAL","78",28,13,41
"26049","MARSABIT","MARSABIT CENTRAL","79",33,38,71
"26050","MARSABIT","MARSABIT CENTRAL","75-79",193,127,320
"26051","MARSABIT","MARSABIT CENTRAL","80",74,75,149
"26052","MARSABIT","MARSABIT CENTRAL","81",25,28,53
"26053","MARSABIT","MARSABIT CENTRAL","82",18,14,32
"26054","MARSABIT","MARSABIT CENTRAL","83",18,18,36
"26055","MARSABIT","MARSABIT CENTRAL","84",25,27,52
"26056","MARSABIT","MARSABIT CENTRAL","80-84",160,162,322
"26057","MARSABIT","MARSABIT CENTRAL","85",19,11,30
"26058","MARSABIT","MARSABIT CENTRAL","86",13,13,26
"26059","MARSABIT","MARSABIT CENTRAL","87",14,8,22
"26060","MARSABIT","MARSABIT CENTRAL","88",4,12,16
"26061","MARSABIT","MARSABIT CENTRAL","89",16,16,32
"26062","MARSABIT","MARSABIT CENTRAL","85-89",66,60,126
"26063","MARSABIT","MARSABIT CENTRAL","90",16,21,37
"26064","MARSABIT","MARSABIT CENTRAL","91",4,10,14
"26065","MARSABIT","MARSABIT CENTRAL","92",8,3,11
"26066","MARSABIT","MARSABIT CENTRAL","93",2,2,4
"26067","MARSABIT","MARSABIT CENTRAL","94",6,4,10
"26068","MARSABIT","MARSABIT CENTRAL","90-94",36,40,76
"26069","MARSABIT","MARSABIT CENTRAL","95",NA,6,6
"26070","MARSABIT","MARSABIT CENTRAL","96",5,2,7
"26071","MARSABIT","MARSABIT CENTRAL","97",2,3,5
"26072","MARSABIT","MARSABIT CENTRAL","98",1,2,3
"26073","MARSABIT","MARSABIT CENTRAL","99",2,6,8
"26074","MARSABIT","MARSABIT CENTRAL","95-99",10,19,29
"26075","MARSABIT","MARSABIT CENTRAL","100+",12,23,35
"26076","MARSABIT","MARSABIT CENTRAL","Not Stated",1,NA,1
"26077","MARSABIT","MARSABIT NORTH","Total",30091,24205,54296
"26078","MARSABIT","MARSABIT NORTH","0",566,566,1132
"26079","MARSABIT","MARSABIT NORTH","1",546,504,1050
"26080","MARSABIT","MARSABIT NORTH","2",625,608,1233
"26081","MARSABIT","MARSABIT NORTH","3",876,772,1648
"26082","MARSABIT","MARSABIT NORTH","4",773,688,1461
"26083","MARSABIT","MARSABIT NORTH","0 - 4",3386,3138,6524
"26084","MARSABIT","MARSABIT NORTH","5",882,793,1675
"26085","MARSABIT","MARSABIT NORTH","6",886,826,1712
"26086","MARSABIT","MARSABIT NORTH","7",798,730,1528
"26087","MARSABIT","MARSABIT NORTH","8",873,867,1740
"26088","MARSABIT","MARSABIT NORTH","9",694,709,1403
"26089","MARSABIT","MARSABIT NORTH","5-9",4133,3925,8058
"26090","MARSABIT","MARSABIT NORTH","10",1139,1113,2252
"26091","MARSABIT","MARSABIT NORTH","11",560,674,1234
"26092","MARSABIT","MARSABIT NORTH","12",1015,709,1724
"26093","MARSABIT","MARSABIT NORTH","13",761,604,1365
"26094","MARSABIT","MARSABIT NORTH","14",727,582,1309
"26095","MARSABIT","MARSABIT NORTH","10 -14",4202,3682,7884
"26096","MARSABIT","MARSABIT NORTH","15",1111,800,1911
"26097","MARSABIT","MARSABIT NORTH","16",717,552,1269
"26098","MARSABIT","MARSABIT NORTH","17",879,558,1437
"26099","MARSABIT","MARSABIT NORTH","18",729,567,1296
"26100","MARSABIT","MARSABIT NORTH","19",525,348,873
"26101","MARSABIT","MARSABIT NORTH","15-19",3961,2825,6786
"26102","MARSABIT","MARSABIT NORTH","20",1043,731,1774
"26103","MARSABIT","MARSABIT NORTH","21",464,353,817
"26104","MARSABIT","MARSABIT NORTH","22",528,472,1000
"26105","MARSABIT","MARSABIT NORTH","23",534,425,959
"26106","MARSABIT","MARSABIT NORTH","24",476,344,820
"26107","MARSABIT","MARSABIT NORTH","20-24",3045,2325,5370
"26108","MARSABIT","MARSABIT NORTH","25",807,651,1458
"26109","MARSABIT","MARSABIT NORTH","26",446,318,764
"26110","MARSABIT","MARSABIT NORTH","27",445,327,772
"26111","MARSABIT","MARSABIT NORTH","28",543,394,937
"26112","MARSABIT","MARSABIT NORTH","29",390,315,705
"26113","MARSABIT","MARSABIT NORTH","25-29",2631,2005,4636
"26114","MARSABIT","MARSABIT NORTH","30",877,573,1450
"26115","MARSABIT","MARSABIT NORTH","31",280,265,545
"26116","MARSABIT","MARSABIT NORTH","32",391,301,692
"26117","MARSABIT","MARSABIT NORTH","33",296,224,520
"26118","MARSABIT","MARSABIT NORTH","34",285,194,479
"26119","MARSABIT","MARSABIT NORTH","30-34",2129,1557,3686
"26120","MARSABIT","MARSABIT NORTH","35",462,386,848
"26121","MARSABIT","MARSABIT NORTH","36",277,177,454
"26122","MARSABIT","MARSABIT NORTH","37",245,219,464
"26123","MARSABIT","MARSABIT NORTH","38",271,164,435
"26124","MARSABIT","MARSABIT NORTH","39",183,136,319
"26125","MARSABIT","MARSABIT NORTH","35-39",1438,1082,2520
"26126","MARSABIT","MARSABIT NORTH","40",524,309,833
"26127","MARSABIT","MARSABIT NORTH","41",212,235,447
"26128","MARSABIT","MARSABIT NORTH","42",191,147,338
"26129","MARSABIT","MARSABIT NORTH","43",191,161,352
"26130","MARSABIT","MARSABIT NORTH","44",90,78,168
"26131","MARSABIT","MARSABIT NORTH","40-44",1208,930,2138
"26132","MARSABIT","MARSABIT NORTH","45",364,251,615
"26133","MARSABIT","MARSABIT NORTH","46",145,115,260
"26134","MARSABIT","MARSABIT NORTH","47",137,108,245
"26135","MARSABIT","MARSABIT NORTH","48",148,114,262
"26136","MARSABIT","MARSABIT NORTH","49",92,72,164
"26137","MARSABIT","MARSABIT NORTH","45-49",886,660,1546
"26138","MARSABIT","MARSABIT NORTH","50",367,252,619
"26139","MARSABIT","MARSABIT NORTH","51",84,49,133
"26140","MARSABIT","MARSABIT NORTH","52",186,137,323
"26141","MARSABIT","MARSABIT NORTH","53",114,90,204
"26142","MARSABIT","MARSABIT NORTH","54",120,51,171
"26143","MARSABIT","MARSABIT NORTH","50-54",871,579,1450
"26144","MARSABIT","MARSABIT NORTH","55",124,70,194
"26145","MARSABIT","MARSABIT NORTH","56",151,76,227
"26146","MARSABIT","MARSABIT NORTH","57",98,79,177
"26147","MARSABIT","MARSABIT NORTH","58",126,68,194
"26148","MARSABIT","MARSABIT NORTH","59",78,60,138
"26149","MARSABIT","MARSABIT NORTH","55-59",577,353,930
"26150","MARSABIT","MARSABIT NORTH","60",287,222,509
"26151","MARSABIT","MARSABIT NORTH","61",66,55,121
"26152","MARSABIT","MARSABIT NORTH","62",78,62,140
"26153","MARSABIT","MARSABIT NORTH","63",71,39,110
"26154","MARSABIT","MARSABIT NORTH","64",44,31,75
"26155","MARSABIT","MARSABIT NORTH","60-64",546,409,955
"26156","MARSABIT","MARSABIT NORTH","65",100,49,149
"26157","MARSABIT","MARSABIT NORTH","66",54,37,91
"26158","MARSABIT","MARSABIT NORTH","67",42,22,64
"26159","MARSABIT","MARSABIT NORTH","68",55,25,80
"26160","MARSABIT","MARSABIT NORTH","69",36,28,64
"26161","MARSABIT","MARSABIT NORTH","65-69",287,161,448
"26162","MARSABIT","MARSABIT NORTH","70",243,148,391
"26163","MARSABIT","MARSABIT NORTH","71",18,31,49
"26164","MARSABIT","MARSABIT NORTH","72",65,36,101
"26165","MARSABIT","MARSABIT NORTH","73",32,16,48
"26166","MARSABIT","MARSABIT NORTH","74",21,12,33
"26167","MARSABIT","MARSABIT NORTH","70-74",379,243,622
"26168","MARSABIT","MARSABIT NORTH","75",35,37,72
"26169","MARSABIT","MARSABIT NORTH","76",20,16,36
"26170","MARSABIT","MARSABIT NORTH","77",15,6,21
"26171","MARSABIT","MARSABIT NORTH","78",24,10,34
"26172","MARSABIT","MARSABIT NORTH","79",15,17,32
"26173","MARSABIT","MARSABIT NORTH","75-79",109,86,195
"26174","MARSABIT","MARSABIT NORTH","80",114,78,192
"26175","MARSABIT","MARSABIT NORTH","81",19,20,39
"26176","MARSABIT","MARSABIT NORTH","82",22,19,41
"26177","MARSABIT","MARSABIT NORTH","83",8,8,16
"26178","MARSABIT","MARSABIT NORTH","84",8,5,13
"26179","MARSABIT","MARSABIT NORTH","80-84",171,130,301
"26180","MARSABIT","MARSABIT NORTH","85",14,18,32
"26181","MARSABIT","MARSABIT NORTH","86",10,6,16
"26182","MARSABIT","MARSABIT NORTH","87",6,9,15
"26183","MARSABIT","MARSABIT NORTH","88",4,3,7
"26184","MARSABIT","MARSABIT NORTH","89",4,6,10
"26185","MARSABIT","MARSABIT NORTH","85-89",38,42,80
"26186","MARSABIT","MARSABIT NORTH","90",49,28,77
"26187","MARSABIT","MARSABIT NORTH","91",6,5,11
"26188","MARSABIT","MARSABIT NORTH","92",12,12,24
"26189","MARSABIT","MARSABIT NORTH","93",3,1,4
"26190","MARSABIT","MARSABIT NORTH","94",1,1,2
"26191","MARSABIT","MARSABIT NORTH","90-94",71,47,118
"26192","MARSABIT","MARSABIT NORTH","95",4,4,8
"26193","MARSABIT","MARSABIT NORTH","96",2,1,3
"26194","MARSABIT","MARSABIT NORTH","97",1,NA,1
"26195","MARSABIT","MARSABIT NORTH","98",2,4,6
"26196","MARSABIT","MARSABIT NORTH","99",1,2,3
"26197","MARSABIT","MARSABIT NORTH","95-99",10,11,21
"26198","MARSABIT","MARSABIT NORTH","100+",13,15,28
"26199","MARSABIT","MARSABIT NORTH","Not Stated",NA,NA,NA
"26200","MARSABIT","MARSABIT SOUTH","Total",33215,32161,65376
"26201","MARSABIT","MARSABIT SOUTH","0",783,705,1488
"26202","MARSABIT","MARSABIT SOUTH","1",845,886,1731
"26203","MARSABIT","MARSABIT SOUTH","2",1114,1117,2231
"26204","MARSABIT","MARSABIT SOUTH","3",1096,1094,2190
"26205","MARSABIT","MARSABIT SOUTH","4",1229,1197,2426
"26206","MARSABIT","MARSABIT SOUTH","0 - 4",5067,4999,10066
"26207","MARSABIT","MARSABIT SOUTH","5",1244,1237,2481
"26208","MARSABIT","MARSABIT SOUTH","6",1199,1256,2455
"26209","MARSABIT","MARSABIT SOUTH","7",944,944,1888
"26210","MARSABIT","MARSABIT SOUTH","8",1297,1306,2603
"26211","MARSABIT","MARSABIT SOUTH","9",898,906,1804
"26212","MARSABIT","MARSABIT SOUTH","5-9",5582,5649,11231
"26213","MARSABIT","MARSABIT SOUTH","10",1697,1648,3345
"26214","MARSABIT","MARSABIT SOUTH","11",750,756,1506
"26215","MARSABIT","MARSABIT SOUTH","12",1447,1201,2648
"26216","MARSABIT","MARSABIT SOUTH","13",875,801,1676
"26217","MARSABIT","MARSABIT SOUTH","14",1019,817,1836
"26218","MARSABIT","MARSABIT SOUTH","10 -14",5788,5223,11011
"26219","MARSABIT","MARSABIT SOUTH","15",1233,976,2209
"26220","MARSABIT","MARSABIT SOUTH","16",849,642,1491
"26221","MARSABIT","MARSABIT SOUTH","17",719,424,1143
"26222","MARSABIT","MARSABIT SOUTH","18",807,648,1455
"26223","MARSABIT","MARSABIT SOUTH","19",497,455,952
"26224","MARSABIT","MARSABIT SOUTH","15-19",4105,3145,7250
"26225","MARSABIT","MARSABIT SOUTH","20",997,901,1898
"26226","MARSABIT","MARSABIT SOUTH","21",415,444,859
"26227","MARSABIT","MARSABIT SOUTH","22",553,688,1241
"26228","MARSABIT","MARSABIT SOUTH","23",480,616,1096
"26229","MARSABIT","MARSABIT SOUTH","24",450,503,953
"26230","MARSABIT","MARSABIT SOUTH","20-24",2895,3152,6047
"26231","MARSABIT","MARSABIT SOUTH","25",725,775,1500
"26232","MARSABIT","MARSABIT SOUTH","26",379,457,836
"26233","MARSABIT","MARSABIT SOUTH","27",364,313,677
"26234","MARSABIT","MARSABIT SOUTH","28",421,462,883
"26235","MARSABIT","MARSABIT SOUTH","29",364,316,680
"26236","MARSABIT","MARSABIT SOUTH","25-29",2253,2323,4576
"26237","MARSABIT","MARSABIT SOUTH","30",900,761,1661
"26238","MARSABIT","MARSABIT SOUTH","31",280,490,770
"26239","MARSABIT","MARSABIT SOUTH","32",344,428,772
"26240","MARSABIT","MARSABIT SOUTH","33",248,411,659
"26241","MARSABIT","MARSABIT SOUTH","34",206,277,483
"26242","MARSABIT","MARSABIT SOUTH","30-34",1978,2367,4345
"26243","MARSABIT","MARSABIT SOUTH","35",493,457,950
"26244","MARSABIT","MARSABIT SOUTH","36",171,188,359
"26245","MARSABIT","MARSABIT SOUTH","37",164,128,292
"26246","MARSABIT","MARSABIT SOUTH","38",161,104,265
"26247","MARSABIT","MARSABIT SOUTH","39",185,112,297
"26248","MARSABIT","MARSABIT SOUTH","35-39",1174,989,2163
"26249","MARSABIT","MARSABIT SOUTH","40",548,303,851
"26250","MARSABIT","MARSABIT SOUTH","41",279,186,465
"26251","MARSABIT","MARSABIT SOUTH","42",217,174,391
"26252","MARSABIT","MARSABIT SOUTH","43",131,95,226
"26253","MARSABIT","MARSABIT SOUTH","44",51,57,108
"26254","MARSABIT","MARSABIT SOUTH","40-44",1226,815,2041
"26255","MARSABIT","MARSABIT SOUTH","45",310,275,585
"26256","MARSABIT","MARSABIT SOUTH","46",137,248,385
"26257","MARSABIT","MARSABIT SOUTH","47",91,129,220
"26258","MARSABIT","MARSABIT SOUTH","48",77,100,177
"26259","MARSABIT","MARSABIT SOUTH","49",110,128,238
"26260","MARSABIT","MARSABIT SOUTH","45-49",725,880,1605
"26261","MARSABIT","MARSABIT SOUTH","50",312,324,636
"26262","MARSABIT","MARSABIT SOUTH","51",87,110,197
"26263","MARSABIT","MARSABIT SOUTH","52",114,105,219
"26264","MARSABIT","MARSABIT SOUTH","53",56,61,117
"26265","MARSABIT","MARSABIT SOUTH","54",81,76,157
"26266","MARSABIT","MARSABIT SOUTH","50-54",650,676,1326
"26267","MARSABIT","MARSABIT SOUTH","55",105,74,179
"26268","MARSABIT","MARSABIT SOUTH","56",78,82,160
"26269","MARSABIT","MARSABIT SOUTH","57",54,47,101
"26270","MARSABIT","MARSABIT SOUTH","58",73,86,159
"26271","MARSABIT","MARSABIT SOUTH","59",80,113,193
"26272","MARSABIT","MARSABIT SOUTH","55-59",390,402,792
"26273","MARSABIT","MARSABIT SOUTH","60",234,206,440
"26274","MARSABIT","MARSABIT SOUTH","61",59,73,132
"26275","MARSABIT","MARSABIT SOUTH","62",49,52,101
"26276","MARSABIT","MARSABIT SOUTH","63",44,74,118
"26277","MARSABIT","MARSABIT SOUTH","64",39,64,103
"26278","MARSABIT","MARSABIT SOUTH","60-64",425,469,894
"26279","MARSABIT","MARSABIT SOUTH","65",80,80,160
"26280","MARSABIT","MARSABIT SOUTH","66",26,41,67
"26281","MARSABIT","MARSABIT SOUTH","67",39,52,91
"26282","MARSABIT","MARSABIT SOUTH","68",49,51,100
"26283","MARSABIT","MARSABIT SOUTH","69",67,120,187
"26284","MARSABIT","MARSABIT SOUTH","65-69",261,344,605
"26285","MARSABIT","MARSABIT SOUTH","70",164,182,346
"26286","MARSABIT","MARSABIT SOUTH","71",60,61,121
"26287","MARSABIT","MARSABIT SOUTH","72",41,34,75
"26288","MARSABIT","MARSABIT SOUTH","73",32,46,78
"26289","MARSABIT","MARSABIT SOUTH","74",43,35,78
"26290","MARSABIT","MARSABIT SOUTH","70-74",340,358,698
"26291","MARSABIT","MARSABIT SOUTH","75",51,28,79
"26292","MARSABIT","MARSABIT SOUTH","76",20,21,41
"26293","MARSABIT","MARSABIT SOUTH","77",18,18,36
"26294","MARSABIT","MARSABIT SOUTH","78",18,25,43
"26295","MARSABIT","MARSABIT SOUTH","79",31,41,72
"26296","MARSABIT","MARSABIT SOUTH","75-79",138,133,271
"26297","MARSABIT","MARSABIT SOUTH","80",64,68,132
"26298","MARSABIT","MARSABIT SOUTH","81",21,21,42
"26299","MARSABIT","MARSABIT SOUTH","82",24,11,35
"26300","MARSABIT","MARSABIT SOUTH","83",7,11,18
"26301","MARSABIT","MARSABIT SOUTH","84",11,20,31
"26302","MARSABIT","MARSABIT SOUTH","80-84",127,131,258
"26303","MARSABIT","MARSABIT SOUTH","85",11,11,22
"26304","MARSABIT","MARSABIT SOUTH","86",15,7,22
"26305","MARSABIT","MARSABIT SOUTH","87",13,12,25
"26306","MARSABIT","MARSABIT SOUTH","88",4,1,5
"26307","MARSABIT","MARSABIT SOUTH","89",13,26,39
"26308","MARSABIT","MARSABIT SOUTH","85-89",56,57,113
"26309","MARSABIT","MARSABIT SOUTH","90",10,17,27
"26310","MARSABIT","MARSABIT SOUTH","91",5,6,11
"26311","MARSABIT","MARSABIT SOUTH","92",3,2,5
"26312","MARSABIT","MARSABIT SOUTH","93",2,3,5
"26313","MARSABIT","MARSABIT SOUTH","94",1,6,7
"26314","MARSABIT","MARSABIT SOUTH","90-94",21,34,55
"26315","MARSABIT","MARSABIT SOUTH","95",3,4,7
"26316","MARSABIT","MARSABIT SOUTH","96",3,3,6
"26317","MARSABIT","MARSABIT SOUTH","97",1,2,3
"26318","MARSABIT","MARSABIT SOUTH","98",1,1,2
"26319","MARSABIT","MARSABIT SOUTH","99",2,NA,2
"26320","MARSABIT","MARSABIT SOUTH","95-99",10,10,20
"26321","MARSABIT","MARSABIT SOUTH","100+",3,5,8
"26322","MARSABIT","MARSABIT SOUTH","Not Stated",1,NA,1
"26323","MARSABIT","MOYALE","Total",56440,52508,108948
"26324","MARSABIT","MOYALE","0",1390,1470,2860
"26325","MARSABIT","MOYALE","1",1645,1538,3183
"26326","MARSABIT","MOYALE","2",2251,2176,4427
"26327","MARSABIT","MOYALE","3",1936,1910,3846
"26328","MARSABIT","MOYALE","4",2462,2183,4645
"26329","MARSABIT","MOYALE","0 - 4",9684,9277,18961
"26330","MARSABIT","MOYALE","5",1852,1801,3653
"26331","MARSABIT","MOYALE","6",2382,2272,4654
"26332","MARSABIT","MOYALE","7",1667,1640,3307
"26333","MARSABIT","MOYALE","8",2355,2387,4742
"26334","MARSABIT","MOYALE","9",1377,1365,2742
"26335","MARSABIT","MOYALE","5-9",9633,9465,19098
"26336","MARSABIT","MOYALE","10",2544,2365,4909
"26337","MARSABIT","MOYALE","11",1139,1286,2425
"26338","MARSABIT","MOYALE","12",2220,1790,4010
"26339","MARSABIT","MOYALE","13",1560,1259,2819
"26340","MARSABIT","MOYALE","14",1804,1528,3332
"26341","MARSABIT","MOYALE","10 -14",9267,8228,17495
"26342","MARSABIT","MOYALE","15",1989,1516,3505
"26343","MARSABIT","MOYALE","16",1710,1431,3141
"26344","MARSABIT","MOYALE","17",1815,1292,3107
"26345","MARSABIT","MOYALE","18",1745,1512,3257
"26346","MARSABIT","MOYALE","19",867,797,1664
"26347","MARSABIT","MOYALE","15-19",8126,6548,14674
"26348","MARSABIT","MOYALE","20",1699,1562,3261
"26349","MARSABIT","MOYALE","21",703,659,1362
"26350","MARSABIT","MOYALE","22",912,890,1802
"26351","MARSABIT","MOYALE","23",722,866,1588
"26352","MARSABIT","MOYALE","24",724,780,1504
"26353","MARSABIT","MOYALE","20-24",4760,4757,9517
"26354","MARSABIT","MOYALE","25",1205,1241,2446
"26355","MARSABIT","MOYALE","26",657,653,1310
"26356","MARSABIT","MOYALE","27",701,745,1446
"26357","MARSABIT","MOYALE","28",631,626,1257
"26358","MARSABIT","MOYALE","29",554,522,1076
"26359","MARSABIT","MOYALE","25-29",3748,3787,7535
"26360","MARSABIT","MOYALE","30",1175,1079,2254
"26361","MARSABIT","MOYALE","31",347,368,715
"26362","MARSABIT","MOYALE","32",540,495,1035
"26363","MARSABIT","MOYALE","33",382,331,713
"26364","MARSABIT","MOYALE","34",358,378,736
"26365","MARSABIT","MOYALE","30-34",2802,2651,5453
"26366","MARSABIT","MOYALE","35",711,650,1361
"26367","MARSABIT","MOYALE","36",377,351,728
"26368","MARSABIT","MOYALE","37",313,281,594
"26369","MARSABIT","MOYALE","38",276,272,548
"26370","MARSABIT","MOYALE","39",189,167,356
"26371","MARSABIT","MOYALE","35-39",1866,1721,3587
"26372","MARSABIT","MOYALE","40",694,547,1241
"26373","MARSABIT","MOYALE","41",368,424,792
"26374","MARSABIT","MOYALE","42",259,174,433
"26375","MARSABIT","MOYALE","43",212,199,411
"26376","MARSABIT","MOYALE","44",157,157,314
"26377","MARSABIT","MOYALE","40-44",1690,1501,3191
"26378","MARSABIT","MOYALE","45",437,411,848
"26379","MARSABIT","MOYALE","46",189,159,348
"26380","MARSABIT","MOYALE","47",247,188,435
"26381","MARSABIT","MOYALE","48",142,117,259
"26382","MARSABIT","MOYALE","49",132,117,249
"26383","MARSABIT","MOYALE","45-49",1147,992,2139
"26384","MARSABIT","MOYALE","50",400,342,742
"26385","MARSABIT","MOYALE","51",142,154,296
"26386","MARSABIT","MOYALE","52",136,120,256
"26387","MARSABIT","MOYALE","53",100,101,201
"26388","MARSABIT","MOYALE","54",177,122,299
"26389","MARSABIT","MOYALE","50-54",955,839,1794
"26390","MARSABIT","MOYALE","55",199,197,396
"26391","MARSABIT","MOYALE","56",119,106,225
"26392","MARSABIT","MOYALE","57",128,148,276
"26393","MARSABIT","MOYALE","58",113,127,240
"26394","MARSABIT","MOYALE","59",149,186,335
"26395","MARSABIT","MOYALE","55-59",708,764,1472
"26396","MARSABIT","MOYALE","60",325,262,587
"26397","MARSABIT","MOYALE","61",112,149,261
"26398","MARSABIT","MOYALE","62",97,79,176
"26399","MARSABIT","MOYALE","63",94,78,172
"26400","MARSABIT","MOYALE","64",80,58,138
"26401","MARSABIT","MOYALE","60-64",708,626,1334
"26402","MARSABIT","MOYALE","65",142,112,254
"26403","MARSABIT","MOYALE","66",67,85,152
"26404","MARSABIT","MOYALE","67",84,55,139
"26405","MARSABIT","MOYALE","68",70,44,114
"26406","MARSABIT","MOYALE","69",87,63,150
"26407","MARSABIT","MOYALE","65-69",450,359,809
"26408","MARSABIT","MOYALE","70",192,193,385
"26409","MARSABIT","MOYALE","71",68,117,185
"26410","MARSABIT","MOYALE","72",44,43,87
"26411","MARSABIT","MOYALE","73",29,26,55
"26412","MARSABIT","MOYALE","74",42,34,76
"26413","MARSABIT","MOYALE","70-74",375,413,788
"26414","MARSABIT","MOYALE","75",59,59,118
"26415","MARSABIT","MOYALE","76",33,52,85
"26416","MARSABIT","MOYALE","77",29,18,47
"26417","MARSABIT","MOYALE","78",31,24,55
"26418","MARSABIT","MOYALE","79",35,49,84
"26419","MARSABIT","MOYALE","75-79",187,202,389
"26420","MARSABIT","MOYALE","80",98,117,215
"26421","MARSABIT","MOYALE","81",25,70,95
"26422","MARSABIT","MOYALE","82",24,8,32
"26423","MARSABIT","MOYALE","83",12,11,23
"26424","MARSABIT","MOYALE","84",16,16,32
"26425","MARSABIT","MOYALE","80-84",175,222,397
"26426","MARSABIT","MOYALE","85",21,19,40
"26427","MARSABIT","MOYALE","86",15,15,30
"26428","MARSABIT","MOYALE","87",9,4,13
"26429","MARSABIT","MOYALE","88",14,3,17
"26430","MARSABIT","MOYALE","89",19,20,39
"26431","MARSABIT","MOYALE","85-89",78,61,139
"26432","MARSABIT","MOYALE","90",29,30,59
"26433","MARSABIT","MOYALE","91",8,17,25
"26434","MARSABIT","MOYALE","92",9,5,14
"26435","MARSABIT","MOYALE","93",3,1,4
"26436","MARSABIT","MOYALE","94",5,3,8
"26437","MARSABIT","MOYALE","90-94",54,56,110
"26438","MARSABIT","MOYALE","95",3,6,9
"26439","MARSABIT","MOYALE","96",NA,4,4
"26440","MARSABIT","MOYALE","97",2,1,3
"26441","MARSABIT","MOYALE","98",2,7,9
"26442","MARSABIT","MOYALE","99",5,1,6
"26443","MARSABIT","MOYALE","95-99",12,19,31
"26444","MARSABIT","MOYALE","100+",14,20,34
"26445","MARSABIT","MOYALE","Not Stated",1,NA,1
"26446","MARSABIT","NORTH HORR","Total",41719,29726,71445
"26447","MARSABIT","NORTH HORR","0",666,632,1298
"26448","MARSABIT","NORTH HORR","1",724,618,1342
"26449","MARSABIT","NORTH HORR","2",881,777,1658
"26450","MARSABIT","NORTH HORR","3",1075,1036,2111
"26451","MARSABIT","NORTH HORR","4",1021,953,1974
"26452","MARSABIT","NORTH HORR","0 - 4",4367,4016,8383
"26453","MARSABIT","NORTH HORR","5",1171,1043,2214
"26454","MARSABIT","NORTH HORR","6",1168,1021,2189
"26455","MARSABIT","NORTH HORR","7",1175,1022,2197
"26456","MARSABIT","NORTH HORR","8",1241,1118,2359
"26457","MARSABIT","NORTH HORR","9",1035,914,1949
"26458","MARSABIT","NORTH HORR","5-9",5790,5118,10908
"26459","MARSABIT","NORTH HORR","10",1731,1454,3185
"26460","MARSABIT","NORTH HORR","11",785,785,1570
"26461","MARSABIT","NORTH HORR","12",1507,945,2452
"26462","MARSABIT","NORTH HORR","13",1070,757,1827
"26463","MARSABIT","NORTH HORR","14",1105,746,1851
"26464","MARSABIT","NORTH HORR","10 -14",6198,4687,10885
"26465","MARSABIT","NORTH HORR","15",1645,988,2633
"26466","MARSABIT","NORTH HORR","16",1084,731,1815
"26467","MARSABIT","NORTH HORR","17",1060,628,1688
"26468","MARSABIT","NORTH HORR","18",1254,701,1955
"26469","MARSABIT","NORTH HORR","19",842,478,1320
"26470","MARSABIT","NORTH HORR","15-19",5885,3526,9411
"26471","MARSABIT","NORTH HORR","20",1669,930,2599
"26472","MARSABIT","NORTH HORR","21",742,411,1153
"26473","MARSABIT","NORTH HORR","22",752,448,1200
"26474","MARSABIT","NORTH HORR","23",793,355,1148
"26475","MARSABIT","NORTH HORR","24",782,443,1225
"26476","MARSABIT","NORTH HORR","20-24",4738,2587,7325
"26477","MARSABIT","NORTH HORR","25",1169,705,1874
"26478","MARSABIT","NORTH HORR","26",635,390,1025
"26479","MARSABIT","NORTH HORR","27",537,327,864
"26480","MARSABIT","NORTH HORR","28",751,488,1239
"26481","MARSABIT","NORTH HORR","29",520,344,864
"26482","MARSABIT","NORTH HORR","25-29",3612,2254,5866
"26483","MARSABIT","NORTH HORR","30",1293,887,2180
"26484","MARSABIT","NORTH HORR","31",355,297,652
"26485","MARSABIT","NORTH HORR","32",506,316,822
"26486","MARSABIT","NORTH HORR","33",350,239,589
"26487","MARSABIT","NORTH HORR","34",309,225,534
"26488","MARSABIT","NORTH HORR","30-34",2813,1964,4777
"26489","MARSABIT","NORTH HORR","35",610,431,1041
"26490","MARSABIT","NORTH HORR","36",315,274,589
"26491","MARSABIT","NORTH HORR","37",265,193,458
"26492","MARSABIT","NORTH HORR","38",331,254,585
"26493","MARSABIT","NORTH HORR","39",235,196,431
"26494","MARSABIT","NORTH HORR","35-39",1756,1348,3104
"26495","MARSABIT","NORTH HORR","40",886,563,1449
"26496","MARSABIT","NORTH HORR","41",261,201,462
"26497","MARSABIT","NORTH HORR","42",276,158,434
"26498","MARSABIT","NORTH HORR","43",228,147,375
"26499","MARSABIT","NORTH HORR","44",99,78,177
"26500","MARSABIT","NORTH HORR","40-44",1750,1147,2897
"26501","MARSABIT","NORTH HORR","45",459,307,766
"26502","MARSABIT","NORTH HORR","46",185,128,313
"26503","MARSABIT","NORTH HORR","47",151,103,254
"26504","MARSABIT","NORTH HORR","48",225,107,332
"26505","MARSABIT","NORTH HORR","49",132,96,228
"26506","MARSABIT","NORTH HORR","45-49",1152,741,1893
"26507","MARSABIT","NORTH HORR","50",629,351,980
"26508","MARSABIT","NORTH HORR","51",101,59,160
"26509","MARSABIT","NORTH HORR","52",183,106,289
"26510","MARSABIT","NORTH HORR","53",104,58,162
"26511","MARSABIT","NORTH HORR","54",91,61,152
"26512","MARSABIT","NORTH HORR","50-54",1108,635,1743
"26513","MARSABIT","NORTH HORR","55",169,124,293
"26514","MARSABIT","NORTH HORR","56",134,74,208
"26515","MARSABIT","NORTH HORR","57",99,63,162
"26516","MARSABIT","NORTH HORR","58",98,76,174
"26517","MARSABIT","NORTH HORR","59",72,46,118
"26518","MARSABIT","NORTH HORR","55-59",572,383,955
"26519","MARSABIT","NORTH HORR","60",412,248,660
"26520","MARSABIT","NORTH HORR","61",72,62,134
"26521","MARSABIT","NORTH HORR","62",78,50,128
"26522","MARSABIT","NORTH HORR","63",60,35,95
"26523","MARSABIT","NORTH HORR","64",43,18,61
"26524","MARSABIT","NORTH HORR","60-64",665,413,1078
"26525","MARSABIT","NORTH HORR","65",112,97,209
"26526","MARSABIT","NORTH HORR","66",43,37,80
"26527","MARSABIT","NORTH HORR","67",70,34,104
"26528","MARSABIT","NORTH HORR","68",44,36,80
"26529","MARSABIT","NORTH HORR","69",40,32,72
"26530","MARSABIT","NORTH HORR","65-69",309,236,545
"26531","MARSABIT","NORTH HORR","70",318,208,526
"26532","MARSABIT","NORTH HORR","71",46,37,83
"26533","MARSABIT","NORTH HORR","72",54,36,90
"26534","MARSABIT","NORTH HORR","73",37,16,53
"26535","MARSABIT","NORTH HORR","74",26,18,44
"26536","MARSABIT","NORTH HORR","70-74",481,315,796
"26537","MARSABIT","NORTH HORR","75",68,41,109
"26538","MARSABIT","NORTH HORR","76",35,17,52
"26539","MARSABIT","NORTH HORR","77",27,12,39
"26540","MARSABIT","NORTH HORR","78",19,11,30
"26541","MARSABIT","NORTH HORR","79",13,17,30
"26542","MARSABIT","NORTH HORR","75-79",162,98,260
"26543","MARSABIT","NORTH HORR","80",123,93,216
"26544","MARSABIT","NORTH HORR","81",23,17,40
"26545","MARSABIT","NORTH HORR","82",16,10,26
"26546","MARSABIT","NORTH HORR","83",8,7,15
"26547","MARSABIT","NORTH HORR","84",7,9,16
"26548","MARSABIT","NORTH HORR","80-84",177,136,313
"26549","MARSABIT","NORTH HORR","85",26,16,42
"26550","MARSABIT","NORTH HORR","86",6,3,9
"26551","MARSABIT","NORTH HORR","87",8,7,15
"26552","MARSABIT","NORTH HORR","88",9,5,14
"26553","MARSABIT","NORTH HORR","89",6,4,10
"26554","MARSABIT","NORTH HORR","85-89",55,35,90
"26555","MARSABIT","NORTH HORR","90",69,45,114
"26556","MARSABIT","NORTH HORR","91",9,5,14
"26557","MARSABIT","NORTH HORR","92",3,5,8
"26558","MARSABIT","NORTH HORR","93",NA,2,2
"26559","MARSABIT","NORTH HORR","94",2,1,3
"26560","MARSABIT","NORTH HORR","90-94",83,58,141
"26561","MARSABIT","NORTH HORR","95",8,4,12
"26562","MARSABIT","NORTH HORR","96",4,2,6
"26563","MARSABIT","NORTH HORR","97",NA,NA,NA
"26564","MARSABIT","NORTH HORR","98",3,1,4
"26565","MARSABIT","NORTH HORR","99",2,1,3
"26566","MARSABIT","NORTH HORR","95-99",17,8,25
"26567","MARSABIT","NORTH HORR","100+",28,19,47
"26568","MARSABIT","NORTH HORR","Not Stated",1,2,3
"26569","MARSABIT","SOLOLO","Total",23468,21354,44822
"26570","MARSABIT","SOLOLO","0",476,436,912
"26571","MARSABIT","SOLOLO","1",621,624,1245
"26572","MARSABIT","SOLOLO","2",813,759,1572
"26573","MARSABIT","SOLOLO","3",710,773,1483
"26574","MARSABIT","SOLOLO","4",877,925,1802
"26575","MARSABIT","SOLOLO","0 - 4",3497,3517,7014
"26576","MARSABIT","SOLOLO","5",759,774,1533
"26577","MARSABIT","SOLOLO","6",913,881,1794
"26578","MARSABIT","SOLOLO","7",701,662,1363
"26579","MARSABIT","SOLOLO","8",981,987,1968
"26580","MARSABIT","SOLOLO","9",550,558,1108
"26581","MARSABIT","SOLOLO","5-9",3904,3862,7766
"26582","MARSABIT","SOLOLO","10",1240,1057,2297
"26583","MARSABIT","SOLOLO","11",484,571,1055
"26584","MARSABIT","SOLOLO","12",980,698,1678
"26585","MARSABIT","SOLOLO","13",585,584,1169
"26586","MARSABIT","SOLOLO","14",699,636,1335
"26587","MARSABIT","SOLOLO","10 -14",3988,3546,7534
"26588","MARSABIT","SOLOLO","15",910,721,1631
"26589","MARSABIT","SOLOLO","16",680,505,1185
"26590","MARSABIT","SOLOLO","17",739,471,1210
"26591","MARSABIT","SOLOLO","18",668,587,1255
"26592","MARSABIT","SOLOLO","19",276,237,513
"26593","MARSABIT","SOLOLO","15-19",3273,2521,5794
"26594","MARSABIT","SOLOLO","20",791,608,1399
"26595","MARSABIT","SOLOLO","21",288,297,585
"26596","MARSABIT","SOLOLO","22",392,323,715
"26597","MARSABIT","SOLOLO","23",334,317,651
"26598","MARSABIT","SOLOLO","24",288,273,561
"26599","MARSABIT","SOLOLO","20-24",2093,1818,3911
"26600","MARSABIT","SOLOLO","25",574,471,1045
"26601","MARSABIT","SOLOLO","26",286,245,531
"26602","MARSABIT","SOLOLO","27",286,226,512
"26603","MARSABIT","SOLOLO","28",283,203,486
"26604","MARSABIT","SOLOLO","29",193,207,400
"26605","MARSABIT","SOLOLO","25-29",1622,1352,2974
"26606","MARSABIT","SOLOLO","30",564,424,988
"26607","MARSABIT","SOLOLO","31",131,141,272
"26608","MARSABIT","SOLOLO","32",178,164,342
"26609","MARSABIT","SOLOLO","33",166,157,323
"26610","MARSABIT","SOLOLO","34",114,118,232
"26611","MARSABIT","SOLOLO","30-34",1153,1004,2157
"26612","MARSABIT","SOLOLO","35",282,270,552
"26613","MARSABIT","SOLOLO","36",129,141,270
"26614","MARSABIT","SOLOLO","37",173,165,338
"26615","MARSABIT","SOLOLO","38",108,126,234
"26616","MARSABIT","SOLOLO","39",80,81,161
"26617","MARSABIT","SOLOLO","35-39",772,783,1555
"26618","MARSABIT","SOLOLO","40",344,256,600
"26619","MARSABIT","SOLOLO","41",149,221,370
"26620","MARSABIT","SOLOLO","42",118,74,192
"26621","MARSABIT","SOLOLO","43",109,92,201
"26622","MARSABIT","SOLOLO","44",63,36,99
"26623","MARSABIT","SOLOLO","40-44",783,679,1462
"26624","MARSABIT","SOLOLO","45",189,209,398
"26625","MARSABIT","SOLOLO","46",77,57,134
"26626","MARSABIT","SOLOLO","47",76,51,127
"26627","MARSABIT","SOLOLO","48",59,44,103
"26628","MARSABIT","SOLOLO","49",51,49,100
"26629","MARSABIT","SOLOLO","45-49",452,410,862
"26630","MARSABIT","SOLOLO","50",182,174,356
"26631","MARSABIT","SOLOLO","51",53,78,131
"26632","MARSABIT","SOLOLO","52",76,86,162
"26633","MARSABIT","SOLOLO","53",53,58,111
"26634","MARSABIT","SOLOLO","54",73,103,176
"26635","MARSABIT","SOLOLO","50-54",437,499,936
"26636","MARSABIT","SOLOLO","55",134,132,266
"26637","MARSABIT","SOLOLO","56",54,69,123
"26638","MARSABIT","SOLOLO","57",58,82,140
"26639","MARSABIT","SOLOLO","58",55,64,119
"26640","MARSABIT","SOLOLO","59",66,75,141
"26641","MARSABIT","SOLOLO","55-59",367,422,789
"26642","MARSABIT","SOLOLO","60",184,129,313
"26643","MARSABIT","SOLOLO","61",49,68,117
"26644","MARSABIT","SOLOLO","62",39,39,78
"26645","MARSABIT","SOLOLO","63",42,46,88
"26646","MARSABIT","SOLOLO","64",33,22,55
"26647","MARSABIT","SOLOLO","60-64",347,304,651
"26648","MARSABIT","SOLOLO","65",100,64,164
"26649","MARSABIT","SOLOLO","66",37,38,75
"26650","MARSABIT","SOLOLO","67",46,30,76
"26651","MARSABIT","SOLOLO","68",40,19,59
"26652","MARSABIT","SOLOLO","69",38,56,94
"26653","MARSABIT","SOLOLO","65-69",261,207,468
"26654","MARSABIT","SOLOLO","70",134,92,226
"26655","MARSABIT","SOLOLO","71",34,45,79
"26656","MARSABIT","SOLOLO","72",38,11,49
"26657","MARSABIT","SOLOLO","73",23,15,38
"26658","MARSABIT","SOLOLO","74",19,14,33
"26659","MARSABIT","SOLOLO","70-74",248,177,425
"26660","MARSABIT","SOLOLO","75",24,31,55
"26661","MARSABIT","SOLOLO","76",13,13,26
"26662","MARSABIT","SOLOLO","77",11,7,18
"26663","MARSABIT","SOLOLO","78",12,12,24
"26664","MARSABIT","SOLOLO","79",16,16,32
"26665","MARSABIT","SOLOLO","75-79",76,79,155
"26666","MARSABIT","SOLOLO","80",51,54,105
"26667","MARSABIT","SOLOLO","81",19,31,50
"26668","MARSABIT","SOLOLO","82",14,15,29
"26669","MARSABIT","SOLOLO","83",8,4,12
"26670","MARSABIT","SOLOLO","84",10,9,19
"26671","MARSABIT","SOLOLO","80-84",102,113,215
"26672","MARSABIT","SOLOLO","85",11,6,17
"26673","MARSABIT","SOLOLO","86",10,8,18
"26674","MARSABIT","SOLOLO","87",5,6,11
"26675","MARSABIT","SOLOLO","88",5,NA,5
"26676","MARSABIT","SOLOLO","89",8,13,21
"26677","MARSABIT","SOLOLO","85-89",39,33,72
"26678","MARSABIT","SOLOLO","90",16,6,22
"26679","MARSABIT","SOLOLO","91",8,3,11
"26680","MARSABIT","SOLOLO","92",5,1,6
"26681","MARSABIT","SOLOLO","93",3,4,7
"26682","MARSABIT","SOLOLO","94",4,1,5
"26683","MARSABIT","SOLOLO","90-94",36,15,51
"26684","MARSABIT","SOLOLO","95",4,5,9
"26685","MARSABIT","SOLOLO","96",2,NA,2
"26686","MARSABIT","SOLOLO","97",4,NA,4
"26687","MARSABIT","SOLOLO","98",3,1,4
"26688","MARSABIT","SOLOLO","99",1,1,2
"26689","MARSABIT","SOLOLO","95-99",14,7,21
"26690","MARSABIT","SOLOLO","100+",4,6,10
"26691","MARSABIT","SOLOLO","Not Stated",NA,NA,NA
"26692","MERU","ALL","Total",767698,777975,1545673
"26693","MERU","ALL","0",15548,15670,31218
"26694","MERU","ALL","1",17210,16949,34159
"26695","MERU","ALL","2",17143,17099,34242
"26696","MERU","ALL","3",17974,17913,35887
"26697","MERU","ALL","4",17509,17247,34756
"26698","MERU","ALL","0 - 4",85384,84878,170262
"26699","MERU","ALL","5",17623,16846,34469
"26700","MERU","ALL","6",17603,17418,35021
"26701","MERU","ALL","7",17585,17241,34826
"26702","MERU","ALL","8",16659,16942,33601
"26703","MERU","ALL","9",18512,18621,37133
"26704","MERU","ALL","5-9",87982,87068,175050
"26705","MERU","ALL","10",20343,19535,39878
"26706","MERU","ALL","11",17689,18241,35930
"26707","MERU","ALL","12",20144,19732,39876
"26708","MERU","ALL","13",20349,20559,40908
"26709","MERU","ALL","14",19317,19013,38330
"26710","MERU","ALL","10 -14",97842,97080,194922
"26711","MERU","ALL","15",18461,18591,37052
"26712","MERU","ALL","16",16680,17304,33984
"26713","MERU","ALL","17",16911,16893,33804
"26714","MERU","ALL","18",14479,14840,29319
"26715","MERU","ALL","19",15335,15757,31092
"26716","MERU","ALL","15-19",81866,83385,165251
"26717","MERU","ALL","20",15365,15960,31325
"26718","MERU","ALL","21",12087,13021,25108
"26719","MERU","ALL","22",12819,13013,25832
"26720","MERU","ALL","23",12808,13370,26178
"26721","MERU","ALL","24",11855,11812,23667
"26722","MERU","ALL","20-24",64934,67176,132110
"26723","MERU","ALL","25",14035,13267,27302
"26724","MERU","ALL","26",10440,10918,21358
"26725","MERU","ALL","27",11501,11543,23044
"26726","MERU","ALL","28",10201,10256,20457
"26727","MERU","ALL","29",10191,10478,20669
"26728","MERU","ALL","25-29",56368,56462,112830
"26729","MERU","ALL","30",15926,16011,31937
"26730","MERU","ALL","31",9362,9449,18811
"26731","MERU","ALL","32",11876,12891,24767
"26732","MERU","ALL","33",10661,11918,22579
"26733","MERU","ALL","34",9257,10159,19416
"26734","MERU","ALL","30-34",57082,60428,117510
"26735","MERU","ALL","35",16901,16646,33547
"26736","MERU","ALL","36",9037,8778,17815
"26737","MERU","ALL","37",9892,8826,18718
"26738","MERU","ALL","38",7832,7968,15800
"26739","MERU","ALL","39",9341,8735,18076
"26740","MERU","ALL","35-39",53003,50953,103956
"26741","MERU","ALL","40",13958,12926,26884
"26742","MERU","ALL","41",9031,7708,16739
"26743","MERU","ALL","42",8327,7307,15634
"26744","MERU","ALL","43",7071,7005,14076
"26745","MERU","ALL","44",6535,6178,12713
"26746","MERU","ALL","40-44",44922,41124,86046
"26747","MERU","ALL","45",10280,9794,20074
"26748","MERU","ALL","46",7022,6802,13824
"26749","MERU","ALL","47",6861,6788,13649
"26750","MERU","ALL","48",5264,5318,10582
"26751","MERU","ALL","49",6388,6444,12832
"26752","MERU","ALL","45-49",35815,35146,70961
"26753","MERU","ALL","50",8746,9238,17984
"26754","MERU","ALL","51",5264,4607,9871
"26755","MERU","ALL","52",4090,3483,7573
"26756","MERU","ALL","53",2953,2741,5694
"26757","MERU","ALL","54",3707,3280,6987
"26758","MERU","ALL","50-54",24760,23349,48109
"26759","MERU","ALL","55",5055,4883,9938
"26760","MERU","ALL","56",5395,5340,10735
"26761","MERU","ALL","57",4064,4783,8847
"26762","MERU","ALL","58",3730,3960,7690
"26763","MERU","ALL","59",4192,4589,8781
"26764","MERU","ALL","55-59",22436,23555,45991
"26765","MERU","ALL","60",6204,7076,13280
"26766","MERU","ALL","61",3291,3463,6754
"26767","MERU","ALL","62",3071,3006,6077
"26768","MERU","ALL","63",2756,2940,5696
"26769","MERU","ALL","64",1975,2156,4131
"26770","MERU","ALL","60-64",17297,18641,35938
"26771","MERU","ALL","65",3909,4642,8551
"26772","MERU","ALL","66",1960,2128,4088
"26773","MERU","ALL","67",3524,3575,7099
"26774","MERU","ALL","68",1883,1809,3692
"26775","MERU","ALL","69",2745,3265,6010
"26776","MERU","ALL","65-69",14021,15419,29440
"26777","MERU","ALL","70",4702,6546,11248
"26778","MERU","ALL","71",1890,2083,3973
"26779","MERU","ALL","72",1887,1889,3776
"26780","MERU","ALL","73",1294,1408,2702
"26781","MERU","ALL","74",1184,1756,2940
"26782","MERU","ALL","70-74",10957,13682,24639
"26783","MERU","ALL","75",1508,1953,3461
"26784","MERU","ALL","76",808,859,1667
"26785","MERU","ALL","77",1171,1272,2443
"26786","MERU","ALL","78",858,808,1666
"26787","MERU","ALL","79",949,1821,2770
"26788","MERU","ALL","75-79",5294,6713,12007
"26789","MERU","ALL","80",1695,3241,4936
"26790","MERU","ALL","81",565,746,1311
"26791","MERU","ALL","82",547,574,1121
"26792","MERU","ALL","83",541,650,1191
"26793","MERU","ALL","84",561,863,1424
"26794","MERU","ALL","80-84",3909,6074,9983
"26795","MERU","ALL","85",631,914,1545
"26796","MERU","ALL","86",413,381,794
"26797","MERU","ALL","87",359,506,865
"26798","MERU","ALL","88",224,280,504
"26799","MERU","ALL","89",444,1136,1580
"26800","MERU","ALL","85-89",2071,3217,5288
"26801","MERU","ALL","90",455,1032,1487
"26802","MERU","ALL","91",156,287,443
"26803","MERU","ALL","92",111,175,286
"26804","MERU","ALL","93",97,157,254
"26805","MERU","ALL","94",107,250,357
"26806","MERU","ALL","90-94",926,1901,2827
"26807","MERU","ALL","95",174,314,488
"26808","MERU","ALL","96",63,107,170
"26809","MERU","ALL","97",100,122,222
"26810","MERU","ALL","98",66,90,156
"26811","MERU","ALL","99",115,293,408
"26812","MERU","ALL","95-99",518,926,1444
"26813","MERU","ALL","100+",295,784,1079
"26814","MERU","ALL","Not Stated",16,14,30
"26815","MERU","BUURI EAST","Total",38101,38497,76598
"26816","MERU","BUURI EAST","0",674,638,1312
"26817","MERU","BUURI EAST","1",731,697,1428
"26818","MERU","BUURI EAST","2",734,722,1456
"26819","MERU","BUURI EAST","3",768,785,1553
"26820","MERU","BUURI EAST","4",695,748,1443
"26821","MERU","BUURI EAST","0 - 4",3602,3590,7192
"26822","MERU","BUURI EAST","5",729,667,1396
"26823","MERU","BUURI EAST","6",788,755,1543
"26824","MERU","BUURI EAST","7",716,746,1462
"26825","MERU","BUURI EAST","8",686,699,1385
"26826","MERU","BUURI EAST","9",791,804,1595
"26827","MERU","BUURI EAST","5-9",3710,3671,7381
"26828","MERU","BUURI EAST","10",865,827,1692
"26829","MERU","BUURI EAST","11",740,788,1528
"26830","MERU","BUURI EAST","12",879,915,1794
"26831","MERU","BUURI EAST","13",978,902,1880
"26832","MERU","BUURI EAST","14",885,839,1724
"26833","MERU","BUURI EAST","10 -14",4347,4271,8618
"26834","MERU","BUURI EAST","15",890,818,1708
"26835","MERU","BUURI EAST","16",789,773,1562
"26836","MERU","BUURI EAST","17",861,755,1616
"26837","MERU","BUURI EAST","18",709,593,1302
"26838","MERU","BUURI EAST","19",721,660,1381
"26839","MERU","BUURI EAST","15-19",3970,3599,7569
"26840","MERU","BUURI EAST","20",650,623,1273
"26841","MERU","BUURI EAST","21",559,480,1039
"26842","MERU","BUURI EAST","22",552,537,1089
"26843","MERU","BUURI EAST","23",620,553,1173
"26844","MERU","BUURI EAST","24",540,487,1027
"26845","MERU","BUURI EAST","20-24",2921,2680,5601
"26846","MERU","BUURI EAST","25",568,507,1075
"26847","MERU","BUURI EAST","26",485,450,935
"26848","MERU","BUURI EAST","27",503,499,1002
"26849","MERU","BUURI EAST","28",414,459,873
"26850","MERU","BUURI EAST","29",489,494,983
"26851","MERU","BUURI EAST","25-29",2459,2409,4868
"26852","MERU","BUURI EAST","30",685,700,1385
"26853","MERU","BUURI EAST","31",445,440,885
"26854","MERU","BUURI EAST","32",542,624,1166
"26855","MERU","BUURI EAST","33",521,587,1108
"26856","MERU","BUURI EAST","34",528,543,1071
"26857","MERU","BUURI EAST","30-34",2721,2894,5615
"26858","MERU","BUURI EAST","35",776,754,1530
"26859","MERU","BUURI EAST","36",504,548,1052
"26860","MERU","BUURI EAST","37",553,455,1008
"26861","MERU","BUURI EAST","38",434,462,896
"26862","MERU","BUURI EAST","39",571,587,1158
"26863","MERU","BUURI EAST","35-39",2838,2806,5644
"26864","MERU","BUURI EAST","40",748,739,1487
"26865","MERU","BUURI EAST","41",487,424,911
"26866","MERU","BUURI EAST","42",493,433,926
"26867","MERU","BUURI EAST","43",389,440,829
"26868","MERU","BUURI EAST","44",375,367,742
"26869","MERU","BUURI EAST","40-44",2492,2403,4895
"26870","MERU","BUURI EAST","45",586,567,1153
"26871","MERU","BUURI EAST","46",405,392,797
"26872","MERU","BUURI EAST","47",448,427,875
"26873","MERU","BUURI EAST","48",361,355,716
"26874","MERU","BUURI EAST","49",384,430,814
"26875","MERU","BUURI EAST","45-49",2184,2171,4355
"26876","MERU","BUURI EAST","50",491,587,1078
"26877","MERU","BUURI EAST","51",352,394,746
"26878","MERU","BUURI EAST","52",344,295,639
"26879","MERU","BUURI EAST","53",246,230,476
"26880","MERU","BUURI EAST","54",297,271,568
"26881","MERU","BUURI EAST","50-54",1730,1777,3507
"26882","MERU","BUURI EAST","55",337,372,709
"26883","MERU","BUURI EAST","56",356,379,735
"26884","MERU","BUURI EAST","57",303,410,713
"26885","MERU","BUURI EAST","58",278,317,595
"26886","MERU","BUURI EAST","59",285,338,623
"26887","MERU","BUURI EAST","55-59",1559,1816,3375
"26888","MERU","BUURI EAST","60",367,454,821
"26889","MERU","BUURI EAST","61",258,256,514
"26890","MERU","BUURI EAST","62",221,181,402
"26891","MERU","BUURI EAST","63",176,210,386
"26892","MERU","BUURI EAST","64",136,141,277
"26893","MERU","BUURI EAST","60-64",1158,1242,2400
"26894","MERU","BUURI EAST","65",217,271,488
"26895","MERU","BUURI EAST","66",136,172,308
"26896","MERU","BUURI EAST","67",232,253,485
"26897","MERU","BUURI EAST","68",124,125,249
"26898","MERU","BUURI EAST","69",172,211,383
"26899","MERU","BUURI EAST","65-69",881,1032,1913
"26900","MERU","BUURI EAST","70",275,407,682
"26901","MERU","BUURI EAST","71",126,131,257
"26902","MERU","BUURI EAST","72",132,124,256
"26903","MERU","BUURI EAST","73",71,100,171
"26904","MERU","BUURI EAST","74",68,120,188
"26905","MERU","BUURI EAST","70-74",672,882,1554
"26906","MERU","BUURI EAST","75",108,107,215
"26907","MERU","BUURI EAST","76",61,60,121
"26908","MERU","BUURI EAST","77",73,103,176
"26909","MERU","BUURI EAST","78",47,61,108
"26910","MERU","BUURI EAST","79",38,100,138
"26911","MERU","BUURI EAST","75-79",327,431,758
"26912","MERU","BUURI EAST","80",108,197,305
"26913","MERU","BUURI EAST","81",48,64,112
"26914","MERU","BUURI EAST","82",43,42,85
"26915","MERU","BUURI EAST","83",46,40,86
"26916","MERU","BUURI EAST","84",51,65,116
"26917","MERU","BUURI EAST","80-84",296,408,704
"26918","MERU","BUURI EAST","85",41,48,89
"26919","MERU","BUURI EAST","86",28,31,59
"26920","MERU","BUURI EAST","87",21,25,46
"26921","MERU","BUURI EAST","88",17,15,32
"26922","MERU","BUURI EAST","89",21,62,83
"26923","MERU","BUURI EAST","85-89",128,181,309
"26924","MERU","BUURI EAST","90",27,59,86
"26925","MERU","BUURI EAST","91",7,36,43
"26926","MERU","BUURI EAST","92",8,9,17
"26927","MERU","BUURI EAST","93",10,7,17
"26928","MERU","BUURI EAST","94",8,20,28
"26929","MERU","BUURI EAST","90-94",60,131,191
"26930","MERU","BUURI EAST","95",7,20,27
"26931","MERU","BUURI EAST","96",2,17,19
"26932","MERU","BUURI EAST","97",8,6,14
"26933","MERU","BUURI EAST","98",6,7,13
"26934","MERU","BUURI EAST","99",6,12,18
"26935","MERU","BUURI EAST","95-99",29,62,91
"26936","MERU","BUURI EAST","100+",16,39,55
"26937","MERU","BUURI EAST","Not Stated",1,2,3
"26938","MERU","BUURI WEST","Total",40496,40264,80760
"26939","MERU","BUURI WEST","0",831,810,1641
"26940","MERU","BUURI WEST","1",881,872,1753
"26941","MERU","BUURI WEST","2",829,857,1686
"26942","MERU","BUURI WEST","3",875,813,1688
"26943","MERU","BUURI WEST","4",831,839,1670
"26944","MERU","BUURI WEST","0 - 4",4247,4191,8438
"26945","MERU","BUURI WEST","5",785,796,1581
"26946","MERU","BUURI WEST","6",807,811,1618
"26947","MERU","BUURI WEST","7",857,818,1675
"26948","MERU","BUURI WEST","8",810,776,1586
"26949","MERU","BUURI WEST","9",884,915,1799
"26950","MERU","BUURI WEST","5-9",4143,4116,8259
"26951","MERU","BUURI WEST","10",859,865,1724
"26952","MERU","BUURI WEST","11",830,844,1674
"26953","MERU","BUURI WEST","12",893,882,1775
"26954","MERU","BUURI WEST","13",948,897,1845
"26955","MERU","BUURI WEST","14",927,825,1752
"26956","MERU","BUURI WEST","10 -14",4457,4313,8770
"26957","MERU","BUURI WEST","15",851,848,1699
"26958","MERU","BUURI WEST","16",812,829,1641
"26959","MERU","BUURI WEST","17",813,802,1615
"26960","MERU","BUURI WEST","18",665,654,1319
"26961","MERU","BUURI WEST","19",709,700,1409
"26962","MERU","BUURI WEST","15-19",3850,3833,7683
"26963","MERU","BUURI WEST","20",696,701,1397
"26964","MERU","BUURI WEST","21",693,690,1383
"26965","MERU","BUURI WEST","22",723,665,1388
"26966","MERU","BUURI WEST","23",760,751,1511
"26967","MERU","BUURI WEST","24",750,721,1471
"26968","MERU","BUURI WEST","20-24",3622,3528,7150
"26969","MERU","BUURI WEST","25",766,777,1543
"26970","MERU","BUURI WEST","26",615,665,1280
"26971","MERU","BUURI WEST","27",710,667,1377
"26972","MERU","BUURI WEST","28",631,639,1270
"26973","MERU","BUURI WEST","29",664,741,1405
"26974","MERU","BUURI WEST","25-29",3386,3489,6875
"26975","MERU","BUURI WEST","30",867,921,1788
"26976","MERU","BUURI WEST","31",616,631,1247
"26977","MERU","BUURI WEST","32",739,843,1582
"26978","MERU","BUURI WEST","33",655,751,1406
"26979","MERU","BUURI WEST","34",569,679,1248
"26980","MERU","BUURI WEST","30-34",3446,3825,7271
"26981","MERU","BUURI WEST","35",889,893,1782
"26982","MERU","BUURI WEST","36",594,580,1174
"26983","MERU","BUURI WEST","37",683,584,1267
"26984","MERU","BUURI WEST","38",558,542,1100
"26985","MERU","BUURI WEST","39",630,563,1193
"26986","MERU","BUURI WEST","35-39",3354,3162,6516
"26987","MERU","BUURI WEST","40",785,709,1494
"26988","MERU","BUURI WEST","41",575,510,1085
"26989","MERU","BUURI WEST","42",627,501,1128
"26990","MERU","BUURI WEST","43",445,478,923
"26991","MERU","BUURI WEST","44",403,356,759
"26992","MERU","BUURI WEST","40-44",2835,2554,5389
"26993","MERU","BUURI WEST","45",601,560,1161
"26994","MERU","BUURI WEST","46",432,425,857
"26995","MERU","BUURI WEST","47",409,384,793
"26996","MERU","BUURI WEST","48",347,310,657
"26997","MERU","BUURI WEST","49",371,343,714
"26998","MERU","BUURI WEST","45-49",2160,2022,4182
"26999","MERU","BUURI WEST","50",455,485,940
"27000","MERU","BUURI WEST","51",323,266,589
"27001","MERU","BUURI WEST","52",246,233,479
"27002","MERU","BUURI WEST","53",180,179,359
"27003","MERU","BUURI WEST","54",223,234,457
"27004","MERU","BUURI WEST","50-54",1427,1397,2824
"27005","MERU","BUURI WEST","55",325,254,579
"27006","MERU","BUURI WEST","56",296,267,563
"27007","MERU","BUURI WEST","57",217,236,453
"27008","MERU","BUURI WEST","58",204,192,396
"27009","MERU","BUURI WEST","59",191,192,383
"27010","MERU","BUURI WEST","55-59",1233,1141,2374
"27011","MERU","BUURI WEST","60",267,283,550
"27012","MERU","BUURI WEST","61",157,166,323
"27013","MERU","BUURI WEST","62",154,144,298
"27014","MERU","BUURI WEST","63",103,143,246
"27015","MERU","BUURI WEST","64",98,89,187
"27016","MERU","BUURI WEST","60-64",779,825,1604
"27017","MERU","BUURI WEST","65",167,154,321
"27018","MERU","BUURI WEST","66",101,102,203
"27019","MERU","BUURI WEST","67",158,190,348
"27020","MERU","BUURI WEST","68",83,70,153
"27021","MERU","BUURI WEST","69",122,139,261
"27022","MERU","BUURI WEST","65-69",631,655,1286
"27023","MERU","BUURI WEST","70",173,191,364
"27024","MERU","BUURI WEST","71",80,86,166
"27025","MERU","BUURI WEST","72",83,87,170
"27026","MERU","BUURI WEST","73",57,56,113
"27027","MERU","BUURI WEST","74",49,66,115
"27028","MERU","BUURI WEST","70-74",442,486,928
"27029","MERU","BUURI WEST","75",47,71,118
"27030","MERU","BUURI WEST","76",38,52,90
"27031","MERU","BUURI WEST","77",48,61,109
"27032","MERU","BUURI WEST","78",40,32,72
"27033","MERU","BUURI WEST","79",35,61,96
"27034","MERU","BUURI WEST","75-79",208,277,485
"27035","MERU","BUURI WEST","80",49,104,153
"27036","MERU","BUURI WEST","81",22,23,45
"27037","MERU","BUURI WEST","82",22,21,43
"27038","MERU","BUURI WEST","83",23,22,45
"27039","MERU","BUURI WEST","84",18,33,51
"27040","MERU","BUURI WEST","80-84",134,203,337
"27041","MERU","BUURI WEST","85",20,26,46
"27042","MERU","BUURI WEST","86",18,16,34
"27043","MERU","BUURI WEST","87",17,27,44
"27044","MERU","BUURI WEST","88",10,13,23
"27045","MERU","BUURI WEST","89",18,44,62
"27046","MERU","BUURI WEST","85-89",83,126,209
"27047","MERU","BUURI WEST","90",13,32,45
"27048","MERU","BUURI WEST","91",6,17,23
"27049","MERU","BUURI WEST","92",6,7,13
"27050","MERU","BUURI WEST","93",4,7,11
"27051","MERU","BUURI WEST","94",6,9,15
"27052","MERU","BUURI WEST","90-94",35,72,107
"27053","MERU","BUURI WEST","95",3,7,10
"27054","MERU","BUURI WEST","96",3,6,9
"27055","MERU","BUURI WEST","97",7,1,8
"27056","MERU","BUURI WEST","98",2,2,4
"27057","MERU","BUURI WEST","99",1,13,14
"27058","MERU","BUURI WEST","95-99",16,29,45
"27059","MERU","BUURI WEST","100+",8,20,28
"27060","MERU","BUURI WEST","Not Stated",NA,NA,NA
"27061","MERU","IGEMBE CENTRAL","Total",111208,110200,221408
"27062","MERU","IGEMBE CENTRAL","0",2225,2315,4540
"27063","MERU","IGEMBE CENTRAL","1",2766,2662,5428
"27064","MERU","IGEMBE CENTRAL","2",2778,2735,5513
"27065","MERU","IGEMBE CENTRAL","3",2966,2943,5909
"27066","MERU","IGEMBE CENTRAL","4",2944,2669,5613
"27067","MERU","IGEMBE CENTRAL","0 - 4",13679,13324,27003
"27068","MERU","IGEMBE CENTRAL","5",2856,2846,5702
"27069","MERU","IGEMBE CENTRAL","6",2868,2879,5747
"27070","MERU","IGEMBE CENTRAL","7",2756,2715,5471
"27071","MERU","IGEMBE CENTRAL","8",2549,2657,5206
"27072","MERU","IGEMBE CENTRAL","9",2977,2818,5795
"27073","MERU","IGEMBE CENTRAL","5-9",14006,13915,27921
"27074","MERU","IGEMBE CENTRAL","10",3336,3128,6464
"27075","MERU","IGEMBE CENTRAL","11",2776,2810,5586
"27076","MERU","IGEMBE CENTRAL","12",3142,3138,6280
"27077","MERU","IGEMBE CENTRAL","13",3215,3203,6418
"27078","MERU","IGEMBE CENTRAL","14",3059,3118,6177
"27079","MERU","IGEMBE CENTRAL","10 -14",15528,15397,30925
"27080","MERU","IGEMBE CENTRAL","15",2937,2839,5776
"27081","MERU","IGEMBE CENTRAL","16",2730,2687,5417
"27082","MERU","IGEMBE CENTRAL","17",2727,2599,5326
"27083","MERU","IGEMBE CENTRAL","18",2315,2451,4766
"27084","MERU","IGEMBE CENTRAL","19",2390,2507,4897
"27085","MERU","IGEMBE CENTRAL","15-19",13099,13083,26182
"27086","MERU","IGEMBE CENTRAL","20",2541,2716,5257
"27087","MERU","IGEMBE CENTRAL","21",1769,1865,3634
"27088","MERU","IGEMBE CENTRAL","22",1952,1913,3865
"27089","MERU","IGEMBE CENTRAL","23",1855,1776,3631
"27090","MERU","IGEMBE CENTRAL","24",1639,1589,3228
"27091","MERU","IGEMBE CENTRAL","20-24",9756,9859,19615
"27092","MERU","IGEMBE CENTRAL","25",2292,1974,4266
"27093","MERU","IGEMBE CENTRAL","26",1476,1474,2950
"27094","MERU","IGEMBE CENTRAL","27",1677,1537,3214
"27095","MERU","IGEMBE CENTRAL","28",1483,1377,2860
"27096","MERU","IGEMBE CENTRAL","29",1416,1412,2828
"27097","MERU","IGEMBE CENTRAL","25-29",8344,7774,16118
"27098","MERU","IGEMBE CENTRAL","30",2529,2454,4983
"27099","MERU","IGEMBE CENTRAL","31",1191,1166,2357
"27100","MERU","IGEMBE CENTRAL","32",1662,1691,3353
"27101","MERU","IGEMBE CENTRAL","33",1328,1422,2750
"27102","MERU","IGEMBE CENTRAL","34",1125,1334,2459
"27103","MERU","IGEMBE CENTRAL","30-34",7835,8067,15902
"27104","MERU","IGEMBE CENTRAL","35",2655,2612,5267
"27105","MERU","IGEMBE CENTRAL","36",1177,1071,2248
"27106","MERU","IGEMBE CENTRAL","37",1242,1180,2422
"27107","MERU","IGEMBE CENTRAL","38",925,1003,1928
"27108","MERU","IGEMBE CENTRAL","39",1114,1104,2218
"27109","MERU","IGEMBE CENTRAL","35-39",7113,6970,14083
"27110","MERU","IGEMBE CENTRAL","40",2056,1945,4001
"27111","MERU","IGEMBE CENTRAL","41",1169,962,2131
"27112","MERU","IGEMBE CENTRAL","42",1052,890,1942
"27113","MERU","IGEMBE CENTRAL","43",777,814,1591
"27114","MERU","IGEMBE CENTRAL","44",815,779,1594
"27115","MERU","IGEMBE CENTRAL","40-44",5869,5390,11259
"27116","MERU","IGEMBE CENTRAL","45",1509,1301,2810
"27117","MERU","IGEMBE CENTRAL","46",848,768,1616
"27118","MERU","IGEMBE CENTRAL","47",819,705,1524
"27119","MERU","IGEMBE CENTRAL","48",572,556,1128
"27120","MERU","IGEMBE CENTRAL","49",786,777,1563
"27121","MERU","IGEMBE CENTRAL","45-49",4534,4107,8641
"27122","MERU","IGEMBE CENTRAL","50",1285,1200,2485
"27123","MERU","IGEMBE CENTRAL","51",554,383,937
"27124","MERU","IGEMBE CENTRAL","52",446,292,738
"27125","MERU","IGEMBE CENTRAL","53",231,216,447
"27126","MERU","IGEMBE CENTRAL","54",393,250,643
"27127","MERU","IGEMBE CENTRAL","50-54",2909,2341,5250
"27128","MERU","IGEMBE CENTRAL","55",601,528,1129
"27129","MERU","IGEMBE CENTRAL","56",677,595,1272
"27130","MERU","IGEMBE CENTRAL","57",383,429,812
"27131","MERU","IGEMBE CENTRAL","58",426,402,828
"27132","MERU","IGEMBE CENTRAL","59",437,494,931
"27133","MERU","IGEMBE CENTRAL","55-59",2524,2448,4972
"27134","MERU","IGEMBE CENTRAL","60",781,934,1715
"27135","MERU","IGEMBE CENTRAL","61",316,315,631
"27136","MERU","IGEMBE CENTRAL","62",316,328,644
"27137","MERU","IGEMBE CENTRAL","63",297,310,607
"27138","MERU","IGEMBE CENTRAL","64",216,235,451
"27139","MERU","IGEMBE CENTRAL","60-64",1926,2122,4048
"27140","MERU","IGEMBE CENTRAL","65",538,651,1189
"27141","MERU","IGEMBE CENTRAL","66",182,174,356
"27142","MERU","IGEMBE CENTRAL","67",358,303,661
"27143","MERU","IGEMBE CENTRAL","68",207,173,380
"27144","MERU","IGEMBE CENTRAL","69",271,373,644
"27145","MERU","IGEMBE CENTRAL","65-69",1556,1674,3230
"27146","MERU","IGEMBE CENTRAL","70",677,980,1657
"27147","MERU","IGEMBE CENTRAL","71",170,170,340
"27148","MERU","IGEMBE CENTRAL","72",162,203,365
"27149","MERU","IGEMBE CENTRAL","73",101,110,211
"27150","MERU","IGEMBE CENTRAL","74",107,185,292
"27151","MERU","IGEMBE CENTRAL","70-74",1217,1648,2865
"27152","MERU","IGEMBE CENTRAL","75",179,240,419
"27153","MERU","IGEMBE CENTRAL","76",60,71,131
"27154","MERU","IGEMBE CENTRAL","77",121,102,223
"27155","MERU","IGEMBE CENTRAL","78",53,75,128
"27156","MERU","IGEMBE CENTRAL","79",100,212,312
"27157","MERU","IGEMBE CENTRAL","75-79",513,700,1213
"27158","MERU","IGEMBE CENTRAL","80",218,438,656
"27159","MERU","IGEMBE CENTRAL","81",50,60,110
"27160","MERU","IGEMBE CENTRAL","82",48,52,100
"27161","MERU","IGEMBE CENTRAL","83",30,45,75
"27162","MERU","IGEMBE CENTRAL","84",46,80,126
"27163","MERU","IGEMBE CENTRAL","80-84",392,675,1067
"27164","MERU","IGEMBE CENTRAL","85",82,103,185
"27165","MERU","IGEMBE CENTRAL","86",37,30,67
"27166","MERU","IGEMBE CENTRAL","87",28,42,70
"27167","MERU","IGEMBE CENTRAL","88",15,26,41
"27168","MERU","IGEMBE CENTRAL","89",45,110,155
"27169","MERU","IGEMBE CENTRAL","85-89",207,311,518
"27170","MERU","IGEMBE CENTRAL","90",61,133,194
"27171","MERU","IGEMBE CENTRAL","91",13,15,28
"27172","MERU","IGEMBE CENTRAL","92",7,11,18
"27173","MERU","IGEMBE CENTRAL","93",9,12,21
"27174","MERU","IGEMBE CENTRAL","94",10,20,30
"27175","MERU","IGEMBE CENTRAL","90-94",100,191,291
"27176","MERU","IGEMBE CENTRAL","95",18,29,47
"27177","MERU","IGEMBE CENTRAL","96",6,8,14
"27178","MERU","IGEMBE CENTRAL","97",14,10,24
"27179","MERU","IGEMBE CENTRAL","98",2,7,9
"27180","MERU","IGEMBE CENTRAL","99",19,19,38
"27181","MERU","IGEMBE CENTRAL","95-99",59,73,132
"27182","MERU","IGEMBE CENTRAL","100+",40,128,168
"27183","MERU","IGEMBE CENTRAL","Not Stated",2,3,5
"27184","MERU","IGEMBE NORTH","Total",83364,85949,169313
"27185","MERU","IGEMBE NORTH","0",1825,1832,3657
"27186","MERU","IGEMBE NORTH","1",2133,2179,4312
"27187","MERU","IGEMBE NORTH","2",2188,2223,4411
"27188","MERU","IGEMBE NORTH","3",2265,2274,4539
"27189","MERU","IGEMBE NORTH","4",2195,2182,4377
"27190","MERU","IGEMBE NORTH","0 - 4",10606,10690,21296
"27191","MERU","IGEMBE NORTH","5",2337,2165,4502
"27192","MERU","IGEMBE NORTH","6",2255,2164,4419
"27193","MERU","IGEMBE NORTH","7",2133,2033,4166
"27194","MERU","IGEMBE NORTH","8",2187,2144,4331
"27195","MERU","IGEMBE NORTH","9",2392,2358,4750
"27196","MERU","IGEMBE NORTH","5-9",11304,10864,22168
"27197","MERU","IGEMBE NORTH","10",2798,2648,5446
"27198","MERU","IGEMBE NORTH","11",2181,2267,4448
"27199","MERU","IGEMBE NORTH","12",2717,2610,5327
"27200","MERU","IGEMBE NORTH","13",2666,2870,5536
"27201","MERU","IGEMBE NORTH","14",2445,2532,4977
"27202","MERU","IGEMBE NORTH","10 -14",12807,12927,25734
"27203","MERU","IGEMBE NORTH","15",2355,2505,4860
"27204","MERU","IGEMBE NORTH","16",2013,2168,4181
"27205","MERU","IGEMBE NORTH","17",1965,2065,4030
"27206","MERU","IGEMBE NORTH","18",1635,1909,3544
"27207","MERU","IGEMBE NORTH","19",1731,1902,3633
"27208","MERU","IGEMBE NORTH","15-19",9699,10549,20248
"27209","MERU","IGEMBE NORTH","20",1958,2072,4030
"27210","MERU","IGEMBE NORTH","21",1256,1413,2669
"27211","MERU","IGEMBE NORTH","22",1381,1431,2812
"27212","MERU","IGEMBE NORTH","23",1184,1437,2621
"27213","MERU","IGEMBE NORTH","24",1237,1168,2405
"27214","MERU","IGEMBE NORTH","20-24",7016,7521,14537
"27215","MERU","IGEMBE NORTH","25",1627,1575,3202
"27216","MERU","IGEMBE NORTH","26",1065,1034,2099
"27217","MERU","IGEMBE NORTH","27",1155,1137,2292
"27218","MERU","IGEMBE NORTH","28",963,1046,2009
"27219","MERU","IGEMBE NORTH","29",931,959,1890
"27220","MERU","IGEMBE NORTH","25-29",5741,5751,11492
"27221","MERU","IGEMBE NORTH","30",1878,1906,3784
"27222","MERU","IGEMBE NORTH","31",742,847,1589
"27223","MERU","IGEMBE NORTH","32",1117,1200,2317
"27224","MERU","IGEMBE NORTH","33",925,1162,2087
"27225","MERU","IGEMBE NORTH","34",802,942,1744
"27226","MERU","IGEMBE NORTH","30-34",5464,6057,11521
"27227","MERU","IGEMBE NORTH","35",1934,1981,3915
"27228","MERU","IGEMBE NORTH","36",740,758,1498
"27229","MERU","IGEMBE NORTH","37",846,845,1691
"27230","MERU","IGEMBE NORTH","38",686,724,1410
"27231","MERU","IGEMBE NORTH","39",753,720,1473
"27232","MERU","IGEMBE NORTH","35-39",4959,5028,9987
"27233","MERU","IGEMBE NORTH","40",1552,1482,3034
"27234","MERU","IGEMBE NORTH","41",781,629,1410
"27235","MERU","IGEMBE NORTH","42",632,609,1241
"27236","MERU","IGEMBE NORTH","43",510,562,1072
"27237","MERU","IGEMBE NORTH","44",612,609,1221
"27238","MERU","IGEMBE NORTH","40-44",4087,3891,7978
"27239","MERU","IGEMBE NORTH","45",1049,1039,2088
"27240","MERU","IGEMBE NORTH","46",549,539,1088
"27241","MERU","IGEMBE NORTH","47",602,504,1106
"27242","MERU","IGEMBE NORTH","48",376,372,748
"27243","MERU","IGEMBE NORTH","49",616,604,1220
"27244","MERU","IGEMBE NORTH","45-49",3192,3058,6250
"27245","MERU","IGEMBE NORTH","50",951,1022,1973
"27246","MERU","IGEMBE NORTH","51",360,293,653
"27247","MERU","IGEMBE NORTH","52",293,222,515
"27248","MERU","IGEMBE NORTH","53",205,157,362
"27249","MERU","IGEMBE NORTH","54",221,226,447
"27250","MERU","IGEMBE NORTH","50-54",2030,1920,3950
"27251","MERU","IGEMBE NORTH","55",411,419,830
"27252","MERU","IGEMBE NORTH","56",462,470,932
"27253","MERU","IGEMBE NORTH","57",234,255,489
"27254","MERU","IGEMBE NORTH","58",241,219,460
"27255","MERU","IGEMBE NORTH","59",309,375,684
"27256","MERU","IGEMBE NORTH","55-59",1657,1738,3395
"27257","MERU","IGEMBE NORTH","60",634,753,1387
"27258","MERU","IGEMBE NORTH","61",203,243,446
"27259","MERU","IGEMBE NORTH","62",270,261,531
"27260","MERU","IGEMBE NORTH","63",199,216,415
"27261","MERU","IGEMBE NORTH","64",169,192,361
"27262","MERU","IGEMBE NORTH","60-64",1475,1665,3140
"27263","MERU","IGEMBE NORTH","65",449,531,980
"27264","MERU","IGEMBE NORTH","66",128,122,250
"27265","MERU","IGEMBE NORTH","67",237,229,466
"27266","MERU","IGEMBE NORTH","68",123,148,271
"27267","MERU","IGEMBE NORTH","69",215,325,540
"27268","MERU","IGEMBE NORTH","65-69",1152,1355,2507
"27269","MERU","IGEMBE NORTH","70",602,802,1404
"27270","MERU","IGEMBE NORTH","71",144,141,285
"27271","MERU","IGEMBE NORTH","72",121,123,244
"27272","MERU","IGEMBE NORTH","73",78,101,179
"27273","MERU","IGEMBE NORTH","74",90,107,197
"27274","MERU","IGEMBE NORTH","70-74",1035,1274,2309
"27275","MERU","IGEMBE NORTH","75",167,191,358
"27276","MERU","IGEMBE NORTH","76",51,58,109
"27277","MERU","IGEMBE NORTH","77",77,76,153
"27278","MERU","IGEMBE NORTH","78",63,47,110
"27279","MERU","IGEMBE NORTH","79",106,153,259
"27280","MERU","IGEMBE NORTH","75-79",464,525,989
"27281","MERU","IGEMBE NORTH","80",197,337,534
"27282","MERU","IGEMBE NORTH","81",35,50,85
"27283","MERU","IGEMBE NORTH","82",39,42,81
"27284","MERU","IGEMBE NORTH","83",33,41,74
"27285","MERU","IGEMBE NORTH","84",41,65,106
"27286","MERU","IGEMBE NORTH","80-84",345,535,880
"27287","MERU","IGEMBE NORTH","85",53,97,150
"27288","MERU","IGEMBE NORTH","86",30,35,65
"27289","MERU","IGEMBE NORTH","87",16,45,61
"27290","MERU","IGEMBE NORTH","88",19,16,35
"27291","MERU","IGEMBE NORTH","89",51,94,145
"27292","MERU","IGEMBE NORTH","85-89",169,287,456
"27293","MERU","IGEMBE NORTH","90",53,116,169
"27294","MERU","IGEMBE NORTH","91",11,16,27
"27295","MERU","IGEMBE NORTH","92",7,11,18
"27296","MERU","IGEMBE NORTH","93",6,4,10
"27297","MERU","IGEMBE NORTH","94",13,8,21
"27298","MERU","IGEMBE NORTH","90-94",90,155,245
"27299","MERU","IGEMBE NORTH","95",16,15,31
"27300","MERU","IGEMBE NORTH","96",4,4,8
"27301","MERU","IGEMBE NORTH","97",4,6,10
"27302","MERU","IGEMBE NORTH","98",4,5,9
"27303","MERU","IGEMBE NORTH","99",10,36,46
"27304","MERU","IGEMBE NORTH","95-99",38,66,104
"27305","MERU","IGEMBE NORTH","100+",33,92,125
"27306","MERU","IGEMBE NORTH","Not Stated",1,1,2
"27307","MERU","IGEMBE SOUTH","Total",80192,81446,161638
"27308","MERU","IGEMBE SOUTH","0",1855,1859,3714
"27309","MERU","IGEMBE SOUTH","1",1910,1922,3832
"27310","MERU","IGEMBE SOUTH","2",1941,1933,3874
"27311","MERU","IGEMBE SOUTH","3",2071,2113,4184
"27312","MERU","IGEMBE SOUTH","4",1972,2055,4027
"27313","MERU","IGEMBE SOUTH","0 - 4",9749,9882,19631
"27314","MERU","IGEMBE SOUTH","5",2049,1919,3968
"27315","MERU","IGEMBE SOUTH","6",1969,1938,3907
"27316","MERU","IGEMBE SOUTH","7",1964,1908,3872
"27317","MERU","IGEMBE SOUTH","8",1774,1825,3599
"27318","MERU","IGEMBE SOUTH","9",1929,1942,3871
"27319","MERU","IGEMBE SOUTH","5-9",9685,9532,19217
"27320","MERU","IGEMBE SOUTH","10",2209,2219,4428
"27321","MERU","IGEMBE SOUTH","11",1842,1931,3773
"27322","MERU","IGEMBE SOUTH","12",2067,2064,4131
"27323","MERU","IGEMBE SOUTH","13",2005,2106,4111
"27324","MERU","IGEMBE SOUTH","14",1946,1975,3921
"27325","MERU","IGEMBE SOUTH","10 -14",10069,10295,20364
"27326","MERU","IGEMBE SOUTH","15",1879,1949,3828
"27327","MERU","IGEMBE SOUTH","16",1702,1898,3600
"27328","MERU","IGEMBE SOUTH","17",1718,1876,3594
"27329","MERU","IGEMBE SOUTH","18",1571,1715,3286
"27330","MERU","IGEMBE SOUTH","19",1652,1855,3507
"27331","MERU","IGEMBE SOUTH","15-19",8522,9293,17815
"27332","MERU","IGEMBE SOUTH","20",1876,1979,3855
"27333","MERU","IGEMBE SOUTH","21",1359,1610,2969
"27334","MERU","IGEMBE SOUTH","22",1585,1699,3284
"27335","MERU","IGEMBE SOUTH","23",1497,1745,3242
"27336","MERU","IGEMBE SOUTH","24",1381,1409,2790
"27337","MERU","IGEMBE SOUTH","20-24",7698,8442,16140
"27338","MERU","IGEMBE SOUTH","25",1858,1759,3617
"27339","MERU","IGEMBE SOUTH","26",1276,1372,2648
"27340","MERU","IGEMBE SOUTH","27",1415,1479,2894
"27341","MERU","IGEMBE SOUTH","28",1275,1272,2547
"27342","MERU","IGEMBE SOUTH","29",1155,1127,2282
"27343","MERU","IGEMBE SOUTH","25-29",6979,7009,13988
"27344","MERU","IGEMBE SOUTH","30",2070,1895,3965
"27345","MERU","IGEMBE SOUTH","31",947,936,1883
"27346","MERU","IGEMBE SOUTH","32",1246,1374,2620
"27347","MERU","IGEMBE SOUTH","33",1097,1253,2350
"27348","MERU","IGEMBE SOUTH","34",886,1036,1922
"27349","MERU","IGEMBE SOUTH","30-34",6246,6494,12740
"27350","MERU","IGEMBE SOUTH","35",2034,1915,3949
"27351","MERU","IGEMBE SOUTH","36",938,850,1788
"27352","MERU","IGEMBE SOUTH","37",1023,918,1941
"27353","MERU","IGEMBE SOUTH","38",779,814,1593
"27354","MERU","IGEMBE SOUTH","39",916,764,1680
"27355","MERU","IGEMBE SOUTH","35-39",5690,5261,10951
"27356","MERU","IGEMBE SOUTH","40",1631,1397,3028
"27357","MERU","IGEMBE SOUTH","41",827,734,1561
"27358","MERU","IGEMBE SOUTH","42",744,695,1439
"27359","MERU","IGEMBE SOUTH","43",605,561,1166
"27360","MERU","IGEMBE SOUTH","44",552,546,1098
"27361","MERU","IGEMBE SOUTH","40-44",4359,3933,8292
"27362","MERU","IGEMBE SOUTH","45",1005,924,1929
"27363","MERU","IGEMBE SOUTH","46",619,595,1214
"27364","MERU","IGEMBE SOUTH","47",551,544,1095
"27365","MERU","IGEMBE SOUTH","48",439,400,839
"27366","MERU","IGEMBE SOUTH","49",520,513,1033
"27367","MERU","IGEMBE SOUTH","45-49",3134,2976,6110
"27368","MERU","IGEMBE SOUTH","50",789,799,1588
"27369","MERU","IGEMBE SOUTH","51",420,259,679
"27370","MERU","IGEMBE SOUTH","52",336,237,573
"27371","MERU","IGEMBE SOUTH","53",213,163,376
"27372","MERU","IGEMBE SOUTH","54",263,183,446
"27373","MERU","IGEMBE SOUTH","50-54",2021,1641,3662
"27374","MERU","IGEMBE SOUTH","55",425,337,762
"27375","MERU","IGEMBE SOUTH","56",525,470,995
"27376","MERU","IGEMBE SOUTH","57",305,314,619
"27377","MERU","IGEMBE SOUTH","58",241,249,490
"27378","MERU","IGEMBE SOUTH","59",357,337,694
"27379","MERU","IGEMBE SOUTH","55-59",1853,1707,3560
"27380","MERU","IGEMBE SOUTH","60",516,578,1094
"27381","MERU","IGEMBE SOUTH","61",182,216,398
"27382","MERU","IGEMBE SOUTH","62",220,248,468
"27383","MERU","IGEMBE SOUTH","63",203,232,435
"27384","MERU","IGEMBE SOUTH","64",169,160,329
"27385","MERU","IGEMBE SOUTH","60-64",1290,1434,2724
"27386","MERU","IGEMBE SOUTH","65",393,447,840
"27387","MERU","IGEMBE SOUTH","66",149,121,270
"27388","MERU","IGEMBE SOUTH","67",269,219,488
"27389","MERU","IGEMBE SOUTH","68",119,115,234
"27390","MERU","IGEMBE SOUTH","69",235,252,487
"27391","MERU","IGEMBE SOUTH","65-69",1165,1154,2319
"27392","MERU","IGEMBE SOUTH","70",455,567,1022
"27393","MERU","IGEMBE SOUTH","71",143,170,313
"27394","MERU","IGEMBE SOUTH","72",106,139,245
"27395","MERU","IGEMBE SOUTH","73",66,79,145
"27396","MERU","IGEMBE SOUTH","74",86,113,199
"27397","MERU","IGEMBE SOUTH","70-74",856,1068,1924
"27398","MERU","IGEMBE SOUTH","75",117,153,270
"27399","MERU","IGEMBE SOUTH","76",42,47,89
"27400","MERU","IGEMBE SOUTH","77",72,82,154
"27401","MERU","IGEMBE SOUTH","78",45,53,98
"27402","MERU","IGEMBE SOUTH","79",71,136,207
"27403","MERU","IGEMBE SOUTH","75-79",347,471,818
"27404","MERU","IGEMBE SOUTH","80",132,261,393
"27405","MERU","IGEMBE SOUTH","81",21,31,52
"27406","MERU","IGEMBE SOUTH","82",39,48,87
"27407","MERU","IGEMBE SOUTH","83",24,22,46
"27408","MERU","IGEMBE SOUTH","84",31,53,84
"27409","MERU","IGEMBE SOUTH","80-84",247,415,662
"27410","MERU","IGEMBE SOUTH","85",39,62,101
"27411","MERU","IGEMBE SOUTH","86",42,16,58
"27412","MERU","IGEMBE SOUTH","87",20,32,52
"27413","MERU","IGEMBE SOUTH","88",12,15,27
"27414","MERU","IGEMBE SOUTH","89",34,77,111
"27415","MERU","IGEMBE SOUTH","85-89",147,202,349
"27416","MERU","IGEMBE SOUTH","90",37,74,111
"27417","MERU","IGEMBE SOUTH","91",7,13,20
"27418","MERU","IGEMBE SOUTH","92",6,13,19
"27419","MERU","IGEMBE SOUTH","93",5,6,11
"27420","MERU","IGEMBE SOUTH","94",12,17,29
"27421","MERU","IGEMBE SOUTH","90-94",67,123,190
"27422","MERU","IGEMBE SOUTH","95",15,26,41
"27423","MERU","IGEMBE SOUTH","96",4,4,8
"27424","MERU","IGEMBE SOUTH","97",9,8,17
"27425","MERU","IGEMBE SOUTH","98",5,4,9
"27426","MERU","IGEMBE SOUTH","99",7,21,28
"27427","MERU","IGEMBE SOUTH","95-99",40,63,103
"27428","MERU","IGEMBE SOUTH","100+",26,49,75
"27429","MERU","IGEMBE SOUTH","Not Stated",2,2,4
"27430","MERU","IMENTI NORTH","Total",88506,89056,177562
"27431","MERU","IMENTI NORTH","0",1879,1846,3725
"27432","MERU","IMENTI NORTH","1",1925,1865,3790
"27433","MERU","IMENTI NORTH","2",1824,1838,3662
"27434","MERU","IMENTI NORTH","3",1794,1786,3580
"27435","MERU","IMENTI NORTH","4",1733,1745,3478
"27436","MERU","IMENTI NORTH","0 - 4",9155,9080,18235
"27437","MERU","IMENTI NORTH","5",1667,1599,3266
"27438","MERU","IMENTI NORTH","6",1635,1720,3355
"27439","MERU","IMENTI NORTH","7",1685,1684,3369
"27440","MERU","IMENTI NORTH","8",1620,1569,3189
"27441","MERU","IMENTI NORTH","9",1673,1730,3403
"27442","MERU","IMENTI NORTH","5-9",8280,8302,16582
"27443","MERU","IMENTI NORTH","10",1716,1608,3324
"27444","MERU","IMENTI NORTH","11",1550,1621,3171
"27445","MERU","IMENTI NORTH","12",1748,1735,3483
"27446","MERU","IMENTI NORTH","13",1747,1717,3464
"27447","MERU","IMENTI NORTH","14",1662,1710,3372
"27448","MERU","IMENTI NORTH","10 -14",8423,8391,16814
"27449","MERU","IMENTI NORTH","15",1562,1707,3269
"27450","MERU","IMENTI NORTH","16",1477,1572,3049
"27451","MERU","IMENTI NORTH","17",1693,1620,3313
"27452","MERU","IMENTI NORTH","18",1438,1448,2886
"27453","MERU","IMENTI NORTH","19",1631,1761,3392
"27454","MERU","IMENTI NORTH","15-19",7801,8108,15909
"27455","MERU","IMENTI NORTH","20",1619,1835,3454
"27456","MERU","IMENTI NORTH","21",1606,1873,3479
"27457","MERU","IMENTI NORTH","22",1723,1840,3563
"27458","MERU","IMENTI NORTH","23",1958,2019,3977
"27459","MERU","IMENTI NORTH","24",1813,1853,3666
"27460","MERU","IMENTI NORTH","20-24",8719,9420,18139
"27461","MERU","IMENTI NORTH","25",1817,1727,3544
"27462","MERU","IMENTI NORTH","26",1598,1620,3218
"27463","MERU","IMENTI NORTH","27",1679,1686,3365
"27464","MERU","IMENTI NORTH","28",1496,1494,2990
"27465","MERU","IMENTI NORTH","29",1563,1642,3205
"27466","MERU","IMENTI NORTH","25-29",8153,8169,16322
"27467","MERU","IMENTI NORTH","30",1994,1996,3990
"27468","MERU","IMENTI NORTH","31",1443,1369,2812
"27469","MERU","IMENTI NORTH","32",1771,1754,3525
"27470","MERU","IMENTI NORTH","33",1469,1573,3042
"27471","MERU","IMENTI NORTH","34",1337,1344,2681
"27472","MERU","IMENTI NORTH","30-34",8014,8036,16050
"27473","MERU","IMENTI NORTH","35",1982,1871,3853
"27474","MERU","IMENTI NORTH","36",1310,1276,2586
"27475","MERU","IMENTI NORTH","37",1373,1160,2533
"27476","MERU","IMENTI NORTH","38",1141,1165,2306
"27477","MERU","IMENTI NORTH","39",1292,1172,2464
"27478","MERU","IMENTI NORTH","35-39",7098,6644,13742
"27479","MERU","IMENTI NORTH","40",1720,1444,3164
"27480","MERU","IMENTI NORTH","41",1221,1039,2260
"27481","MERU","IMENTI NORTH","42",1105,969,2074
"27482","MERU","IMENTI NORTH","43",980,904,1884
"27483","MERU","IMENTI NORTH","44",824,713,1537
"27484","MERU","IMENTI NORTH","40-44",5850,5069,10919
"27485","MERU","IMENTI NORTH","45",1150,1118,2268
"27486","MERU","IMENTI NORTH","46",911,822,1733
"27487","MERU","IMENTI NORTH","47",900,850,1750
"27488","MERU","IMENTI NORTH","48",716,681,1397
"27489","MERU","IMENTI NORTH","49",802,724,1526
"27490","MERU","IMENTI NORTH","45-49",4479,4195,8674
"27491","MERU","IMENTI NORTH","50",977,995,1972
"27492","MERU","IMENTI NORTH","51",756,722,1478
"27493","MERU","IMENTI NORTH","52",587,555,1142
"27494","MERU","IMENTI NORTH","53",467,467,934
"27495","MERU","IMENTI NORTH","54",580,505,1085
"27496","MERU","IMENTI NORTH","50-54",3367,3244,6611
"27497","MERU","IMENTI NORTH","55",638,630,1268
"27498","MERU","IMENTI NORTH","56",696,697,1393
"27499","MERU","IMENTI NORTH","57",573,660,1233
"27500","MERU","IMENTI NORTH","58",487,493,980
"27501","MERU","IMENTI NORTH","59",559,550,1109
"27502","MERU","IMENTI NORTH","55-59",2953,3030,5983
"27503","MERU","IMENTI NORTH","60",690,808,1498
"27504","MERU","IMENTI NORTH","61",433,477,910
"27505","MERU","IMENTI NORTH","62",402,380,782
"27506","MERU","IMENTI NORTH","63",347,374,721
"27507","MERU","IMENTI NORTH","64",258,285,543
"27508","MERU","IMENTI NORTH","60-64",2130,2324,4454
"27509","MERU","IMENTI NORTH","65",391,473,864
"27510","MERU","IMENTI NORTH","66",228,258,486
"27511","MERU","IMENTI NORTH","67",417,446,863
"27512","MERU","IMENTI NORTH","68",239,203,442
"27513","MERU","IMENTI NORTH","69",317,336,653
"27514","MERU","IMENTI NORTH","65-69",1592,1716,3308
"27515","MERU","IMENTI NORTH","70",422,581,1003
"27516","MERU","IMENTI NORTH","71",231,252,483
"27517","MERU","IMENTI NORTH","72",207,169,376
"27518","MERU","IMENTI NORTH","73",165,167,332
"27519","MERU","IMENTI NORTH","74",153,157,310
"27520","MERU","IMENTI NORTH","70-74",1178,1326,2504
"27521","MERU","IMENTI NORTH","75",165,189,354
"27522","MERU","IMENTI NORTH","76",94,110,204
"27523","MERU","IMENTI NORTH","77",142,176,318
"27524","MERU","IMENTI NORTH","78",72,65,137
"27525","MERU","IMENTI NORTH","79",88,175,263
"27526","MERU","IMENTI NORTH","75-79",561,715,1276
"27527","MERU","IMENTI NORTH","80",157,301,458
"27528","MERU","IMENTI NORTH","81",68,95,163
"27529","MERU","IMENTI NORTH","82",69,61,130
"27530","MERU","IMENTI NORTH","83",75,76,151
"27531","MERU","IMENTI NORTH","84",45,87,132
"27532","MERU","IMENTI NORTH","80-84",414,620,1034
"27533","MERU","IMENTI NORTH","85",49,84,133
"27534","MERU","IMENTI NORTH","86",33,40,73
"27535","MERU","IMENTI NORTH","87",39,49,88
"27536","MERU","IMENTI NORTH","88",24,29,53
"27537","MERU","IMENTI NORTH","89",39,104,143
"27538","MERU","IMENTI NORTH","85-89",184,306,490
"27539","MERU","IMENTI NORTH","90",40,92,132
"27540","MERU","IMENTI NORTH","91",17,36,53
"27541","MERU","IMENTI NORTH","92",10,22,32
"27542","MERU","IMENTI NORTH","93",10,18,28
"27543","MERU","IMENTI NORTH","94",6,23,29
"27544","MERU","IMENTI NORTH","90-94",83,191,274
"27545","MERU","IMENTI NORTH","95",19,38,57
"27546","MERU","IMENTI NORTH","96",7,13,20
"27547","MERU","IMENTI NORTH","97",8,17,25
"27548","MERU","IMENTI NORTH","98",2,15,17
"27549","MERU","IMENTI NORTH","99",7,22,29
"27550","MERU","IMENTI NORTH","95-99",43,105,148
"27551","MERU","IMENTI NORTH","100+",23,64,87
"27552","MERU","IMENTI NORTH","Not Stated",6,1,7
"27553","MERU","IMENTI SOUTH","Total",103338,103162,206500
"27554","MERU","IMENTI SOUTH","0",1830,1905,3735
"27555","MERU","IMENTI SOUTH","1",2016,1959,3975
"27556","MERU","IMENTI SOUTH","2",1997,2074,4071
"27557","MERU","IMENTI SOUTH","3",2064,2123,4187
"27558","MERU","IMENTI SOUTH","4",2051,1966,4017
"27559","MERU","IMENTI SOUTH","0 - 4",9958,10027,19985
"27560","MERU","IMENTI SOUTH","5",1948,1883,3831
"27561","MERU","IMENTI SOUTH","6",2012,1927,3939
"27562","MERU","IMENTI SOUTH","7",2089,2041,4130
"27563","MERU","IMENTI SOUTH","8",1889,1995,3884
"27564","MERU","IMENTI SOUTH","9",2127,2123,4250
"27565","MERU","IMENTI SOUTH","5-9",10065,9969,20034
"27566","MERU","IMENTI SOUTH","10",2146,2118,4264
"27567","MERU","IMENTI SOUTH","11",2030,2133,4163
"27568","MERU","IMENTI SOUTH","12",2245,2231,4476
"27569","MERU","IMENTI SOUTH","13",2291,2271,4562
"27570","MERU","IMENTI SOUTH","14",2295,2068,4363
"27571","MERU","IMENTI SOUTH","10 -14",11007,10821,21828
"27572","MERU","IMENTI SOUTH","15",2074,2014,4088
"27573","MERU","IMENTI SOUTH","16",1970,1981,3951
"27574","MERU","IMENTI SOUTH","17",1989,2013,4002
"27575","MERU","IMENTI SOUTH","18",1807,1715,3522
"27576","MERU","IMENTI SOUTH","19",1797,1767,3564
"27577","MERU","IMENTI SOUTH","15-19",9637,9490,19127
"27578","MERU","IMENTI SOUTH","20",1755,1762,3517
"27579","MERU","IMENTI SOUTH","21",1608,1620,3228
"27580","MERU","IMENTI SOUTH","22",1673,1613,3286
"27581","MERU","IMENTI SOUTH","23",1688,1684,3372
"27582","MERU","IMENTI SOUTH","24",1537,1589,3126
"27583","MERU","IMENTI SOUTH","20-24",8261,8268,16529
"27584","MERU","IMENTI SOUTH","25",1662,1560,3222
"27585","MERU","IMENTI SOUTH","26",1343,1486,2829
"27586","MERU","IMENTI SOUTH","27",1554,1555,3109
"27587","MERU","IMENTI SOUTH","28",1390,1441,2831
"27588","MERU","IMENTI SOUTH","29",1530,1534,3064
"27589","MERU","IMENTI SOUTH","25-29",7479,7576,15055
"27590","MERU","IMENTI SOUTH","30",2081,2090,4171
"27591","MERU","IMENTI SOUTH","31",1499,1488,2987
"27592","MERU","IMENTI SOUTH","32",1763,1902,3665
"27593","MERU","IMENTI SOUTH","33",1673,1740,3413
"27594","MERU","IMENTI SOUTH","34",1482,1412,2894
"27595","MERU","IMENTI SOUTH","30-34",8498,8632,17130
"27596","MERU","IMENTI SOUTH","35",2049,1922,3971
"27597","MERU","IMENTI SOUTH","36",1369,1264,2633
"27598","MERU","IMENTI SOUTH","37",1448,1284,2732
"27599","MERU","IMENTI SOUTH","38",1173,1175,2348
"27600","MERU","IMENTI SOUTH","39",1519,1374,2893
"27601","MERU","IMENTI SOUTH","35-39",7558,7019,14577
"27602","MERU","IMENTI SOUTH","40",1862,1756,3618
"27603","MERU","IMENTI SOUTH","41",1458,1190,2648
"27604","MERU","IMENTI SOUTH","42",1348,1158,2506
"27605","MERU","IMENTI SOUTH","43",1273,1173,2446
"27606","MERU","IMENTI SOUTH","44",1117,1036,2153
"27607","MERU","IMENTI SOUTH","40-44",7058,6313,13371
"27608","MERU","IMENTI SOUTH","45",1584,1469,3053
"27609","MERU","IMENTI SOUTH","46",1182,1126,2308
"27610","MERU","IMENTI SOUTH","47",1160,1202,2362
"27611","MERU","IMENTI SOUTH","48",932,1013,1945
"27612","MERU","IMENTI SOUTH","49",1124,1162,2286
"27613","MERU","IMENTI SOUTH","45-49",5982,5972,11954
"27614","MERU","IMENTI SOUTH","50",1316,1363,2679
"27615","MERU","IMENTI SOUTH","51",994,805,1799
"27616","MERU","IMENTI SOUTH","52",709,651,1360
"27617","MERU","IMENTI SOUTH","53",571,532,1103
"27618","MERU","IMENTI SOUTH","54",665,622,1287
"27619","MERU","IMENTI SOUTH","50-54",4255,3973,8228
"27620","MERU","IMENTI SOUTH","55",821,835,1656
"27621","MERU","IMENTI SOUTH","56",895,901,1796
"27622","MERU","IMENTI SOUTH","57",717,831,1548
"27623","MERU","IMENTI SOUTH","58",737,696,1433
"27624","MERU","IMENTI SOUTH","59",834,788,1622
"27625","MERU","IMENTI SOUTH","55-59",4004,4051,8055
"27626","MERU","IMENTI SOUTH","60",1000,966,1966
"27627","MERU","IMENTI SOUTH","61",642,613,1255
"27628","MERU","IMENTI SOUTH","62",541,499,1040
"27629","MERU","IMENTI SOUTH","63",560,515,1075
"27630","MERU","IMENTI SOUTH","64",292,333,625
"27631","MERU","IMENTI SOUTH","60-64",3035,2926,5961
"27632","MERU","IMENTI SOUTH","65",579,642,1221
"27633","MERU","IMENTI SOUTH","66",361,385,746
"27634","MERU","IMENTI SOUTH","67",619,667,1286
"27635","MERU","IMENTI SOUTH","68",337,343,680
"27636","MERU","IMENTI SOUTH","69",482,472,954
"27637","MERU","IMENTI SOUTH","65-69",2378,2509,4887
"27638","MERU","IMENTI SOUTH","70",596,826,1422
"27639","MERU","IMENTI SOUTH","71",342,341,683
"27640","MERU","IMENTI SOUTH","72",315,328,643
"27641","MERU","IMENTI SOUTH","73",240,247,487
"27642","MERU","IMENTI SOUTH","74",246,328,574
"27643","MERU","IMENTI SOUTH","70-74",1739,2070,3809
"27644","MERU","IMENTI SOUTH","75",222,364,586
"27645","MERU","IMENTI SOUTH","76",165,166,331
"27646","MERU","IMENTI SOUTH","77",235,243,478
"27647","MERU","IMENTI SOUTH","78",152,154,306
"27648","MERU","IMENTI SOUTH","79",184,295,479
"27649","MERU","IMENTI SOUTH","75-79",958,1222,2180
"27650","MERU","IMENTI SOUTH","80",269,517,786
"27651","MERU","IMENTI SOUTH","81",111,141,252
"27652","MERU","IMENTI SOUTH","82",110,117,227
"27653","MERU","IMENTI SOUTH","83",123,143,266
"27654","MERU","IMENTI SOUTH","84",131,151,282
"27655","MERU","IMENTI SOUTH","80-84",744,1069,1813
"27656","MERU","IMENTI SOUTH","85",129,186,315
"27657","MERU","IMENTI SOUTH","86",69,78,147
"27658","MERU","IMENTI SOUTH","87",66,114,180
"27659","MERU","IMENTI SOUTH","88",44,66,110
"27660","MERU","IMENTI SOUTH","89",72,174,246
"27661","MERU","IMENTI SOUTH","85-89",380,618,998
"27662","MERU","IMENTI SOUTH","90",72,170,242
"27663","MERU","IMENTI SOUTH","91",42,43,85
"27664","MERU","IMENTI SOUTH","92",29,39,68
"27665","MERU","IMENTI SOUTH","93",25,44,69
"27666","MERU","IMENTI SOUTH","94",18,48,66
"27667","MERU","IMENTI SOUTH","90-94",186,344,530
"27668","MERU","IMENTI SOUTH","95",34,68,102
"27669","MERU","IMENTI SOUTH","96",15,23,38
"27670","MERU","IMENTI SOUTH","97",27,30,57
"27671","MERU","IMENTI SOUTH","98",15,16,31
"27672","MERU","IMENTI SOUTH","99",22,47,69
"27673","MERU","IMENTI SOUTH","95-99",113,184,297
"27674","MERU","IMENTI SOUTH","100+",43,109,152
"27675","MERU","IMENTI SOUTH","Not Stated",NA,NA,NA
"27676","MERU","MERU CENTRAL","Total",66920,66894,133814
"27677","MERU","MERU CENTRAL","0",1163,1123,2286
"27678","MERU","MERU CENTRAL","1",1336,1323,2659
"27679","MERU","MERU CENTRAL","2",1322,1260,2582
"27680","MERU","MERU CENTRAL","3",1313,1356,2669
"27681","MERU","MERU CENTRAL","4",1329,1300,2629
"27682","MERU","MERU CENTRAL","0 - 4",6463,6362,12825
"27683","MERU","MERU CENTRAL","5",1271,1233,2504
"27684","MERU","MERU CENTRAL","6",1346,1357,2703
"27685","MERU","MERU CENTRAL","7",1362,1325,2687
"27686","MERU","MERU CENTRAL","8",1289,1301,2590
"27687","MERU","MERU CENTRAL","9",1415,1459,2874
"27688","MERU","MERU CENTRAL","5-9",6683,6675,13358
"27689","MERU","MERU CENTRAL","10",1541,1426,2967
"27690","MERU","MERU CENTRAL","11",1425,1364,2789
"27691","MERU","MERU CENTRAL","12",1588,1498,3086
"27692","MERU","MERU CENTRAL","13",1513,1526,3039
"27693","MERU","MERU CENTRAL","14",1429,1447,2876
"27694","MERU","MERU CENTRAL","10 -14",7496,7261,14757
"27695","MERU","MERU CENTRAL","15",1379,1354,2733
"27696","MERU","MERU CENTRAL","16",1271,1337,2608
"27697","MERU","MERU CENTRAL","17",1396,1377,2773
"27698","MERU","MERU CENTRAL","18",1187,1053,2240
"27699","MERU","MERU CENTRAL","19",1264,1224,2488
"27700","MERU","MERU CENTRAL","15-19",6497,6345,12842
"27701","MERU","MERU CENTRAL","20",1106,1061,2167
"27702","MERU","MERU CENTRAL","21",1007,971,1978
"27703","MERU","MERU CENTRAL","22",1002,962,1964
"27704","MERU","MERU CENTRAL","23",1051,998,2049
"27705","MERU","MERU CENTRAL","24",973,915,1888
"27706","MERU","MERU CENTRAL","20-24",5139,4907,10046
"27707","MERU","MERU CENTRAL","25",986,942,1928
"27708","MERU","MERU CENTRAL","26",807,868,1675
"27709","MERU","MERU CENTRAL","27",922,891,1813
"27710","MERU","MERU CENTRAL","28",814,840,1654
"27711","MERU","MERU CENTRAL","29",840,903,1743
"27712","MERU","MERU CENTRAL","25-29",4369,4444,8813
"27713","MERU","MERU CENTRAL","30",1179,1206,2385
"27714","MERU","MERU CENTRAL","31",873,889,1762
"27715","MERU","MERU CENTRAL","32",1040,1133,2173
"27716","MERU","MERU CENTRAL","33",1101,1083,2184
"27717","MERU","MERU CENTRAL","34",944,927,1871
"27718","MERU","MERU CENTRAL","30-34",5137,5238,10375
"27719","MERU","MERU CENTRAL","35",1407,1265,2672
"27720","MERU","MERU CENTRAL","36",936,898,1834
"27721","MERU","MERU CENTRAL","37",954,827,1781
"27722","MERU","MERU CENTRAL","38",808,724,1532
"27723","MERU","MERU CENTRAL","39",995,882,1877
"27724","MERU","MERU CENTRAL","35-39",5100,4596,9696
"27725","MERU","MERU CENTRAL","40",1147,979,2126
"27726","MERU","MERU CENTRAL","41",939,739,1678
"27727","MERU","MERU CENTRAL","42",864,769,1633
"27728","MERU","MERU CENTRAL","43",789,730,1519
"27729","MERU","MERU CENTRAL","44",718,616,1334
"27730","MERU","MERU CENTRAL","40-44",4457,3833,8290
"27731","MERU","MERU CENTRAL","45",962,916,1878
"27732","MERU","MERU CENTRAL","46",756,691,1447
"27733","MERU","MERU CENTRAL","47",730,750,1480
"27734","MERU","MERU CENTRAL","48",610,579,1189
"27735","MERU","MERU CENTRAL","49",702,705,1407
"27736","MERU","MERU CENTRAL","45-49",3760,3641,7401
"27737","MERU","MERU CENTRAL","50",781,781,1562
"27738","MERU","MERU CENTRAL","51",559,619,1178
"27739","MERU","MERU CENTRAL","52",470,441,911
"27740","MERU","MERU CENTRAL","53",391,377,768
"27741","MERU","MERU CENTRAL","54",414,435,849
"27742","MERU","MERU CENTRAL","50-54",2615,2653,5268
"27743","MERU","MERU CENTRAL","55",576,571,1147
"27744","MERU","MERU CENTRAL","56",559,564,1123
"27745","MERU","MERU CENTRAL","57",479,612,1091
"27746","MERU","MERU CENTRAL","58",438,521,959
"27747","MERU","MERU CENTRAL","59",558,574,1132
"27748","MERU","MERU CENTRAL","55-59",2610,2842,5452
"27749","MERU","MERU CENTRAL","60",615,706,1321
"27750","MERU","MERU CENTRAL","61",445,435,880
"27751","MERU","MERU CENTRAL","62",383,351,734
"27752","MERU","MERU CENTRAL","63",362,352,714
"27753","MERU","MERU CENTRAL","64",236,254,490
"27754","MERU","MERU CENTRAL","60-64",2041,2098,4139
"27755","MERU","MERU CENTRAL","65",389,463,852
"27756","MERU","MERU CENTRAL","66",240,271,511
"27757","MERU","MERU CENTRAL","67",477,505,982
"27758","MERU","MERU CENTRAL","68",224,226,450
"27759","MERU","MERU CENTRAL","69",339,376,715
"27760","MERU","MERU CENTRAL","65-69",1669,1841,3510
"27761","MERU","MERU CENTRAL","70",450,666,1116
"27762","MERU","MERU CENTRAL","71",254,267,521
"27763","MERU","MERU CENTRAL","72",234,220,454
"27764","MERU","MERU CENTRAL","73",177,176,353
"27765","MERU","MERU CENTRAL","74",162,264,426
"27766","MERU","MERU CENTRAL","70-74",1277,1593,2870
"27767","MERU","MERU CENTRAL","75",169,214,383
"27768","MERU","MERU CENTRAL","76",97,103,200
"27769","MERU","MERU CENTRAL","77",160,194,354
"27770","MERU","MERU CENTRAL","78",123,106,229
"27771","MERU","MERU CENTRAL","79",101,246,347
"27772","MERU","MERU CENTRAL","75-79",650,863,1513
"27773","MERU","MERU CENTRAL","80",170,356,526
"27774","MERU","MERU CENTRAL","81",80,122,202
"27775","MERU","MERU CENTRAL","82",67,84,151
"27776","MERU","MERU CENTRAL","83",68,97,165
"27777","MERU","MERU CENTRAL","84",88,140,228
"27778","MERU","MERU CENTRAL","80-84",473,799,1272
"27779","MERU","MERU CENTRAL","85",91,97,188
"27780","MERU","MERU CENTRAL","86",64,58,122
"27781","MERU","MERU CENTRAL","87",54,70,124
"27782","MERU","MERU CENTRAL","88",34,40,74
"27783","MERU","MERU CENTRAL","89",56,193,249
"27784","MERU","MERU CENTRAL","85-89",299,458,757
"27785","MERU","MERU CENTRAL","90",47,108,155
"27786","MERU","MERU CENTRAL","91",19,48,67
"27787","MERU","MERU CENTRAL","92",17,28,45
"27788","MERU","MERU CENTRAL","93",11,28,39
"27789","MERU","MERU CENTRAL","94",11,38,49
"27790","MERU","MERU CENTRAL","90-94",105,250,355
"27791","MERU","MERU CENTRAL","95",18,39,57
"27792","MERU","MERU CENTRAL","96",3,10,13
"27793","MERU","MERU CENTRAL","97",5,16,21
"27794","MERU","MERU CENTRAL","98",13,13,26
"27795","MERU","MERU CENTRAL","99",10,44,54
"27796","MERU","MERU CENTRAL","95-99",49,122,171
"27797","MERU","MERU CENTRAL","100+",27,70,97
"27798","MERU","MERU CENTRAL","Not Stated",4,3,7
"27799","MERU","TIGANIA CENTRAL","Total",51814,52916,104730
"27800","MERU","TIGANIA CENTRAL","0",1211,1160,2371
"27801","MERU","TIGANIA CENTRAL","1",1204,1191,2395
"27802","MERU","TIGANIA CENTRAL","2",1190,1204,2394
"27803","MERU","TIGANIA CENTRAL","3",1346,1297,2643
"27804","MERU","TIGANIA CENTRAL","4",1266,1283,2549
"27805","MERU","TIGANIA CENTRAL","0 - 4",6217,6135,12352
"27806","MERU","TIGANIA CENTRAL","5",1358,1274,2632
"27807","MERU","TIGANIA CENTRAL","6",1313,1297,2610
"27808","MERU","TIGANIA CENTRAL","7",1283,1368,2651
"27809","MERU","TIGANIA CENTRAL","8",1275,1296,2571
"27810","MERU","TIGANIA CENTRAL","9",1475,1492,2967
"27811","MERU","TIGANIA CENTRAL","5-9",6704,6727,13431
"27812","MERU","TIGANIA CENTRAL","10",1529,1476,3005
"27813","MERU","TIGANIA CENTRAL","11",1427,1474,2901
"27814","MERU","TIGANIA CENTRAL","12",1575,1531,3106
"27815","MERU","TIGANIA CENTRAL","13",1638,1541,3179
"27816","MERU","TIGANIA CENTRAL","14",1503,1443,2946
"27817","MERU","TIGANIA CENTRAL","10 -14",7672,7465,15137
"27818","MERU","TIGANIA CENTRAL","15",1437,1454,2891
"27819","MERU","TIGANIA CENTRAL","16",1356,1369,2725
"27820","MERU","TIGANIA CENTRAL","17",1248,1204,2452
"27821","MERU","TIGANIA CENTRAL","18",1022,1091,2113
"27822","MERU","TIGANIA CENTRAL","19",1034,1120,2154
"27823","MERU","TIGANIA CENTRAL","15-19",6097,6238,12335
"27824","MERU","TIGANIA CENTRAL","20",1041,1077,2118
"27825","MERU","TIGANIA CENTRAL","21",739,804,1543
"27826","MERU","TIGANIA CENTRAL","22",769,845,1614
"27827","MERU","TIGANIA CENTRAL","23",805,806,1611
"27828","MERU","TIGANIA CENTRAL","24",735,713,1448
"27829","MERU","TIGANIA CENTRAL","20-24",4089,4245,8334
"27830","MERU","TIGANIA CENTRAL","25",867,884,1751
"27831","MERU","TIGANIA CENTRAL","26",630,676,1306
"27832","MERU","TIGANIA CENTRAL","27",657,734,1391
"27833","MERU","TIGANIA CENTRAL","28",617,575,1192
"27834","MERU","TIGANIA CENTRAL","29",589,611,1200
"27835","MERU","TIGANIA CENTRAL","25-29",3360,3480,6840
"27836","MERU","TIGANIA CENTRAL","30",933,981,1914
"27837","MERU","TIGANIA CENTRAL","31",582,612,1194
"27838","MERU","TIGANIA CENTRAL","32",706,798,1504
"27839","MERU","TIGANIA CENTRAL","33",689,857,1546
"27840","MERU","TIGANIA CENTRAL","34",641,686,1327
"27841","MERU","TIGANIA CENTRAL","30-34",3551,3934,7485
"27842","MERU","TIGANIA CENTRAL","35",1112,1099,2211
"27843","MERU","TIGANIA CENTRAL","36",488,485,973
"27844","MERU","TIGANIA CENTRAL","37",618,520,1138
"27845","MERU","TIGANIA CENTRAL","38",420,425,845
"27846","MERU","TIGANIA CENTRAL","39",502,502,1004
"27847","MERU","TIGANIA CENTRAL","35-39",3140,3031,6171
"27848","MERU","TIGANIA CENTRAL","40",845,784,1629
"27849","MERU","TIGANIA CENTRAL","41",547,478,1025
"27850","MERU","TIGANIA CENTRAL","42",502,361,863
"27851","MERU","TIGANIA CENTRAL","43",409,365,774
"27852","MERU","TIGANIA CENTRAL","44",381,338,719
"27853","MERU","TIGANIA CENTRAL","40-44",2684,2326,5010
"27854","MERU","TIGANIA CENTRAL","45",594,534,1128
"27855","MERU","TIGANIA CENTRAL","46",412,448,860
"27856","MERU","TIGANIA CENTRAL","47",430,442,872
"27857","MERU","TIGANIA CENTRAL","48",319,366,685
"27858","MERU","TIGANIA CENTRAL","49",372,379,751
"27859","MERU","TIGANIA CENTRAL","45-49",2127,2169,4296
"27860","MERU","TIGANIA CENTRAL","50",525,601,1126
"27861","MERU","TIGANIA CENTRAL","51",307,255,562
"27862","MERU","TIGANIA CENTRAL","52",181,170,351
"27863","MERU","TIGANIA CENTRAL","53",113,109,222
"27864","MERU","TIGANIA CENTRAL","54",176,164,340
"27865","MERU","TIGANIA CENTRAL","50-54",1302,1299,2601
"27866","MERU","TIGANIA CENTRAL","55",271,270,541
"27867","MERU","TIGANIA CENTRAL","56",258,289,547
"27868","MERU","TIGANIA CENTRAL","57",239,283,522
"27869","MERU","TIGANIA CENTRAL","58",236,258,494
"27870","MERU","TIGANIA CENTRAL","59",222,285,507
"27871","MERU","TIGANIA CENTRAL","55-59",1226,1385,2611
"27872","MERU","TIGANIA CENTRAL","60",445,488,933
"27873","MERU","TIGANIA CENTRAL","61",206,208,414
"27874","MERU","TIGANIA CENTRAL","62",185,178,363
"27875","MERU","TIGANIA CENTRAL","63",155,192,347
"27876","MERU","TIGANIA CENTRAL","64",115,149,264
"27877","MERU","TIGANIA CENTRAL","60-64",1106,1215,2321
"27878","MERU","TIGANIA CENTRAL","65",219,291,510
"27879","MERU","TIGANIA CENTRAL","66",150,156,306
"27880","MERU","TIGANIA CENTRAL","67",222,203,425
"27881","MERU","TIGANIA CENTRAL","68",117,128,245
"27882","MERU","TIGANIA CENTRAL","69",186,251,437
"27883","MERU","TIGANIA CENTRAL","65-69",894,1029,1923
"27884","MERU","TIGANIA CENTRAL","70",315,455,770
"27885","MERU","TIGANIA CENTRAL","71",132,163,295
"27886","MERU","TIGANIA CENTRAL","72",187,143,330
"27887","MERU","TIGANIA CENTRAL","73",81,90,171
"27888","MERU","TIGANIA CENTRAL","74",61,122,183
"27889","MERU","TIGANIA CENTRAL","70-74",776,973,1749
"27890","MERU","TIGANIA CENTRAL","75",111,121,232
"27891","MERU","TIGANIA CENTRAL","76",55,51,106
"27892","MERU","TIGANIA CENTRAL","77",68,78,146
"27893","MERU","TIGANIA CENTRAL","78",81,69,150
"27894","MERU","TIGANIA CENTRAL","79",76,119,195
"27895","MERU","TIGANIA CENTRAL","75-79",391,438,829
"27896","MERU","TIGANIA CENTRAL","80",93,191,284
"27897","MERU","TIGANIA CENTRAL","81",36,47,83
"27898","MERU","TIGANIA CENTRAL","82",28,32,60
"27899","MERU","TIGANIA CENTRAL","83",32,46,78
"27900","MERU","TIGANIA CENTRAL","84",31,52,83
"27901","MERU","TIGANIA CENTRAL","80-84",220,368,588
"27902","MERU","TIGANIA CENTRAL","85",38,53,91
"27903","MERU","TIGANIA CENTRAL","86",18,20,38
"27904","MERU","TIGANIA CENTRAL","87",28,31,59
"27905","MERU","TIGANIA CENTRAL","88",9,21,30
"27906","MERU","TIGANIA CENTRAL","89",35,80,115
"27907","MERU","TIGANIA CENTRAL","85-89",128,205,333
"27908","MERU","TIGANIA CENTRAL","90",28,64,92
"27909","MERU","TIGANIA CENTRAL","91",13,27,40
"27910","MERU","TIGANIA CENTRAL","92",6,9,15
"27911","MERU","TIGANIA CENTRAL","93",7,9,16
"27912","MERU","TIGANIA CENTRAL","94",3,20,23
"27913","MERU","TIGANIA CENTRAL","90-94",57,129,186
"27914","MERU","TIGANIA CENTRAL","95",14,22,36
"27915","MERU","TIGANIA CENTRAL","96",4,5,9
"27916","MERU","TIGANIA CENTRAL","97",7,2,9
"27917","MERU","TIGANIA CENTRAL","98",3,3,6
"27918","MERU","TIGANIA CENTRAL","99",12,30,42
"27919","MERU","TIGANIA CENTRAL","95-99",40,62,102
"27920","MERU","TIGANIA CENTRAL","100+",33,63,96
"27921","MERU","TIGANIA CENTRAL","Not Stated",NA,NA,NA
"27922","MERU","TIGANIA EAST","Total",35352,37194,72546
"27923","MERU","TIGANIA EAST","0",755,791,1546
"27924","MERU","TIGANIA EAST","1",812,816,1628
"27925","MERU","TIGANIA EAST","2",855,838,1693
"27926","MERU","TIGANIA EAST","3",989,847,1836
"27927","MERU","TIGANIA EAST","4",929,889,1818
"27928","MERU","TIGANIA EAST","0 - 4",4340,4181,8521
"27929","MERU","TIGANIA EAST","5",992,911,1903
"27930","MERU","TIGANIA EAST","6",1015,959,1974
"27931","MERU","TIGANIA EAST","7",1006,966,1972
"27932","MERU","TIGANIA EAST","8",945,973,1918
"27933","MERU","TIGANIA EAST","9",1005,1091,2096
"27934","MERU","TIGANIA EAST","5-9",4963,4900,9863
"27935","MERU","TIGANIA EAST","10",1236,1186,2422
"27936","MERU","TIGANIA EAST","11",1060,1064,2124
"27937","MERU","TIGANIA EAST","12",1224,1220,2444
"27938","MERU","TIGANIA EAST","13",1230,1306,2536
"27939","MERU","TIGANIA EAST","14",1153,1070,2223
"27940","MERU","TIGANIA EAST","10 -14",5903,5846,11749
"27941","MERU","TIGANIA EAST","15",1069,1050,2119
"27942","MERU","TIGANIA EAST","16",874,962,1836
"27943","MERU","TIGANIA EAST","17",858,945,1803
"27944","MERU","TIGANIA EAST","18",677,734,1411
"27945","MERU","TIGANIA EAST","19",695,728,1423
"27946","MERU","TIGANIA EAST","15-19",4173,4419,8592
"27947","MERU","TIGANIA EAST","20",698,763,1461
"27948","MERU","TIGANIA EAST","21",471,547,1018
"27949","MERU","TIGANIA EAST","22",516,558,1074
"27950","MERU","TIGANIA EAST","23",426,545,971
"27951","MERU","TIGANIA EAST","24",437,423,860
"27952","MERU","TIGANIA EAST","20-24",2548,2836,5384
"27953","MERU","TIGANIA EAST","25",587,525,1112
"27954","MERU","TIGANIA EAST","26",393,426,819
"27955","MERU","TIGANIA EAST","27",388,429,817
"27956","MERU","TIGANIA EAST","28",356,362,718
"27957","MERU","TIGANIA EAST","29",301,331,632
"27958","MERU","TIGANIA EAST","25-29",2025,2073,4098
"27959","MERU","TIGANIA EAST","30",561,616,1177
"27960","MERU","TIGANIA EAST","31",349,363,712
"27961","MERU","TIGANIA EAST","32",421,487,908
"27962","MERU","TIGANIA EAST","33",370,437,807
"27963","MERU","TIGANIA EAST","34",319,393,712
"27964","MERU","TIGANIA EAST","30-34",2020,2296,4316
"27965","MERU","TIGANIA EAST","35",635,736,1371
"27966","MERU","TIGANIA EAST","36",271,338,609
"27967","MERU","TIGANIA EAST","37",348,361,709
"27968","MERU","TIGANIA EAST","38",287,251,538
"27969","MERU","TIGANIA EAST","39",326,309,635
"27970","MERU","TIGANIA EAST","35-39",1867,1995,3862
"27971","MERU","TIGANIA EAST","40",491,494,985
"27972","MERU","TIGANIA EAST","41",343,325,668
"27973","MERU","TIGANIA EAST","42",282,299,581
"27974","MERU","TIGANIA EAST","43",308,323,631
"27975","MERU","TIGANIA EAST","44",220,260,480
"27976","MERU","TIGANIA EAST","40-44",1644,1701,3345
"27977","MERU","TIGANIA EAST","45",413,441,854
"27978","MERU","TIGANIA EAST","46",273,320,593
"27979","MERU","TIGANIA EAST","47",265,307,572
"27980","MERU","TIGANIA EAST","48",189,214,403
"27981","MERU","TIGANIA EAST","49",207,264,471
"27982","MERU","TIGANIA EAST","45-49",1347,1546,2893
"27983","MERU","TIGANIA EAST","50",385,475,860
"27984","MERU","TIGANIA EAST","51",183,186,369
"27985","MERU","TIGANIA EAST","52",147,126,273
"27986","MERU","TIGANIA EAST","53",111,102,213
"27987","MERU","TIGANIA EAST","54",177,116,293
"27988","MERU","TIGANIA EAST","50-54",1003,1005,2008
"27989","MERU","TIGANIA EAST","55",191,179,370
"27990","MERU","TIGANIA EAST","56",204,185,389
"27991","MERU","TIGANIA EAST","57",186,238,424
"27992","MERU","TIGANIA EAST","58",128,184,312
"27993","MERU","TIGANIA EAST","59",146,199,345
"27994","MERU","TIGANIA EAST","55-59",855,985,1840
"27995","MERU","TIGANIA EAST","60",278,373,651
"27996","MERU","TIGANIA EAST","61",141,180,321
"27997","MERU","TIGANIA EAST","62",120,132,252
"27998","MERU","TIGANIA EAST","63",111,137,248
"27999","MERU","TIGANIA EAST","64",82,94,176
"28000","MERU","TIGANIA EAST","60-64",732,916,1648
"28001","MERU","TIGANIA EAST","65",167,218,385
"28002","MERU","TIGANIA EAST","66",92,121,213
"28003","MERU","TIGANIA EAST","67",179,202,381
"28004","MERU","TIGANIA EAST","68",104,91,195
"28005","MERU","TIGANIA EAST","69",114,154,268
"28006","MERU","TIGANIA EAST","65-69",656,786,1442
"28007","MERU","TIGANIA EAST","70",223,317,540
"28008","MERU","TIGANIA EAST","71",92,119,211
"28009","MERU","TIGANIA EAST","72",134,134,268
"28010","MERU","TIGANIA EAST","73",76,72,148
"28011","MERU","TIGANIA EAST","74",43,84,127
"28012","MERU","TIGANIA EAST","70-74",568,726,1294
"28013","MERU","TIGANIA EAST","75",72,102,174
"28014","MERU","TIGANIA EAST","76",55,44,99
"28015","MERU","TIGANIA EAST","77",63,54,117
"28016","MERU","TIGANIA EAST","78",58,42,100
"28017","MERU","TIGANIA EAST","79",47,100,147
"28018","MERU","TIGANIA EAST","75-79",295,342,637
"28019","MERU","TIGANIA EAST","80",100,171,271
"28020","MERU","TIGANIA EAST","81",32,39,71
"28021","MERU","TIGANIA EAST","82",26,23,49
"28022","MERU","TIGANIA EAST","83",21,37,58
"28023","MERU","TIGANIA EAST","84",26,43,69
"28024","MERU","TIGANIA EAST","80-84",205,313,518
"28025","MERU","TIGANIA EAST","85",35,56,91
"28026","MERU","TIGANIA EAST","86",23,14,37
"28027","MERU","TIGANIA EAST","87",27,20,47
"28028","MERU","TIGANIA EAST","88",13,8,21
"28029","MERU","TIGANIA EAST","89",22,60,82
"28030","MERU","TIGANIA EAST","85-89",120,158,278
"28031","MERU","TIGANIA EAST","90",29,59,88
"28032","MERU","TIGANIA EAST","91",5,11,16
"28033","MERU","TIGANIA EAST","92",6,5,11
"28034","MERU","TIGANIA EAST","93",1,4,5
"28035","MERU","TIGANIA EAST","94",3,13,16
"28036","MERU","TIGANIA EAST","90-94",44,92,136
"28037","MERU","TIGANIA EAST","95",10,17,27
"28038","MERU","TIGANIA EAST","96",9,5,14
"28039","MERU","TIGANIA EAST","97",1,7,8
"28040","MERU","TIGANIA EAST","98",4,5,9
"28041","MERU","TIGANIA EAST","99",5,14,19
"28042","MERU","TIGANIA EAST","95-99",29,48,77
"28043","MERU","TIGANIA EAST","100+",15,29,44
"28044","MERU","TIGANIA EAST","Not Stated",NA,1,1
"28045","MERU","TIGANIA WEST","Total",67715,72241,139956
"28046","MERU","TIGANIA WEST","0",1293,1383,2676
"28047","MERU","TIGANIA WEST","1",1493,1462,2955
"28048","MERU","TIGANIA WEST","2",1482,1409,2891
"28049","MERU","TIGANIA WEST","3",1520,1573,3093
"28050","MERU","TIGANIA WEST","4",1562,1568,3130
"28051","MERU","TIGANIA WEST","0 - 4",7350,7395,14745
"28052","MERU","TIGANIA WEST","5",1628,1552,3180
"28053","MERU","TIGANIA WEST","6",1590,1609,3199
"28054","MERU","TIGANIA WEST","7",1733,1636,3369
"28055","MERU","TIGANIA WEST","8",1634,1706,3340
"28056","MERU","TIGANIA WEST","9",1842,1888,3730
"28057","MERU","TIGANIA WEST","5-9",8427,8391,16818
"28058","MERU","TIGANIA WEST","10",2106,2031,4137
"28059","MERU","TIGANIA WEST","11",1825,1942,3767
"28060","MERU","TIGANIA WEST","12",2066,1906,3972
"28061","MERU","TIGANIA WEST","13",2114,2220,4334
"28062","MERU","TIGANIA WEST","14",2011,1985,3996
"28063","MERU","TIGANIA WEST","10 -14",10122,10084,20206
"28064","MERU","TIGANIA WEST","15",2027,2050,4077
"28065","MERU","TIGANIA WEST","16",1681,1728,3409
"28066","MERU","TIGANIA WEST","17",1641,1634,3275
"28067","MERU","TIGANIA WEST","18",1450,1477,2927
"28068","MERU","TIGANIA WEST","19",1708,1533,3241
"28069","MERU","TIGANIA WEST","15-19",8507,8422,16929
"28070","MERU","TIGANIA WEST","20",1424,1368,2792
"28071","MERU","TIGANIA WEST","21",1011,1144,2155
"28072","MERU","TIGANIA WEST","22",936,947,1883
"28073","MERU","TIGANIA WEST","23",959,1053,2012
"28074","MERU","TIGANIA WEST","24",803,941,1744
"28075","MERU","TIGANIA WEST","20-24",5133,5453,10586
"28076","MERU","TIGANIA WEST","25",983,1027,2010
"28077","MERU","TIGANIA WEST","26",734,840,1574
"28078","MERU","TIGANIA WEST","27",817,921,1738
"28079","MERU","TIGANIA WEST","28",738,747,1485
"28080","MERU","TIGANIA WEST","29",675,719,1394
"28081","MERU","TIGANIA WEST","25-29",3947,4254,8201
"28082","MERU","TIGANIA WEST","30",1126,1242,2368
"28083","MERU","TIGANIA WEST","31",649,704,1353
"28084","MERU","TIGANIA WEST","32",847,1081,1928
"28085","MERU","TIGANIA WEST","33",811,1048,1859
"28086","MERU","TIGANIA WEST","34",604,859,1463
"28087","MERU","TIGANIA WEST","30-34",4037,4934,8971
"28088","MERU","TIGANIA WEST","35",1408,1590,2998
"28089","MERU","TIGANIA WEST","36",686,709,1395
"28090","MERU","TIGANIA WEST","37",788,692,1480
"28091","MERU","TIGANIA WEST","38",604,680,1284
"28092","MERU","TIGANIA WEST","39",705,755,1460
"28093","MERU","TIGANIA WEST","35-39",4191,4426,8617
"28094","MERU","TIGANIA WEST","40",1095,1195,2290
"28095","MERU","TIGANIA WEST","41",671,675,1346
"28096","MERU","TIGANIA WEST","42",659,622,1281
"28097","MERU","TIGANIA WEST","43",572,652,1224
"28098","MERU","TIGANIA WEST","44",509,554,1063
"28099","MERU","TIGANIA WEST","40-44",3506,3698,7204
"28100","MERU","TIGANIA WEST","45",818,923,1741
"28101","MERU","TIGANIA WEST","46",614,673,1287
"28102","MERU","TIGANIA WEST","47",536,671,1207
"28103","MERU","TIGANIA WEST","48",391,471,862
"28104","MERU","TIGANIA WEST","49",488,541,1029
"28105","MERU","TIGANIA WEST","45-49",2847,3279,6126
"28106","MERU","TIGANIA WEST","50",779,930,1709
"28107","MERU","TIGANIA WEST","51",445,425,870
"28108","MERU","TIGANIA WEST","52",322,261,583
"28109","MERU","TIGANIA WEST","53",221,209,430
"28110","MERU","TIGANIA WEST","54",292,274,566
"28111","MERU","TIGANIA WEST","50-54",2059,2099,4158
"28112","MERU","TIGANIA WEST","55",455,488,943
"28113","MERU","TIGANIA WEST","56",461,522,983
"28114","MERU","TIGANIA WEST","57",421,515,936
"28115","MERU","TIGANIA WEST","58",312,429,741
"28116","MERU","TIGANIA WEST","59",288,455,743
"28117","MERU","TIGANIA WEST","55-59",1937,2409,4346
"28118","MERU","TIGANIA WEST","60",604,733,1337
"28119","MERU","TIGANIA WEST","61",303,353,656
"28120","MERU","TIGANIA WEST","62",254,304,558
"28121","MERU","TIGANIA WEST","63",236,259,495
"28122","MERU","TIGANIA WEST","64",203,224,427
"28123","MERU","TIGANIA WEST","60-64",1600,1873,3473
"28124","MERU","TIGANIA WEST","65",395,501,896
"28125","MERU","TIGANIA WEST","66",191,246,437
"28126","MERU","TIGANIA WEST","67",349,358,707
"28127","MERU","TIGANIA WEST","68",204,187,391
"28128","MERU","TIGANIA WEST","69",289,376,665
"28129","MERU","TIGANIA WEST","65-69",1428,1668,3096
"28130","MERU","TIGANIA WEST","70",512,754,1266
"28131","MERU","TIGANIA WEST","71",175,243,418
"28132","MERU","TIGANIA WEST","72",203,219,422
"28133","MERU","TIGANIA WEST","73",182,210,392
"28134","MERU","TIGANIA WEST","74",119,210,329
"28135","MERU","TIGANIA WEST","70-74",1191,1636,2827
"28136","MERU","TIGANIA WEST","75",150,201,351
"28137","MERU","TIGANIA WEST","76",90,97,187
"28138","MERU","TIGANIA WEST","77",111,103,214
"28139","MERU","TIGANIA WEST","78",123,104,227
"28140","MERU","TIGANIA WEST","79",102,224,326
"28141","MERU","TIGANIA WEST","75-79",576,729,1305
"28142","MERU","TIGANIA WEST","80",202,368,570
"28143","MERU","TIGANIA WEST","81",62,74,136
"28144","MERU","TIGANIA WEST","82",56,52,108
"28145","MERU","TIGANIA WEST","83",66,81,147
"28146","MERU","TIGANIA WEST","84",53,94,147
"28147","MERU","TIGANIA WEST","80-84",439,669,1108
"28148","MERU","TIGANIA WEST","85",54,102,156
"28149","MERU","TIGANIA WEST","86",51,43,94
"28150","MERU","TIGANIA WEST","87",43,51,94
"28151","MERU","TIGANIA WEST","88",27,31,58
"28152","MERU","TIGANIA WEST","89",51,138,189
"28153","MERU","TIGANIA WEST","85-89",226,365,591
"28154","MERU","TIGANIA WEST","90",48,125,173
"28155","MERU","TIGANIA WEST","91",16,25,41
"28156","MERU","TIGANIA WEST","92",9,21,30
"28157","MERU","TIGANIA WEST","93",9,18,27
"28158","MERU","TIGANIA WEST","94",17,34,51
"28159","MERU","TIGANIA WEST","90-94",99,223,322
"28160","MERU","TIGANIA WEST","95",20,33,53
"28161","MERU","TIGANIA WEST","96",6,12,18
"28162","MERU","TIGANIA WEST","97",10,19,29
"28163","MERU","TIGANIA WEST","98",10,13,23
"28164","MERU","TIGANIA WEST","99",16,35,51
"28165","MERU","TIGANIA WEST","95-99",62,112,174
"28166","MERU","TIGANIA WEST","100+",31,121,152
"28167","MERU","TIGANIA WEST","Not Stated",NA,1,1
"28168","MERU","MERU NATIONAL PARK","Total",283,102,385
"28169","MERU","MERU NATIONAL PARK","0",7,5,12
"28170","MERU","MERU NATIONAL PARK","1",3,1,4
"28171","MERU","MERU NATIONAL PARK","2",3,5,8
"28172","MERU","MERU NATIONAL PARK","3",2,3,5
"28173","MERU","MERU NATIONAL PARK","4",2,2,4
"28174","MERU","MERU NATIONAL PARK","0 - 4",17,16,33
"28175","MERU","MERU NATIONAL PARK","5",3,1,4
"28176","MERU","MERU NATIONAL PARK","6",4,2,6
"28177","MERU","MERU NATIONAL PARK","7",1,NA,1
"28178","MERU","MERU NATIONAL PARK","8",1,NA,1
"28179","MERU","MERU NATIONAL PARK","9",2,1,3
"28180","MERU","MERU NATIONAL PARK","5-9",11,4,15
"28181","MERU","MERU NATIONAL PARK","10",NA,3,3
"28182","MERU","MERU NATIONAL PARK","11",2,3,5
"28183","MERU","MERU NATIONAL PARK","12",NA,2,2
"28184","MERU","MERU NATIONAL PARK","13",2,NA,2
"28185","MERU","MERU NATIONAL PARK","14",1,1,2
"28186","MERU","MERU NATIONAL PARK","10 -14",5,9,14
"28187","MERU","MERU NATIONAL PARK","15",1,2,3
"28188","MERU","MERU NATIONAL PARK","16",1,NA,1
"28189","MERU","MERU NATIONAL PARK","17",1,3,4
"28190","MERU","MERU NATIONAL PARK","18",NA,NA,NA
"28191","MERU","MERU NATIONAL PARK","19",2,NA,2
"28192","MERU","MERU NATIONAL PARK","15-19",5,5,10
"28193","MERU","MERU NATIONAL PARK","20",NA,3,3
"28194","MERU","MERU NATIONAL PARK","21",3,3,6
"28195","MERU","MERU NATIONAL PARK","22",NA,3,3
"28196","MERU","MERU NATIONAL PARK","23",1,3,4
"28197","MERU","MERU NATIONAL PARK","24",7,1,8
"28198","MERU","MERU NATIONAL PARK","20-24",11,13,24
"28199","MERU","MERU NATIONAL PARK","25",7,7,14
"28200","MERU","MERU NATIONAL PARK","26",11,4,15
"28201","MERU","MERU NATIONAL PARK","27",14,8,22
"28202","MERU","MERU NATIONAL PARK","28",11,2,13
"28203","MERU","MERU NATIONAL PARK","29",24,4,28
"28204","MERU","MERU NATIONAL PARK","25-29",67,25,92
"28205","MERU","MERU NATIONAL PARK","30",11,3,14
"28206","MERU","MERU NATIONAL PARK","31",9,3,12
"28207","MERU","MERU NATIONAL PARK","32",9,2,11
"28208","MERU","MERU NATIONAL PARK","33",5,2,7
"28209","MERU","MERU NATIONAL PARK","34",12,3,15
"28210","MERU","MERU NATIONAL PARK","30-34",46,13,59
"28211","MERU","MERU NATIONAL PARK","35",7,4,11
"28212","MERU","MERU NATIONAL PARK","36",14,NA,14
"28213","MERU","MERU NATIONAL PARK","37",9,NA,9
"28214","MERU","MERU NATIONAL PARK","38",10,2,12
"28215","MERU","MERU NATIONAL PARK","39",7,1,8
"28216","MERU","MERU NATIONAL PARK","35-39",47,7,54
"28217","MERU","MERU NATIONAL PARK","40",8,1,9
"28218","MERU","MERU NATIONAL PARK","41",5,2,7
"28219","MERU","MERU NATIONAL PARK","42",8,NA,8
"28220","MERU","MERU NATIONAL PARK","43",3,2,5
"28221","MERU","MERU NATIONAL PARK","44",3,NA,3
"28222","MERU","MERU NATIONAL PARK","40-44",27,5,32
"28223","MERU","MERU NATIONAL PARK","45",3,1,4
"28224","MERU","MERU NATIONAL PARK","46",8,1,9
"28225","MERU","MERU NATIONAL PARK","47",3,1,4
"28226","MERU","MERU NATIONAL PARK","48",4,NA,4
"28227","MERU","MERU NATIONAL PARK","49",7,NA,7
"28228","MERU","MERU NATIONAL PARK","45-49",25,3,28
"28229","MERU","MERU NATIONAL PARK","50",2,NA,2
"28230","MERU","MERU NATIONAL PARK","51",3,NA,3
"28231","MERU","MERU NATIONAL PARK","52",4,NA,4
"28232","MERU","MERU NATIONAL PARK","53",3,NA,3
"28233","MERU","MERU NATIONAL PARK","54",NA,NA,NA
"28234","MERU","MERU NATIONAL PARK","50-54",12,NA,12
"28235","MERU","MERU NATIONAL PARK","55",3,NA,3
"28236","MERU","MERU NATIONAL PARK","56",1,NA,1
"28237","MERU","MERU NATIONAL PARK","57",1,NA,1
"28238","MERU","MERU NATIONAL PARK","58",NA,NA,NA
"28239","MERU","MERU NATIONAL PARK","59",1,2,3
"28240","MERU","MERU NATIONAL PARK","55-59",6,2,8
"28241","MERU","MERU NATIONAL PARK","60",1,NA,1
"28242","MERU","MERU NATIONAL PARK","61",1,NA,1
"28243","MERU","MERU NATIONAL PARK","62",1,NA,1
"28244","MERU","MERU NATIONAL PARK","63",NA,NA,NA
"28245","MERU","MERU NATIONAL PARK","64",NA,NA,NA
"28246","MERU","MERU NATIONAL PARK","60-64",3,NA,3
"28247","MERU","MERU NATIONAL PARK","65",NA,NA,NA
"28248","MERU","MERU NATIONAL PARK","66",NA,NA,NA
"28249","MERU","MERU NATIONAL PARK","67",NA,NA,NA
"28250","MERU","MERU NATIONAL PARK","68",NA,NA,NA
"28251","MERU","MERU NATIONAL PARK","69",1,NA,1
"28252","MERU","MERU NATIONAL PARK","65-69",1,NA,1
"28253","MERU","MERU NATIONAL PARK","70",NA,NA,NA
"28254","MERU","MERU NATIONAL PARK","71",NA,NA,NA
"28255","MERU","MERU NATIONAL PARK","72",NA,NA,NA
"28256","MERU","MERU NATIONAL PARK","73",NA,NA,NA
"28257","MERU","MERU NATIONAL PARK","74",NA,NA,NA
"28258","MERU","MERU NATIONAL PARK","70-74",NA,NA,NA
"28259","MERU","MERU NATIONAL PARK","75",NA,NA,NA
"28260","MERU","MERU NATIONAL PARK","76",NA,NA,NA
"28261","MERU","MERU NATIONAL PARK","77",NA,NA,NA
"28262","MERU","MERU NATIONAL PARK","78",NA,NA,NA
"28263","MERU","MERU NATIONAL PARK","79",NA,NA,NA
"28264","MERU","MERU NATIONAL PARK","75-79",NA,NA,NA
"28265","MERU","MERU NATIONAL PARK","80",NA,NA,NA
"28266","MERU","MERU NATIONAL PARK","81",NA,NA,NA
"28267","MERU","MERU NATIONAL PARK","82",NA,NA,NA
"28268","MERU","MERU NATIONAL PARK","83",NA,NA,NA
"28269","MERU","MERU NATIONAL PARK","84",NA,NA,NA
"28270","MERU","MERU NATIONAL PARK","80-84",NA,NA,NA
"28271","MERU","MERU NATIONAL PARK","85",NA,NA,NA
"28272","MERU","MERU NATIONAL PARK","86",NA,NA,NA
"28273","MERU","MERU NATIONAL PARK","87",NA,NA,NA
"28274","MERU","MERU NATIONAL PARK","88",NA,NA,NA
"28275","MERU","MERU NATIONAL PARK","89",NA,NA,NA
"28276","MERU","MERU NATIONAL PARK","85-89",NA,NA,NA
"28277","MERU","MERU NATIONAL PARK","90",NA,NA,NA
"28278","MERU","MERU NATIONAL PARK","91",NA,NA,NA
"28279","MERU","MERU NATIONAL PARK","92",NA,NA,NA
"28280","MERU","MERU NATIONAL PARK","93",NA,NA,NA
"28281","MERU","MERU NATIONAL PARK","94",NA,NA,NA
"28282","MERU","MERU NATIONAL PARK","90-94",NA,NA,NA
"28283","MERU","MERU NATIONAL PARK","95",NA,NA,NA
"28284","MERU","MERU NATIONAL PARK","96",NA,NA,NA
"28285","MERU","MERU NATIONAL PARK","97",NA,NA,NA
"28286","MERU","MERU NATIONAL PARK","98",NA,NA,NA
"28287","MERU","MERU NATIONAL PARK","99",NA,NA,NA
"28288","MERU","MERU NATIONAL PARK","95-99",NA,NA,NA
"28289","MERU","MERU NATIONAL PARK","100+",NA,NA,NA
"28290","MERU","MERU NATIONAL PARK","Not Stated",NA,NA,NA
"28291","MERU","MT. KENYA FOREST","Total",409,54,463
"28292","MERU","MT. KENYA FOREST","0",NA,3,3
"28293","MERU","MT. KENYA FOREST","1",NA,NA,NA
"28294","MERU","MT. KENYA FOREST","2",NA,1,1
"28295","MERU","MT. KENYA FOREST","3",1,NA,1
"28296","MERU","MT. KENYA FOREST","4",NA,1,1
"28297","MERU","MT. KENYA FOREST","0 - 4",1,5,6
"28298","MERU","MT. KENYA FOREST","5",NA,NA,NA
"28299","MERU","MT. KENYA FOREST","6",1,NA,1
"28300","MERU","MT. KENYA FOREST","7",NA,1,1
"28301","MERU","MT. KENYA FOREST","8",NA,1,1
"28302","MERU","MT. KENYA FOREST","9",NA,NA,NA
"28303","MERU","MT. KENYA FOREST","5-9",1,2,3
"28304","MERU","MT. KENYA FOREST","10",2,NA,2
"28305","MERU","MT. KENYA FOREST","11",1,NA,1
"28306","MERU","MT. KENYA FOREST","12",NA,NA,NA
"28307","MERU","MT. KENYA FOREST","13",2,NA,2
"28308","MERU","MT. KENYA FOREST","14",1,NA,1
"28309","MERU","MT. KENYA FOREST","10 -14",6,NA,6
"28310","MERU","MT. KENYA FOREST","15",NA,1,1
"28311","MERU","MT. KENYA FOREST","16",4,NA,4
"28312","MERU","MT. KENYA FOREST","17",1,NA,1
"28313","MERU","MT. KENYA FOREST","18",3,NA,3
"28314","MERU","MT. KENYA FOREST","19",1,NA,1
"28315","MERU","MT. KENYA FOREST","15-19",9,1,10
"28316","MERU","MT. KENYA FOREST","20",1,NA,1
"28317","MERU","MT. KENYA FOREST","21",6,1,7
"28318","MERU","MT. KENYA FOREST","22",7,NA,7
"28319","MERU","MT. KENYA FOREST","23",4,NA,4
"28320","MERU","MT. KENYA FOREST","24",3,3,6
"28321","MERU","MT. KENYA FOREST","20-24",21,4,25
"28322","MERU","MT. KENYA FOREST","25",15,3,18
"28323","MERU","MT. KENYA FOREST","26",7,3,10
"28324","MERU","MT. KENYA FOREST","27",10,NA,10
"28325","MERU","MT. KENYA FOREST","28",13,2,15
"28326","MERU","MT. KENYA FOREST","29",14,1,15
"28327","MERU","MT. KENYA FOREST","25-29",59,9,68
"28328","MERU","MT. KENYA FOREST","30",12,1,13
"28329","MERU","MT. KENYA FOREST","31",17,1,18
"28330","MERU","MT. KENYA FOREST","32",13,2,15
"28331","MERU","MT. KENYA FOREST","33",17,3,20
"28332","MERU","MT. KENYA FOREST","34",8,1,9
"28333","MERU","MT. KENYA FOREST","30-34",67,8,75
"28334","MERU","MT. KENYA FOREST","35",13,4,17
"28335","MERU","MT. KENYA FOREST","36",10,1,11
"28336","MERU","MT. KENYA FOREST","37",7,NA,7
"28337","MERU","MT. KENYA FOREST","38",7,1,8
"28338","MERU","MT. KENYA FOREST","39",11,2,13
"28339","MERU","MT. KENYA FOREST","35-39",48,8,56
"28340","MERU","MT. KENYA FOREST","40",18,1,19
"28341","MERU","MT. KENYA FOREST","41",8,1,9
"28342","MERU","MT. KENYA FOREST","42",11,1,12
"28343","MERU","MT. KENYA FOREST","43",11,1,12
"28344","MERU","MT. KENYA FOREST","44",6,4,10
"28345","MERU","MT. KENYA FOREST","40-44",54,8,62
"28346","MERU","MT. KENYA FOREST","45",6,1,7
"28347","MERU","MT. KENYA FOREST","46",13,2,15
"28348","MERU","MT. KENYA FOREST","47",8,1,9
"28349","MERU","MT. KENYA FOREST","48",8,1,9
"28350","MERU","MT. KENYA FOREST","49",9,2,11
"28351","MERU","MT. KENYA FOREST","45-49",44,7,51
"28352","MERU","MT. KENYA FOREST","50",10,NA,10
"28353","MERU","MT. KENYA FOREST","51",8,NA,8
"28354","MERU","MT. KENYA FOREST","52",5,NA,5
"28355","MERU","MT. KENYA FOREST","53",1,NA,1
"28356","MERU","MT. KENYA FOREST","54",6,NA,6
"28357","MERU","MT. KENYA FOREST","50-54",30,NA,30
"28358","MERU","MT. KENYA FOREST","55",1,NA,1
"28359","MERU","MT. KENYA FOREST","56",5,1,6
"28360","MERU","MT. KENYA FOREST","57",6,NA,6
"28361","MERU","MT. KENYA FOREST","58",2,NA,2
"28362","MERU","MT. KENYA FOREST","59",5,NA,5
"28363","MERU","MT. KENYA FOREST","55-59",19,1,20
"28364","MERU","MT. KENYA FOREST","60",6,NA,6
"28365","MERU","MT. KENYA FOREST","61",4,1,5
"28366","MERU","MT. KENYA FOREST","62",4,NA,4
"28367","MERU","MT. KENYA FOREST","63",7,NA,7
"28368","MERU","MT. KENYA FOREST","64",1,NA,1
"28369","MERU","MT. KENYA FOREST","60-64",22,1,23
"28370","MERU","MT. KENYA FOREST","65",5,NA,5
"28371","MERU","MT. KENYA FOREST","66",2,NA,2
"28372","MERU","MT. KENYA FOREST","67",7,NA,7
"28373","MERU","MT. KENYA FOREST","68",2,NA,2
"28374","MERU","MT. KENYA FOREST","69",2,NA,2
"28375","MERU","MT. KENYA FOREST","65-69",18,NA,18
"28376","MERU","MT. KENYA FOREST","70",2,NA,2
"28377","MERU","MT. KENYA FOREST","71",1,NA,1
"28378","MERU","MT. KENYA FOREST","72",3,NA,3
"28379","MERU","MT. KENYA FOREST","73",NA,NA,NA
"28380","MERU","MT. KENYA FOREST","74",NA,NA,NA
"28381","MERU","MT. KENYA FOREST","70-74",6,NA,6
"28382","MERU","MT. KENYA FOREST","75",1,NA,1
"28383","MERU","MT. KENYA FOREST","76",NA,NA,NA
"28384","MERU","MT. KENYA FOREST","77",1,NA,1
"28385","MERU","MT. KENYA FOREST","78",1,NA,1
"28386","MERU","MT. KENYA FOREST","79",1,NA,1
"28387","MERU","MT. KENYA FOREST","75-79",4,NA,4
"28388","MERU","MT. KENYA FOREST","80",NA,NA,NA
"28389","MERU","MT. KENYA FOREST","81",NA,NA,NA
"28390","MERU","MT. KENYA FOREST","82",NA,NA,NA
"28391","MERU","MT. KENYA FOREST","83",NA,NA,NA
"28392","MERU","MT. KENYA FOREST","84",NA,NA,NA
"28393","MERU","MT. KENYA FOREST","80-84",NA,NA,NA
"28394","MERU","MT. KENYA FOREST","85",NA,NA,NA
"28395","MERU","MT. KENYA FOREST","86",NA,NA,NA
"28396","MERU","MT. KENYA FOREST","87",NA,NA,NA
"28397","MERU","MT. KENYA FOREST","88",NA,NA,NA
"28398","MERU","MT. KENYA FOREST","89",NA,NA,NA
"28399","MERU","MT. KENYA FOREST","85-89",NA,NA,NA
"28400","MERU","MT. KENYA FOREST","90",NA,NA,NA
"28401","MERU","MT. KENYA FOREST","91",NA,NA,NA
"28402","MERU","MT. KENYA FOREST","92",NA,NA,NA
"28403","MERU","MT. KENYA FOREST","93",NA,NA,NA
"28404","MERU","MT. KENYA FOREST","94",NA,NA,NA
"28405","MERU","MT. KENYA FOREST","90-94",NA,NA,NA
"28406","MERU","MT. KENYA FOREST","95",NA,NA,NA
"28407","MERU","MT. KENYA FOREST","96",NA,NA,NA
"28408","MERU","MT. KENYA FOREST","97",NA,NA,NA
"28409","MERU","MT. KENYA FOREST","98",NA,NA,NA
"28410","MERU","MT. KENYA FOREST","99",NA,NA,NA
"28411","MERU","MT. KENYA FOREST","95-99",NA,NA,NA
"28412","MERU","MT. KENYA FOREST","100+",NA,NA,NA
"28413","MERU","MT. KENYA FOREST","Not Stated",NA,NA,NA
"28414","MIGORI","ALL","Total",536187,580214,1116401
"28415","MIGORI","ALL","0",14715,14978,29693
"28416","MIGORI","ALL","1",15558,15778,31336
"28417","MIGORI","ALL","2",15719,16144,31863
"28418","MIGORI","ALL","3",17042,17249,34291
"28419","MIGORI","ALL","4",17103,17140,34243
"28420","MIGORI","ALL","0 - 4",80137,81289,161426
"28421","MIGORI","ALL","5",17591,17613,35204
"28422","MIGORI","ALL","6",17559,17792,35351
"28423","MIGORI","ALL","7",16364,16378,32742
"28424","MIGORI","ALL","8",16265,16760,33025
"28425","MIGORI","ALL","9",17702,17698,35400
"28426","MIGORI","ALL","5-9",85481,86241,171722
"28427","MIGORI","ALL","10",19279,19501,38780
"28428","MIGORI","ALL","11",16505,17385,33890
"28429","MIGORI","ALL","12",19277,18862,38139
"28430","MIGORI","ALL","13",17905,18155,36060
"28431","MIGORI","ALL","14",16436,16325,32761
"28432","MIGORI","ALL","10 -14",89402,90228,179630
"28433","MIGORI","ALL","15",16041,16066,32107
"28434","MIGORI","ALL","16",13979,14078,28057
"28435","MIGORI","ALL","17",13367,13203,26570
"28436","MIGORI","ALL","18",11094,11285,22379
"28437","MIGORI","ALL","19",12363,13202,25565
"28438","MIGORI","ALL","15-19",66844,67834,134678
"28439","MIGORI","ALL","20",10942,13369,24311
"28440","MIGORI","ALL","21",8907,11108,20015
"28441","MIGORI","ALL","22",8276,10686,18962
"28442","MIGORI","ALL","23",8810,10994,19804
"28443","MIGORI","ALL","24",8048,9698,17746
"28444","MIGORI","ALL","20-24",44983,55855,100838
"28445","MIGORI","ALL","25",9683,11211,20894
"28446","MIGORI","ALL","26",7327,9181,16508
"28447","MIGORI","ALL","27",7731,9303,17034
"28448","MIGORI","ALL","28",5705,7200,12905
"28449","MIGORI","ALL","29",5515,6981,12496
"28450","MIGORI","ALL","25-29",35961,43876,79837
"28451","MIGORI","ALL","30",8456,10778,19234
"28452","MIGORI","ALL","31",5719,7211,12930
"28453","MIGORI","ALL","32",6861,8557,15418
"28454","MIGORI","ALL","33",5859,7428,13287
"28455","MIGORI","ALL","34",5498,6209,11707
"28456","MIGORI","ALL","30-34",32393,40183,72576
"28457","MIGORI","ALL","35",7397,7484,14881
"28458","MIGORI","ALL","36",5013,4488,9501
"28459","MIGORI","ALL","37",4841,4305,9146
"28460","MIGORI","ALL","38",3297,3135,6432
"28461","MIGORI","ALL","39",3968,3452,7420
"28462","MIGORI","ALL","35-39",24516,22864,47380
"28463","MIGORI","ALL","40",5258,5267,10525
"28464","MIGORI","ALL","41",4348,4271,8619
"28465","MIGORI","ALL","42",4050,4219,8269
"28466","MIGORI","ALL","43",3713,3802,7515
"28467","MIGORI","ALL","44",2832,2926,5758
"28468","MIGORI","ALL","40-44",20201,20485,40686
"28469","MIGORI","ALL","45",4474,4630,9104
"28470","MIGORI","ALL","46",3074,3380,6454
"28471","MIGORI","ALL","47",3435,3969,7404
"28472","MIGORI","ALL","48",1834,2182,4016
"28473","MIGORI","ALL","49",2257,2533,4790
"28474","MIGORI","ALL","45-49",15074,16694,31768
"28475","MIGORI","ALL","50",2960,3709,6669
"28476","MIGORI","ALL","51",2128,2552,4680
"28477","MIGORI","ALL","52",1682,2063,3745
"28478","MIGORI","ALL","53",1500,1656,3156
"28479","MIGORI","ALL","54",1851,2008,3859
"28480","MIGORI","ALL","50-54",10121,11988,22109
"28481","MIGORI","ALL","55",1973,2397,4370
"28482","MIGORI","ALL","56",2055,2566,4621
"28483","MIGORI","ALL","57",1962,3071,5033
"28484","MIGORI","ALL","58",1317,1594,2911
"28485","MIGORI","ALL","59",1511,2066,3577
"28486","MIGORI","ALL","55-59",8818,11694,20512
"28487","MIGORI","ALL","60",2176,3026,5202
"28488","MIGORI","ALL","61",1706,2178,3884
"28489","MIGORI","ALL","62",1253,1474,2727
"28490","MIGORI","ALL","63",1366,1588,2954
"28491","MIGORI","ALL","64",988,1354,2342
"28492","MIGORI","ALL","60-64",7489,9620,17109
"28493","MIGORI","ALL","65",1384,2000,3384
"28494","MIGORI","ALL","66",996,1247,2243
"28495","MIGORI","ALL","67",1415,2070,3485
"28496","MIGORI","ALL","68",629,780,1409
"28497","MIGORI","ALL","69",1004,1432,2436
"28498","MIGORI","ALL","65-69",5428,7529,12957
"28499","MIGORI","ALL","70",1340,2093,3433
"28500","MIGORI","ALL","71",898,1131,2029
"28501","MIGORI","ALL","72",757,830,1587
"28502","MIGORI","ALL","73",567,696,1263
"28503","MIGORI","ALL","74",598,857,1455
"28504","MIGORI","ALL","70-74",4160,5607,9767
"28505","MIGORI","ALL","75",537,803,1340
"28506","MIGORI","ALL","76",429,628,1057
"28507","MIGORI","ALL","77",589,854,1443
"28508","MIGORI","ALL","78",282,377,659
"28509","MIGORI","ALL","79",375,781,1156
"28510","MIGORI","ALL","75-79",2212,3443,5655
"28511","MIGORI","ALL","80",429,910,1339
"28512","MIGORI","ALL","81",324,464,788
"28513","MIGORI","ALL","82",299,352,651
"28514","MIGORI","ALL","83",280,356,636
"28515","MIGORI","ALL","84",232,391,623
"28516","MIGORI","ALL","80-84",1564,2473,4037
"28517","MIGORI","ALL","85",212,340,552
"28518","MIGORI","ALL","86",168,199,367
"28519","MIGORI","ALL","87",260,358,618
"28520","MIGORI","ALL","88",91,160,251
"28521","MIGORI","ALL","89",156,372,528
"28522","MIGORI","ALL","85-89",887,1429,2316
"28523","MIGORI","ALL","90",108,202,310
"28524","MIGORI","ALL","91",76,110,186
"28525","MIGORI","ALL","92",51,55,106
"28526","MIGORI","ALL","93",38,59,97
"28527","MIGORI","ALL","94",30,67,97
"28528","MIGORI","ALL","90-94",303,493,796
"28529","MIGORI","ALL","95",58,103,161
"28530","MIGORI","ALL","96",28,38,66
"28531","MIGORI","ALL","97",18,40,58
"28532","MIGORI","ALL","98",13,25,38
"28533","MIGORI","ALL","99",24,50,74
"28534","MIGORI","ALL","95-99",141,256,397
"28535","MIGORI","ALL","100+",67,121,188
"28536","MIGORI","ALL","Not Stated",5,12,17
"28537","MIGORI","AWENDO","Total",56348,60939,117287
"28538","MIGORI","AWENDO","0",1559,1617,3176
"28539","MIGORI","AWENDO","1",1535,1524,3059
"28540","MIGORI","AWENDO","2",1509,1480,2989
"28541","MIGORI","AWENDO","3",1604,1642,3246
"28542","MIGORI","AWENDO","4",1775,1688,3463
"28543","MIGORI","AWENDO","0 - 4",7982,7951,15933
"28544","MIGORI","AWENDO","5",1724,1717,3441
"28545","MIGORI","AWENDO","6",1793,1804,3597
"28546","MIGORI","AWENDO","7",1700,1696,3396
"28547","MIGORI","AWENDO","8",1608,1684,3292
"28548","MIGORI","AWENDO","9",1877,1875,3752
"28549","MIGORI","AWENDO","5-9",8702,8776,17478
"28550","MIGORI","AWENDO","10",2028,1945,3973
"28551","MIGORI","AWENDO","11",1775,1845,3620
"28552","MIGORI","AWENDO","12",2079,1997,4076
"28553","MIGORI","AWENDO","13",1939,1972,3911
"28554","MIGORI","AWENDO","14",1761,1820,3581
"28555","MIGORI","AWENDO","10 -14",9582,9579,19161
"28556","MIGORI","AWENDO","15",1622,1723,3345
"28557","MIGORI","AWENDO","16",1560,1497,3057
"28558","MIGORI","AWENDO","17",1408,1428,2836
"28559","MIGORI","AWENDO","18",1146,1199,2345
"28560","MIGORI","AWENDO","19",1282,1318,2600
"28561","MIGORI","AWENDO","15-19",7018,7165,14183
"28562","MIGORI","AWENDO","20",1085,1346,2431
"28563","MIGORI","AWENDO","21",966,1188,2154
"28564","MIGORI","AWENDO","22",819,1053,1872
"28565","MIGORI","AWENDO","23",864,1110,1974
"28566","MIGORI","AWENDO","24",792,1009,1801
"28567","MIGORI","AWENDO","20-24",4526,5706,10232
"28568","MIGORI","AWENDO","25",925,1092,2017
"28569","MIGORI","AWENDO","26",791,981,1772
"28570","MIGORI","AWENDO","27",819,1063,1882
"28571","MIGORI","AWENDO","28",595,705,1300
"28572","MIGORI","AWENDO","29",602,824,1426
"28573","MIGORI","AWENDO","25-29",3732,4665,8397
"28574","MIGORI","AWENDO","30",839,1147,1986
"28575","MIGORI","AWENDO","31",671,824,1495
"28576","MIGORI","AWENDO","32",803,995,1798
"28577","MIGORI","AWENDO","33",627,821,1448
"28578","MIGORI","AWENDO","34",614,735,1349
"28579","MIGORI","AWENDO","30-34",3554,4522,8076
"28580","MIGORI","AWENDO","35",826,756,1582
"28581","MIGORI","AWENDO","36",609,510,1119
"28582","MIGORI","AWENDO","37",556,462,1018
"28583","MIGORI","AWENDO","38",364,340,704
"28584","MIGORI","AWENDO","39",494,394,888
"28585","MIGORI","AWENDO","35-39",2849,2462,5311
"28586","MIGORI","AWENDO","40",501,507,1008
"28587","MIGORI","AWENDO","41",491,420,911
"28588","MIGORI","AWENDO","42",470,438,908
"28589","MIGORI","AWENDO","43",470,414,884
"28590","MIGORI","AWENDO","44",385,306,691
"28591","MIGORI","AWENDO","40-44",2317,2085,4402
"28592","MIGORI","AWENDO","45",439,470,909
"28593","MIGORI","AWENDO","46",317,319,636
"28594","MIGORI","AWENDO","47",373,474,847
"28595","MIGORI","AWENDO","48",208,272,480
"28596","MIGORI","AWENDO","49",269,293,562
"28597","MIGORI","AWENDO","45-49",1606,1828,3434
"28598","MIGORI","AWENDO","50",288,381,669
"28599","MIGORI","AWENDO","51",222,238,460
"28600","MIGORI","AWENDO","52",183,199,382
"28601","MIGORI","AWENDO","53",184,179,363
"28602","MIGORI","AWENDO","54",199,200,399
"28603","MIGORI","AWENDO","50-54",1076,1197,2273
"28604","MIGORI","AWENDO","55",200,250,450
"28605","MIGORI","AWENDO","56",230,302,532
"28606","MIGORI","AWENDO","57",229,386,615
"28607","MIGORI","AWENDO","58",131,183,314
"28608","MIGORI","AWENDO","59",194,249,443
"28609","MIGORI","AWENDO","55-59",984,1370,2354
"28610","MIGORI","AWENDO","60",218,359,577
"28611","MIGORI","AWENDO","61",170,274,444
"28612","MIGORI","AWENDO","62",157,208,365
"28613","MIGORI","AWENDO","63",146,201,347
"28614","MIGORI","AWENDO","64",105,159,264
"28615","MIGORI","AWENDO","60-64",796,1201,1997
"28616","MIGORI","AWENDO","65",161,205,366
"28617","MIGORI","AWENDO","66",115,170,285
"28618","MIGORI","AWENDO","67",144,266,410
"28619","MIGORI","AWENDO","68",63,76,139
"28620","MIGORI","AWENDO","69",118,134,252
"28621","MIGORI","AWENDO","65-69",601,851,1452
"28622","MIGORI","AWENDO","70",154,206,360
"28623","MIGORI","AWENDO","71",101,130,231
"28624","MIGORI","AWENDO","72",102,84,186
"28625","MIGORI","AWENDO","73",60,77,137
"28626","MIGORI","AWENDO","74",51,87,138
"28627","MIGORI","AWENDO","70-74",468,584,1052
"28628","MIGORI","AWENDO","75",61,96,157
"28629","MIGORI","AWENDO","76",47,93,140
"28630","MIGORI","AWENDO","77",61,119,180
"28631","MIGORI","AWENDO","78",31,42,73
"28632","MIGORI","AWENDO","79",35,102,137
"28633","MIGORI","AWENDO","75-79",235,452,687
"28634","MIGORI","AWENDO","80",47,110,157
"28635","MIGORI","AWENDO","81",36,51,87
"28636","MIGORI","AWENDO","82",27,47,74
"28637","MIGORI","AWENDO","83",41,44,85
"28638","MIGORI","AWENDO","84",27,44,71
"28639","MIGORI","AWENDO","80-84",178,296,474
"28640","MIGORI","AWENDO","85",24,42,66
"28641","MIGORI","AWENDO","86",20,22,42
"28642","MIGORI","AWENDO","87",25,43,68
"28643","MIGORI","AWENDO","88",9,25,34
"28644","MIGORI","AWENDO","89",12,31,43
"28645","MIGORI","AWENDO","85-89",90,163,253
"28646","MIGORI","AWENDO","90",14,29,43
"28647","MIGORI","AWENDO","91",7,7,14
"28648","MIGORI","AWENDO","92",5,7,12
"28649","MIGORI","AWENDO","93",2,5,7
"28650","MIGORI","AWENDO","94",2,7,9
"28651","MIGORI","AWENDO","90-94",30,55,85
"28652","MIGORI","AWENDO","95",8,11,19
"28653","MIGORI","AWENDO","96",NA,3,3
"28654","MIGORI","AWENDO","97",1,3,4
"28655","MIGORI","AWENDO","98",3,1,4
"28656","MIGORI","AWENDO","99",2,4,6
"28657","MIGORI","AWENDO","95-99",14,22,36
"28658","MIGORI","AWENDO","100+",6,6,12
"28659","MIGORI","AWENDO","Not Stated",2,3,5
"28660","MIGORI","KURIA EAST","Total",46969,49894,96863
"28661","MIGORI","KURIA EAST","0",1205,1295,2500
"28662","MIGORI","KURIA EAST","1",1412,1488,2900
"28663","MIGORI","KURIA EAST","2",1475,1556,3031
"28664","MIGORI","KURIA EAST","3",1672,1633,3305
"28665","MIGORI","KURIA EAST","4",1665,1584,3249
"28666","MIGORI","KURIA EAST","0 - 4",7429,7556,14985
"28667","MIGORI","KURIA EAST","5",1679,1676,3355
"28668","MIGORI","KURIA EAST","6",1666,1662,3328
"28669","MIGORI","KURIA EAST","7",1462,1501,2963
"28670","MIGORI","KURIA EAST","8",1665,1706,3371
"28671","MIGORI","KURIA EAST","9",1745,1647,3392
"28672","MIGORI","KURIA EAST","5-9",8217,8192,16409
"28673","MIGORI","KURIA EAST","10",1935,2004,3939
"28674","MIGORI","KURIA EAST","11",1500,1566,3066
"28675","MIGORI","KURIA EAST","12",1751,1759,3510
"28676","MIGORI","KURIA EAST","13",1628,1559,3187
"28677","MIGORI","KURIA EAST","14",1517,1538,3055
"28678","MIGORI","KURIA EAST","10 -14",8331,8426,16757
"28679","MIGORI","KURIA EAST","15",1479,1452,2931
"28680","MIGORI","KURIA EAST","16",1319,1153,2472
"28681","MIGORI","KURIA EAST","17",1189,1059,2248
"28682","MIGORI","KURIA EAST","18",1072,1023,2095
"28683","MIGORI","KURIA EAST","19",1115,1102,2217
"28684","MIGORI","KURIA EAST","15-19",6174,5789,11963
"28685","MIGORI","KURIA EAST","20",1057,1222,2279
"28686","MIGORI","KURIA EAST","21",696,810,1506
"28687","MIGORI","KURIA EAST","22",717,846,1563
"28688","MIGORI","KURIA EAST","23",731,830,1561
"28689","MIGORI","KURIA EAST","24",596,754,1350
"28690","MIGORI","KURIA EAST","20-24",3797,4462,8259
"28691","MIGORI","KURIA EAST","25",818,944,1762
"28692","MIGORI","KURIA EAST","26",580,669,1249
"28693","MIGORI","KURIA EAST","27",475,629,1104
"28694","MIGORI","KURIA EAST","28",472,663,1135
"28695","MIGORI","KURIA EAST","29",380,468,848
"28696","MIGORI","KURIA EAST","25-29",2725,3373,6098
"28697","MIGORI","KURIA EAST","30",735,928,1663
"28698","MIGORI","KURIA EAST","31",367,486,853
"28699","MIGORI","KURIA EAST","32",460,604,1064
"28700","MIGORI","KURIA EAST","33",351,520,871
"28701","MIGORI","KURIA EAST","34",304,373,677
"28702","MIGORI","KURIA EAST","30-34",2217,2911,5128
"28703","MIGORI","KURIA EAST","35",595,688,1283
"28704","MIGORI","KURIA EAST","36",370,313,683
"28705","MIGORI","KURIA EAST","37",290,262,552
"28706","MIGORI","KURIA EAST","38",245,290,535
"28707","MIGORI","KURIA EAST","39",246,240,486
"28708","MIGORI","KURIA EAST","35-39",1746,1793,3539
"28709","MIGORI","KURIA EAST","40",542,548,1090
"28710","MIGORI","KURIA EAST","41",263,297,560
"28711","MIGORI","KURIA EAST","42",286,320,606
"28712","MIGORI","KURIA EAST","43",267,281,548
"28713","MIGORI","KURIA EAST","44",189,230,419
"28714","MIGORI","KURIA EAST","40-44",1547,1676,3223
"28715","MIGORI","KURIA EAST","45",403,482,885
"28716","MIGORI","KURIA EAST","46",267,302,569
"28717","MIGORI","KURIA EAST","47",271,267,538
"28718","MIGORI","KURIA EAST","48",158,185,343
"28719","MIGORI","KURIA EAST","49",157,171,328
"28720","MIGORI","KURIA EAST","45-49",1256,1407,2663
"28721","MIGORI","KURIA EAST","50",271,411,682
"28722","MIGORI","KURIA EAST","51",143,196,339
"28723","MIGORI","KURIA EAST","52",117,143,260
"28724","MIGORI","KURIA EAST","53",91,106,197
"28725","MIGORI","KURIA EAST","54",185,187,372
"28726","MIGORI","KURIA EAST","50-54",807,1043,1850
"28727","MIGORI","KURIA EAST","55",146,221,367
"28728","MIGORI","KURIA EAST","56",196,225,421
"28729","MIGORI","KURIA EAST","57",135,151,286
"28730","MIGORI","KURIA EAST","58",124,120,244
"28731","MIGORI","KURIA EAST","59",136,187,323
"28732","MIGORI","KURIA EAST","55-59",737,904,1641
"28733","MIGORI","KURIA EAST","60",244,317,561
"28734","MIGORI","KURIA EAST","61",153,168,321
"28735","MIGORI","KURIA EAST","62",97,105,202
"28736","MIGORI","KURIA EAST","63",110,120,230
"28737","MIGORI","KURIA EAST","64",67,85,152
"28738","MIGORI","KURIA EAST","60-64",671,795,1466
"28739","MIGORI","KURIA EAST","65",141,156,297
"28740","MIGORI","KURIA EAST","66",59,62,121
"28741","MIGORI","KURIA EAST","67",106,76,182
"28742","MIGORI","KURIA EAST","68",59,81,140
"28743","MIGORI","KURIA EAST","69",88,103,191
"28744","MIGORI","KURIA EAST","65-69",453,478,931
"28745","MIGORI","KURIA EAST","70",132,205,337
"28746","MIGORI","KURIA EAST","71",69,76,145
"28747","MIGORI","KURIA EAST","72",52,55,107
"28748","MIGORI","KURIA EAST","73",42,42,84
"28749","MIGORI","KURIA EAST","74",52,49,101
"28750","MIGORI","KURIA EAST","70-74",347,427,774
"28751","MIGORI","KURIA EAST","75",69,69,138
"28752","MIGORI","KURIA EAST","76",35,35,70
"28753","MIGORI","KURIA EAST","77",45,53,98
"28754","MIGORI","KURIA EAST","78",30,40,70
"28755","MIGORI","KURIA EAST","79",24,41,65
"28756","MIGORI","KURIA EAST","75-79",203,238,441
"28757","MIGORI","KURIA EAST","80",49,78,127
"28758","MIGORI","KURIA EAST","81",18,25,43
"28759","MIGORI","KURIA EAST","82",22,25,47
"28760","MIGORI","KURIA EAST","83",19,24,43
"28761","MIGORI","KURIA EAST","84",22,25,47
"28762","MIGORI","KURIA EAST","80-84",130,177,307
"28763","MIGORI","KURIA EAST","85",35,22,57
"28764","MIGORI","KURIA EAST","86",22,13,35
"28765","MIGORI","KURIA EAST","87",22,32,54
"28766","MIGORI","KURIA EAST","88",12,6,18
"28767","MIGORI","KURIA EAST","89",17,34,51
"28768","MIGORI","KURIA EAST","85-89",108,107,215
"28769","MIGORI","KURIA EAST","90",15,28,43
"28770","MIGORI","KURIA EAST","91",9,20,29
"28771","MIGORI","KURIA EAST","92",5,7,12
"28772","MIGORI","KURIA EAST","93",3,10,13
"28773","MIGORI","KURIA EAST","94",5,8,13
"28774","MIGORI","KURIA EAST","90-94",37,73,110
"28775","MIGORI","KURIA EAST","95",12,17,29
"28776","MIGORI","KURIA EAST","96",3,3,6
"28777","MIGORI","KURIA EAST","97",2,6,8
"28778","MIGORI","KURIA EAST","98",NA,2,2
"28779","MIGORI","KURIA EAST","99",4,12,16
"28780","MIGORI","KURIA EAST","95-99",21,40,61
"28781","MIGORI","KURIA EAST","100+",16,25,41
"28782","MIGORI","KURIA EAST","Not Stated",NA,2,2
"28783","MIGORI","KURIA WEST","Total",101090,107417,208507
"28784","MIGORI","KURIA WEST","0",2733,2775,5508
"28785","MIGORI","KURIA WEST","1",2825,3022,5847
"28786","MIGORI","KURIA WEST","2",3037,3230,6267
"28787","MIGORI","KURIA WEST","3",3333,3316,6649
"28788","MIGORI","KURIA WEST","4",3275,3314,6589
"28789","MIGORI","KURIA WEST","0 - 4",15203,15657,30860
"28790","MIGORI","KURIA WEST","5",3352,3385,6737
"28791","MIGORI","KURIA WEST","6",3386,3472,6858
"28792","MIGORI","KURIA WEST","7",3242,3123,6365
"28793","MIGORI","KURIA WEST","8",3187,3365,6552
"28794","MIGORI","KURIA WEST","9",3494,3514,7008
"28795","MIGORI","KURIA WEST","5-9",16661,16859,33520
"28796","MIGORI","KURIA WEST","10",3768,3929,7697
"28797","MIGORI","KURIA WEST","11",3001,3325,6326
"28798","MIGORI","KURIA WEST","12",3541,3487,7028
"28799","MIGORI","KURIA WEST","13",3297,3324,6621
"28800","MIGORI","KURIA WEST","14",3195,2974,6169
"28801","MIGORI","KURIA WEST","10 -14",16802,17039,33841
"28802","MIGORI","KURIA WEST","15",3062,2946,6008
"28803","MIGORI","KURIA WEST","16",2673,2602,5275
"28804","MIGORI","KURIA WEST","17",2517,2390,4907
"28805","MIGORI","KURIA WEST","18",2262,2268,4530
"28806","MIGORI","KURIA WEST","19",2340,2485,4825
"28807","MIGORI","KURIA WEST","15-19",12854,12691,25545
"28808","MIGORI","KURIA WEST","20",2266,2736,5002
"28809","MIGORI","KURIA WEST","21",1710,2085,3795
"28810","MIGORI","KURIA WEST","22",1659,2173,3832
"28811","MIGORI","KURIA WEST","23",1700,2034,3734
"28812","MIGORI","KURIA WEST","24",1600,1787,3387
"28813","MIGORI","KURIA WEST","20-24",8935,10815,19750
"28814","MIGORI","KURIA WEST","25",1997,2272,4269
"28815","MIGORI","KURIA WEST","26",1438,1645,3083
"28816","MIGORI","KURIA WEST","27",1339,1526,2865
"28817","MIGORI","KURIA WEST","28",1177,1475,2652
"28818","MIGORI","KURIA WEST","29",999,1190,2189
"28819","MIGORI","KURIA WEST","25-29",6950,8108,15058
"28820","MIGORI","KURIA WEST","30",1772,2048,3820
"28821","MIGORI","KURIA WEST","31",1045,1279,2324
"28822","MIGORI","KURIA WEST","32",1233,1520,2753
"28823","MIGORI","KURIA WEST","33",1070,1305,2375
"28824","MIGORI","KURIA WEST","34",983,1092,2075
"28825","MIGORI","KURIA WEST","30-34",6103,7244,13347
"28826","MIGORI","KURIA WEST","35",1456,1541,2997
"28827","MIGORI","KURIA WEST","36",839,779,1618
"28828","MIGORI","KURIA WEST","37",738,726,1464
"28829","MIGORI","KURIA WEST","38",631,628,1259
"28830","MIGORI","KURIA WEST","39",682,626,1308
"28831","MIGORI","KURIA WEST","35-39",4346,4300,8646
"28832","MIGORI","KURIA WEST","40",1159,1026,2185
"28833","MIGORI","KURIA WEST","41",738,706,1444
"28834","MIGORI","KURIA WEST","42",672,706,1378
"28835","MIGORI","KURIA WEST","43",623,631,1254
"28836","MIGORI","KURIA WEST","44",482,481,963
"28837","MIGORI","KURIA WEST","40-44",3674,3550,7224
"28838","MIGORI","KURIA WEST","45",974,979,1953
"28839","MIGORI","KURIA WEST","46",561,646,1207
"28840","MIGORI","KURIA WEST","47",567,641,1208
"28841","MIGORI","KURIA WEST","48",322,397,719
"28842","MIGORI","KURIA WEST","49",423,447,870
"28843","MIGORI","KURIA WEST","45-49",2847,3110,5957
"28844","MIGORI","KURIA WEST","50",648,701,1349
"28845","MIGORI","KURIA WEST","51",396,437,833
"28846","MIGORI","KURIA WEST","52",291,316,607
"28847","MIGORI","KURIA WEST","53",237,282,519
"28848","MIGORI","KURIA WEST","54",375,375,750
"28849","MIGORI","KURIA WEST","50-54",1947,2111,4058
"28850","MIGORI","KURIA WEST","55",392,382,774
"28851","MIGORI","KURIA WEST","56",364,361,725
"28852","MIGORI","KURIA WEST","57",343,396,739
"28853","MIGORI","KURIA WEST","58",276,305,581
"28854","MIGORI","KURIA WEST","59",213,306,519
"28855","MIGORI","KURIA WEST","55-59",1588,1750,3338
"28856","MIGORI","KURIA WEST","60",393,488,881
"28857","MIGORI","KURIA WEST","61",207,240,447
"28858","MIGORI","KURIA WEST","62",160,168,328
"28859","MIGORI","KURIA WEST","63",163,200,363
"28860","MIGORI","KURIA WEST","64",132,159,291
"28861","MIGORI","KURIA WEST","60-64",1055,1255,2310
"28862","MIGORI","KURIA WEST","65",201,315,516
"28863","MIGORI","KURIA WEST","66",136,134,270
"28864","MIGORI","KURIA WEST","67",143,226,369
"28865","MIGORI","KURIA WEST","68",113,150,263
"28866","MIGORI","KURIA WEST","69",149,207,356
"28867","MIGORI","KURIA WEST","65-69",742,1032,1774
"28868","MIGORI","KURIA WEST","70",238,317,555
"28869","MIGORI","KURIA WEST","71",103,114,217
"28870","MIGORI","KURIA WEST","72",101,116,217
"28871","MIGORI","KURIA WEST","73",66,104,170
"28872","MIGORI","KURIA WEST","74",100,114,214
"28873","MIGORI","KURIA WEST","70-74",608,765,1373
"28874","MIGORI","KURIA WEST","75",81,136,217
"28875","MIGORI","KURIA WEST","76",52,57,109
"28876","MIGORI","KURIA WEST","77",81,62,143
"28877","MIGORI","KURIA WEST","78",55,57,112
"28878","MIGORI","KURIA WEST","79",62,86,148
"28879","MIGORI","KURIA WEST","75-79",331,398,729
"28880","MIGORI","KURIA WEST","80",77,167,244
"28881","MIGORI","KURIA WEST","81",42,68,110
"28882","MIGORI","KURIA WEST","82",40,48,88
"28883","MIGORI","KURIA WEST","83",37,40,77
"28884","MIGORI","KURIA WEST","84",29,55,84
"28885","MIGORI","KURIA WEST","80-84",225,378,603
"28886","MIGORI","KURIA WEST","85",27,51,78
"28887","MIGORI","KURIA WEST","86",25,32,57
"28888","MIGORI","KURIA WEST","87",35,32,67
"28889","MIGORI","KURIA WEST","88",15,20,35
"28890","MIGORI","KURIA WEST","89",22,52,74
"28891","MIGORI","KURIA WEST","85-89",124,187,311
"28892","MIGORI","KURIA WEST","90",22,44,66
"28893","MIGORI","KURIA WEST","91",11,20,31
"28894","MIGORI","KURIA WEST","92",7,3,10
"28895","MIGORI","KURIA WEST","93",10,8,18
"28896","MIGORI","KURIA WEST","94",3,6,9
"28897","MIGORI","KURIA WEST","90-94",53,81,134
"28898","MIGORI","KURIA WEST","95",14,36,50
"28899","MIGORI","KURIA WEST","96",5,6,11
"28900","MIGORI","KURIA WEST","97",5,7,12
"28901","MIGORI","KURIA WEST","98",3,3,6
"28902","MIGORI","KURIA WEST","99",7,7,14
"28903","MIGORI","KURIA WEST","95-99",34,59,93
"28904","MIGORI","KURIA WEST","100+",6,26,32
"28905","MIGORI","KURIA WEST","Not Stated",2,2,4
"28906","MIGORI","NYATIKE","Total",83989,92164,176153
"28907","MIGORI","NYATIKE","0",2473,2588,5061
"28908","MIGORI","NYATIKE","1",2578,2488,5066
"28909","MIGORI","NYATIKE","2",2603,2599,5202
"28910","MIGORI","NYATIKE","3",2790,2885,5675
"28911","MIGORI","NYATIKE","4",2686,2745,5431
"28912","MIGORI","NYATIKE","0 - 4",13130,13305,26435
"28913","MIGORI","NYATIKE","5",2892,2782,5674
"28914","MIGORI","NYATIKE","6",2718,2785,5503
"28915","MIGORI","NYATIKE","7",2456,2648,5104
"28916","MIGORI","NYATIKE","8",2427,2463,4890
"28917","MIGORI","NYATIKE","9",2706,2697,5403
"28918","MIGORI","NYATIKE","5-9",13199,13375,26574
"28919","MIGORI","NYATIKE","10",2883,2913,5796
"28920","MIGORI","NYATIKE","11",2615,2682,5297
"28921","MIGORI","NYATIKE","12",3027,2989,6016
"28922","MIGORI","NYATIKE","13",2771,2759,5530
"28923","MIGORI","NYATIKE","14",2611,2466,5077
"28924","MIGORI","NYATIKE","10 -14",13907,13809,27716
"28925","MIGORI","NYATIKE","15",2491,2505,4996
"28926","MIGORI","NYATIKE","16",2145,2216,4361
"28927","MIGORI","NYATIKE","17",2032,2086,4118
"28928","MIGORI","NYATIKE","18",1606,1693,3299
"28929","MIGORI","NYATIKE","19",1880,2067,3947
"28930","MIGORI","NYATIKE","15-19",10154,10567,20721
"28931","MIGORI","NYATIKE","20",1681,2065,3746
"28932","MIGORI","NYATIKE","21",1375,1667,3042
"28933","MIGORI","NYATIKE","22",1243,1579,2822
"28934","MIGORI","NYATIKE","23",1447,1729,3176
"28935","MIGORI","NYATIKE","24",1249,1507,2756
"28936","MIGORI","NYATIKE","20-24",6995,8547,15542
"28937","MIGORI","NYATIKE","25",1492,1613,3105
"28938","MIGORI","NYATIKE","26",1154,1431,2585
"28939","MIGORI","NYATIKE","27",1179,1538,2717
"28940","MIGORI","NYATIKE","28",805,1049,1854
"28941","MIGORI","NYATIKE","29",866,1069,1935
"28942","MIGORI","NYATIKE","25-29",5496,6700,12196
"28943","MIGORI","NYATIKE","30",1300,1575,2875
"28944","MIGORI","NYATIKE","31",906,1170,2076
"28945","MIGORI","NYATIKE","32",1080,1383,2463
"28946","MIGORI","NYATIKE","33",995,1306,2301
"28947","MIGORI","NYATIKE","34",924,1078,2002
"28948","MIGORI","NYATIKE","30-34",5205,6512,11717
"28949","MIGORI","NYATIKE","35",1155,1242,2397
"28950","MIGORI","NYATIKE","36",829,817,1646
"28951","MIGORI","NYATIKE","37",835,757,1592
"28952","MIGORI","NYATIKE","38",487,445,932
"28953","MIGORI","NYATIKE","39",627,571,1198
"28954","MIGORI","NYATIKE","35-39",3933,3832,7765
"28955","MIGORI","NYATIKE","40",788,850,1638
"28956","MIGORI","NYATIKE","41",675,755,1430
"28957","MIGORI","NYATIKE","42",605,715,1320
"28958","MIGORI","NYATIKE","43",583,721,1304
"28959","MIGORI","NYATIKE","44",504,538,1042
"28960","MIGORI","NYATIKE","40-44",3155,3579,6734
"28961","MIGORI","NYATIKE","45",742,778,1520
"28962","MIGORI","NYATIKE","46",485,531,1016
"28963","MIGORI","NYATIKE","47",554,696,1250
"28964","MIGORI","NYATIKE","48",253,344,597
"28965","MIGORI","NYATIKE","49",347,422,769
"28966","MIGORI","NYATIKE","45-49",2381,2771,5152
"28967","MIGORI","NYATIKE","50",454,538,992
"28968","MIGORI","NYATIKE","51",380,417,797
"28969","MIGORI","NYATIKE","52",275,305,580
"28970","MIGORI","NYATIKE","53",224,230,454
"28971","MIGORI","NYATIKE","54",258,290,548
"28972","MIGORI","NYATIKE","50-54",1591,1780,3371
"28973","MIGORI","NYATIKE","55",268,359,627
"28974","MIGORI","NYATIKE","56",268,417,685
"28975","MIGORI","NYATIKE","57",336,532,868
"28976","MIGORI","NYATIKE","58",180,213,393
"28977","MIGORI","NYATIKE","59",227,292,519
"28978","MIGORI","NYATIKE","55-59",1279,1813,3092
"28979","MIGORI","NYATIKE","60",331,481,812
"28980","MIGORI","NYATIKE","61",298,376,674
"28981","MIGORI","NYATIKE","62",205,233,438
"28982","MIGORI","NYATIKE","63",221,219,440
"28983","MIGORI","NYATIKE","64",159,231,390
"28984","MIGORI","NYATIKE","60-64",1214,1540,2754
"28985","MIGORI","NYATIKE","65",215,329,544
"28986","MIGORI","NYATIKE","66",149,232,381
"28987","MIGORI","NYATIKE","67",249,416,665
"28988","MIGORI","NYATIKE","68",71,96,167
"28989","MIGORI","NYATIKE","69",160,266,426
"28990","MIGORI","NYATIKE","65-69",844,1339,2183
"28991","MIGORI","NYATIKE","70",184,386,570
"28992","MIGORI","NYATIKE","71",185,234,419
"28993","MIGORI","NYATIKE","72",125,161,286
"28994","MIGORI","NYATIKE","73",87,138,225
"28995","MIGORI","NYATIKE","74",99,188,287
"28996","MIGORI","NYATIKE","70-74",680,1107,1787
"28997","MIGORI","NYATIKE","75",58,140,198
"28998","MIGORI","NYATIKE","76",62,108,170
"28999","MIGORI","NYATIKE","77",109,199,308
"29000","MIGORI","NYATIKE","78",47,61,108
"29001","MIGORI","NYATIKE","79",64,163,227
"29002","MIGORI","NYATIKE","75-79",340,671,1011
"29003","MIGORI","NYATIKE","80",58,154,212
"29004","MIGORI","NYATIKE","81",66,103,169
"29005","MIGORI","NYATIKE","82",63,70,133
"29006","MIGORI","NYATIKE","83",46,68,114
"29007","MIGORI","NYATIKE","84",44,90,134
"29008","MIGORI","NYATIKE","80-84",277,485,762
"29009","MIGORI","NYATIKE","85",39,76,115
"29010","MIGORI","NYATIKE","86",26,34,60
"29011","MIGORI","NYATIKE","87",38,68,106
"29012","MIGORI","NYATIKE","88",11,32,43
"29013","MIGORI","NYATIKE","89",27,67,94
"29014","MIGORI","NYATIKE","85-89",141,277,418
"29015","MIGORI","NYATIKE","90",17,39,56
"29016","MIGORI","NYATIKE","91",12,13,25
"29017","MIGORI","NYATIKE","92",7,13,20
"29018","MIGORI","NYATIKE","93",6,10,16
"29019","MIGORI","NYATIKE","94",5,16,21
"29020","MIGORI","NYATIKE","90-94",47,91,138
"29021","MIGORI","NYATIKE","95",4,7,11
"29022","MIGORI","NYATIKE","96",6,12,18
"29023","MIGORI","NYATIKE","97",3,7,10
"29024","MIGORI","NYATIKE","98",NA,4,4
"29025","MIGORI","NYATIKE","99",2,13,15
"29026","MIGORI","NYATIKE","95-99",15,43,58
"29027","MIGORI","NYATIKE","100+",6,20,26
"29028","MIGORI","NYATIKE","Not Stated",NA,1,1
"29029","MIGORI","RONGO","Total",59257,65329,124586
"29030","MIGORI","RONGO","0",1588,1536,3124
"29031","MIGORI","RONGO","1",1601,1653,3254
"29032","MIGORI","RONGO","2",1595,1655,3250
"29033","MIGORI","RONGO","3",1758,1713,3471
"29034","MIGORI","RONGO","4",1781,1829,3610
"29035","MIGORI","RONGO","0 - 4",8323,8386,16709
"29036","MIGORI","RONGO","5",1812,1808,3620
"29037","MIGORI","RONGO","6",1832,1793,3625
"29038","MIGORI","RONGO","7",1757,1752,3509
"29039","MIGORI","RONGO","8",1766,1774,3540
"29040","MIGORI","RONGO","9",1808,1932,3740
"29041","MIGORI","RONGO","5-9",8975,9059,18034
"29042","MIGORI","RONGO","10",2100,2037,4137
"29043","MIGORI","RONGO","11",1817,1856,3673
"29044","MIGORI","RONGO","12",2028,2056,4084
"29045","MIGORI","RONGO","13",2012,2141,4153
"29046","MIGORI","RONGO","14",1809,1848,3657
"29047","MIGORI","RONGO","10 -14",9766,9938,19704
"29048","MIGORI","RONGO","15",1745,1765,3510
"29049","MIGORI","RONGO","16",1521,1609,3130
"29050","MIGORI","RONGO","17",1556,1479,3035
"29051","MIGORI","RONGO","18",1271,1327,2598
"29052","MIGORI","RONGO","19",1522,1614,3136
"29053","MIGORI","RONGO","15-19",7615,7794,15409
"29054","MIGORI","RONGO","20",1267,1420,2687
"29055","MIGORI","RONGO","21",1089,1327,2416
"29056","MIGORI","RONGO","22",938,1268,2206
"29057","MIGORI","RONGO","23",1002,1388,2390
"29058","MIGORI","RONGO","24",951,1194,2145
"29059","MIGORI","RONGO","20-24",5247,6597,11844
"29060","MIGORI","RONGO","25",1067,1332,2399
"29061","MIGORI","RONGO","26",873,1081,1954
"29062","MIGORI","RONGO","27",961,1062,2023
"29063","MIGORI","RONGO","28",682,804,1486
"29064","MIGORI","RONGO","29",662,905,1567
"29065","MIGORI","RONGO","25-29",4245,5184,9429
"29066","MIGORI","RONGO","30",950,1443,2393
"29067","MIGORI","RONGO","31",704,943,1647
"29068","MIGORI","RONGO","32",798,1112,1910
"29069","MIGORI","RONGO","33",657,868,1525
"29070","MIGORI","RONGO","34",640,764,1404
"29071","MIGORI","RONGO","30-34",3749,5130,8879
"29072","MIGORI","RONGO","35",830,812,1642
"29073","MIGORI","RONGO","36",632,516,1148
"29074","MIGORI","RONGO","37",627,468,1095
"29075","MIGORI","RONGO","38",409,372,781
"29076","MIGORI","RONGO","39",486,408,894
"29077","MIGORI","RONGO","35-39",2984,2576,5560
"29078","MIGORI","RONGO","40",493,599,1092
"29079","MIGORI","RONGO","41",532,432,964
"29080","MIGORI","RONGO","42",420,432,852
"29081","MIGORI","RONGO","43",422,409,831
"29082","MIGORI","RONGO","44",291,350,641
"29083","MIGORI","RONGO","40-44",2158,2222,4380
"29084","MIGORI","RONGO","45",466,502,968
"29085","MIGORI","RONGO","46",309,368,677
"29086","MIGORI","RONGO","47",345,422,767
"29087","MIGORI","RONGO","48",211,259,470
"29088","MIGORI","RONGO","49",220,264,484
"29089","MIGORI","RONGO","45-49",1551,1815,3366
"29090","MIGORI","RONGO","50",332,450,782
"29091","MIGORI","RONGO","51",219,277,496
"29092","MIGORI","RONGO","52",187,289,476
"29093","MIGORI","RONGO","53",160,215,375
"29094","MIGORI","RONGO","54",183,224,407
"29095","MIGORI","RONGO","50-54",1081,1455,2536
"29096","MIGORI","RONGO","55",206,314,520
"29097","MIGORI","RONGO","56",239,310,549
"29098","MIGORI","RONGO","57",214,405,619
"29099","MIGORI","RONGO","58",131,191,322
"29100","MIGORI","RONGO","59",152,265,417
"29101","MIGORI","RONGO","55-59",942,1485,2427
"29102","MIGORI","RONGO","60",248,357,605
"29103","MIGORI","RONGO","61",179,284,463
"29104","MIGORI","RONGO","62",159,178,337
"29105","MIGORI","RONGO","63",169,202,371
"29106","MIGORI","RONGO","64",131,160,291
"29107","MIGORI","RONGO","60-64",886,1181,2067
"29108","MIGORI","RONGO","65",162,251,413
"29109","MIGORI","RONGO","66",139,144,283
"29110","MIGORI","RONGO","67",182,238,420
"29111","MIGORI","RONGO","68",76,95,171
"29112","MIGORI","RONGO","69",114,171,285
"29113","MIGORI","RONGO","65-69",673,899,1572
"29114","MIGORI","RONGO","70",155,266,421
"29115","MIGORI","RONGO","71",87,143,230
"29116","MIGORI","RONGO","72",84,94,178
"29117","MIGORI","RONGO","73",78,73,151
"29118","MIGORI","RONGO","74",72,101,173
"29119","MIGORI","RONGO","70-74",476,677,1153
"29120","MIGORI","RONGO","75",58,99,157
"29121","MIGORI","RONGO","76",53,75,128
"29122","MIGORI","RONGO","77",68,83,151
"29123","MIGORI","RONGO","78",28,53,81
"29124","MIGORI","RONGO","79",39,85,124
"29125","MIGORI","RONGO","75-79",246,395,641
"29126","MIGORI","RONGO","80",49,100,149
"29127","MIGORI","RONGO","81",37,54,91
"29128","MIGORI","RONGO","82",30,35,65
"29129","MIGORI","RONGO","83",35,52,87
"29130","MIGORI","RONGO","84",25,56,81
"29131","MIGORI","RONGO","80-84",176,297,473
"29132","MIGORI","RONGO","85",28,35,63
"29133","MIGORI","RONGO","86",16,22,38
"29134","MIGORI","RONGO","87",40,37,77
"29135","MIGORI","RONGO","88",10,18,28
"29136","MIGORI","RONGO","89",19,42,61
"29137","MIGORI","RONGO","85-89",113,154,267
"29138","MIGORI","RONGO","90",11,12,23
"29139","MIGORI","RONGO","91",10,15,25
"29140","MIGORI","RONGO","92",6,11,17
"29141","MIGORI","RONGO","93",2,4,6
"29142","MIGORI","RONGO","94",3,4,7
"29143","MIGORI","RONGO","90-94",32,46,78
"29144","MIGORI","RONGO","95",7,6,13
"29145","MIGORI","RONGO","96",3,5,8
"29146","MIGORI","RONGO","97",NA,5,5
"29147","MIGORI","RONGO","98",2,4,6
"29148","MIGORI","RONGO","99",2,6,8
"29149","MIGORI","RONGO","95-99",14,26,40
"29150","MIGORI","RONGO","100+",5,12,17
"29151","MIGORI","RONGO","Not Stated",NA,1,1
"29152","MIGORI","SUNA EAST","Total",58977,63694,122671
"29153","MIGORI","SUNA EAST","0",1327,1343,2670
"29154","MIGORI","SUNA EAST","1",1795,1886,3681
"29155","MIGORI","SUNA EAST","2",1647,1640,3287
"29156","MIGORI","SUNA EAST","3",1827,1833,3660
"29157","MIGORI","SUNA EAST","4",1827,1808,3635
"29158","MIGORI","SUNA EAST","0 - 4",8423,8510,16933
"29159","MIGORI","SUNA EAST","5",1806,1885,3691
"29160","MIGORI","SUNA EAST","6",1834,1934,3768
"29161","MIGORI","SUNA EAST","7",1722,1732,3454
"29162","MIGORI","SUNA EAST","8",1746,1752,3498
"29163","MIGORI","SUNA EAST","9",1885,1845,3730
"29164","MIGORI","SUNA EAST","5-9",8993,9148,18141
"29165","MIGORI","SUNA EAST","10",1924,2030,3954
"29166","MIGORI","SUNA EAST","11",1742,1929,3671
"29167","MIGORI","SUNA EAST","12",2030,1992,4022
"29168","MIGORI","SUNA EAST","13",1853,1959,3812
"29169","MIGORI","SUNA EAST","14",1762,1792,3554
"29170","MIGORI","SUNA EAST","10 -14",9311,9702,19013
"29171","MIGORI","SUNA EAST","15",1787,1801,3588
"29172","MIGORI","SUNA EAST","16",1510,1548,3058
"29173","MIGORI","SUNA EAST","17",1447,1529,2976
"29174","MIGORI","SUNA EAST","18",1215,1164,2379
"29175","MIGORI","SUNA EAST","19",1334,1474,2808
"29176","MIGORI","SUNA EAST","15-19",7293,7516,14809
"29177","MIGORI","SUNA EAST","20",1086,1411,2497
"29178","MIGORI","SUNA EAST","21",955,1295,2250
"29179","MIGORI","SUNA EAST","22",930,1177,2107
"29180","MIGORI","SUNA EAST","23",998,1275,2273
"29181","MIGORI","SUNA EAST","24",911,1127,2038
"29182","MIGORI","SUNA EAST","20-24",4880,6285,11165
"29183","MIGORI","SUNA EAST","25",1113,1257,2370
"29184","MIGORI","SUNA EAST","26",826,1116,1942
"29185","MIGORI","SUNA EAST","27",945,1102,2047
"29186","MIGORI","SUNA EAST","28",692,804,1496
"29187","MIGORI","SUNA EAST","29",645,794,1439
"29188","MIGORI","SUNA EAST","25-29",4221,5073,9294
"29189","MIGORI","SUNA EAST","30",979,1157,2136
"29190","MIGORI","SUNA EAST","31",644,805,1449
"29191","MIGORI","SUNA EAST","32",836,958,1794
"29192","MIGORI","SUNA EAST","33",677,783,1460
"29193","MIGORI","SUNA EAST","34",665,699,1364
"29194","MIGORI","SUNA EAST","30-34",3801,4402,8203
"29195","MIGORI","SUNA EAST","35",812,802,1614
"29196","MIGORI","SUNA EAST","36",564,473,1037
"29197","MIGORI","SUNA EAST","37",552,483,1035
"29198","MIGORI","SUNA EAST","38",403,337,740
"29199","MIGORI","SUNA EAST","39",482,375,857
"29200","MIGORI","SUNA EAST","35-39",2813,2470,5283
"29201","MIGORI","SUNA EAST","40",541,548,1089
"29202","MIGORI","SUNA EAST","41",558,570,1128
"29203","MIGORI","SUNA EAST","42",502,477,979
"29204","MIGORI","SUNA EAST","43",423,396,819
"29205","MIGORI","SUNA EAST","44",303,282,585
"29206","MIGORI","SUNA EAST","40-44",2327,2273,4600
"29207","MIGORI","SUNA EAST","45",477,438,915
"29208","MIGORI","SUNA EAST","46",385,380,765
"29209","MIGORI","SUNA EAST","47",429,492,921
"29210","MIGORI","SUNA EAST","48",219,226,445
"29211","MIGORI","SUNA EAST","49",264,290,554
"29212","MIGORI","SUNA EAST","45-49",1774,1826,3600
"29213","MIGORI","SUNA EAST","50",324,372,696
"29214","MIGORI","SUNA EAST","51",250,312,562
"29215","MIGORI","SUNA EAST","52",220,271,491
"29216","MIGORI","SUNA EAST","53",181,199,380
"29217","MIGORI","SUNA EAST","54",223,228,451
"29218","MIGORI","SUNA EAST","50-54",1198,1382,2580
"29219","MIGORI","SUNA EAST","55",259,292,551
"29220","MIGORI","SUNA EAST","56",272,328,600
"29221","MIGORI","SUNA EAST","57",218,368,586
"29222","MIGORI","SUNA EAST","58",166,165,331
"29223","MIGORI","SUNA EAST","59",203,253,456
"29224","MIGORI","SUNA EAST","55-59",1118,1406,2524
"29225","MIGORI","SUNA EAST","60",257,353,610
"29226","MIGORI","SUNA EAST","61",235,265,500
"29227","MIGORI","SUNA EAST","62",160,169,329
"29228","MIGORI","SUNA EAST","63",194,226,420
"29229","MIGORI","SUNA EAST","64",131,200,331
"29230","MIGORI","SUNA EAST","60-64",977,1213,2190
"29231","MIGORI","SUNA EAST","65",188,249,437
"29232","MIGORI","SUNA EAST","66",115,173,288
"29233","MIGORI","SUNA EAST","67",194,262,456
"29234","MIGORI","SUNA EAST","68",84,94,178
"29235","MIGORI","SUNA EAST","69",139,190,329
"29236","MIGORI","SUNA EAST","65-69",720,968,1688
"29237","MIGORI","SUNA EAST","70",164,228,392
"29238","MIGORI","SUNA EAST","71",111,126,237
"29239","MIGORI","SUNA EAST","72",89,112,201
"29240","MIGORI","SUNA EAST","73",79,84,163
"29241","MIGORI","SUNA EAST","74",74,92,166
"29242","MIGORI","SUNA EAST","70-74",517,642,1159
"29243","MIGORI","SUNA EAST","75",74,92,166
"29244","MIGORI","SUNA EAST","76",53,71,124
"29245","MIGORI","SUNA EAST","77",61,99,160
"29246","MIGORI","SUNA EAST","78",35,36,71
"29247","MIGORI","SUNA EAST","79",47,83,130
"29248","MIGORI","SUNA EAST","75-79",270,381,651
"29249","MIGORI","SUNA EAST","80",56,101,157
"29250","MIGORI","SUNA EAST","81",39,38,77
"29251","MIGORI","SUNA EAST","82",42,34,76
"29252","MIGORI","SUNA EAST","83",29,35,64
"29253","MIGORI","SUNA EAST","84",23,40,63
"29254","MIGORI","SUNA EAST","80-84",189,248,437
"29255","MIGORI","SUNA EAST","85",23,46,69
"29256","MIGORI","SUNA EAST","86",20,26,46
"29257","MIGORI","SUNA EAST","87",32,44,76
"29258","MIGORI","SUNA EAST","88",8,19,27
"29259","MIGORI","SUNA EAST","89",14,35,49
"29260","MIGORI","SUNA EAST","85-89",97,170,267
"29261","MIGORI","SUNA EAST","90",5,13,18
"29262","MIGORI","SUNA EAST","91",11,12,23
"29263","MIGORI","SUNA EAST","92",7,6,13
"29264","MIGORI","SUNA EAST","93",3,10,13
"29265","MIGORI","SUNA EAST","94",3,8,11
"29266","MIGORI","SUNA EAST","90-94",29,49,78
"29267","MIGORI","SUNA EAST","95",5,8,13
"29268","MIGORI","SUNA EAST","96",3,3,6
"29269","MIGORI","SUNA EAST","97",2,3,5
"29270","MIGORI","SUNA EAST","98",2,2,4
"29271","MIGORI","SUNA EAST","99",2,3,5
"29272","MIGORI","SUNA EAST","95-99",14,19,33
"29273","MIGORI","SUNA EAST","100+",12,10,22
"29274","MIGORI","SUNA EAST","Not Stated",NA,1,1
"29275","MIGORI","SUNA WEST","Total",61430,67459,128889
"29276","MIGORI","SUNA WEST","0",1905,1872,3777
"29277","MIGORI","SUNA WEST","1",1860,1885,3745
"29278","MIGORI","SUNA WEST","2",1958,1966,3924
"29279","MIGORI","SUNA WEST","3",2030,2057,4087
"29280","MIGORI","SUNA WEST","4",1992,2002,3994
"29281","MIGORI","SUNA WEST","0 - 4",9745,9782,19527
"29282","MIGORI","SUNA WEST","5",2024,2026,4050
"29283","MIGORI","SUNA WEST","6",1973,2050,4023
"29284","MIGORI","SUNA WEST","7",1792,1824,3616
"29285","MIGORI","SUNA WEST","8",1760,1813,3573
"29286","MIGORI","SUNA WEST","9",1903,1926,3829
"29287","MIGORI","SUNA WEST","5-9",9452,9639,19091
"29288","MIGORI","SUNA WEST","10",2127,2159,4286
"29289","MIGORI","SUNA WEST","11",1855,1873,3728
"29290","MIGORI","SUNA WEST","12",2203,2178,4381
"29291","MIGORI","SUNA WEST","13",1991,2024,4015
"29292","MIGORI","SUNA WEST","14",1687,1790,3477
"29293","MIGORI","SUNA WEST","10 -14",9863,10024,19887
"29294","MIGORI","SUNA WEST","15",1739,1841,3580
"29295","MIGORI","SUNA WEST","16",1441,1660,3101
"29296","MIGORI","SUNA WEST","17",1445,1592,3037
"29297","MIGORI","SUNA WEST","18",1155,1295,2450
"29298","MIGORI","SUNA WEST","19",1326,1501,2827
"29299","MIGORI","SUNA WEST","15-19",7106,7889,14995
"29300","MIGORI","SUNA WEST","20",1224,1619,2843
"29301","MIGORI","SUNA WEST","21",991,1419,2410
"29302","MIGORI","SUNA WEST","22",981,1413,2394
"29303","MIGORI","SUNA WEST","23",1074,1412,2486
"29304","MIGORI","SUNA WEST","24",1068,1326,2394
"29305","MIGORI","SUNA WEST","20-24",5338,7189,12527
"29306","MIGORI","SUNA WEST","25",1204,1455,2659
"29307","MIGORI","SUNA WEST","26",917,1173,2090
"29308","MIGORI","SUNA WEST","27",1062,1258,2320
"29309","MIGORI","SUNA WEST","28",738,901,1639
"29310","MIGORI","SUNA WEST","29",726,872,1598
"29311","MIGORI","SUNA WEST","25-29",4647,5659,10306
"29312","MIGORI","SUNA WEST","30",1013,1260,2273
"29313","MIGORI","SUNA WEST","31",699,773,1472
"29314","MIGORI","SUNA WEST","32",870,937,1807
"29315","MIGORI","SUNA WEST","33",752,892,1644
"29316","MIGORI","SUNA WEST","34",682,713,1395
"29317","MIGORI","SUNA WEST","30-34",4016,4575,8591
"29318","MIGORI","SUNA WEST","35",818,798,1616
"29319","MIGORI","SUNA WEST","36",518,505,1023
"29320","MIGORI","SUNA WEST","37",650,546,1196
"29321","MIGORI","SUNA WEST","38",351,359,710
"29322","MIGORI","SUNA WEST","39",440,445,885
"29323","MIGORI","SUNA WEST","35-39",2777,2653,5430
"29324","MIGORI","SUNA WEST","40",606,599,1205
"29325","MIGORI","SUNA WEST","41",501,487,988
"29326","MIGORI","SUNA WEST","42",533,532,1065
"29327","MIGORI","SUNA WEST","43",462,421,883
"29328","MIGORI","SUNA WEST","44",316,319,635
"29329","MIGORI","SUNA WEST","40-44",2418,2358,4776
"29330","MIGORI","SUNA WEST","45",488,455,943
"29331","MIGORI","SUNA WEST","46",337,356,693
"29332","MIGORI","SUNA WEST","47",384,436,820
"29333","MIGORI","SUNA WEST","48",205,223,428
"29334","MIGORI","SUNA WEST","49",295,301,596
"29335","MIGORI","SUNA WEST","45-49",1709,1771,3480
"29336","MIGORI","SUNA WEST","50",282,379,661
"29337","MIGORI","SUNA WEST","51",248,319,567
"29338","MIGORI","SUNA WEST","52",183,223,406
"29339","MIGORI","SUNA WEST","53",206,188,394
"29340","MIGORI","SUNA WEST","54",210,227,437
"29341","MIGORI","SUNA WEST","50-54",1129,1336,2465
"29342","MIGORI","SUNA WEST","55",250,280,530
"29343","MIGORI","SUNA WEST","56",230,285,515
"29344","MIGORI","SUNA WEST","57",216,364,580
"29345","MIGORI","SUNA WEST","58",128,180,308
"29346","MIGORI","SUNA WEST","59",158,216,374
"29347","MIGORI","SUNA WEST","55-59",982,1325,2307
"29348","MIGORI","SUNA WEST","60",219,283,502
"29349","MIGORI","SUNA WEST","61",182,238,420
"29350","MIGORI","SUNA WEST","62",133,157,290
"29351","MIGORI","SUNA WEST","63",125,171,296
"29352","MIGORI","SUNA WEST","64",98,157,255
"29353","MIGORI","SUNA WEST","60-64",757,1006,1763
"29354","MIGORI","SUNA WEST","65",125,199,324
"29355","MIGORI","SUNA WEST","66",106,124,230
"29356","MIGORI","SUNA WEST","67",152,237,389
"29357","MIGORI","SUNA WEST","68",72,77,149
"29358","MIGORI","SUNA WEST","69",83,148,231
"29359","MIGORI","SUNA WEST","65-69",538,785,1323
"29360","MIGORI","SUNA WEST","70",126,190,316
"29361","MIGORI","SUNA WEST","71",91,129,220
"29362","MIGORI","SUNA WEST","72",94,81,175
"29363","MIGORI","SUNA WEST","73",54,78,132
"29364","MIGORI","SUNA WEST","74",59,105,164
"29365","MIGORI","SUNA WEST","70-74",424,583,1007
"29366","MIGORI","SUNA WEST","75",55,66,121
"29367","MIGORI","SUNA WEST","76",42,65,107
"29368","MIGORI","SUNA WEST","77",79,118,197
"29369","MIGORI","SUNA WEST","78",18,35,53
"29370","MIGORI","SUNA WEST","79",46,93,139
"29371","MIGORI","SUNA WEST","75-79",240,377,617
"29372","MIGORI","SUNA WEST","80",41,106,147
"29373","MIGORI","SUNA WEST","81",29,59,88
"29374","MIGORI","SUNA WEST","82",31,42,73
"29375","MIGORI","SUNA WEST","83",29,31,60
"29376","MIGORI","SUNA WEST","84",31,38,69
"29377","MIGORI","SUNA WEST","80-84",161,276,437
"29378","MIGORI","SUNA WEST","85",9,22,31
"29379","MIGORI","SUNA WEST","86",11,21,32
"29380","MIGORI","SUNA WEST","87",29,42,71
"29381","MIGORI","SUNA WEST","88",10,17,27
"29382","MIGORI","SUNA WEST","89",21,52,73
"29383","MIGORI","SUNA WEST","85-89",80,154,234
"29384","MIGORI","SUNA WEST","90",7,17,24
"29385","MIGORI","SUNA WEST","91",5,9,14
"29386","MIGORI","SUNA WEST","92",8,2,10
"29387","MIGORI","SUNA WEST","93",7,7,14
"29388","MIGORI","SUNA WEST","94",6,10,16
"29389","MIGORI","SUNA WEST","90-94",33,45,78
"29390","MIGORI","SUNA WEST","95",2,9,11
"29391","MIGORI","SUNA WEST","96",3,4,7
"29392","MIGORI","SUNA WEST","97",2,3,5
"29393","MIGORI","SUNA WEST","98",1,4,5
"29394","MIGORI","SUNA WEST","99",NA,1,1
"29395","MIGORI","SUNA WEST","95-99",8,21,29
"29396","MIGORI","SUNA WEST","100+",6,12,18
"29397","MIGORI","SUNA WEST","Not Stated",1,NA,1
"29398","MIGORI","URIRI","Total",68127,73318,141445
"29399","MIGORI","URIRI","0",1925,1952,3877
"29400","MIGORI","URIRI","1",1952,1832,3784
"29401","MIGORI","URIRI","2",1895,2018,3913
"29402","MIGORI","URIRI","3",2028,2170,4198
"29403","MIGORI","URIRI","4",2102,2170,4272
"29404","MIGORI","URIRI","0 - 4",9902,10142,20044
"29405","MIGORI","URIRI","5",2302,2334,4636
"29406","MIGORI","URIRI","6",2357,2292,4649
"29407","MIGORI","URIRI","7",2233,2102,4335
"29408","MIGORI","URIRI","8",2106,2203,4309
"29409","MIGORI","URIRI","9",2284,2262,4546
"29410","MIGORI","URIRI","5-9",11282,11193,22475
"29411","MIGORI","URIRI","10",2514,2484,4998
"29412","MIGORI","URIRI","11",2200,2309,4509
"29413","MIGORI","URIRI","12",2618,2404,5022
"29414","MIGORI","URIRI","13",2414,2417,4831
"29415","MIGORI","URIRI","14",2094,2097,4191
"29416","MIGORI","URIRI","10 -14",11840,11711,23551
"29417","MIGORI","URIRI","15",2116,2033,4149
"29418","MIGORI","URIRI","16",1810,1793,3603
"29419","MIGORI","URIRI","17",1773,1640,3413
"29420","MIGORI","URIRI","18",1367,1316,2683
"29421","MIGORI","URIRI","19",1564,1641,3205
"29422","MIGORI","URIRI","15-19",8630,8423,17053
"29423","MIGORI","URIRI","20",1276,1550,2826
"29424","MIGORI","URIRI","21",1125,1317,2442
"29425","MIGORI","URIRI","22",989,1177,2166
"29426","MIGORI","URIRI","23",994,1216,2210
"29427","MIGORI","URIRI","24",881,994,1875
"29428","MIGORI","URIRI","20-24",5265,6254,11519
"29429","MIGORI","URIRI","25",1067,1246,2313
"29430","MIGORI","URIRI","26",748,1085,1833
"29431","MIGORI","URIRI","27",951,1125,2076
"29432","MIGORI","URIRI","28",544,799,1343
"29433","MIGORI","URIRI","29",635,859,1494
"29434","MIGORI","URIRI","25-29",3945,5114,9059
"29435","MIGORI","URIRI","30",868,1220,2088
"29436","MIGORI","URIRI","31",683,931,1614
"29437","MIGORI","URIRI","32",781,1048,1829
"29438","MIGORI","URIRI","33",730,933,1663
"29439","MIGORI","URIRI","34",686,755,1441
"29440","MIGORI","URIRI","30-34",3748,4887,8635
"29441","MIGORI","URIRI","35",905,845,1750
"29442","MIGORI","URIRI","36",652,575,1227
"29443","MIGORI","URIRI","37",593,601,1194
"29444","MIGORI","URIRI","38",407,364,771
"29445","MIGORI","URIRI","39",511,393,904
"29446","MIGORI","URIRI","35-39",3068,2778,5846
"29447","MIGORI","URIRI","40",628,590,1218
"29448","MIGORI","URIRI","41",590,604,1194
"29449","MIGORI","URIRI","42",562,599,1161
"29450","MIGORI","URIRI","43",463,529,992
"29451","MIGORI","URIRI","44",362,420,782
"29452","MIGORI","URIRI","40-44",2605,2742,5347
"29453","MIGORI","URIRI","45",485,526,1011
"29454","MIGORI","URIRI","46",413,478,891
"29455","MIGORI","URIRI","47",512,541,1053
"29456","MIGORI","URIRI","48",258,276,534
"29457","MIGORI","URIRI","49",282,345,627
"29458","MIGORI","URIRI","45-49",1950,2166,4116
"29459","MIGORI","URIRI","50",361,477,838
"29460","MIGORI","URIRI","51",270,356,626
"29461","MIGORI","URIRI","52",226,317,543
"29462","MIGORI","URIRI","53",217,257,474
"29463","MIGORI","URIRI","54",218,277,495
"29464","MIGORI","URIRI","50-54",1292,1684,2976
"29465","MIGORI","URIRI","55",252,299,551
"29466","MIGORI","URIRI","56",256,338,594
"29467","MIGORI","URIRI","57",271,469,740
"29468","MIGORI","URIRI","58",181,237,418
"29469","MIGORI","URIRI","59",228,298,526
"29470","MIGORI","URIRI","55-59",1188,1641,2829
"29471","MIGORI","URIRI","60",266,388,654
"29472","MIGORI","URIRI","61",282,333,615
"29473","MIGORI","URIRI","62",182,256,438
"29474","MIGORI","URIRI","63",238,249,487
"29475","MIGORI","URIRI","64",165,203,368
"29476","MIGORI","URIRI","60-64",1133,1429,2562
"29477","MIGORI","URIRI","65",191,296,487
"29478","MIGORI","URIRI","66",177,208,385
"29479","MIGORI","URIRI","67",245,349,594
"29480","MIGORI","URIRI","68",91,111,202
"29481","MIGORI","URIRI","69",153,213,366
"29482","MIGORI","URIRI","65-69",857,1177,2034
"29483","MIGORI","URIRI","70",187,295,482
"29484","MIGORI","URIRI","71",151,179,330
"29485","MIGORI","URIRI","72",110,127,237
"29486","MIGORI","URIRI","73",101,100,201
"29487","MIGORI","URIRI","74",91,121,212
"29488","MIGORI","URIRI","70-74",640,822,1462
"29489","MIGORI","URIRI","75",81,105,186
"29490","MIGORI","URIRI","76",85,124,209
"29491","MIGORI","URIRI","77",85,121,206
"29492","MIGORI","URIRI","78",38,53,91
"29493","MIGORI","URIRI","79",58,128,186
"29494","MIGORI","URIRI","75-79",347,531,878
"29495","MIGORI","URIRI","80",52,94,146
"29496","MIGORI","URIRI","81",57,66,123
"29497","MIGORI","URIRI","82",44,51,95
"29498","MIGORI","URIRI","83",44,62,106
"29499","MIGORI","URIRI","84",31,43,74
"29500","MIGORI","URIRI","80-84",228,316,544
"29501","MIGORI","URIRI","85",27,46,73
"29502","MIGORI","URIRI","86",28,29,57
"29503","MIGORI","URIRI","87",39,60,99
"29504","MIGORI","URIRI","88",16,23,39
"29505","MIGORI","URIRI","89",24,59,83
"29506","MIGORI","URIRI","85-89",134,217,351
"29507","MIGORI","URIRI","90",17,20,37
"29508","MIGORI","URIRI","91",11,14,25
"29509","MIGORI","URIRI","92",6,6,12
"29510","MIGORI","URIRI","93",5,5,10
"29511","MIGORI","URIRI","94",3,8,11
"29512","MIGORI","URIRI","90-94",42,53,95
"29513","MIGORI","URIRI","95",6,9,15
"29514","MIGORI","URIRI","96",5,2,7
"29515","MIGORI","URIRI","97",3,6,9
"29516","MIGORI","URIRI","98",2,5,7
"29517","MIGORI","URIRI","99",5,4,9
"29518","MIGORI","URIRI","95-99",21,26,47
"29519","MIGORI","URIRI","100+",10,10,20
"29520","MIGORI","URIRI","Not Stated",NA,2,2
"29521","MOMBASA","ALL","Total",610257,598046,1208303
"29522","MOMBASA","ALL","0",15111,15009,30120
"29523","MOMBASA","ALL","1",15805,15308,31113
"29524","MOMBASA","ALL","2",15088,14837,29925
"29525","MOMBASA","ALL","3",14660,14031,28691
"29526","MOMBASA","ALL","4",14061,13993,28054
"29527","MOMBASA","ALL","0 - 4",74725,73178,147903
"29528","MOMBASA","ALL","5",13851,14023,27874
"29529","MOMBASA","ALL","6",12889,13216,26105
"29530","MOMBASA","ALL","7",13268,13203,26471
"29531","MOMBASA","ALL","8",11996,12423,24419
"29532","MOMBASA","ALL","9",12523,12594,25117
"29533","MOMBASA","ALL","5-9",64527,65459,129986
"29534","MOMBASA","ALL","10",12349,12343,24692
"29535","MOMBASA","ALL","11",11115,11497,22612
"29536","MOMBASA","ALL","12",11661,11630,23291
"29537","MOMBASA","ALL","13",11631,12081,23712
"29538","MOMBASA","ALL","14",10388,10729,21117
"29539","MOMBASA","ALL","10 -14",57144,58280,115424
"29540","MOMBASA","ALL","15",9199,9724,18923
"29541","MOMBASA","ALL","16",8922,9863,18785
"29542","MOMBASA","ALL","17",9863,10487,20350
"29543","MOMBASA","ALL","18",8964,10217,19181
"29544","MOMBASA","ALL","19",10596,12898,23494
"29545","MOMBASA","ALL","15-19",47544,53189,100733
"29546","MOMBASA","ALL","20",11186,14416,25602
"29547","MOMBASA","ALL","21",11527,13706,25233
"29548","MOMBASA","ALL","22",12833,15192,28025
"29549","MOMBASA","ALL","23",14195,16513,30708
"29550","MOMBASA","ALL","24",14081,16084,30165
"29551","MOMBASA","ALL","20-24",63822,75911,139733
"29552","MOMBASA","ALL","25",16231,16675,32906
"29553","MOMBASA","ALL","26",14231,15107,29338
"29554","MOMBASA","ALL","27",14111,14768,28879
"29555","MOMBASA","ALL","28",12333,13049,25382
"29556","MOMBASA","ALL","29",12921,13202,26123
"29557","MOMBASA","ALL","25-29",69827,72801,142628
"29558","MOMBASA","ALL","30",15982,16319,32301
"29559","MOMBASA","ALL","31",10866,10548,21414
"29560","MOMBASA","ALL","32",13578,13379,26957
"29561","MOMBASA","ALL","33",10592,10562,21154
"29562","MOMBASA","ALL","34",10335,10056,20391
"29563","MOMBASA","ALL","30-34",61353,60864,122217
"29564","MOMBASA","ALL","35",12644,11396,24040
"29565","MOMBASA","ALL","36",9495,8491,17986
"29566","MOMBASA","ALL","37",9167,8165,17332
"29567","MOMBASA","ALL","38",7666,6978,14644
"29568","MOMBASA","ALL","39",8106,7005,15111
"29569","MOMBASA","ALL","35-39",47078,42035,89113
"29570","MOMBASA","ALL","40",10190,8555,18745
"29571","MOMBASA","ALL","41",8490,6541,15031
"29572","MOMBASA","ALL","42",8405,6505,14910
"29573","MOMBASA","ALL","43",6979,5521,12500
"29574","MOMBASA","ALL","44",6034,4598,10632
"29575","MOMBASA","ALL","40-44",40098,31720,71818
"29576","MOMBASA","ALL","45",8759,6234,14993
"29577","MOMBASA","ALL","46",5852,4342,10194
"29578","MOMBASA","ALL","47",6402,4282,10684
"29579","MOMBASA","ALL","48",4607,3406,8013
"29580","MOMBASA","ALL","49",5045,3338,8383
"29581","MOMBASA","ALL","45-49",30665,21602,52267
"29582","MOMBASA","ALL","50",6027,4430,10457
"29583","MOMBASA","ALL","51",4139,2577,6716
"29584","MOMBASA","ALL","52",3674,2567,6241
"29585","MOMBASA","ALL","53",2788,1911,4699
"29586","MOMBASA","ALL","54",3227,2117,5344
"29587","MOMBASA","ALL","50-54",19855,13602,33457
"29588","MOMBASA","ALL","55",3158,2059,5217
"29589","MOMBASA","ALL","56",3259,2366,5625
"29590","MOMBASA","ALL","57",2881,2099,4980
"29591","MOMBASA","ALL","58",2170,1769,3939
"29592","MOMBASA","ALL","59",2403,1908,4311
"29593","MOMBASA","ALL","55-59",13871,10201,24072
"29594","MOMBASA","ALL","60",2538,2356,4894
"29595","MOMBASA","ALL","61",1794,1444,3238
"29596","MOMBASA","ALL","62",1617,1274,2891
"29597","MOMBASA","ALL","63",1462,1273,2735
"29598","MOMBASA","ALL","64",1238,1038,2276
"29599","MOMBASA","ALL","60-64",8649,7385,16034
"29600","MOMBASA","ALL","65",1555,1434,2989
"29601","MOMBASA","ALL","66",1007,856,1863
"29602","MOMBASA","ALL","67",1229,994,2223
"29603","MOMBASA","ALL","68",721,682,1403
"29604","MOMBASA","ALL","69",879,886,1765
"29605","MOMBASA","ALL","65-69",5391,4852,10243
"29606","MOMBASA","ALL","70",1027,1265,2292
"29607","MOMBASA","ALL","71",624,618,1242
"29608","MOMBASA","ALL","72",574,518,1092
"29609","MOMBASA","ALL","73",464,446,910
"29610","MOMBASA","ALL","74",387,472,859
"29611","MOMBASA","ALL","70-74",3076,3319,6395
"29612","MOMBASA","ALL","75",430,500,930
"29613","MOMBASA","ALL","76",280,315,595
"29614","MOMBASA","ALL","77",263,263,526
"29615","MOMBASA","ALL","78",222,221,443
"29616","MOMBASA","ALL","79",241,310,551
"29617","MOMBASA","ALL","75-79",1436,1609,3045
"29618","MOMBASA","ALL","80",234,493,727
"29619","MOMBASA","ALL","81",130,178,308
"29620","MOMBASA","ALL","82",138,156,294
"29621","MOMBASA","ALL","83",128,144,272
"29622","MOMBASA","ALL","84",92,165,257
"29623","MOMBASA","ALL","80-84",722,1136,1858
"29624","MOMBASA","ALL","85",88,171,259
"29625","MOMBASA","ALL","86",65,82,147
"29626","MOMBASA","ALL","87",59,70,129
"29627","MOMBASA","ALL","88",30,57,87
"29628","MOMBASA","ALL","89",52,129,181
"29629","MOMBASA","ALL","85-89",294,509,803
"29630","MOMBASA","ALL","90",39,107,146
"29631","MOMBASA","ALL","91",17,38,55
"29632","MOMBASA","ALL","92",19,26,45
"29633","MOMBASA","ALL","93",12,24,36
"29634","MOMBASA","ALL","94",11,30,41
"29635","MOMBASA","ALL","90-94",98,225,323
"29636","MOMBASA","ALL","95",11,41,52
"29637","MOMBASA","ALL","96",13,17,30
"29638","MOMBASA","ALL","97",9,12,21
"29639","MOMBASA","ALL","98",8,7,15
"29640","MOMBASA","ALL","99",13,21,34
"29641","MOMBASA","ALL","95-99",54,98,152
"29642","MOMBASA","ALL","100+",14,59,73
"29643","MOMBASA","ALL","Not Stated",14,12,26
"29644","MOMBASA","CHANGAMWE","Total",68761,63121,131882
"29645","MOMBASA","CHANGAMWE","0",1584,1595,3179
"29646","MOMBASA","CHANGAMWE","1",1510,1447,2957
"29647","MOMBASA","CHANGAMWE","2",1557,1539,3096
"29648","MOMBASA","CHANGAMWE","3",1482,1416,2898
"29649","MOMBASA","CHANGAMWE","4",1355,1290,2645
"29650","MOMBASA","CHANGAMWE","0 - 4",7488,7287,14775
"29651","MOMBASA","CHANGAMWE","5",1369,1419,2788
"29652","MOMBASA","CHANGAMWE","6",1363,1390,2753
"29653","MOMBASA","CHANGAMWE","7",1341,1342,2683
"29654","MOMBASA","CHANGAMWE","8",1240,1202,2442
"29655","MOMBASA","CHANGAMWE","9",1288,1364,2652
"29656","MOMBASA","CHANGAMWE","5-9",6601,6717,13318
"29657","MOMBASA","CHANGAMWE","10",1265,1265,2530
"29658","MOMBASA","CHANGAMWE","11",1155,1227,2382
"29659","MOMBASA","CHANGAMWE","12",1210,1204,2414
"29660","MOMBASA","CHANGAMWE","13",1211,1298,2509
"29661","MOMBASA","CHANGAMWE","14",1069,1039,2108
"29662","MOMBASA","CHANGAMWE","10 -14",5910,6033,11943
"29663","MOMBASA","CHANGAMWE","15",914,997,1911
"29664","MOMBASA","CHANGAMWE","16",885,971,1856
"29665","MOMBASA","CHANGAMWE","17",906,1100,2006
"29666","MOMBASA","CHANGAMWE","18",880,974,1854
"29667","MOMBASA","CHANGAMWE","19",1044,1168,2212
"29668","MOMBASA","CHANGAMWE","15-19",4629,5210,9839
"29669","MOMBASA","CHANGAMWE","20",1123,1455,2578
"29670","MOMBASA","CHANGAMWE","21",1287,1440,2727
"29671","MOMBASA","CHANGAMWE","22",1389,1547,2936
"29672","MOMBASA","CHANGAMWE","23",1606,1745,3351
"29673","MOMBASA","CHANGAMWE","24",1621,1716,3337
"29674","MOMBASA","CHANGAMWE","20-24",7026,7903,14929
"29675","MOMBASA","CHANGAMWE","25",1822,1861,3683
"29676","MOMBASA","CHANGAMWE","26",1592,1694,3286
"29677","MOMBASA","CHANGAMWE","27",1783,1574,3357
"29678","MOMBASA","CHANGAMWE","28",1399,1511,2910
"29679","MOMBASA","CHANGAMWE","29",1532,1581,3113
"29680","MOMBASA","CHANGAMWE","25-29",8128,8221,16349
"29681","MOMBASA","CHANGAMWE","30",1932,1844,3776
"29682","MOMBASA","CHANGAMWE","31",1357,1192,2549
"29683","MOMBASA","CHANGAMWE","32",1694,1627,3321
"29684","MOMBASA","CHANGAMWE","33",1311,1192,2503
"29685","MOMBASA","CHANGAMWE","34",1308,1185,2493
"29686","MOMBASA","CHANGAMWE","30-34",7602,7040,14642
"29687","MOMBASA","CHANGAMWE","35",1606,1385,2991
"29688","MOMBASA","CHANGAMWE","36",1206,1025,2231
"29689","MOMBASA","CHANGAMWE","37",1109,999,2108
"29690","MOMBASA","CHANGAMWE","38",981,863,1844
"29691","MOMBASA","CHANGAMWE","39",1137,843,1980
"29692","MOMBASA","CHANGAMWE","35-39",6039,5115,11154
"29693","MOMBASA","CHANGAMWE","40",1319,1007,2326
"29694","MOMBASA","CHANGAMWE","41",1137,735,1872
"29695","MOMBASA","CHANGAMWE","42",1110,721,1831
"29696","MOMBASA","CHANGAMWE","43",886,645,1531
"29697","MOMBASA","CHANGAMWE","44",768,515,1283
"29698","MOMBASA","CHANGAMWE","40-44",5220,3623,8843
"29699","MOMBASA","CHANGAMWE","45",1180,687,1867
"29700","MOMBASA","CHANGAMWE","46",766,444,1210
"29701","MOMBASA","CHANGAMWE","47",810,438,1248
"29702","MOMBASA","CHANGAMWE","48",613,369,982
"29703","MOMBASA","CHANGAMWE","49",649,357,1006
"29704","MOMBASA","CHANGAMWE","45-49",4018,2295,6313
"29705","MOMBASA","CHANGAMWE","50",722,458,1180
"29706","MOMBASA","CHANGAMWE","51",478,264,742
"29707","MOMBASA","CHANGAMWE","52",429,264,693
"29708","MOMBASA","CHANGAMWE","53",346,196,542
"29709","MOMBASA","CHANGAMWE","54",424,211,635
"29710","MOMBASA","CHANGAMWE","50-54",2399,1393,3792
"29711","MOMBASA","CHANGAMWE","55",403,208,611
"29712","MOMBASA","CHANGAMWE","56",387,197,584
"29713","MOMBASA","CHANGAMWE","57",354,176,530
"29714","MOMBASA","CHANGAMWE","58",272,145,417
"29715","MOMBASA","CHANGAMWE","59",284,147,431
"29716","MOMBASA","CHANGAMWE","55-59",1700,873,2573
"29717","MOMBASA","CHANGAMWE","60",304,180,484
"29718","MOMBASA","CHANGAMWE","61",205,131,336
"29719","MOMBASA","CHANGAMWE","62",179,99,278
"29720","MOMBASA","CHANGAMWE","63",144,95,239
"29721","MOMBASA","CHANGAMWE","64",135,74,209
"29722","MOMBASA","CHANGAMWE","60-64",967,579,1546
"29723","MOMBASA","CHANGAMWE","65",189,97,286
"29724","MOMBASA","CHANGAMWE","66",98,63,161
"29725","MOMBASA","CHANGAMWE","67",121,83,204
"29726","MOMBASA","CHANGAMWE","68",78,60,138
"29727","MOMBASA","CHANGAMWE","69",96,71,167
"29728","MOMBASA","CHANGAMWE","65-69",582,374,956
"29729","MOMBASA","CHANGAMWE","70",87,88,175
"29730","MOMBASA","CHANGAMWE","71",51,40,91
"29731","MOMBASA","CHANGAMWE","72",65,32,97
"29732","MOMBASA","CHANGAMWE","73",34,31,65
"29733","MOMBASA","CHANGAMWE","74",32,34,66
"29734","MOMBASA","CHANGAMWE","70-74",269,225,494
"29735","MOMBASA","CHANGAMWE","75",33,34,67
"29736","MOMBASA","CHANGAMWE","76",16,19,35
"29737","MOMBASA","CHANGAMWE","77",20,15,35
"29738","MOMBASA","CHANGAMWE","78",13,5,18
"29739","MOMBASA","CHANGAMWE","79",11,22,33
"29740","MOMBASA","CHANGAMWE","75-79",93,95,188
"29741","MOMBASA","CHANGAMWE","80",19,31,50
"29742","MOMBASA","CHANGAMWE","81",9,11,20
"29743","MOMBASA","CHANGAMWE","82",6,10,16
"29744","MOMBASA","CHANGAMWE","83",15,10,25
"29745","MOMBASA","CHANGAMWE","84",7,14,21
"29746","MOMBASA","CHANGAMWE","80-84",56,76,132
"29747","MOMBASA","CHANGAMWE","85",3,7,10
"29748","MOMBASA","CHANGAMWE","86",3,3,6
"29749","MOMBASA","CHANGAMWE","87",5,1,6
"29750","MOMBASA","CHANGAMWE","88",1,7,8
"29751","MOMBASA","CHANGAMWE","89",8,6,14
"29752","MOMBASA","CHANGAMWE","85-89",20,24,44
"29753","MOMBASA","CHANGAMWE","90",2,12,14
"29754","MOMBASA","CHANGAMWE","91",4,3,7
"29755","MOMBASA","CHANGAMWE","92",1,2,3
"29756","MOMBASA","CHANGAMWE","93",2,1,3
"29757","MOMBASA","CHANGAMWE","94",1,2,3
"29758","MOMBASA","CHANGAMWE","90-94",10,20,30
"29759","MOMBASA","CHANGAMWE","95",1,5,6
"29760","MOMBASA","CHANGAMWE","96",NA,2,2
"29761","MOMBASA","CHANGAMWE","97",1,1,2
"29762","MOMBASA","CHANGAMWE","98",NA,2,2
"29763","MOMBASA","CHANGAMWE","99",NA,2,2
"29764","MOMBASA","CHANGAMWE","95-99",2,12,14
"29765","MOMBASA","CHANGAMWE","100+",2,5,7
"29766","MOMBASA","CHANGAMWE","Not Stated",NA,1,1
"29767","MOMBASA","JOMVU","Total",83002,80410,163412
"29768","MOMBASA","JOMVU","0",2285,2176,4461
"29769","MOMBASA","JOMVU","1",2294,2136,4430
"29770","MOMBASA","JOMVU","2",2100,2077,4177
"29771","MOMBASA","JOMVU","3",2063,2055,4118
"29772","MOMBASA","JOMVU","4",2026,1944,3970
"29773","MOMBASA","JOMVU","0 - 4",10768,10388,21156
"29774","MOMBASA","JOMVU","5",1968,2028,3996
"29775","MOMBASA","JOMVU","6",1804,1898,3702
"29776","MOMBASA","JOMVU","7",1912,1945,3857
"29777","MOMBASA","JOMVU","8",1737,1881,3618
"29778","MOMBASA","JOMVU","9",1934,1850,3784
"29779","MOMBASA","JOMVU","5-9",9355,9602,18957
"29780","MOMBASA","JOMVU","10",1820,1838,3658
"29781","MOMBASA","JOMVU","11",1627,1765,3392
"29782","MOMBASA","JOMVU","12",1712,1667,3379
"29783","MOMBASA","JOMVU","13",1689,1697,3386
"29784","MOMBASA","JOMVU","14",1412,1501,2913
"29785","MOMBASA","JOMVU","10 -14",8260,8468,16728
"29786","MOMBASA","JOMVU","15",1300,1313,2613
"29787","MOMBASA","JOMVU","16",1150,1276,2426
"29788","MOMBASA","JOMVU","17",1229,1296,2525
"29789","MOMBASA","JOMVU","18",1143,1316,2459
"29790","MOMBASA","JOMVU","19",1326,1666,2992
"29791","MOMBASA","JOMVU","15-19",6148,6867,13015
"29792","MOMBASA","JOMVU","20",1400,1767,3167
"29793","MOMBASA","JOMVU","21",1397,1707,3104
"29794","MOMBASA","JOMVU","22",1609,1912,3521
"29795","MOMBASA","JOMVU","23",1769,2041,3810
"29796","MOMBASA","JOMVU","24",1800,2045,3845
"29797","MOMBASA","JOMVU","20-24",7975,9472,17447
"29798","MOMBASA","JOMVU","25",2110,2152,4262
"29799","MOMBASA","JOMVU","26",1901,2001,3902
"29800","MOMBASA","JOMVU","27",1822,2027,3849
"29801","MOMBASA","JOMVU","28",1603,1706,3309
"29802","MOMBASA","JOMVU","29",1739,1801,3540
"29803","MOMBASA","JOMVU","25-29",9175,9687,18862
"29804","MOMBASA","JOMVU","30",2140,2255,4395
"29805","MOMBASA","JOMVU","31",1560,1496,3056
"29806","MOMBASA","JOMVU","32",1876,1886,3762
"29807","MOMBASA","JOMVU","33",1511,1514,3025
"29808","MOMBASA","JOMVU","34",1455,1517,2972
"29809","MOMBASA","JOMVU","30-34",8542,8668,17210
"29810","MOMBASA","JOMVU","35",1793,1577,3370
"29811","MOMBASA","JOMVU","36",1355,1275,2630
"29812","MOMBASA","JOMVU","37",1381,1252,2633
"29813","MOMBASA","JOMVU","38",1101,981,2082
"29814","MOMBASA","JOMVU","39",1079,972,2051
"29815","MOMBASA","JOMVU","35-39",6709,6057,12766
"29816","MOMBASA","JOMVU","40",1408,1142,2550
"29817","MOMBASA","JOMVU","41",1224,917,2141
"29818","MOMBASA","JOMVU","42",1212,872,2084
"29819","MOMBASA","JOMVU","43",1006,722,1728
"29820","MOMBASA","JOMVU","44",903,599,1502
"29821","MOMBASA","JOMVU","40-44",5753,4252,10005
"29822","MOMBASA","JOMVU","45",1182,827,2009
"29823","MOMBASA","JOMVU","46",833,536,1369
"29824","MOMBASA","JOMVU","47",912,536,1448
"29825","MOMBASA","JOMVU","48",654,378,1032
"29826","MOMBASA","JOMVU","49",646,355,1001
"29827","MOMBASA","JOMVU","45-49",4227,2632,6859
"29828","MOMBASA","JOMVU","50",761,488,1249
"29829","MOMBASA","JOMVU","51",557,273,830
"29830","MOMBASA","JOMVU","52",436,235,671
"29831","MOMBASA","JOMVU","53",348,182,530
"29832","MOMBASA","JOMVU","54",356,195,551
"29833","MOMBASA","JOMVU","50-54",2458,1373,3831
"29834","MOMBASA","JOMVU","55",368,211,579
"29835","MOMBASA","JOMVU","56",391,263,654
"29836","MOMBASA","JOMVU","57",313,222,535
"29837","MOMBASA","JOMVU","58",252,163,415
"29838","MOMBASA","JOMVU","59",294,166,460
"29839","MOMBASA","JOMVU","55-59",1618,1025,2643
"29840","MOMBASA","JOMVU","60",269,291,560
"29841","MOMBASA","JOMVU","61",212,134,346
"29842","MOMBASA","JOMVU","62",174,125,299
"29843","MOMBASA","JOMVU","63",155,139,294
"29844","MOMBASA","JOMVU","64",137,113,250
"29845","MOMBASA","JOMVU","60-64",947,802,1749
"29846","MOMBASA","JOMVU","65",173,145,318
"29847","MOMBASA","JOMVU","66",121,84,205
"29848","MOMBASA","JOMVU","67",145,96,241
"29849","MOMBASA","JOMVU","68",68,64,132
"29850","MOMBASA","JOMVU","69",92,93,185
"29851","MOMBASA","JOMVU","65-69",599,482,1081
"29852","MOMBASA","JOMVU","70",94,122,216
"29853","MOMBASA","JOMVU","71",57,67,124
"29854","MOMBASA","JOMVU","72",56,45,101
"29855","MOMBASA","JOMVU","73",50,38,88
"29856","MOMBASA","JOMVU","74",23,45,68
"29857","MOMBASA","JOMVU","70-74",280,317,597
"29858","MOMBASA","JOMVU","75",35,47,82
"29859","MOMBASA","JOMVU","76",26,21,47
"29860","MOMBASA","JOMVU","77",25,18,43
"29861","MOMBASA","JOMVU","78",13,12,25
"29862","MOMBASA","JOMVU","79",18,31,49
"29863","MOMBASA","JOMVU","75-79",117,129,246
"29864","MOMBASA","JOMVU","80",14,36,50
"29865","MOMBASA","JOMVU","81",7,21,28
"29866","MOMBASA","JOMVU","82",10,11,21
"29867","MOMBASA","JOMVU","83",5,10,15
"29868","MOMBASA","JOMVU","84",2,9,11
"29869","MOMBASA","JOMVU","80-84",38,87,125
"29870","MOMBASA","JOMVU","85",4,15,19
"29871","MOMBASA","JOMVU","86",3,5,8
"29872","MOMBASA","JOMVU","87",6,7,13
"29873","MOMBASA","JOMVU","88",1,6,7
"29874","MOMBASA","JOMVU","89",2,19,21
"29875","MOMBASA","JOMVU","85-89",16,52,68
"29876","MOMBASA","JOMVU","90",2,12,14
"29877","MOMBASA","JOMVU","91",1,4,5
"29878","MOMBASA","JOMVU","92",2,4,6
"29879","MOMBASA","JOMVU","93",1,8,9
"29880","MOMBASA","JOMVU","94",2,3,5
"29881","MOMBASA","JOMVU","90-94",8,31,39
"29882","MOMBASA","JOMVU","95",1,6,7
"29883","MOMBASA","JOMVU","96",NA,1,1
"29884","MOMBASA","JOMVU","97",NA,1,1
"29885","MOMBASA","JOMVU","98",2,1,3
"29886","MOMBASA","JOMVU","99",1,2,3
"29887","MOMBASA","JOMVU","95-99",4,11,15
"29888","MOMBASA","JOMVU","100+",3,6,9
"29889","MOMBASA","JOMVU","Not Stated",2,2,4
"29890","MOMBASA","KISAUNI","Total",146748,145176,291924
"29891","MOMBASA","KISAUNI","0",3826,3805,7631
"29892","MOMBASA","KISAUNI","1",4098,3986,8084
"29893","MOMBASA","KISAUNI","2",3941,3790,7731
"29894","MOMBASA","KISAUNI","3",3709,3623,7332
"29895","MOMBASA","KISAUNI","4",3622,3572,7194
"29896","MOMBASA","KISAUNI","0 - 4",19196,18776,37972
"29897","MOMBASA","KISAUNI","5",3522,3548,7070
"29898","MOMBASA","KISAUNI","6",3287,3301,6588
"29899","MOMBASA","KISAUNI","7",3418,3326,6744
"29900","MOMBASA","KISAUNI","8",3080,3129,6209
"29901","MOMBASA","KISAUNI","9",3196,3201,6397
"29902","MOMBASA","KISAUNI","5-9",16503,16505,33008
"29903","MOMBASA","KISAUNI","10",3130,3085,6215
"29904","MOMBASA","KISAUNI","11",2893,2973,5866
"29905","MOMBASA","KISAUNI","12",2931,2995,5926
"29906","MOMBASA","KISAUNI","13",2985,3047,6032
"29907","MOMBASA","KISAUNI","14",2602,2702,5304
"29908","MOMBASA","KISAUNI","10 -14",14541,14802,29343
"29909","MOMBASA","KISAUNI","15",2309,2460,4769
"29910","MOMBASA","KISAUNI","16",2273,2429,4702
"29911","MOMBASA","KISAUNI","17",2592,2547,5139
"29912","MOMBASA","KISAUNI","18",2273,2431,4704
"29913","MOMBASA","KISAUNI","19",2606,3084,5690
"29914","MOMBASA","KISAUNI","15-19",12053,12951,25004
"29915","MOMBASA","KISAUNI","20",2609,3474,6083
"29916","MOMBASA","KISAUNI","21",2648,3266,5914
"29917","MOMBASA","KISAUNI","22",3001,3614,6615
"29918","MOMBASA","KISAUNI","23",3213,3993,7206
"29919","MOMBASA","KISAUNI","24",3218,3810,7028
"29920","MOMBASA","KISAUNI","20-24",14689,18157,32846
"29921","MOMBASA","KISAUNI","25",3822,4055,7877
"29922","MOMBASA","KISAUNI","26",3402,3634,7036
"29923","MOMBASA","KISAUNI","27",3367,3534,6901
"29924","MOMBASA","KISAUNI","28",2831,3176,6007
"29925","MOMBASA","KISAUNI","29",3106,3304,6410
"29926","MOMBASA","KISAUNI","25-29",16528,17703,34231
"29927","MOMBASA","KISAUNI","30",3789,3847,7636
"29928","MOMBASA","KISAUNI","31",2602,2607,5209
"29929","MOMBASA","KISAUNI","32",3232,3158,6390
"29930","MOMBASA","KISAUNI","33",2523,2521,5044
"29931","MOMBASA","KISAUNI","34",2443,2495,4938
"29932","MOMBASA","KISAUNI","30-34",14589,14628,29217
"29933","MOMBASA","KISAUNI","35",2952,2759,5711
"29934","MOMBASA","KISAUNI","36",2285,2009,4294
"29935","MOMBASA","KISAUNI","37",2207,1843,4050
"29936","MOMBASA","KISAUNI","38",1783,1577,3360
"29937","MOMBASA","KISAUNI","39",1957,1626,3583
"29938","MOMBASA","KISAUNI","35-39",11184,9814,20998
"29939","MOMBASA","KISAUNI","40",2333,2008,4341
"29940","MOMBASA","KISAUNI","41",2052,1541,3593
"29941","MOMBASA","KISAUNI","42",1951,1518,3469
"29942","MOMBASA","KISAUNI","43",1592,1282,2874
"29943","MOMBASA","KISAUNI","44",1384,1065,2449
"29944","MOMBASA","KISAUNI","40-44",9312,7414,16726
"29945","MOMBASA","KISAUNI","45",1922,1466,3388
"29946","MOMBASA","KISAUNI","46",1308,1069,2377
"29947","MOMBASA","KISAUNI","47",1499,1001,2500
"29948","MOMBASA","KISAUNI","48",1003,781,1784
"29949","MOMBASA","KISAUNI","49",1179,791,1970
"29950","MOMBASA","KISAUNI","45-49",6911,5108,12019
"29951","MOMBASA","KISAUNI","50",1383,1021,2404
"29952","MOMBASA","KISAUNI","51",956,594,1550
"29953","MOMBASA","KISAUNI","52",841,591,1432
"29954","MOMBASA","KISAUNI","53",581,425,1006
"29955","MOMBASA","KISAUNI","54",709,445,1154
"29956","MOMBASA","KISAUNI","50-54",4470,3076,7546
"29957","MOMBASA","KISAUNI","55",701,401,1102
"29958","MOMBASA","KISAUNI","56",669,514,1183
"29959","MOMBASA","KISAUNI","57",653,460,1113
"29960","MOMBASA","KISAUNI","58",401,381,782
"29961","MOMBASA","KISAUNI","59",458,431,889
"29962","MOMBASA","KISAUNI","55-59",2882,2187,5069
"29963","MOMBASA","KISAUNI","60",514,509,1023
"29964","MOMBASA","KISAUNI","61",364,322,686
"29965","MOMBASA","KISAUNI","62",321,278,599
"29966","MOMBASA","KISAUNI","63",289,306,595
"29967","MOMBASA","KISAUNI","64",237,221,458
"29968","MOMBASA","KISAUNI","60-64",1725,1636,3361
"29969","MOMBASA","KISAUNI","65",315,318,633
"29970","MOMBASA","KISAUNI","66",216,167,383
"29971","MOMBASA","KISAUNI","67",255,216,471
"29972","MOMBASA","KISAUNI","68",143,121,264
"29973","MOMBASA","KISAUNI","69",186,193,379
"29974","MOMBASA","KISAUNI","65-69",1115,1015,2130
"29975","MOMBASA","KISAUNI","70",208,269,477
"29976","MOMBASA","KISAUNI","71",135,115,250
"29977","MOMBASA","KISAUNI","72",90,92,182
"29978","MOMBASA","KISAUNI","73",88,82,170
"29979","MOMBASA","KISAUNI","74",74,80,154
"29980","MOMBASA","KISAUNI","70-74",595,638,1233
"29981","MOMBASA","KISAUNI","75",89,95,184
"29982","MOMBASA","KISAUNI","76",44,67,111
"29983","MOMBASA","KISAUNI","77",40,57,97
"29984","MOMBASA","KISAUNI","78",38,38,76
"29985","MOMBASA","KISAUNI","79",39,75,114
"29986","MOMBASA","KISAUNI","75-79",250,332,582
"29987","MOMBASA","KISAUNI","80",40,110,150
"29988","MOMBASA","KISAUNI","81",21,29,50
"29989","MOMBASA","KISAUNI","82",17,20,37
"29990","MOMBASA","KISAUNI","83",15,28,43
"29991","MOMBASA","KISAUNI","84",18,37,55
"29992","MOMBASA","KISAUNI","80-84",111,224,335
"29993","MOMBASA","KISAUNI","85",19,44,63
"29994","MOMBASA","KISAUNI","86",16,16,32
"29995","MOMBASA","KISAUNI","87",7,14,21
"29996","MOMBASA","KISAUNI","88",8,9,17
"29997","MOMBASA","KISAUNI","89",9,32,41
"29998","MOMBASA","KISAUNI","85-89",59,115,174
"29999","MOMBASA","KISAUNI","90",6,27,33
"30000","MOMBASA","KISAUNI","91",3,8,11
"30001","MOMBASA","KISAUNI","92",2,4,6
"30002","MOMBASA","KISAUNI","93",NA,5,5
"30003","MOMBASA","KISAUNI","94",2,8,10
"30004","MOMBASA","KISAUNI","90-94",13,52,65
"30005","MOMBASA","KISAUNI","95",4,13,17
"30006","MOMBASA","KISAUNI","96",4,2,6
"30007","MOMBASA","KISAUNI","97",2,2,4
"30008","MOMBASA","KISAUNI","98",1,1,2
"30009","MOMBASA","KISAUNI","99",6,5,11
"30010","MOMBASA","KISAUNI","95-99",17,23,40
"30011","MOMBASA","KISAUNI","100+",4,18,22
"30012","MOMBASA","KISAUNI","Not Stated",1,2,3
"30013","MOMBASA","LIKONI","Total",126962,123392,250354
"30014","MOMBASA","LIKONI","0",3529,3510,7039
"30015","MOMBASA","LIKONI","1",3519,3511,7030
"30016","MOMBASA","LIKONI","2",3350,3375,6725
"30017","MOMBASA","LIKONI","3",3295,3098,6393
"30018","MOMBASA","LIKONI","4",3183,3263,6446
"30019","MOMBASA","LIKONI","0 - 4",16876,16757,33633
"30020","MOMBASA","LIKONI","5",3141,3163,6304
"30021","MOMBASA","LIKONI","6",2816,2894,5710
"30022","MOMBASA","LIKONI","7",2829,2902,5731
"30023","MOMBASA","LIKONI","8",2533,2614,5147
"30024","MOMBASA","LIKONI","9",2592,2718,5310
"30025","MOMBASA","LIKONI","5-9",13911,14291,28202
"30026","MOMBASA","LIKONI","10",2546,2632,5178
"30027","MOMBASA","LIKONI","11",2142,2286,4428
"30028","MOMBASA","LIKONI","12",2427,2404,4831
"30029","MOMBASA","LIKONI","13",2312,2595,4907
"30030","MOMBASA","LIKONI","14",2185,2353,4538
"30031","MOMBASA","LIKONI","10 -14",11612,12270,23882
"30032","MOMBASA","LIKONI","15",1900,2005,3905
"30033","MOMBASA","LIKONI","16",1812,2070,3882
"30034","MOMBASA","LIKONI","17",2039,2161,4200
"30035","MOMBASA","LIKONI","18",1781,2225,4006
"30036","MOMBASA","LIKONI","19",2224,2861,5085
"30037","MOMBASA","LIKONI","15-19",9756,11322,21078
"30038","MOMBASA","LIKONI","20",2406,3254,5660
"30039","MOMBASA","LIKONI","21",2464,2909,5373
"30040","MOMBASA","LIKONI","22",2822,3517,6339
"30041","MOMBASA","LIKONI","23",3173,3813,6986
"30042","MOMBASA","LIKONI","24",3302,3736,7038
"30043","MOMBASA","LIKONI","20-24",14167,17229,31396
"30044","MOMBASA","LIKONI","25",3785,3780,7565
"30045","MOMBASA","LIKONI","26",3303,3350,6653
"30046","MOMBASA","LIKONI","27",3207,3238,6445
"30047","MOMBASA","LIKONI","28",2742,2797,5539
"30048","MOMBASA","LIKONI","29",2859,2699,5558
"30049","MOMBASA","LIKONI","25-29",15896,15864,31760
"30050","MOMBASA","LIKONI","30",3712,3644,7356
"30051","MOMBASA","LIKONI","31",2264,2055,4319
"30052","MOMBASA","LIKONI","32",2889,2752,5641
"30053","MOMBASA","LIKONI","33",2222,2095,4317
"30054","MOMBASA","LIKONI","34",2173,1866,4039
"30055","MOMBASA","LIKONI","30-34",13260,12412,25672
"30056","MOMBASA","LIKONI","35",2704,2185,4889
"30057","MOMBASA","LIKONI","36",1882,1502,3384
"30058","MOMBASA","LIKONI","37",1811,1511,3322
"30059","MOMBASA","LIKONI","38",1518,1208,2726
"30060","MOMBASA","LIKONI","39",1501,1244,2745
"30061","MOMBASA","LIKONI","35-39",9416,7650,17066
"30062","MOMBASA","LIKONI","40",2165,1670,3835
"30063","MOMBASA","LIKONI","41",1580,1188,2768
"30064","MOMBASA","LIKONI","42",1582,1163,2745
"30065","MOMBASA","LIKONI","43",1360,917,2277
"30066","MOMBASA","LIKONI","44",1100,787,1887
"30067","MOMBASA","LIKONI","40-44",7787,5725,13512
"30068","MOMBASA","LIKONI","45",1738,1036,2774
"30069","MOMBASA","LIKONI","46",1016,678,1694
"30070","MOMBASA","LIKONI","47",1096,707,1803
"30071","MOMBASA","LIKONI","48",770,534,1304
"30072","MOMBASA","LIKONI","49",858,508,1366
"30073","MOMBASA","LIKONI","45-49",5478,3463,8941
"30074","MOMBASA","LIKONI","50",1133,821,1954
"30075","MOMBASA","LIKONI","51",736,414,1150
"30076","MOMBASA","LIKONI","52",645,385,1030
"30077","MOMBASA","LIKONI","53",407,240,647
"30078","MOMBASA","LIKONI","54",524,275,799
"30079","MOMBASA","LIKONI","50-54",3445,2135,5580
"30080","MOMBASA","LIKONI","55",557,286,843
"30081","MOMBASA","LIKONI","56",543,378,921
"30082","MOMBASA","LIKONI","57",458,315,773
"30083","MOMBASA","LIKONI","58",372,267,639
"30084","MOMBASA","LIKONI","59",356,318,674
"30085","MOMBASA","LIKONI","55-59",2286,1564,3850
"30086","MOMBASA","LIKONI","60",454,406,860
"30087","MOMBASA","LIKONI","61",282,210,492
"30088","MOMBASA","LIKONI","62",256,196,452
"30089","MOMBASA","LIKONI","63",231,175,406
"30090","MOMBASA","LIKONI","64",208,151,359
"30091","MOMBASA","LIKONI","60-64",1431,1138,2569
"30092","MOMBASA","LIKONI","65",259,225,484
"30093","MOMBASA","LIKONI","66",157,106,263
"30094","MOMBASA","LIKONI","67",199,159,358
"30095","MOMBASA","LIKONI","68",102,77,179
"30096","MOMBASA","LIKONI","69",134,142,276
"30097","MOMBASA","LIKONI","65-69",851,709,1560
"30098","MOMBASA","LIKONI","70",167,215,382
"30099","MOMBASA","LIKONI","71",93,63,156
"30100","MOMBASA","LIKONI","72",77,50,127
"30101","MOMBASA","LIKONI","73",56,43,99
"30102","MOMBASA","LIKONI","74",52,37,89
"30103","MOMBASA","LIKONI","70-74",445,408,853
"30104","MOMBASA","LIKONI","75",57,76,133
"30105","MOMBASA","LIKONI","76",31,37,68
"30106","MOMBASA","LIKONI","77",37,32,69
"30107","MOMBASA","LIKONI","78",22,31,53
"30108","MOMBASA","LIKONI","79",42,31,73
"30109","MOMBASA","LIKONI","75-79",189,207,396
"30110","MOMBASA","LIKONI","80",28,89,117
"30111","MOMBASA","LIKONI","81",22,15,37
"30112","MOMBASA","LIKONI","82",20,12,32
"30113","MOMBASA","LIKONI","83",11,10,21
"30114","MOMBASA","LIKONI","84",15,17,32
"30115","MOMBASA","LIKONI","80-84",96,143,239
"30116","MOMBASA","LIKONI","85",13,13,26
"30117","MOMBASA","LIKONI","86",7,7,14
"30118","MOMBASA","LIKONI","87",7,11,18
"30119","MOMBASA","LIKONI","88",3,7,10
"30120","MOMBASA","LIKONI","89",5,26,31
"30121","MOMBASA","LIKONI","85-89",35,64,99
"30122","MOMBASA","LIKONI","90",5,11,16
"30123","MOMBASA","LIKONI","91",NA,2,2
"30124","MOMBASA","LIKONI","92",2,2,4
"30125","MOMBASA","LIKONI","93",3,1,4
"30126","MOMBASA","LIKONI","94",1,5,6
"30127","MOMBASA","LIKONI","90-94",11,21,32
"30128","MOMBASA","LIKONI","95",2,5,7
"30129","MOMBASA","LIKONI","96",3,NA,3
"30130","MOMBASA","LIKONI","97",1,3,4
"30131","MOMBASA","LIKONI","98",1,NA,1
"30132","MOMBASA","LIKONI","99",1,2,3
"30133","MOMBASA","LIKONI","95-99",8,10,18
"30134","MOMBASA","LIKONI","100+",3,8,11
"30135","MOMBASA","LIKONI","Not Stated",3,2,5
"30136","MOMBASA","MVITA","Total",75565,78601,154166
"30137","MOMBASA","MVITA","0",1535,1468,3003
"30138","MOMBASA","MVITA","1",1582,1482,3064
"30139","MOMBASA","MVITA","2",1599,1540,3139
"30140","MOMBASA","MVITA","3",1636,1510,3146
"30141","MOMBASA","MVITA","4",1584,1566,3150
"30142","MOMBASA","MVITA","0 - 4",7936,7566,15502
"30143","MOMBASA","MVITA","5",1531,1528,3059
"30144","MOMBASA","MVITA","6",1410,1519,2929
"30145","MOMBASA","MVITA","7",1497,1463,2960
"30146","MOMBASA","MVITA","8",1392,1485,2877
"30147","MOMBASA","MVITA","9",1490,1404,2894
"30148","MOMBASA","MVITA","5-9",7320,7399,14719
"30149","MOMBASA","MVITA","10",1491,1478,2969
"30150","MOMBASA","MVITA","11",1405,1349,2754
"30151","MOMBASA","MVITA","12",1403,1443,2846
"30152","MOMBASA","MVITA","13",1486,1439,2925
"30153","MOMBASA","MVITA","14",1401,1368,2769
"30154","MOMBASA","MVITA","10 -14",7186,7077,14263
"30155","MOMBASA","MVITA","15",1274,1283,2557
"30156","MOMBASA","MVITA","16",1360,1420,2780
"30157","MOMBASA","MVITA","17",1456,1562,3018
"30158","MOMBASA","MVITA","18",1372,1514,2886
"30159","MOMBASA","MVITA","19",1527,1856,3383
"30160","MOMBASA","MVITA","15-19",6989,7635,14624
"30161","MOMBASA","MVITA","20",1631,1895,3526
"30162","MOMBASA","MVITA","21",1624,1773,3397
"30163","MOMBASA","MVITA","22",1692,1874,3566
"30164","MOMBASA","MVITA","23",1777,1876,3653
"30165","MOMBASA","MVITA","24",1609,1768,3377
"30166","MOMBASA","MVITA","20-24",8333,9186,17519
"30167","MOMBASA","MVITA","25",1691,1740,3431
"30168","MOMBASA","MVITA","26",1435,1538,2973
"30169","MOMBASA","MVITA","27",1334,1518,2852
"30170","MOMBASA","MVITA","28",1391,1369,2760
"30171","MOMBASA","MVITA","29",1304,1334,2638
"30172","MOMBASA","MVITA","25-29",7155,7499,14654
"30173","MOMBASA","MVITA","30",1456,1665,3121
"30174","MOMBASA","MVITA","31",1048,1173,2221
"30175","MOMBASA","MVITA","32",1307,1431,2738
"30176","MOMBASA","MVITA","33",1085,1217,2302
"30177","MOMBASA","MVITA","34",998,1150,2148
"30178","MOMBASA","MVITA","30-34",5894,6636,12530
"30179","MOMBASA","MVITA","35",1198,1297,2495
"30180","MOMBASA","MVITA","36",1007,1136,2143
"30181","MOMBASA","MVITA","37",958,1047,2005
"30182","MOMBASA","MVITA","38",900,1035,1935
"30183","MOMBASA","MVITA","39",934,960,1894
"30184","MOMBASA","MVITA","35-39",4997,5475,10472
"30185","MOMBASA","MVITA","40",1088,1161,2249
"30186","MOMBASA","MVITA","41",924,909,1833
"30187","MOMBASA","MVITA","42",1029,1035,2064
"30188","MOMBASA","MVITA","43",833,941,1774
"30189","MOMBASA","MVITA","44",768,769,1537
"30190","MOMBASA","MVITA","40-44",4642,4815,9457
"30191","MOMBASA","MVITA","45",1098,1018,2116
"30192","MOMBASA","MVITA","46",773,766,1539
"30193","MOMBASA","MVITA","47",881,771,1652
"30194","MOMBASA","MVITA","48",704,684,1388
"30195","MOMBASA","MVITA","49",722,694,1416
"30196","MOMBASA","MVITA","45-49",4178,3933,8111
"30197","MOMBASA","MVITA","50",874,850,1724
"30198","MOMBASA","MVITA","51",634,532,1166
"30199","MOMBASA","MVITA","52",636,586,1222
"30200","MOMBASA","MVITA","53",522,505,1027
"30201","MOMBASA","MVITA","54",593,577,1170
"30202","MOMBASA","MVITA","50-54",3259,3050,6309
"30203","MOMBASA","MVITA","55",531,535,1066
"30204","MOMBASA","MVITA","56",651,562,1213
"30205","MOMBASA","MVITA","57",527,515,1042
"30206","MOMBASA","MVITA","58",460,495,955
"30207","MOMBASA","MVITA","59",518,487,1005
"30208","MOMBASA","MVITA","55-59",2687,2594,5281
"30209","MOMBASA","MVITA","60",530,555,1085
"30210","MOMBASA","MVITA","61",366,373,739
"30211","MOMBASA","MVITA","62",381,345,726
"30212","MOMBASA","MVITA","63",340,347,687
"30213","MOMBASA","MVITA","64",300,294,594
"30214","MOMBASA","MVITA","60-64",1917,1914,3831
"30215","MOMBASA","MVITA","65",343,399,742
"30216","MOMBASA","MVITA","66",253,280,533
"30217","MOMBASA","MVITA","67",277,285,562
"30218","MOMBASA","MVITA","68",211,226,437
"30219","MOMBASA","MVITA","69",205,250,455
"30220","MOMBASA","MVITA","65-69",1289,1440,2729
"30221","MOMBASA","MVITA","70",264,336,600
"30222","MOMBASA","MVITA","71",156,212,368
"30223","MOMBASA","MVITA","72",186,208,394
"30224","MOMBASA","MVITA","73",144,168,312
"30225","MOMBASA","MVITA","74",128,177,305
"30226","MOMBASA","MVITA","70-74",878,1101,1979
"30227","MOMBASA","MVITA","75",118,180,298
"30228","MOMBASA","MVITA","76",106,114,220
"30229","MOMBASA","MVITA","77",84,100,184
"30230","MOMBASA","MVITA","78",84,96,180
"30231","MOMBASA","MVITA","79",80,90,170
"30232","MOMBASA","MVITA","75-79",472,580,1052
"30233","MOMBASA","MVITA","80",84,143,227
"30234","MOMBASA","MVITA","81",43,73,116
"30235","MOMBASA","MVITA","82",58,77,135
"30236","MOMBASA","MVITA","83",57,63,120
"30237","MOMBASA","MVITA","84",33,66,99
"30238","MOMBASA","MVITA","80-84",275,422,697
"30239","MOMBASA","MVITA","85",29,70,99
"30240","MOMBASA","MVITA","86",20,30,50
"30241","MOMBASA","MVITA","87",25,22,47
"30242","MOMBASA","MVITA","88",10,20,30
"30243","MOMBASA","MVITA","89",17,26,43
"30244","MOMBASA","MVITA","85-89",101,168,269
"30245","MOMBASA","MVITA","90",18,31,49
"30246","MOMBASA","MVITA","91",5,13,18
"30247","MOMBASA","MVITA","92",6,10,16
"30248","MOMBASA","MVITA","93",4,6,10
"30249","MOMBASA","MVITA","94",2,7,9
"30250","MOMBASA","MVITA","90-94",35,67,102
"30251","MOMBASA","MVITA","95",NA,8,8
"30252","MOMBASA","MVITA","96",4,8,12
"30253","MOMBASA","MVITA","97",4,3,7
"30254","MOMBASA","MVITA","98",4,3,7
"30255","MOMBASA","MVITA","99",4,6,10
"30256","MOMBASA","MVITA","95-99",16,28,44
"30257","MOMBASA","MVITA","100+",1,13,14
"30258","MOMBASA","MVITA","Not Stated",5,3,8
"30259","MOMBASA","NYALI","Total",109219,107346,216565
"30260","MOMBASA","NYALI","0",2352,2455,4807
"30261","MOMBASA","NYALI","1",2802,2746,5548
"30262","MOMBASA","NYALI","2",2541,2516,5057
"30263","MOMBASA","NYALI","3",2475,2329,4804
"30264","MOMBASA","NYALI","4",2291,2358,4649
"30265","MOMBASA","NYALI","0 - 4",12461,12404,24865
"30266","MOMBASA","NYALI","5",2320,2337,4657
"30267","MOMBASA","NYALI","6",2209,2214,4423
"30268","MOMBASA","NYALI","7",2271,2225,4496
"30269","MOMBASA","NYALI","8",2014,2112,4126
"30270","MOMBASA","NYALI","9",2023,2057,4080
"30271","MOMBASA","NYALI","5-9",10837,10945,21782
"30272","MOMBASA","NYALI","10",2097,2045,4142
"30273","MOMBASA","NYALI","11",1893,1897,3790
"30274","MOMBASA","NYALI","12",1978,1917,3895
"30275","MOMBASA","NYALI","13",1948,2005,3953
"30276","MOMBASA","NYALI","14",1719,1766,3485
"30277","MOMBASA","NYALI","10 -14",9635,9630,19265
"30278","MOMBASA","NYALI","15",1502,1666,3168
"30279","MOMBASA","NYALI","16",1442,1697,3139
"30280","MOMBASA","NYALI","17",1641,1821,3462
"30281","MOMBASA","NYALI","18",1515,1757,3272
"30282","MOMBASA","NYALI","19",1869,2263,4132
"30283","MOMBASA","NYALI","15-19",7969,9204,17173
"30284","MOMBASA","NYALI","20",2017,2571,4588
"30285","MOMBASA","NYALI","21",2107,2611,4718
"30286","MOMBASA","NYALI","22",2320,2728,5048
"30287","MOMBASA","NYALI","23",2657,3045,5702
"30288","MOMBASA","NYALI","24",2531,3009,5540
"30289","MOMBASA","NYALI","20-24",11632,13964,25596
"30290","MOMBASA","NYALI","25",3001,3087,6088
"30291","MOMBASA","NYALI","26",2598,2890,5488
"30292","MOMBASA","NYALI","27",2598,2877,5475
"30293","MOMBASA","NYALI","28",2367,2490,4857
"30294","MOMBASA","NYALI","29",2381,2483,4864
"30295","MOMBASA","NYALI","25-29",12945,13827,26772
"30296","MOMBASA","NYALI","30",2953,3064,6017
"30297","MOMBASA","NYALI","31",2035,2025,4060
"30298","MOMBASA","NYALI","32",2580,2525,5105
"30299","MOMBASA","NYALI","33",1940,2023,3963
"30300","MOMBASA","NYALI","34",1958,1843,3801
"30301","MOMBASA","NYALI","30-34",11466,11480,22946
"30302","MOMBASA","NYALI","35",2391,2193,4584
"30303","MOMBASA","NYALI","36",1760,1544,3304
"30304","MOMBASA","NYALI","37",1701,1513,3214
"30305","MOMBASA","NYALI","38",1383,1314,2697
"30306","MOMBASA","NYALI","39",1498,1360,2858
"30307","MOMBASA","NYALI","35-39",8733,7924,16657
"30308","MOMBASA","NYALI","40",1877,1567,3444
"30309","MOMBASA","NYALI","41",1573,1251,2824
"30310","MOMBASA","NYALI","42",1521,1196,2717
"30311","MOMBASA","NYALI","43",1302,1014,2316
"30312","MOMBASA","NYALI","44",1111,863,1974
"30313","MOMBASA","NYALI","40-44",7384,5891,13275
"30314","MOMBASA","NYALI","45",1639,1200,2839
"30315","MOMBASA","NYALI","46",1156,849,2005
"30316","MOMBASA","NYALI","47",1204,829,2033
"30317","MOMBASA","NYALI","48",863,660,1523
"30318","MOMBASA","NYALI","49",991,633,1624
"30319","MOMBASA","NYALI","45-49",5853,4171,10024
"30320","MOMBASA","NYALI","50",1154,792,1946
"30321","MOMBASA","NYALI","51",778,500,1278
"30322","MOMBASA","NYALI","52",687,506,1193
"30323","MOMBASA","NYALI","53",584,363,947
"30324","MOMBASA","NYALI","54",621,414,1035
"30325","MOMBASA","NYALI","50-54",3824,2575,6399
"30326","MOMBASA","NYALI","55",598,418,1016
"30327","MOMBASA","NYALI","56",618,452,1070
"30328","MOMBASA","NYALI","57",576,411,987
"30329","MOMBASA","NYALI","58",413,318,731
"30330","MOMBASA","NYALI","59",493,359,852
"30331","MOMBASA","NYALI","55-59",2698,1958,4656
"30332","MOMBASA","NYALI","60",467,415,882
"30333","MOMBASA","NYALI","61",365,274,639
"30334","MOMBASA","NYALI","62",306,231,537
"30335","MOMBASA","NYALI","63",303,211,514
"30336","MOMBASA","NYALI","64",221,185,406
"30337","MOMBASA","NYALI","60-64",1662,1316,2978
"30338","MOMBASA","NYALI","65",276,250,526
"30339","MOMBASA","NYALI","66",162,156,318
"30340","MOMBASA","NYALI","67",232,155,387
"30341","MOMBASA","NYALI","68",119,134,253
"30342","MOMBASA","NYALI","69",166,137,303
"30343","MOMBASA","NYALI","65-69",955,832,1787
"30344","MOMBASA","NYALI","70",207,235,442
"30345","MOMBASA","NYALI","71",132,121,253
"30346","MOMBASA","NYALI","72",100,91,191
"30347","MOMBASA","NYALI","73",92,84,176
"30348","MOMBASA","NYALI","74",78,99,177
"30349","MOMBASA","NYALI","70-74",609,630,1239
"30350","MOMBASA","NYALI","75",98,68,166
"30351","MOMBASA","NYALI","76",57,57,114
"30352","MOMBASA","NYALI","77",57,41,98
"30353","MOMBASA","NYALI","78",52,39,91
"30354","MOMBASA","NYALI","79",51,61,112
"30355","MOMBASA","NYALI","75-79",315,266,581
"30356","MOMBASA","NYALI","80",49,84,133
"30357","MOMBASA","NYALI","81",28,29,57
"30358","MOMBASA","NYALI","82",27,26,53
"30359","MOMBASA","NYALI","83",25,23,48
"30360","MOMBASA","NYALI","84",17,22,39
"30361","MOMBASA","NYALI","80-84",146,184,330
"30362","MOMBASA","NYALI","85",20,22,42
"30363","MOMBASA","NYALI","86",16,21,37
"30364","MOMBASA","NYALI","87",9,15,24
"30365","MOMBASA","NYALI","88",7,8,15
"30366","MOMBASA","NYALI","89",11,20,31
"30367","MOMBASA","NYALI","85-89",63,86,149
"30368","MOMBASA","NYALI","90",6,14,20
"30369","MOMBASA","NYALI","91",4,8,12
"30370","MOMBASA","NYALI","92",6,4,10
"30371","MOMBASA","NYALI","93",2,3,5
"30372","MOMBASA","NYALI","94",3,5,8
"30373","MOMBASA","NYALI","90-94",21,34,55
"30374","MOMBASA","NYALI","95",3,4,7
"30375","MOMBASA","NYALI","96",2,4,6
"30376","MOMBASA","NYALI","97",1,2,3
"30377","MOMBASA","NYALI","98",NA,NA,NA
"30378","MOMBASA","NYALI","99",1,4,5
"30379","MOMBASA","NYALI","95-99",7,14,21
"30380","MOMBASA","NYALI","100+",1,9,10
"30381","MOMBASA","NYALI","Not Stated",3,2,5
"30382","MURANG'A","ALL","Total",523940,532669,1056609
"30383","MURANG'A","ALL","0",10902,10549,21451
"30384","MURANG'A","ALL","1",10891,10729,21620
"30385","MURANG'A","ALL","2",11127,10804,21931
"30386","MURANG'A","ALL","3",11144,11394,22538
"30387","MURANG'A","ALL","4",11631,11343,22974
"30388","MURANG'A","ALL","0 - 4",55695,54819,110514
"30389","MURANG'A","ALL","5",11199,10834,22033
"30390","MURANG'A","ALL","6",11096,11133,22229
"30391","MURANG'A","ALL","7",11630,11365,22995
"30392","MURANG'A","ALL","8",11248,11064,22312
"30393","MURANG'A","ALL","9",12391,12291,24682
"30394","MURANG'A","ALL","5-9",57564,56687,114251
"30395","MURANG'A","ALL","10",11966,11576,23542
"30396","MURANG'A","ALL","11",11092,11152,22244
"30397","MURANG'A","ALL","12",12314,11746,24060
"30398","MURANG'A","ALL","13",12435,12084,24519
"30399","MURANG'A","ALL","14",12144,11249,23393
"30400","MURANG'A","ALL","10 -14",59951,57807,117758
"30401","MURANG'A","ALL","15",11909,11201,23110
"30402","MURANG'A","ALL","16",11612,11057,22669
"30403","MURANG'A","ALL","17",12101,10760,22861
"30404","MURANG'A","ALL","18",9979,8672,18651
"30405","MURANG'A","ALL","19",9706,8470,18176
"30406","MURANG'A","ALL","15-19",55307,50160,105467
"30407","MURANG'A","ALL","20",8514,8011,16525
"30408","MURANG'A","ALL","21",7773,7400,15173
"30409","MURANG'A","ALL","22",7564,7321,14885
"30410","MURANG'A","ALL","23",7549,7624,15173
"30411","MURANG'A","ALL","24",6814,6856,13670
"30412","MURANG'A","ALL","20-24",38214,37212,75426
"30413","MURANG'A","ALL","25",6880,6930,13810
"30414","MURANG'A","ALL","26",6024,6334,12358
"30415","MURANG'A","ALL","27",6503,6532,13035
"30416","MURANG'A","ALL","28",5907,6280,12187
"30417","MURANG'A","ALL","29",6509,6899,13408
"30418","MURANG'A","ALL","25-29",31823,32975,64798
"30419","MURANG'A","ALL","30",8096,8278,16374
"30420","MURANG'A","ALL","31",6215,6210,12425
"30421","MURANG'A","ALL","32",7692,8002,15694
"30422","MURANG'A","ALL","33",6805,7153,13958
"30423","MURANG'A","ALL","34",6572,6711,13283
"30424","MURANG'A","ALL","30-34",35380,36354,71734
"30425","MURANG'A","ALL","35",8501,8567,17068
"30426","MURANG'A","ALL","36",6500,6685,13185
"30427","MURANG'A","ALL","37",6781,6459,13240
"30428","MURANG'A","ALL","38",5947,6265,12212
"30429","MURANG'A","ALL","39",6645,6547,13192
"30430","MURANG'A","ALL","35-39",34374,34523,68897
"30431","MURANG'A","ALL","40",7947,7763,15710
"30432","MURANG'A","ALL","41",6609,6271,12880
"30433","MURANG'A","ALL","42",6516,6274,12790
"30434","MURANG'A","ALL","43",5633,5588,11221
"30435","MURANG'A","ALL","44",5246,5125,10371
"30436","MURANG'A","ALL","40-44",31951,31021,62972
"30437","MURANG'A","ALL","45",7259,7082,14341
"30438","MURANG'A","ALL","46",5737,5607,11344
"30439","MURANG'A","ALL","47",6006,5913,11919
"30440","MURANG'A","ALL","48",4742,4697,9439
"30441","MURANG'A","ALL","49",4804,4956,9760
"30442","MURANG'A","ALL","45-49",28548,28255,56803
"30443","MURANG'A","ALL","50",5424,5856,11280
"30444","MURANG'A","ALL","51",4317,4339,8656
"30445","MURANG'A","ALL","52",4758,5068,9826
"30446","MURANG'A","ALL","53",3572,3900,7472
"30447","MURANG'A","ALL","54",4117,4365,8482
"30448","MURANG'A","ALL","50-54",22188,23528,45716
"30449","MURANG'A","ALL","55",4556,4602,9158
"30450","MURANG'A","ALL","56",4852,4989,9841
"30451","MURANG'A","ALL","57",3877,4650,8527
"30452","MURANG'A","ALL","58",3174,3709,6883
"30453","MURANG'A","ALL","59",3728,4085,7813
"30454","MURANG'A","ALL","55-59",20187,22035,42222
"30455","MURANG'A","ALL","60",4116,4566,8682
"30456","MURANG'A","ALL","61",3231,3640,6871
"30457","MURANG'A","ALL","62",2903,2945,5848
"30458","MURANG'A","ALL","63",2423,2625,5048
"30459","MURANG'A","ALL","64",1951,2047,3998
"30460","MURANG'A","ALL","60-64",14624,15823,30447
"30461","MURANG'A","ALL","65",2954,3358,6312
"30462","MURANG'A","ALL","66",2150,2461,4611
"30463","MURANG'A","ALL","67",3838,4197,8035
"30464","MURANG'A","ALL","68",1786,1917,3703
"30465","MURANG'A","ALL","69",2628,2923,5551
"30466","MURANG'A","ALL","65-69",13356,14856,28212
"30467","MURANG'A","ALL","70",3293,4417,7710
"30468","MURANG'A","ALL","71",2335,2677,5012
"30469","MURANG'A","ALL","72",2322,2161,4483
"30470","MURANG'A","ALL","73",1926,1879,3805
"30471","MURANG'A","ALL","74",1658,1989,3647
"30472","MURANG'A","ALL","70-74",11534,13123,24657
"30473","MURANG'A","ALL","75",1388,1977,3365
"30474","MURANG'A","ALL","76",1527,2968,4495
"30475","MURANG'A","ALL","77",1109,1577,2686
"30476","MURANG'A","ALL","78",787,961,1748
"30477","MURANG'A","ALL","79",982,1677,2659
"30478","MURANG'A","ALL","75-79",5793,9160,14953
"30479","MURANG'A","ALL","80",1172,2177,3349
"30480","MURANG'A","ALL","81",617,1128,1745
"30481","MURANG'A","ALL","82",633,810,1443
"30482","MURANG'A","ALL","83",752,1010,1762
"30483","MURANG'A","ALL","84",637,1187,1824
"30484","MURANG'A","ALL","80-84",3811,6312,10123
"30485","MURANG'A","ALL","85",587,1010,1597
"30486","MURANG'A","ALL","86",437,726,1163
"30487","MURANG'A","ALL","87",487,754,1241
"30488","MURANG'A","ALL","88",242,378,620
"30489","MURANG'A","ALL","89",410,1133,1543
"30490","MURANG'A","ALL","85-89",2163,4001,6164
"30491","MURANG'A","ALL","90",254,696,950
"30492","MURANG'A","ALL","91",254,498,752
"30493","MURANG'A","ALL","92",147,300,447
"30494","MURANG'A","ALL","93",121,287,408
"30495","MURANG'A","ALL","94",90,331,421
"30496","MURANG'A","ALL","90-94",866,2112,2978
"30497","MURANG'A","ALL","95",139,346,485
"30498","MURANG'A","ALL","96",81,192,273
"30499","MURANG'A","ALL","97",93,215,308
"30500","MURANG'A","ALL","98",64,142,206
"30501","MURANG'A","ALL","99",74,310,384
"30502","MURANG'A","ALL","95-99",451,1205,1656
"30503","MURANG'A","ALL","100+",152,695,847
"30504","MURANG'A","ALL","Not Stated",8,6,14
"30505","MURANG'A","MURANG'A EAST","Total",54665,55645,110310
"30506","MURANG'A","MURANG'A EAST","0",1276,1184,2460
"30507","MURANG'A","MURANG'A EAST","1",1201,1130,2331
"30508","MURANG'A","MURANG'A EAST","2",1187,1162,2349
"30509","MURANG'A","MURANG'A EAST","3",1145,1153,2298
"30510","MURANG'A","MURANG'A EAST","4",1224,1180,2404
"30511","MURANG'A","MURANG'A EAST","0 - 4",6033,5809,11842
"30512","MURANG'A","MURANG'A EAST","5",1110,1053,2163
"30513","MURANG'A","MURANG'A EAST","6",1048,1099,2147
"30514","MURANG'A","MURANG'A EAST","7",1163,1102,2265
"30515","MURANG'A","MURANG'A EAST","8",1043,1129,2172
"30516","MURANG'A","MURANG'A EAST","9",1149,1257,2406
"30517","MURANG'A","MURANG'A EAST","5-9",5513,5640,11153
"30518","MURANG'A","MURANG'A EAST","10",1164,1110,2274
"30519","MURANG'A","MURANG'A EAST","11",1097,1040,2137
"30520","MURANG'A","MURANG'A EAST","12",1153,1140,2293
"30521","MURANG'A","MURANG'A EAST","13",1193,1135,2328
"30522","MURANG'A","MURANG'A EAST","14",1113,1027,2140
"30523","MURANG'A","MURANG'A EAST","10 -14",5720,5452,11172
"30524","MURANG'A","MURANG'A EAST","15",1137,1083,2220
"30525","MURANG'A","MURANG'A EAST","16",1111,1134,2245
"30526","MURANG'A","MURANG'A EAST","17",1182,1108,2290
"30527","MURANG'A","MURANG'A EAST","18",941,902,1843
"30528","MURANG'A","MURANG'A EAST","19",985,965,1950
"30529","MURANG'A","MURANG'A EAST","15-19",5356,5192,10548
"30530","MURANG'A","MURANG'A EAST","20",897,922,1819
"30531","MURANG'A","MURANG'A EAST","21",883,967,1850
"30532","MURANG'A","MURANG'A EAST","22",884,985,1869
"30533","MURANG'A","MURANG'A EAST","23",922,994,1916
"30534","MURANG'A","MURANG'A EAST","24",899,887,1786
"30535","MURANG'A","MURANG'A EAST","20-24",4485,4755,9240
"30536","MURANG'A","MURANG'A EAST","25",814,862,1676
"30537","MURANG'A","MURANG'A EAST","26",787,808,1595
"30538","MURANG'A","MURANG'A EAST","27",804,784,1588
"30539","MURANG'A","MURANG'A EAST","28",716,773,1489
"30540","MURANG'A","MURANG'A EAST","29",786,923,1709
"30541","MURANG'A","MURANG'A EAST","25-29",3907,4150,8057
"30542","MURANG'A","MURANG'A EAST","30",1021,984,2005
"30543","MURANG'A","MURANG'A EAST","31",733,732,1465
"30544","MURANG'A","MURANG'A EAST","32",940,887,1827
"30545","MURANG'A","MURANG'A EAST","33",762,779,1541
"30546","MURANG'A","MURANG'A EAST","34",756,706,1462
"30547","MURANG'A","MURANG'A EAST","30-34",4212,4088,8300
"30548","MURANG'A","MURANG'A EAST","35",983,941,1924
"30549","MURANG'A","MURANG'A EAST","36",741,734,1475
"30550","MURANG'A","MURANG'A EAST","37",752,701,1453
"30551","MURANG'A","MURANG'A EAST","38",685,677,1362
"30552","MURANG'A","MURANG'A EAST","39",720,773,1493
"30553","MURANG'A","MURANG'A EAST","35-39",3881,3826,7707
"30554","MURANG'A","MURANG'A EAST","40",890,821,1711
"30555","MURANG'A","MURANG'A EAST","41",701,638,1339
"30556","MURANG'A","MURANG'A EAST","42",729,658,1387
"30557","MURANG'A","MURANG'A EAST","43",542,533,1075
"30558","MURANG'A","MURANG'A EAST","44",566,512,1078
"30559","MURANG'A","MURANG'A EAST","40-44",3428,3162,6590
"30560","MURANG'A","MURANG'A EAST","45",756,674,1430
"30561","MURANG'A","MURANG'A EAST","46",568,560,1128
"30562","MURANG'A","MURANG'A EAST","47",623,537,1160
"30563","MURANG'A","MURANG'A EAST","48",462,483,945
"30564","MURANG'A","MURANG'A EAST","49",556,490,1046
"30565","MURANG'A","MURANG'A EAST","45-49",2965,2744,5709
"30566","MURANG'A","MURANG'A EAST","50",569,613,1182
"30567","MURANG'A","MURANG'A EAST","51",458,430,888
"30568","MURANG'A","MURANG'A EAST","52",479,491,970
"30569","MURANG'A","MURANG'A EAST","53",356,380,736
"30570","MURANG'A","MURANG'A EAST","54",445,416,861
"30571","MURANG'A","MURANG'A EAST","50-54",2307,2330,4637
"30572","MURANG'A","MURANG'A EAST","55",475,457,932
"30573","MURANG'A","MURANG'A EAST","56",498,481,979
"30574","MURANG'A","MURANG'A EAST","57",373,470,843
"30575","MURANG'A","MURANG'A EAST","58",311,357,668
"30576","MURANG'A","MURANG'A EAST","59",369,400,769
"30577","MURANG'A","MURANG'A EAST","55-59",2026,2165,4191
"30578","MURANG'A","MURANG'A EAST","60",430,446,876
"30579","MURANG'A","MURANG'A EAST","61",340,358,698
"30580","MURANG'A","MURANG'A EAST","62",261,313,574
"30581","MURANG'A","MURANG'A EAST","63",218,253,471
"30582","MURANG'A","MURANG'A EAST","64",183,201,384
"30583","MURANG'A","MURANG'A EAST","60-64",1432,1571,3003
"30584","MURANG'A","MURANG'A EAST","65",258,275,533
"30585","MURANG'A","MURANG'A EAST","66",213,249,462
"30586","MURANG'A","MURANG'A EAST","67",345,402,747
"30587","MURANG'A","MURANG'A EAST","68",175,182,357
"30588","MURANG'A","MURANG'A EAST","69",262,274,536
"30589","MURANG'A","MURANG'A EAST","65-69",1253,1382,2635
"30590","MURANG'A","MURANG'A EAST","70",303,389,692
"30591","MURANG'A","MURANG'A EAST","71",181,288,469
"30592","MURANG'A","MURANG'A EAST","72",209,202,411
"30593","MURANG'A","MURANG'A EAST","73",171,184,355
"30594","MURANG'A","MURANG'A EAST","74",157,168,325
"30595","MURANG'A","MURANG'A EAST","70-74",1021,1231,2252
"30596","MURANG'A","MURANG'A EAST","75",138,174,312
"30597","MURANG'A","MURANG'A EAST","76",99,194,293
"30598","MURANG'A","MURANG'A EAST","77",106,146,252
"30599","MURANG'A","MURANG'A EAST","78",68,91,159
"30600","MURANG'A","MURANG'A EAST","79",66,168,234
"30601","MURANG'A","MURANG'A EAST","75-79",477,773,1250
"30602","MURANG'A","MURANG'A EAST","80",82,216,298
"30603","MURANG'A","MURANG'A EAST","81",49,149,198
"30604","MURANG'A","MURANG'A EAST","82",59,82,141
"30605","MURANG'A","MURANG'A EAST","83",85,94,179
"30606","MURANG'A","MURANG'A EAST","84",49,106,155
"30607","MURANG'A","MURANG'A EAST","80-84",324,647,971
"30608","MURANG'A","MURANG'A EAST","85",41,96,137
"30609","MURANG'A","MURANG'A EAST","86",43,56,99
"30610","MURANG'A","MURANG'A EAST","87",46,58,104
"30611","MURANG'A","MURANG'A EAST","88",25,21,46
"30612","MURANG'A","MURANG'A EAST","89",25,100,125
"30613","MURANG'A","MURANG'A EAST","85-89",180,331,511
"30614","MURANG'A","MURANG'A EAST","90",27,67,94
"30615","MURANG'A","MURANG'A EAST","91",16,68,84
"30616","MURANG'A","MURANG'A EAST","92",17,22,39
"30617","MURANG'A","MURANG'A EAST","93",10,30,40
"30618","MURANG'A","MURANG'A EAST","94",5,28,33
"30619","MURANG'A","MURANG'A EAST","90-94",75,215,290
"30620","MURANG'A","MURANG'A EAST","95",22,38,60
"30621","MURANG'A","MURANG'A EAST","96",11,19,30
"30622","MURANG'A","MURANG'A EAST","97",11,22,33
"30623","MURANG'A","MURANG'A EAST","98",3,9,12
"30624","MURANG'A","MURANG'A EAST","99",5,23,28
"30625","MURANG'A","MURANG'A EAST","95-99",52,111,163
"30626","MURANG'A","MURANG'A EAST","100+",18,69,87
"30627","MURANG'A","MURANG'A EAST","Not Stated",NA,2,2
"30628","MURANG'A","KANGEMA","Total",39582,40862,80444
"30629","MURANG'A","KANGEMA","0",736,759,1495
"30630","MURANG'A","KANGEMA","1",725,750,1475
"30631","MURANG'A","KANGEMA","2",800,759,1559
"30632","MURANG'A","KANGEMA","3",776,770,1546
"30633","MURANG'A","KANGEMA","4",863,802,1665
"30634","MURANG'A","KANGEMA","0 - 4",3900,3840,7740
"30635","MURANG'A","KANGEMA","5",788,770,1558
"30636","MURANG'A","KANGEMA","6",780,841,1621
"30637","MURANG'A","KANGEMA","7",849,836,1685
"30638","MURANG'A","KANGEMA","8",747,766,1513
"30639","MURANG'A","KANGEMA","9",950,832,1782
"30640","MURANG'A","KANGEMA","5-9",4114,4045,8159
"30641","MURANG'A","KANGEMA","10",860,831,1691
"30642","MURANG'A","KANGEMA","11",807,789,1596
"30643","MURANG'A","KANGEMA","12",882,815,1697
"30644","MURANG'A","KANGEMA","13",908,859,1767
"30645","MURANG'A","KANGEMA","14",855,802,1657
"30646","MURANG'A","KANGEMA","10 -14",4312,4096,8408
"30647","MURANG'A","KANGEMA","15",940,802,1742
"30648","MURANG'A","KANGEMA","16",838,837,1675
"30649","MURANG'A","KANGEMA","17",966,814,1780
"30650","MURANG'A","KANGEMA","18",725,626,1351
"30651","MURANG'A","KANGEMA","19",693,593,1286
"30652","MURANG'A","KANGEMA","15-19",4162,3672,7834
"30653","MURANG'A","KANGEMA","20",588,539,1127
"30654","MURANG'A","KANGEMA","21",542,515,1057
"30655","MURANG'A","KANGEMA","22",524,488,1012
"30656","MURANG'A","KANGEMA","23",559,511,1070
"30657","MURANG'A","KANGEMA","24",439,460,899
"30658","MURANG'A","KANGEMA","20-24",2652,2513,5165
"30659","MURANG'A","KANGEMA","25",408,432,840
"30660","MURANG'A","KANGEMA","26",397,402,799
"30661","MURANG'A","KANGEMA","27",449,433,882
"30662","MURANG'A","KANGEMA","28",381,416,797
"30663","MURANG'A","KANGEMA","29",437,480,917
"30664","MURANG'A","KANGEMA","25-29",2072,2163,4235
"30665","MURANG'A","KANGEMA","30",527,560,1087
"30666","MURANG'A","KANGEMA","31",455,422,877
"30667","MURANG'A","KANGEMA","32",558,593,1151
"30668","MURANG'A","KANGEMA","33",525,516,1041
"30669","MURANG'A","KANGEMA","34",495,551,1046
"30670","MURANG'A","KANGEMA","30-34",2560,2642,5202
"30671","MURANG'A","KANGEMA","35",584,658,1242
"30672","MURANG'A","KANGEMA","36",501,562,1063
"30673","MURANG'A","KANGEMA","37",506,500,1006
"30674","MURANG'A","KANGEMA","38",442,513,955
"30675","MURANG'A","KANGEMA","39",495,546,1041
"30676","MURANG'A","KANGEMA","35-39",2528,2779,5307
"30677","MURANG'A","KANGEMA","40",664,595,1259
"30678","MURANG'A","KANGEMA","41",528,533,1061
"30679","MURANG'A","KANGEMA","42",498,488,986
"30680","MURANG'A","KANGEMA","43",487,424,911
"30681","MURANG'A","KANGEMA","44",386,442,828
"30682","MURANG'A","KANGEMA","40-44",2563,2482,5045
"30683","MURANG'A","KANGEMA","45",598,589,1187
"30684","MURANG'A","KANGEMA","46",443,492,935
"30685","MURANG'A","KANGEMA","47",468,517,985
"30686","MURANG'A","KANGEMA","48",383,439,822
"30687","MURANG'A","KANGEMA","49",418,443,861
"30688","MURANG'A","KANGEMA","45-49",2310,2480,4790
"30689","MURANG'A","KANGEMA","50",433,517,950
"30690","MURANG'A","KANGEMA","51",377,377,754
"30691","MURANG'A","KANGEMA","52",379,425,804
"30692","MURANG'A","KANGEMA","53",294,354,648
"30693","MURANG'A","KANGEMA","54",367,378,745
"30694","MURANG'A","KANGEMA","50-54",1850,2051,3901
"30695","MURANG'A","KANGEMA","55",437,404,841
"30696","MURANG'A","KANGEMA","56",378,440,818
"30697","MURANG'A","KANGEMA","57",310,427,737
"30698","MURANG'A","KANGEMA","58",268,278,546
"30699","MURANG'A","KANGEMA","59",355,391,746
"30700","MURANG'A","KANGEMA","55-59",1748,1940,3688
"30701","MURANG'A","KANGEMA","60",353,421,774
"30702","MURANG'A","KANGEMA","61",277,334,611
"30703","MURANG'A","KANGEMA","62",276,289,565
"30704","MURANG'A","KANGEMA","63",213,228,441
"30705","MURANG'A","KANGEMA","64",132,147,279
"30706","MURANG'A","KANGEMA","60-64",1251,1419,2670
"30707","MURANG'A","KANGEMA","65",269,319,588
"30708","MURANG'A","KANGEMA","66",209,236,445
"30709","MURANG'A","KANGEMA","67",344,354,698
"30710","MURANG'A","KANGEMA","68",160,182,342
"30711","MURANG'A","KANGEMA","69",224,274,498
"30712","MURANG'A","KANGEMA","65-69",1206,1365,2571
"30713","MURANG'A","KANGEMA","70",288,394,682
"30714","MURANG'A","KANGEMA","71",217,276,493
"30715","MURANG'A","KANGEMA","72",207,196,403
"30716","MURANG'A","KANGEMA","73",218,186,404
"30717","MURANG'A","KANGEMA","74",171,197,368
"30718","MURANG'A","KANGEMA","70-74",1101,1249,2350
"30719","MURANG'A","KANGEMA","75",142,177,319
"30720","MURANG'A","KANGEMA","76",156,230,386
"30721","MURANG'A","KANGEMA","77",114,160,274
"30722","MURANG'A","KANGEMA","78",69,92,161
"30723","MURANG'A","KANGEMA","79",87,164,251
"30724","MURANG'A","KANGEMA","75-79",568,823,1391
"30725","MURANG'A","KANGEMA","80",106,186,292
"30726","MURANG'A","KANGEMA","81",70,113,183
"30727","MURANG'A","KANGEMA","82",58,89,147
"30728","MURANG'A","KANGEMA","83",77,89,166
"30729","MURANG'A","KANGEMA","84",58,134,192
"30730","MURANG'A","KANGEMA","80-84",369,611,980
"30731","MURANG'A","KANGEMA","85",48,87,135
"30732","MURANG'A","KANGEMA","86",39,68,107
"30733","MURANG'A","KANGEMA","87",28,83,111
"30734","MURANG'A","KANGEMA","88",23,36,59
"30735","MURANG'A","KANGEMA","89",39,104,143
"30736","MURANG'A","KANGEMA","85-89",177,378,555
"30737","MURANG'A","KANGEMA","90",18,41,59
"30738","MURANG'A","KANGEMA","91",28,59,87
"30739","MURANG'A","KANGEMA","92",15,31,46
"30740","MURANG'A","KANGEMA","93",14,15,29
"30741","MURANG'A","KANGEMA","94",7,36,43
"30742","MURANG'A","KANGEMA","90-94",82,182,264
"30743","MURANG'A","KANGEMA","95",10,22,32
"30744","MURANG'A","KANGEMA","96",3,18,21
"30745","MURANG'A","KANGEMA","97",8,11,19
"30746","MURANG'A","KANGEMA","98",5,9,14
"30747","MURANG'A","KANGEMA","99",9,28,37
"30748","MURANG'A","KANGEMA","95-99",35,88,123
"30749","MURANG'A","KANGEMA","100+",22,44,66
"30750","MURANG'A","KANGEMA","Not Stated",NA,NA,NA
"30751","MURANG'A","MATHIOYA","Total",45454,47359,92813
"30752","MURANG'A","MATHIOYA","0",871,818,1689
"30753","MURANG'A","MATHIOYA","1",845,857,1702
"30754","MURANG'A","MATHIOYA","2",918,915,1833
"30755","MURANG'A","MATHIOYA","3",977,990,1967
"30756","MURANG'A","MATHIOYA","4",1029,1008,2037
"30757","MURANG'A","MATHIOYA","0 - 4",4640,4588,9228
"30758","MURANG'A","MATHIOYA","5",991,948,1939
"30759","MURANG'A","MATHIOYA","6",914,974,1888
"30760","MURANG'A","MATHIOYA","7",1005,1005,2010
"30761","MURANG'A","MATHIOYA","8",962,944,1906
"30762","MURANG'A","MATHIOYA","9",1045,1081,2126
"30763","MURANG'A","MATHIOYA","5-9",4917,4952,9869
"30764","MURANG'A","MATHIOYA","10",1008,1019,2027
"30765","MURANG'A","MATHIOYA","11",1023,974,1997
"30766","MURANG'A","MATHIOYA","12",1091,1016,2107
"30767","MURANG'A","MATHIOYA","13",1041,1016,2057
"30768","MURANG'A","MATHIOYA","14",1043,992,2035
"30769","MURANG'A","MATHIOYA","10 -14",5206,5017,10223
"30770","MURANG'A","MATHIOYA","15",997,970,1967
"30771","MURANG'A","MATHIOYA","16",1007,907,1914
"30772","MURANG'A","MATHIOYA","17",1056,948,2004
"30773","MURANG'A","MATHIOYA","18",886,766,1652
"30774","MURANG'A","MATHIOYA","19",809,650,1459
"30775","MURANG'A","MATHIOYA","15-19",4755,4241,8996
"30776","MURANG'A","MATHIOYA","20",725,636,1361
"30777","MURANG'A","MATHIOYA","21",583,563,1146
"30778","MURANG'A","MATHIOYA","22",578,511,1089
"30779","MURANG'A","MATHIOYA","23",544,564,1108
"30780","MURANG'A","MATHIOYA","24",480,525,1005
"30781","MURANG'A","MATHIOYA","20-24",2910,2799,5709
"30782","MURANG'A","MATHIOYA","25",497,540,1037
"30783","MURANG'A","MATHIOYA","26",410,504,914
"30784","MURANG'A","MATHIOYA","27",464,548,1012
"30785","MURANG'A","MATHIOYA","28",461,496,957
"30786","MURANG'A","MATHIOYA","29",473,559,1032
"30787","MURANG'A","MATHIOYA","25-29",2305,2647,4952
"30788","MURANG'A","MATHIOYA","30",673,692,1365
"30789","MURANG'A","MATHIOYA","31",494,527,1021
"30790","MURANG'A","MATHIOYA","32",635,653,1288
"30791","MURANG'A","MATHIOYA","33",573,660,1233
"30792","MURANG'A","MATHIOYA","34",574,569,1143
"30793","MURANG'A","MATHIOYA","30-34",2949,3101,6050
"30794","MURANG'A","MATHIOYA","35",756,760,1516
"30795","MURANG'A","MATHIOYA","36",584,563,1147
"30796","MURANG'A","MATHIOYA","37",604,531,1135
"30797","MURANG'A","MATHIOYA","38",503,520,1023
"30798","MURANG'A","MATHIOYA","39",579,572,1151
"30799","MURANG'A","MATHIOYA","35-39",3026,2946,5972
"30800","MURANG'A","MATHIOYA","40",678,666,1344
"30801","MURANG'A","MATHIOYA","41",554,570,1124
"30802","MURANG'A","MATHIOYA","42",545,587,1132
"30803","MURANG'A","MATHIOYA","43",466,522,988
"30804","MURANG'A","MATHIOYA","44",494,466,960
"30805","MURANG'A","MATHIOYA","40-44",2737,2811,5548
"30806","MURANG'A","MATHIOYA","45",688,636,1324
"30807","MURANG'A","MATHIOYA","46",515,503,1018
"30808","MURANG'A","MATHIOYA","47",565,493,1058
"30809","MURANG'A","MATHIOYA","48",408,448,856
"30810","MURANG'A","MATHIOYA","49",384,482,866
"30811","MURANG'A","MATHIOYA","45-49",2560,2562,5122
"30812","MURANG'A","MATHIOYA","50",519,570,1089
"30813","MURANG'A","MATHIOYA","51",412,417,829
"30814","MURANG'A","MATHIOYA","52",440,553,993
"30815","MURANG'A","MATHIOYA","53",351,407,758
"30816","MURANG'A","MATHIOYA","54",395,430,825
"30817","MURANG'A","MATHIOYA","50-54",2117,2377,4494
"30818","MURANG'A","MATHIOYA","55",482,448,930
"30819","MURANG'A","MATHIOYA","56",483,545,1028
"30820","MURANG'A","MATHIOYA","57",360,421,781
"30821","MURANG'A","MATHIOYA","58",305,408,713
"30822","MURANG'A","MATHIOYA","59",344,402,746
"30823","MURANG'A","MATHIOYA","55-59",1974,2224,4198
"30824","MURANG'A","MATHIOYA","60",359,484,843
"30825","MURANG'A","MATHIOYA","61",320,360,680
"30826","MURANG'A","MATHIOYA","62",292,294,586
"30827","MURANG'A","MATHIOYA","63",218,223,441
"30828","MURANG'A","MATHIOYA","64",172,173,345
"30829","MURANG'A","MATHIOYA","60-64",1361,1534,2895
"30830","MURANG'A","MATHIOYA","65",307,379,686
"30831","MURANG'A","MATHIOYA","66",238,253,491
"30832","MURANG'A","MATHIOYA","67",377,464,841
"30833","MURANG'A","MATHIOYA","68",169,197,366
"30834","MURANG'A","MATHIOYA","69",285,322,607
"30835","MURANG'A","MATHIOYA","65-69",1376,1615,2991
"30836","MURANG'A","MATHIOYA","70",353,535,888
"30837","MURANG'A","MATHIOYA","71",231,293,524
"30838","MURANG'A","MATHIOYA","72",232,223,455
"30839","MURANG'A","MATHIOYA","73",217,201,418
"30840","MURANG'A","MATHIOYA","74",180,219,399
"30841","MURANG'A","MATHIOYA","70-74",1213,1471,2684
"30842","MURANG'A","MATHIOYA","75",159,199,358
"30843","MURANG'A","MATHIOYA","76",150,283,433
"30844","MURANG'A","MATHIOYA","77",117,174,291
"30845","MURANG'A","MATHIOYA","78",84,111,195
"30846","MURANG'A","MATHIOYA","79",114,203,317
"30847","MURANG'A","MATHIOYA","75-79",624,970,1594
"30848","MURANG'A","MATHIOYA","80",128,259,387
"30849","MURANG'A","MATHIOYA","81",64,115,179
"30850","MURANG'A","MATHIOYA","82",68,73,141
"30851","MURANG'A","MATHIOYA","83",74,89,163
"30852","MURANG'A","MATHIOYA","84",67,114,181
"30853","MURANG'A","MATHIOYA","80-84",401,650,1051
"30854","MURANG'A","MATHIOYA","85",60,128,188
"30855","MURANG'A","MATHIOYA","86",44,61,105
"30856","MURANG'A","MATHIOYA","87",67,80,147
"30857","MURANG'A","MATHIOYA","88",21,41,62
"30858","MURANG'A","MATHIOYA","89",47,140,187
"30859","MURANG'A","MATHIOYA","85-89",239,450,689
"30860","MURANG'A","MATHIOYA","90",21,100,121
"30861","MURANG'A","MATHIOYA","91",28,51,79
"30862","MURANG'A","MATHIOYA","92",12,30,42
"30863","MURANG'A","MATHIOYA","93",11,21,32
"30864","MURANG'A","MATHIOYA","94",5,33,38
"30865","MURANG'A","MATHIOYA","90-94",77,235,312
"30866","MURANG'A","MATHIOYA","95",14,37,51
"30867","MURANG'A","MATHIOYA","96",14,15,29
"30868","MURANG'A","MATHIOYA","97",9,18,27
"30869","MURANG'A","MATHIOYA","98",9,14,23
"30870","MURANG'A","MATHIOYA","99",8,33,41
"30871","MURANG'A","MATHIOYA","95-99",54,117,171
"30872","MURANG'A","MATHIOYA","100+",12,52,64
"30873","MURANG'A","MATHIOYA","Not Stated",1,NA,1
"30874","MURANG'A","KAHURO","Total",43352,44834,88186
"30875","MURANG'A","KAHURO","0",793,740,1533
"30876","MURANG'A","KAHURO","1",794,772,1566
"30877","MURANG'A","KAHURO","2",822,807,1629
"30878","MURANG'A","KAHURO","3",874,808,1682
"30879","MURANG'A","KAHURO","4",864,874,1738
"30880","MURANG'A","KAHURO","0 - 4",4147,4001,8148
"30881","MURANG'A","KAHURO","5",871,835,1706
"30882","MURANG'A","KAHURO","6",882,875,1757
"30883","MURANG'A","KAHURO","7",890,895,1785
"30884","MURANG'A","KAHURO","8",925,916,1841
"30885","MURANG'A","KAHURO","9",988,996,1984
"30886","MURANG'A","KAHURO","5-9",4556,4517,9073
"30887","MURANG'A","KAHURO","10",996,924,1920
"30888","MURANG'A","KAHURO","11",922,968,1890
"30889","MURANG'A","KAHURO","12",1016,903,1919
"30890","MURANG'A","KAHURO","13",1052,962,2014
"30891","MURANG'A","KAHURO","14",1021,888,1909
"30892","MURANG'A","KAHURO","10 -14",5007,4645,9652
"30893","MURANG'A","KAHURO","15",1015,944,1959
"30894","MURANG'A","KAHURO","16",996,897,1893
"30895","MURANG'A","KAHURO","17",1001,875,1876
"30896","MURANG'A","KAHURO","18",914,732,1646
"30897","MURANG'A","KAHURO","19",805,635,1440
"30898","MURANG'A","KAHURO","15-19",4731,4083,8814
"30899","MURANG'A","KAHURO","20",644,626,1270
"30900","MURANG'A","KAHURO","21",571,530,1101
"30901","MURANG'A","KAHURO","22",550,492,1042
"30902","MURANG'A","KAHURO","23",490,499,989
"30903","MURANG'A","KAHURO","24",424,433,857
"30904","MURANG'A","KAHURO","20-24",2679,2580,5259
"30905","MURANG'A","KAHURO","25",425,426,851
"30906","MURANG'A","KAHURO","26",354,399,753
"30907","MURANG'A","KAHURO","27",385,392,777
"30908","MURANG'A","KAHURO","28",388,385,773
"30909","MURANG'A","KAHURO","29",423,452,875
"30910","MURANG'A","KAHURO","25-29",1975,2054,4029
"30911","MURANG'A","KAHURO","30",516,564,1080
"30912","MURANG'A","KAHURO","31",432,478,910
"30913","MURANG'A","KAHURO","32",575,625,1200
"30914","MURANG'A","KAHURO","33",476,538,1014
"30915","MURANG'A","KAHURO","34",512,510,1022
"30916","MURANG'A","KAHURO","30-34",2511,2715,5226
"30917","MURANG'A","KAHURO","35",641,667,1308
"30918","MURANG'A","KAHURO","36",513,536,1049
"30919","MURANG'A","KAHURO","37",584,555,1139
"30920","MURANG'A","KAHURO","38",505,527,1032
"30921","MURANG'A","KAHURO","39",498,534,1032
"30922","MURANG'A","KAHURO","35-39",2741,2819,5560
"30923","MURANG'A","KAHURO","40",683,692,1375
"30924","MURANG'A","KAHURO","41",549,541,1090
"30925","MURANG'A","KAHURO","42",534,557,1091
"30926","MURANG'A","KAHURO","43",437,499,936
"30927","MURANG'A","KAHURO","44",431,411,842
"30928","MURANG'A","KAHURO","40-44",2634,2700,5334
"30929","MURANG'A","KAHURO","45",607,653,1260
"30930","MURANG'A","KAHURO","46",486,464,950
"30931","MURANG'A","KAHURO","47",515,570,1085
"30932","MURANG'A","KAHURO","48",415,406,821
"30933","MURANG'A","KAHURO","49",456,462,918
"30934","MURANG'A","KAHURO","45-49",2479,2555,5034
"30935","MURANG'A","KAHURO","50",494,568,1062
"30936","MURANG'A","KAHURO","51",366,402,768
"30937","MURANG'A","KAHURO","52",440,444,884
"30938","MURANG'A","KAHURO","53",364,392,756
"30939","MURANG'A","KAHURO","54",383,412,795
"30940","MURANG'A","KAHURO","50-54",2047,2218,4265
"30941","MURANG'A","KAHURO","55",420,481,901
"30942","MURANG'A","KAHURO","56",475,519,994
"30943","MURANG'A","KAHURO","57",384,468,852
"30944","MURANG'A","KAHURO","58",308,446,754
"30945","MURANG'A","KAHURO","59",337,448,785
"30946","MURANG'A","KAHURO","55-59",1924,2362,4286
"30947","MURANG'A","KAHURO","60",409,471,880
"30948","MURANG'A","KAHURO","61",319,397,716
"30949","MURANG'A","KAHURO","62",335,335,670
"30950","MURANG'A","KAHURO","63",278,269,547
"30951","MURANG'A","KAHURO","64",215,233,448
"30952","MURANG'A","KAHURO","60-64",1556,1705,3261
"30953","MURANG'A","KAHURO","65",324,366,690
"30954","MURANG'A","KAHURO","66",250,284,534
"30955","MURANG'A","KAHURO","67",449,471,920
"30956","MURANG'A","KAHURO","68",210,217,427
"30957","MURANG'A","KAHURO","69",297,311,608
"30958","MURANG'A","KAHURO","65-69",1530,1649,3179
"30959","MURANG'A","KAHURO","70",388,544,932
"30960","MURANG'A","KAHURO","71",258,289,547
"30961","MURANG'A","KAHURO","72",236,268,504
"30962","MURANG'A","KAHURO","73",213,191,404
"30963","MURANG'A","KAHURO","74",202,261,463
"30964","MURANG'A","KAHURO","70-74",1297,1553,2850
"30965","MURANG'A","KAHURO","75",191,224,415
"30966","MURANG'A","KAHURO","76",163,305,468
"30967","MURANG'A","KAHURO","77",125,200,325
"30968","MURANG'A","KAHURO","78",99,106,205
"30969","MURANG'A","KAHURO","79",95,200,295
"30970","MURANG'A","KAHURO","75-79",673,1035,1708
"30971","MURANG'A","KAHURO","80",145,268,413
"30972","MURANG'A","KAHURO","81",75,122,197
"30973","MURANG'A","KAHURO","82",56,103,159
"30974","MURANG'A","KAHURO","83",69,124,193
"30975","MURANG'A","KAHURO","84",70,112,182
"30976","MURANG'A","KAHURO","80-84",415,729,1144
"30977","MURANG'A","KAHURO","85",75,135,210
"30978","MURANG'A","KAHURO","86",55,91,146
"30979","MURANG'A","KAHURO","87",62,93,155
"30980","MURANG'A","KAHURO","88",25,40,65
"30981","MURANG'A","KAHURO","89",50,123,173
"30982","MURANG'A","KAHURO","85-89",267,482,749
"30983","MURANG'A","KAHURO","90",31,84,115
"30984","MURANG'A","KAHURO","91",35,58,93
"30985","MURANG'A","KAHURO","92",17,36,53
"30986","MURANG'A","KAHURO","93",17,32,49
"30987","MURANG'A","KAHURO","94",12,38,50
"30988","MURANG'A","KAHURO","90-94",112,248,360
"30989","MURANG'A","KAHURO","95",16,33,49
"30990","MURANG'A","KAHURO","96",10,20,30
"30991","MURANG'A","KAHURO","97",9,18,27
"30992","MURANG'A","KAHURO","98",7,13,20
"30993","MURANG'A","KAHURO","99",9,28,37
"30994","MURANG'A","KAHURO","95-99",51,112,163
"30995","MURANG'A","KAHURO","100+",20,72,92
"30996","MURANG'A","KAHURO","Not Stated",NA,NA,NA
"30997","MURANG'A","MURANG'A SOUTH","Total",91732,93087,184819
"30998","MURANG'A","MURANG'A SOUTH","0",2059,2033,4092
"30999","MURANG'A","MURANG'A SOUTH","1",1972,2023,3995
"31000","MURANG'A","MURANG'A SOUTH","2",2022,1964,3986
"31001","MURANG'A","MURANG'A SOUTH","3",1987,2119,4106
"31002","MURANG'A","MURANG'A SOUTH","4",2063,2071,4134
"31003","MURANG'A","MURANG'A SOUTH","0 - 4",10103,10210,20313
"31004","MURANG'A","MURANG'A SOUTH","5",2022,1911,3933
"31005","MURANG'A","MURANG'A SOUTH","6",2065,1991,4056
"31006","MURANG'A","MURANG'A SOUTH","7",2058,2068,4126
"31007","MURANG'A","MURANG'A SOUTH","8",2053,1926,3979
"31008","MURANG'A","MURANG'A SOUTH","9",2326,2216,4542
"31009","MURANG'A","MURANG'A SOUTH","5-9",10524,10112,20636
"31010","MURANG'A","MURANG'A SOUTH","10",2196,2119,4315
"31011","MURANG'A","MURANG'A SOUTH","11",1943,2072,4015
"31012","MURANG'A","MURANG'A SOUTH","12",2185,2132,4317
"31013","MURANG'A","MURANG'A SOUTH","13",2260,2279,4539
"31014","MURANG'A","MURANG'A SOUTH","14",2188,2110,4298
"31015","MURANG'A","MURANG'A SOUTH","10 -14",10772,10712,21484
"31016","MURANG'A","MURANG'A SOUTH","15",2201,2054,4255
"31017","MURANG'A","MURANG'A SOUTH","16",2090,1960,4050
"31018","MURANG'A","MURANG'A SOUTH","17",2125,1855,3980
"31019","MURANG'A","MURANG'A SOUTH","18",1770,1560,3330
"31020","MURANG'A","MURANG'A SOUTH","19",1720,1603,3323
"31021","MURANG'A","MURANG'A SOUTH","15-19",9906,9032,18938
"31022","MURANG'A","MURANG'A SOUTH","20",1571,1531,3102
"31023","MURANG'A","MURANG'A SOUTH","21",1401,1407,2808
"31024","MURANG'A","MURANG'A SOUTH","22",1384,1392,2776
"31025","MURANG'A","MURANG'A SOUTH","23",1395,1475,2870
"31026","MURANG'A","MURANG'A SOUTH","24",1280,1363,2643
"31027","MURANG'A","MURANG'A SOUTH","20-24",7031,7168,14199
"31028","MURANG'A","MURANG'A SOUTH","25",1359,1356,2715
"31029","MURANG'A","MURANG'A SOUTH","26",1195,1267,2462
"31030","MURANG'A","MURANG'A SOUTH","27",1281,1241,2522
"31031","MURANG'A","MURANG'A SOUTH","28",1179,1197,2376
"31032","MURANG'A","MURANG'A SOUTH","29",1223,1296,2519
"31033","MURANG'A","MURANG'A SOUTH","25-29",6237,6357,12594
"31034","MURANG'A","MURANG'A SOUTH","30",1510,1533,3043
"31035","MURANG'A","MURANG'A SOUTH","31",1117,1112,2229
"31036","MURANG'A","MURANG'A SOUTH","32",1386,1423,2809
"31037","MURANG'A","MURANG'A SOUTH","33",1230,1296,2526
"31038","MURANG'A","MURANG'A SOUTH","34",1153,1165,2318
"31039","MURANG'A","MURANG'A SOUTH","30-34",6396,6529,12925
"31040","MURANG'A","MURANG'A SOUTH","35",1498,1516,3014
"31041","MURANG'A","MURANG'A SOUTH","36",1083,1174,2257
"31042","MURANG'A","MURANG'A SOUTH","37",1150,1122,2272
"31043","MURANG'A","MURANG'A SOUTH","38",1013,1057,2070
"31044","MURANG'A","MURANG'A SOUTH","39",1136,1061,2197
"31045","MURANG'A","MURANG'A SOUTH","35-39",5880,5930,11810
"31046","MURANG'A","MURANG'A SOUTH","40",1277,1383,2660
"31047","MURANG'A","MURANG'A SOUTH","41",1082,1093,2175
"31048","MURANG'A","MURANG'A SOUTH","42",1128,1076,2204
"31049","MURANG'A","MURANG'A SOUTH","43",948,917,1865
"31050","MURANG'A","MURANG'A SOUTH","44",849,862,1711
"31051","MURANG'A","MURANG'A SOUTH","40-44",5284,5331,10615
"31052","MURANG'A","MURANG'A SOUTH","45",1268,1223,2491
"31053","MURANG'A","MURANG'A SOUTH","46",967,932,1899
"31054","MURANG'A","MURANG'A SOUTH","47",1017,1031,2048
"31055","MURANG'A","MURANG'A SOUTH","48",819,784,1603
"31056","MURANG'A","MURANG'A SOUTH","49",776,768,1544
"31057","MURANG'A","MURANG'A SOUTH","45-49",4847,4738,9585
"31058","MURANG'A","MURANG'A SOUTH","50",894,929,1823
"31059","MURANG'A","MURANG'A SOUTH","51",715,716,1431
"31060","MURANG'A","MURANG'A SOUTH","52",811,791,1602
"31061","MURANG'A","MURANG'A SOUTH","53",562,593,1155
"31062","MURANG'A","MURANG'A SOUTH","54",657,739,1396
"31063","MURANG'A","MURANG'A SOUTH","50-54",3639,3768,7407
"31064","MURANG'A","MURANG'A SOUTH","55",781,782,1563
"31065","MURANG'A","MURANG'A SOUTH","56",863,836,1699
"31066","MURANG'A","MURANG'A SOUTH","57",602,711,1313
"31067","MURANG'A","MURANG'A SOUTH","58",489,560,1049
"31068","MURANG'A","MURANG'A SOUTH","59",597,641,1238
"31069","MURANG'A","MURANG'A SOUTH","55-59",3332,3530,6862
"31070","MURANG'A","MURANG'A SOUTH","60",674,677,1351
"31071","MURANG'A","MURANG'A SOUTH","61",532,546,1078
"31072","MURANG'A","MURANG'A SOUTH","62",454,432,886
"31073","MURANG'A","MURANG'A SOUTH","63",387,428,815
"31074","MURANG'A","MURANG'A SOUTH","64",333,347,680
"31075","MURANG'A","MURANG'A SOUTH","60-64",2380,2430,4810
"31076","MURANG'A","MURANG'A SOUTH","65",472,533,1005
"31077","MURANG'A","MURANG'A SOUTH","66",307,385,692
"31078","MURANG'A","MURANG'A SOUTH","67",598,617,1215
"31079","MURANG'A","MURANG'A SOUTH","68",279,269,548
"31080","MURANG'A","MURANG'A SOUTH","69",373,432,805
"31081","MURANG'A","MURANG'A SOUTH","65-69",2029,2236,4265
"31082","MURANG'A","MURANG'A SOUTH","70",482,670,1152
"31083","MURANG'A","MURANG'A SOUTH","71",306,361,667
"31084","MURANG'A","MURANG'A SOUTH","72",350,292,642
"31085","MURANG'A","MURANG'A SOUTH","73",242,232,474
"31086","MURANG'A","MURANG'A SOUTH","74",219,235,454
"31087","MURANG'A","MURANG'A SOUTH","70-74",1599,1790,3389
"31088","MURANG'A","MURANG'A SOUTH","75",175,268,443
"31089","MURANG'A","MURANG'A SOUTH","76",174,376,550
"31090","MURANG'A","MURANG'A SOUTH","77",129,215,344
"31091","MURANG'A","MURANG'A SOUTH","78",108,137,245
"31092","MURANG'A","MURANG'A SOUTH","79",129,213,342
"31093","MURANG'A","MURANG'A SOUTH","75-79",715,1209,1924
"31094","MURANG'A","MURANG'A SOUTH","80",180,324,504
"31095","MURANG'A","MURANG'A SOUTH","81",64,143,207
"31096","MURANG'A","MURANG'A SOUTH","82",100,102,202
"31097","MURANG'A","MURANG'A SOUTH","83",128,140,268
"31098","MURANG'A","MURANG'A SOUTH","84",96,160,256
"31099","MURANG'A","MURANG'A SOUTH","80-84",568,869,1437
"31100","MURANG'A","MURANG'A SOUTH","85",78,121,199
"31101","MURANG'A","MURANG'A SOUTH","86",52,97,149
"31102","MURANG'A","MURANG'A SOUTH","87",73,88,161
"31103","MURANG'A","MURANG'A SOUTH","88",40,58,98
"31104","MURANG'A","MURANG'A SOUTH","89",58,160,218
"31105","MURANG'A","MURANG'A SOUTH","85-89",301,524,825
"31106","MURANG'A","MURANG'A SOUTH","90",31,108,139
"31107","MURANG'A","MURANG'A SOUTH","91",25,52,77
"31108","MURANG'A","MURANG'A SOUTH","92",17,43,60
"31109","MURANG'A","MURANG'A SOUTH","93",22,49,71
"31110","MURANG'A","MURANG'A SOUTH","94",11,47,58
"31111","MURANG'A","MURANG'A SOUTH","90-94",106,299,405
"31112","MURANG'A","MURANG'A SOUTH","95",16,56,72
"31113","MURANG'A","MURANG'A SOUTH","96",12,30,42
"31114","MURANG'A","MURANG'A SOUTH","97",10,28,38
"31115","MURANG'A","MURANG'A SOUTH","98",10,17,27
"31116","MURANG'A","MURANG'A SOUTH","99",10,41,51
"31117","MURANG'A","MURANG'A SOUTH","95-99",58,172,230
"31118","MURANG'A","MURANG'A SOUTH","100+",21,138,159
"31119","MURANG'A","MURANG'A SOUTH","Not Stated",4,3,7
"31120","MURANG'A","GATANGA","Total",94437,93548,187985
"31121","MURANG'A","GATANGA","0",1998,1914,3912
"31122","MURANG'A","GATANGA","1",2057,1959,4016
"31123","MURANG'A","GATANGA","2",2044,1944,3988
"31124","MURANG'A","GATANGA","3",2062,2135,4197
"31125","MURANG'A","GATANGA","4",2109,2070,4179
"31126","MURANG'A","GATANGA","0 - 4",10270,10022,20292
"31127","MURANG'A","GATANGA","5",2063,2033,4096
"31128","MURANG'A","GATANGA","6",2066,2041,4107
"31129","MURANG'A","GATANGA","7",2082,2044,4126
"31130","MURANG'A","GATANGA","8",2027,2062,4089
"31131","MURANG'A","GATANGA","9",2221,2224,4445
"31132","MURANG'A","GATANGA","5-9",10459,10404,20863
"31133","MURANG'A","GATANGA","10",2200,2156,4356
"31134","MURANG'A","GATANGA","11",2036,2035,4071
"31135","MURANG'A","GATANGA","12",2254,2204,4458
"31136","MURANG'A","GATANGA","13",2235,2208,4443
"31137","MURANG'A","GATANGA","14",2361,2129,4490
"31138","MURANG'A","GATANGA","10 -14",11086,10732,21818
"31139","MURANG'A","GATANGA","15",2225,1986,4211
"31140","MURANG'A","GATANGA","16",2180,2039,4219
"31141","MURANG'A","GATANGA","17",2181,2010,4191
"31142","MURANG'A","GATANGA","18",1812,1527,3339
"31143","MURANG'A","GATANGA","19",1800,1455,3255
"31144","MURANG'A","GATANGA","15-19",10198,9017,19215
"31145","MURANG'A","GATANGA","20",1634,1484,3118
"31146","MURANG'A","GATANGA","21",1511,1364,2875
"31147","MURANG'A","GATANGA","22",1394,1376,2770
"31148","MURANG'A","GATANGA","23",1497,1459,2956
"31149","MURANG'A","GATANGA","24",1361,1248,2609
"31150","MURANG'A","GATANGA","20-24",7397,6931,14328
"31151","MURANG'A","GATANGA","25",1379,1312,2691
"31152","MURANG'A","GATANGA","26",1194,1151,2345
"31153","MURANG'A","GATANGA","27",1329,1221,2550
"31154","MURANG'A","GATANGA","28",1091,1175,2266
"31155","MURANG'A","GATANGA","29",1273,1238,2511
"31156","MURANG'A","GATANGA","25-29",6266,6097,12363
"31157","MURANG'A","GATANGA","30",1515,1461,2976
"31158","MURANG'A","GATANGA","31",1186,1141,2327
"31159","MURANG'A","GATANGA","32",1362,1443,2805
"31160","MURANG'A","GATANGA","33",1252,1302,2554
"31161","MURANG'A","GATANGA","34",1177,1226,2403
"31162","MURANG'A","GATANGA","30-34",6492,6573,13065
"31163","MURANG'A","GATANGA","35",1509,1476,2985
"31164","MURANG'A","GATANGA","36",1152,1236,2388
"31165","MURANG'A","GATANGA","37",1198,1151,2349
"31166","MURANG'A","GATANGA","38",1004,1115,2119
"31167","MURANG'A","GATANGA","39",1231,1192,2423
"31168","MURANG'A","GATANGA","35-39",6094,6170,12264
"31169","MURANG'A","GATANGA","40",1416,1329,2745
"31170","MURANG'A","GATANGA","41",1249,1168,2417
"31171","MURANG'A","GATANGA","42",1185,1104,2289
"31172","MURANG'A","GATANGA","43",1100,994,2094
"31173","MURANG'A","GATANGA","44",992,954,1946
"31174","MURANG'A","GATANGA","40-44",5942,5549,11491
"31175","MURANG'A","GATANGA","45",1289,1199,2488
"31176","MURANG'A","GATANGA","46",1057,1011,2068
"31177","MURANG'A","GATANGA","47",1089,1033,2122
"31178","MURANG'A","GATANGA","48",846,778,1624
"31179","MURANG'A","GATANGA","49",820,857,1677
"31180","MURANG'A","GATANGA","45-49",5101,4878,9979
"31181","MURANG'A","GATANGA","50",907,925,1832
"31182","MURANG'A","GATANGA","51",775,756,1531
"31183","MURANG'A","GATANGA","52",845,912,1757
"31184","MURANG'A","GATANGA","53",598,653,1251
"31185","MURANG'A","GATANGA","54",741,675,1416
"31186","MURANG'A","GATANGA","50-54",3866,3921,7787
"31187","MURANG'A","GATANGA","55",723,665,1388
"31188","MURANG'A","GATANGA","56",794,732,1526
"31189","MURANG'A","GATANGA","57",652,772,1424
"31190","MURANG'A","GATANGA","58",531,583,1114
"31191","MURANG'A","GATANGA","59",606,614,1220
"31192","MURANG'A","GATANGA","55-59",3306,3366,6672
"31193","MURANG'A","GATANGA","60",629,664,1293
"31194","MURANG'A","GATANGA","61",487,543,1030
"31195","MURANG'A","GATANGA","62",459,462,921
"31196","MURANG'A","GATANGA","63",382,457,839
"31197","MURANG'A","GATANGA","64",310,337,647
"31198","MURANG'A","GATANGA","60-64",2267,2463,4730
"31199","MURANG'A","GATANGA","65",452,477,929
"31200","MURANG'A","GATANGA","66",327,364,691
"31201","MURANG'A","GATANGA","67",593,622,1215
"31202","MURANG'A","GATANGA","68",280,301,581
"31203","MURANG'A","GATANGA","69",409,472,881
"31204","MURANG'A","GATANGA","65-69",2061,2236,4297
"31205","MURANG'A","GATANGA","70",437,554,991
"31206","MURANG'A","GATANGA","71",370,352,722
"31207","MURANG'A","GATANGA","72",362,322,684
"31208","MURANG'A","GATANGA","73",267,274,541
"31209","MURANG'A","GATANGA","74",250,286,536
"31210","MURANG'A","GATANGA","70-74",1686,1788,3474
"31211","MURANG'A","GATANGA","75",174,279,453
"31212","MURANG'A","GATANGA","76",243,484,727
"31213","MURANG'A","GATANGA","77",176,225,401
"31214","MURANG'A","GATANGA","78",121,130,251
"31215","MURANG'A","GATANGA","79",147,229,376
"31216","MURANG'A","GATANGA","75-79",861,1347,2208
"31217","MURANG'A","GATANGA","80",155,277,432
"31218","MURANG'A","GATANGA","81",106,157,263
"31219","MURANG'A","GATANGA","82",105,131,236
"31220","MURANG'A","GATANGA","83",96,151,247
"31221","MURANG'A","GATANGA","84",84,166,250
"31222","MURANG'A","GATANGA","80-84",546,882,1428
"31223","MURANG'A","GATANGA","85",85,152,237
"31224","MURANG'A","GATANGA","86",64,119,183
"31225","MURANG'A","GATANGA","87",70,102,172
"31226","MURANG'A","GATANGA","88",37,69,106
"31227","MURANG'A","GATANGA","89",54,159,213
"31228","MURANG'A","GATANGA","85-89",310,601,911
"31229","MURANG'A","GATANGA","90",38,93,131
"31230","MURANG'A","GATANGA","91",45,63,108
"31231","MURANG'A","GATANGA","92",19,48,67
"31232","MURANG'A","GATANGA","93",17,50,67
"31233","MURANG'A","GATANGA","94",21,46,67
"31234","MURANG'A","GATANGA","90-94",140,300,440
"31235","MURANG'A","GATANGA","95",20,42,62
"31236","MURANG'A","GATANGA","96",14,29,43
"31237","MURANG'A","GATANGA","97",15,35,50
"31238","MURANG'A","GATANGA","98",10,16,26
"31239","MURANG'A","GATANGA","99",7,43,50
"31240","MURANG'A","GATANGA","95-99",66,165,231
"31241","MURANG'A","GATANGA","100+",22,106,128
"31242","MURANG'A","GATANGA","Not Stated",1,NA,1
"31243","MURANG'A","KIGUMO","Total",67989,68929,136918
"31244","MURANG'A","KIGUMO","0",1359,1301,2660
"31245","MURANG'A","KIGUMO","1",1432,1461,2893
"31246","MURANG'A","KIGUMO","2",1429,1369,2798
"31247","MURANG'A","KIGUMO","3",1449,1466,2915
"31248","MURANG'A","KIGUMO","4",1550,1451,3001
"31249","MURANG'A","KIGUMO","0 - 4",7219,7048,14267
"31250","MURANG'A","KIGUMO","5",1514,1496,3010
"31251","MURANG'A","KIGUMO","6",1521,1470,2991
"31252","MURANG'A","KIGUMO","7",1581,1485,3066
"31253","MURANG'A","KIGUMO","8",1549,1454,3003
"31254","MURANG'A","KIGUMO","9",1681,1624,3305
"31255","MURANG'A","KIGUMO","5-9",7846,7529,15375
"31256","MURANG'A","KIGUMO","10",1596,1501,3097
"31257","MURANG'A","KIGUMO","11",1467,1442,2909
"31258","MURANG'A","KIGUMO","12",1652,1566,3218
"31259","MURANG'A","KIGUMO","13",1659,1589,3248
"31260","MURANG'A","KIGUMO","14",1574,1451,3025
"31261","MURANG'A","KIGUMO","10 -14",7948,7549,15497
"31262","MURANG'A","KIGUMO","15",1463,1449,2912
"31263","MURANG'A","KIGUMO","16",1490,1414,2904
"31264","MURANG'A","KIGUMO","17",1488,1393,2881
"31265","MURANG'A","KIGUMO","18",1256,1081,2337
"31266","MURANG'A","KIGUMO","19",1248,1095,2343
"31267","MURANG'A","KIGUMO","15-19",6945,6432,13377
"31268","MURANG'A","KIGUMO","20",1103,948,2051
"31269","MURANG'A","KIGUMO","21",956,916,1872
"31270","MURANG'A","KIGUMO","22",965,889,1854
"31271","MURANG'A","KIGUMO","23",886,901,1787
"31272","MURANG'A","KIGUMO","24",838,841,1679
"31273","MURANG'A","KIGUMO","20-24",4748,4495,9243
"31274","MURANG'A","KIGUMO","25",878,892,1770
"31275","MURANG'A","KIGUMO","26",743,783,1526
"31276","MURANG'A","KIGUMO","27",750,805,1555
"31277","MURANG'A","KIGUMO","28",737,834,1571
"31278","MURANG'A","KIGUMO","29",838,885,1723
"31279","MURANG'A","KIGUMO","25-29",3946,4199,8145
"31280","MURANG'A","KIGUMO","30",1038,1076,2114
"31281","MURANG'A","KIGUMO","31",785,775,1560
"31282","MURANG'A","KIGUMO","32",1011,1063,2074
"31283","MURANG'A","KIGUMO","33",896,921,1817
"31284","MURANG'A","KIGUMO","34",904,881,1785
"31285","MURANG'A","KIGUMO","30-34",4634,4716,9350
"31286","MURANG'A","KIGUMO","35",1139,1127,2266
"31287","MURANG'A","KIGUMO","36",824,818,1642
"31288","MURANG'A","KIGUMO","37",876,906,1782
"31289","MURANG'A","KIGUMO","38",772,815,1587
"31290","MURANG'A","KIGUMO","39",845,806,1651
"31291","MURANG'A","KIGUMO","35-39",4456,4472,8928
"31292","MURANG'A","KIGUMO","40",1053,1016,2069
"31293","MURANG'A","KIGUMO","41",900,780,1680
"31294","MURANG'A","KIGUMO","42",819,811,1630
"31295","MURANG'A","KIGUMO","43",732,765,1497
"31296","MURANG'A","KIGUMO","44",663,713,1376
"31297","MURANG'A","KIGUMO","40-44",4167,4085,8252
"31298","MURANG'A","KIGUMO","45",915,931,1846
"31299","MURANG'A","KIGUMO","46",761,716,1477
"31300","MURANG'A","KIGUMO","47",768,780,1548
"31301","MURANG'A","KIGUMO","48",615,601,1216
"31302","MURANG'A","KIGUMO","49",644,680,1324
"31303","MURANG'A","KIGUMO","45-49",3703,3708,7411
"31304","MURANG'A","KIGUMO","50",703,776,1479
"31305","MURANG'A","KIGUMO","51",511,574,1085
"31306","MURANG'A","KIGUMO","52",611,653,1264
"31307","MURANG'A","KIGUMO","53",484,488,972
"31308","MURANG'A","KIGUMO","54",503,611,1114
"31309","MURANG'A","KIGUMO","50-54",2812,3102,5914
"31310","MURANG'A","KIGUMO","55",542,614,1156
"31311","MURANG'A","KIGUMO","56",624,631,1255
"31312","MURANG'A","KIGUMO","57",483,577,1060
"31313","MURANG'A","KIGUMO","58",419,436,855
"31314","MURANG'A","KIGUMO","59",481,519,1000
"31315","MURANG'A","KIGUMO","55-59",2549,2777,5326
"31316","MURANG'A","KIGUMO","60",530,628,1158
"31317","MURANG'A","KIGUMO","61",400,451,851
"31318","MURANG'A","KIGUMO","62",367,324,691
"31319","MURANG'A","KIGUMO","63",314,326,640
"31320","MURANG'A","KIGUMO","64",274,271,545
"31321","MURANG'A","KIGUMO","60-64",1885,2000,3885
"31322","MURANG'A","KIGUMO","65",376,444,820
"31323","MURANG'A","KIGUMO","66",294,298,592
"31324","MURANG'A","KIGUMO","67",469,577,1046
"31325","MURANG'A","KIGUMO","68",201,255,456
"31326","MURANG'A","KIGUMO","69",311,365,676
"31327","MURANG'A","KIGUMO","65-69",1651,1939,3590
"31328","MURANG'A","KIGUMO","70",461,559,1020
"31329","MURANG'A","KIGUMO","71",338,367,705
"31330","MURANG'A","KIGUMO","72",312,269,581
"31331","MURANG'A","KIGUMO","73",281,297,578
"31332","MURANG'A","KIGUMO","74",223,281,504
"31333","MURANG'A","KIGUMO","70-74",1615,1773,3388
"31334","MURANG'A","KIGUMO","75",187,288,475
"31335","MURANG'A","KIGUMO","76",255,451,706
"31336","MURANG'A","KIGUMO","77",175,205,380
"31337","MURANG'A","KIGUMO","78",96,127,223
"31338","MURANG'A","KIGUMO","79",152,223,375
"31339","MURANG'A","KIGUMO","75-79",865,1294,2159
"31340","MURANG'A","KIGUMO","80",172,253,425
"31341","MURANG'A","KIGUMO","81",95,133,228
"31342","MURANG'A","KIGUMO","82",81,106,187
"31343","MURANG'A","KIGUMO","83",90,124,214
"31344","MURANG'A","KIGUMO","84",96,174,270
"31345","MURANG'A","KIGUMO","80-84",534,790,1324
"31346","MURANG'A","KIGUMO","85",79,118,197
"31347","MURANG'A","KIGUMO","86",68,101,169
"31348","MURANG'A","KIGUMO","87",57,93,150
"31349","MURANG'A","KIGUMO","88",31,41,72
"31350","MURANG'A","KIGUMO","89",48,143,191
"31351","MURANG'A","KIGUMO","85-89",283,496,779
"31352","MURANG'A","KIGUMO","90",35,90,125
"31353","MURANG'A","KIGUMO","91",34,64,98
"31354","MURANG'A","KIGUMO","92",18,46,64
"31355","MURANG'A","KIGUMO","93",8,32,40
"31356","MURANG'A","KIGUMO","94",12,33,45
"31357","MURANG'A","KIGUMO","90-94",107,265,372
"31358","MURANG'A","KIGUMO","95",23,50,73
"31359","MURANG'A","KIGUMO","96",9,24,33
"31360","MURANG'A","KIGUMO","97",12,31,43
"31361","MURANG'A","KIGUMO","98",5,26,31
"31362","MURANG'A","KIGUMO","99",11,35,46
"31363","MURANG'A","KIGUMO","95-99",60,166,226
"31364","MURANG'A","KIGUMO","100+",15,93,108
"31365","MURANG'A","KIGUMO","Not Stated",1,1,2
"31366","MURANG'A","KANDARA","Total",86698,88393,175091
"31367","MURANG'A","KANDARA","0",1810,1800,3610
"31368","MURANG'A","KANDARA","1",1864,1777,3641
"31369","MURANG'A","KANDARA","2",1905,1884,3789
"31370","MURANG'A","KANDARA","3",1874,1952,3826
"31371","MURANG'A","KANDARA","4",1929,1887,3816
"31372","MURANG'A","KANDARA","0 - 4",9382,9300,18682
"31373","MURANG'A","KANDARA","5",1839,1788,3627
"31374","MURANG'A","KANDARA","6",1820,1841,3661
"31375","MURANG'A","KANDARA","7",2001,1930,3931
"31376","MURANG'A","KANDARA","8",1942,1867,3809
"31377","MURANG'A","KANDARA","9",2031,2061,4092
"31378","MURANG'A","KANDARA","5-9",9633,9487,19120
"31379","MURANG'A","KANDARA","10",1946,1916,3862
"31380","MURANG'A","KANDARA","11",1797,1831,3628
"31381","MURANG'A","KANDARA","12",2081,1970,4051
"31382","MURANG'A","KANDARA","13",2087,2036,4123
"31383","MURANG'A","KANDARA","14",1989,1849,3838
"31384","MURANG'A","KANDARA","10 -14",9900,9602,19502
"31385","MURANG'A","KANDARA","15",1931,1913,3844
"31386","MURANG'A","KANDARA","16",1900,1869,3769
"31387","MURANG'A","KANDARA","17",2102,1757,3859
"31388","MURANG'A","KANDARA","18",1675,1478,3153
"31389","MURANG'A","KANDARA","19",1645,1474,3119
"31390","MURANG'A","KANDARA","15-19",9253,8491,17744
"31391","MURANG'A","KANDARA","20",1352,1325,2677
"31392","MURANG'A","KANDARA","21",1326,1138,2464
"31393","MURANG'A","KANDARA","22",1284,1188,2472
"31394","MURANG'A","KANDARA","23",1256,1220,2476
"31395","MURANG'A","KANDARA","24",1091,1098,2189
"31396","MURANG'A","KANDARA","20-24",6309,5969,12278
"31397","MURANG'A","KANDARA","25",1118,1110,2228
"31398","MURANG'A","KANDARA","26",941,1019,1960
"31399","MURANG'A","KANDARA","27",1041,1107,2148
"31400","MURANG'A","KANDARA","28",953,1003,1956
"31401","MURANG'A","KANDARA","29",1055,1066,2121
"31402","MURANG'A","KANDARA","25-29",5108,5305,10413
"31403","MURANG'A","KANDARA","30",1295,1408,2703
"31404","MURANG'A","KANDARA","31",1013,1023,2036
"31405","MURANG'A","KANDARA","32",1224,1315,2539
"31406","MURANG'A","KANDARA","33",1091,1141,2232
"31407","MURANG'A","KANDARA","34",1000,1103,2103
"31408","MURANG'A","KANDARA","30-34",5623,5990,11613
"31409","MURANG'A","KANDARA","35",1391,1422,2813
"31410","MURANG'A","KANDARA","36",1099,1061,2160
"31411","MURANG'A","KANDARA","37",1111,993,2104
"31412","MURANG'A","KANDARA","38",1022,1041,2063
"31413","MURANG'A","KANDARA","39",1139,1063,2202
"31414","MURANG'A","KANDARA","35-39",5762,5580,11342
"31415","MURANG'A","KANDARA","40",1286,1261,2547
"31416","MURANG'A","KANDARA","41",1046,947,1993
"31417","MURANG'A","KANDARA","42",1078,993,2071
"31418","MURANG'A","KANDARA","43",921,934,1855
"31419","MURANG'A","KANDARA","44",865,765,1630
"31420","MURANG'A","KANDARA","40-44",5196,4900,10096
"31421","MURANG'A","KANDARA","45",1138,1177,2315
"31422","MURANG'A","KANDARA","46",938,929,1867
"31423","MURANG'A","KANDARA","47",961,952,1913
"31424","MURANG'A","KANDARA","48",794,758,1552
"31425","MURANG'A","KANDARA","49",750,774,1524
"31426","MURANG'A","KANDARA","45-49",4581,4590,9171
"31427","MURANG'A","KANDARA","50",904,958,1862
"31428","MURANG'A","KANDARA","51",701,667,1368
"31429","MURANG'A","KANDARA","52",753,799,1552
"31430","MURANG'A","KANDARA","53",562,633,1195
"31431","MURANG'A","KANDARA","54",625,703,1328
"31432","MURANG'A","KANDARA","50-54",3545,3760,7305
"31433","MURANG'A","KANDARA","55",695,751,1446
"31434","MURANG'A","KANDARA","56",737,805,1542
"31435","MURANG'A","KANDARA","57",713,804,1517
"31436","MURANG'A","KANDARA","58",543,641,1184
"31437","MURANG'A","KANDARA","59",639,670,1309
"31438","MURANG'A","KANDARA","55-59",3327,3671,6998
"31439","MURANG'A","KANDARA","60",732,775,1507
"31440","MURANG'A","KANDARA","61",556,651,1207
"31441","MURANG'A","KANDARA","62",459,496,955
"31442","MURANG'A","KANDARA","63",413,441,854
"31443","MURANG'A","KANDARA","64",332,338,670
"31444","MURANG'A","KANDARA","60-64",2492,2701,5193
"31445","MURANG'A","KANDARA","65",496,565,1061
"31446","MURANG'A","KANDARA","66",312,392,704
"31447","MURANG'A","KANDARA","67",663,690,1353
"31448","MURANG'A","KANDARA","68",312,314,626
"31449","MURANG'A","KANDARA","69",467,473,940
"31450","MURANG'A","KANDARA","65-69",2250,2434,4684
"31451","MURANG'A","KANDARA","70",581,772,1353
"31452","MURANG'A","KANDARA","71",434,451,885
"31453","MURANG'A","KANDARA","72",414,389,803
"31454","MURANG'A","KANDARA","73",317,314,631
"31455","MURANG'A","KANDARA","74",256,342,598
"31456","MURANG'A","KANDARA","70-74",2002,2268,4270
"31457","MURANG'A","KANDARA","75",222,368,590
"31458","MURANG'A","KANDARA","76",287,645,932
"31459","MURANG'A","KANDARA","77",167,252,419
"31460","MURANG'A","KANDARA","78",142,167,309
"31461","MURANG'A","KANDARA","79",192,277,469
"31462","MURANG'A","KANDARA","75-79",1010,1709,2719
"31463","MURANG'A","KANDARA","80",204,394,598
"31464","MURANG'A","KANDARA","81",94,196,290
"31465","MURANG'A","KANDARA","82",106,124,230
"31466","MURANG'A","KANDARA","83",133,199,332
"31467","MURANG'A","KANDARA","84",117,221,338
"31468","MURANG'A","KANDARA","80-84",654,1134,1788
"31469","MURANG'A","KANDARA","85",121,173,294
"31470","MURANG'A","KANDARA","86",72,133,205
"31471","MURANG'A","KANDARA","87",84,157,241
"31472","MURANG'A","KANDARA","88",40,72,112
"31473","MURANG'A","KANDARA","89",89,204,293
"31474","MURANG'A","KANDARA","85-89",406,739,1145
"31475","MURANG'A","KANDARA","90",53,113,166
"31476","MURANG'A","KANDARA","91",43,83,126
"31477","MURANG'A","KANDARA","92",32,44,76
"31478","MURANG'A","KANDARA","93",22,58,80
"31479","MURANG'A","KANDARA","94",17,70,87
"31480","MURANG'A","KANDARA","90-94",167,368,535
"31481","MURANG'A","KANDARA","95",18,68,86
"31482","MURANG'A","KANDARA","96",8,37,45
"31483","MURANG'A","KANDARA","97",19,52,71
"31484","MURANG'A","KANDARA","98",15,38,53
"31485","MURANG'A","KANDARA","99",15,79,94
"31486","MURANG'A","KANDARA","95-99",75,274,349
"31487","MURANG'A","KANDARA","100+",22,121,143
"31488","MURANG'A","KANDARA","Not Stated",1,NA,1
"31489","MURANG'A","ABERDARE FOREST","Total",31,12,43
"31490","MURANG'A","ABERDARE FOREST","0",NA,NA,NA
"31491","MURANG'A","ABERDARE FOREST","1",1,NA,1
"31492","MURANG'A","ABERDARE FOREST","2",NA,NA,NA
"31493","MURANG'A","ABERDARE FOREST","3",NA,1,1
"31494","MURANG'A","ABERDARE FOREST","4",NA,NA,NA
"31495","MURANG'A","ABERDARE FOREST","0 - 4",1,1,2
"31496","MURANG'A","ABERDARE FOREST","5",1,NA,1
"31497","MURANG'A","ABERDARE FOREST","6",NA,1,1
"31498","MURANG'A","ABERDARE FOREST","7",1,NA,1
"31499","MURANG'A","ABERDARE FOREST","8",NA,NA,NA
"31500","MURANG'A","ABERDARE FOREST","9",NA,NA,NA
"31501","MURANG'A","ABERDARE FOREST","5-9",2,1,3
"31502","MURANG'A","ABERDARE FOREST","10",NA,NA,NA
"31503","MURANG'A","ABERDARE FOREST","11",NA,1,1
"31504","MURANG'A","ABERDARE FOREST","12",NA,NA,NA
"31505","MURANG'A","ABERDARE FOREST","13",NA,NA,NA
"31506","MURANG'A","ABERDARE FOREST","14",NA,1,1
"31507","MURANG'A","ABERDARE FOREST","10 -14",NA,2,2
"31508","MURANG'A","ABERDARE FOREST","15",NA,NA,NA
"31509","MURANG'A","ABERDARE FOREST","16",NA,NA,NA
"31510","MURANG'A","ABERDARE FOREST","17",NA,NA,NA
"31511","MURANG'A","ABERDARE FOREST","18",NA,NA,NA
"31512","MURANG'A","ABERDARE FOREST","19",1,NA,1
"31513","MURANG'A","ABERDARE FOREST","15-19",1,NA,1
"31514","MURANG'A","ABERDARE FOREST","20",NA,NA,NA
"31515","MURANG'A","ABERDARE FOREST","21",NA,NA,NA
"31516","MURANG'A","ABERDARE FOREST","22",1,NA,1
"31517","MURANG'A","ABERDARE FOREST","23",NA,1,1
"31518","MURANG'A","ABERDARE FOREST","24",2,1,3
"31519","MURANG'A","ABERDARE FOREST","20-24",3,2,5
"31520","MURANG'A","ABERDARE FOREST","25",2,NA,2
"31521","MURANG'A","ABERDARE FOREST","26",3,1,4
"31522","MURANG'A","ABERDARE FOREST","27",NA,1,1
"31523","MURANG'A","ABERDARE FOREST","28",1,1,2
"31524","MURANG'A","ABERDARE FOREST","29",1,NA,1
"31525","MURANG'A","ABERDARE FOREST","25-29",7,3,10
"31526","MURANG'A","ABERDARE FOREST","30",1,NA,1
"31527","MURANG'A","ABERDARE FOREST","31",NA,NA,NA
"31528","MURANG'A","ABERDARE FOREST","32",1,NA,1
"31529","MURANG'A","ABERDARE FOREST","33",NA,NA,NA
"31530","MURANG'A","ABERDARE FOREST","34",1,NA,1
"31531","MURANG'A","ABERDARE FOREST","30-34",3,NA,3
"31532","MURANG'A","ABERDARE FOREST","35",NA,NA,NA
"31533","MURANG'A","ABERDARE FOREST","36",3,1,4
"31534","MURANG'A","ABERDARE FOREST","37",NA,NA,NA
"31535","MURANG'A","ABERDARE FOREST","38",1,NA,1
"31536","MURANG'A","ABERDARE FOREST","39",2,NA,2
"31537","MURANG'A","ABERDARE FOREST","35-39",6,1,7
"31538","MURANG'A","ABERDARE FOREST","40",NA,NA,NA
"31539","MURANG'A","ABERDARE FOREST","41",NA,1,1
"31540","MURANG'A","ABERDARE FOREST","42",NA,NA,NA
"31541","MURANG'A","ABERDARE FOREST","43",NA,NA,NA
"31542","MURANG'A","ABERDARE FOREST","44",NA,NA,NA
"31543","MURANG'A","ABERDARE FOREST","40-44",NA,1,1
"31544","MURANG'A","ABERDARE FOREST","45",NA,NA,NA
"31545","MURANG'A","ABERDARE FOREST","46",2,NA,2
"31546","MURANG'A","ABERDARE FOREST","47",NA,NA,NA
"31547","MURANG'A","ABERDARE FOREST","48",NA,NA,NA
"31548","MURANG'A","ABERDARE FOREST","49",NA,NA,NA
"31549","MURANG'A","ABERDARE FOREST","45-49",2,NA,2
"31550","MURANG'A","ABERDARE FOREST","50",1,NA,1
"31551","MURANG'A","ABERDARE FOREST","51",2,NA,2
"31552","MURANG'A","ABERDARE FOREST","52",NA,NA,NA
"31553","MURANG'A","ABERDARE FOREST","53",1,NA,1
"31554","MURANG'A","ABERDARE FOREST","54",1,1,2
"31555","MURANG'A","ABERDARE FOREST","50-54",5,1,6
"31556","MURANG'A","ABERDARE FOREST","55",1,NA,1
"31557","MURANG'A","ABERDARE FOREST","56",NA,NA,NA
"31558","MURANG'A","ABERDARE FOREST","57",NA,NA,NA
"31559","MURANG'A","ABERDARE FOREST","58",NA,NA,NA
"31560","MURANG'A","ABERDARE FOREST","59",NA,NA,NA
"31561","MURANG'A","ABERDARE FOREST","55-59",1,NA,1
"31562","MURANG'A","ABERDARE FOREST","60",NA,NA,NA
"31563","MURANG'A","ABERDARE FOREST","61",NA,NA,NA
"31564","MURANG'A","ABERDARE FOREST","62",NA,NA,NA
"31565","MURANG'A","ABERDARE FOREST","63",NA,NA,NA
"31566","MURANG'A","ABERDARE FOREST","64",NA,NA,NA
"31567","MURANG'A","ABERDARE FOREST","60-64",NA,NA,NA
"31568","MURANG'A","ABERDARE FOREST","65",NA,NA,NA
"31569","MURANG'A","ABERDARE FOREST","66",NA,NA,NA
"31570","MURANG'A","ABERDARE FOREST","67",NA,NA,NA
"31571","MURANG'A","ABERDARE FOREST","68",NA,NA,NA
"31572","MURANG'A","ABERDARE FOREST","69",NA,NA,NA
"31573","MURANG'A","ABERDARE FOREST","65-69",NA,NA,NA
"31574","MURANG'A","ABERDARE FOREST","70",NA,NA,NA
"31575","MURANG'A","ABERDARE FOREST","71",NA,NA,NA
"31576","MURANG'A","ABERDARE FOREST","72",NA,NA,NA
"31577","MURANG'A","ABERDARE FOREST","73",NA,NA,NA
"31578","MURANG'A","ABERDARE FOREST","74",NA,NA,NA
"31579","MURANG'A","ABERDARE FOREST","70-74",NA,NA,NA
"31580","MURANG'A","ABERDARE FOREST","75",NA,NA,NA
"31581","MURANG'A","ABERDARE FOREST","76",NA,NA,NA
"31582","MURANG'A","ABERDARE FOREST","77",NA,NA,NA
"31583","MURANG'A","ABERDARE FOREST","78",NA,NA,NA
"31584","MURANG'A","ABERDARE FOREST","79",NA,NA,NA
"31585","MURANG'A","ABERDARE FOREST","75-79",NA,NA,NA
"31586","MURANG'A","ABERDARE FOREST","80",NA,NA,NA
"31587","MURANG'A","ABERDARE FOREST","81",NA,NA,NA
"31588","MURANG'A","ABERDARE FOREST","82",NA,NA,NA
"31589","MURANG'A","ABERDARE FOREST","83",NA,NA,NA
"31590","MURANG'A","ABERDARE FOREST","84",NA,NA,NA
"31591","MURANG'A","ABERDARE FOREST","80-84",NA,NA,NA
"31592","MURANG'A","ABERDARE FOREST","85",NA,NA,NA
"31593","MURANG'A","ABERDARE FOREST","86",NA,NA,NA
"31594","MURANG'A","ABERDARE FOREST","87",NA,NA,NA
"31595","MURANG'A","ABERDARE FOREST","88",NA,NA,NA
"31596","MURANG'A","ABERDARE FOREST","89",NA,NA,NA
"31597","MURANG'A","ABERDARE FOREST","85-89",NA,NA,NA
"31598","MURANG'A","ABERDARE FOREST","90",NA,NA,NA
"31599","MURANG'A","ABERDARE FOREST","91",NA,NA,NA
"31600","MURANG'A","ABERDARE FOREST","92",NA,NA,NA
"31601","MURANG'A","ABERDARE FOREST","93",NA,NA,NA
"31602","MURANG'A","ABERDARE FOREST","94",NA,NA,NA
"31603","MURANG'A","ABERDARE FOREST","90-94",NA,NA,NA
"31604","MURANG'A","ABERDARE FOREST","95",NA,NA,NA
"31605","MURANG'A","ABERDARE FOREST","96",NA,NA,NA
"31606","MURANG'A","ABERDARE FOREST","97",NA,NA,NA
"31607","MURANG'A","ABERDARE FOREST","98",NA,NA,NA
"31608","MURANG'A","ABERDARE FOREST","99",NA,NA,NA
"31609","MURANG'A","ABERDARE FOREST","95-99",NA,NA,NA
"31610","MURANG'A","ABERDARE FOREST","100+",NA,NA,NA
"31611","MURANG'A","ABERDARE FOREST","Not Stated",NA,NA,NA
"31612","NAIROBI","ALL","Total",2192452,2204376,4396828
"31613","NAIROBI","ALL","0",57265,56523,113788
"31614","NAIROBI","ALL","1",56019,54601,110620
"31615","NAIROBI","ALL","2",52518,51848,104366
"31616","NAIROBI","ALL","3",51115,51027,102142
"31617","NAIROBI","ALL","4",47182,46889,94071
"31618","NAIROBI","ALL","0 - 4",264099,260888,524987
"31619","NAIROBI","ALL","5",45203,44711,89914
"31620","NAIROBI","ALL","6",43635,44226,87861
"31621","NAIROBI","ALL","7",43507,43655,87162
"31622","NAIROBI","ALL","8",40916,41615,82531
"31623","NAIROBI","ALL","9",41969,43275,85244
"31624","NAIROBI","ALL","5-9",215230,217482,432712
"31625","NAIROBI","ALL","10",40791,40892,81683
"31626","NAIROBI","ALL","11",35581,37513,73094
"31627","NAIROBI","ALL","12",37907,39622,77529
"31628","NAIROBI","ALL","13",36701,39479,76180
"31629","NAIROBI","ALL","14",34028,36036,70064
"31630","NAIROBI","ALL","10 -14",185008,193542,378550
"31631","NAIROBI","ALL","15",30919,35136,66055
"31632","NAIROBI","ALL","16",30408,35599,66007
"31633","NAIROBI","ALL","17",32413,37865,70278
"31634","NAIROBI","ALL","18",29102,36415,65517
"31635","NAIROBI","ALL","19",36256,47740,83996
"31636","NAIROBI","ALL","15-19",159098,192755,351853
"31637","NAIROBI","ALL","20",39853,55625,95478
"31638","NAIROBI","ALL","21",45052,57938,102990
"31639","NAIROBI","ALL","22",49186,62338,111524
"31640","NAIROBI","ALL","23",57179,70152,127331
"31641","NAIROBI","ALL","24",58264,67432,125696
"31642","NAIROBI","ALL","20-24",249534,313485,563019
"31643","NAIROBI","ALL","25",63693,69680,133373
"31644","NAIROBI","ALL","26",56174,62288,118462
"31645","NAIROBI","ALL","27",57764,60383,118147
"31646","NAIROBI","ALL","28",50792,53563,104355
"31647","NAIROBI","ALL","29",54280,54931,109211
"31648","NAIROBI","ALL","25-29",282703,300845,583548
"31649","NAIROBI","ALL","30",64070,65757,129827
"31650","NAIROBI","ALL","31",44601,42537,87138
"31651","NAIROBI","ALL","32",56015,54958,110973
"31652","NAIROBI","ALL","33",43556,42761,86317
"31653","NAIROBI","ALL","34",41234,39981,81215
"31654","NAIROBI","ALL","30-34",249476,245994,495470
"31655","NAIROBI","ALL","35",49053,44052,93105
"31656","NAIROBI","ALL","36",35610,33131,68741
"31657","NAIROBI","ALL","37",34835,30671,65506
"31658","NAIROBI","ALL","38",30710,28604,59314
"31659","NAIROBI","ALL","39",31593,27537,59130
"31660","NAIROBI","ALL","35-39",181801,163995,345796
"31661","NAIROBI","ALL","40",37229,30970,68199
"31662","NAIROBI","ALL","41",29619,23693,53312
"31663","NAIROBI","ALL","42",28657,22977,51634
"31664","NAIROBI","ALL","43",24278,19898,44176
"31665","NAIROBI","ALL","44",19495,16346,35841
"31666","NAIROBI","ALL","40-44",139278,113884,253162
"31667","NAIROBI","ALL","45",28137,21111,49248
"31668","NAIROBI","ALL","46",19749,14969,34718
"31669","NAIROBI","ALL","47",20398,14741,35139
"31670","NAIROBI","ALL","48",15447,11472,26919
"31671","NAIROBI","ALL","49",16988,11920,28908
"31672","NAIROBI","ALL","45-49",100719,74213,174932
"31673","NAIROBI","ALL","50",18699,14032,32731
"31674","NAIROBI","ALL","51",12961,9112,22073
"31675","NAIROBI","ALL","52",13381,9179,22560
"31676","NAIROBI","ALL","53",9905,7611,17516
"31677","NAIROBI","ALL","54",11271,7798,19069
"31678","NAIROBI","ALL","50-54",66217,47732,113949
"31679","NAIROBI","ALL","55",10869,7263,18132
"31680","NAIROBI","ALL","56",10179,7370,17549
"31681","NAIROBI","ALL","57",8966,6677,15643
"31682","NAIROBI","ALL","58",7164,5147,12311
"31683","NAIROBI","ALL","59",7561,5405,12966
"31684","NAIROBI","ALL","55-59",44739,31862,76601
"31685","NAIROBI","ALL","60",7694,6148,13842
"31686","NAIROBI","ALL","61",5197,3948,9145
"31687","NAIROBI","ALL","62",4853,3447,8300
"31688","NAIROBI","ALL","63",4051,3103,7154
"31689","NAIROBI","ALL","64",3106,2437,5543
"31690","NAIROBI","ALL","60-64",24901,19083,43984
"31691","NAIROBI","ALL","65",3992,3256,7248
"31692","NAIROBI","ALL","66",2591,2191,4782
"31693","NAIROBI","ALL","67",3553,2762,6315
"31694","NAIROBI","ALL","68",1914,1612,3526
"31695","NAIROBI","ALL","69",2408,2104,4512
"31696","NAIROBI","ALL","65-69",14458,11925,26383
"31697","NAIROBI","ALL","70",2676,2653,5329
"31698","NAIROBI","ALL","71",1797,1541,3338
"31699","NAIROBI","ALL","72",1672,1376,3048
"31700","NAIROBI","ALL","73",1295,1119,2414
"31701","NAIROBI","ALL","74",1129,1096,2225
"31702","NAIROBI","ALL","70-74",8569,7785,16354
"31703","NAIROBI","ALL","75",909,1084,1993
"31704","NAIROBI","ALL","76",849,947,1796
"31705","NAIROBI","ALL","77",682,763,1445
"31706","NAIROBI","ALL","78",505,516,1021
"31707","NAIROBI","ALL","79",530,652,1182
"31708","NAIROBI","ALL","75-79",3475,3962,7437
"31709","NAIROBI","ALL","80",603,917,1520
"31710","NAIROBI","ALL","81",302,432,734
"31711","NAIROBI","ALL","82",341,408,749
"31712","NAIROBI","ALL","83",335,388,723
"31713","NAIROBI","ALL","84",275,384,659
"31714","NAIROBI","ALL","80-84",1856,2529,4385
"31715","NAIROBI","ALL","85",243,335,578
"31716","NAIROBI","ALL","86",172,268,440
"31717","NAIROBI","ALL","87",155,270,425
"31718","NAIROBI","ALL","88",111,132,243
"31719","NAIROBI","ALL","89",116,248,364
"31720","NAIROBI","ALL","85-89",797,1253,2050
"31721","NAIROBI","ALL","90",89,218,307
"31722","NAIROBI","ALL","91",65,135,200
"31723","NAIROBI","ALL","92",47,98,145
"31724","NAIROBI","ALL","93",39,75,114
"31725","NAIROBI","ALL","94",30,77,107
"31726","NAIROBI","ALL","90-94",270,603,873
"31727","NAIROBI","ALL","95",32,108,140
"31728","NAIROBI","ALL","96",29,65,94
"31729","NAIROBI","ALL","97",22,46,68
"31730","NAIROBI","ALL","98",16,34,50
"31731","NAIROBI","ALL","99",16,66,82
"31732","NAIROBI","ALL","95-99",115,319,434
"31733","NAIROBI","ALL","100+",35,171,206
"31734","NAIROBI","ALL","Not Stated",74,69,143
"31735","NAIROBI","DAGORETTI","Total",217651,216526,434177
"31736","NAIROBI","DAGORETTI","0",6004,5820,11824
"31737","NAIROBI","DAGORETTI","1",5785,5715,11500
"31738","NAIROBI","DAGORETTI","2",5241,5462,10703
"31739","NAIROBI","DAGORETTI","3",5172,5285,10457
"31740","NAIROBI","DAGORETTI","4",4814,4691,9505
"31741","NAIROBI","DAGORETTI","0 - 4",27016,26973,53989
"31742","NAIROBI","DAGORETTI","5",4395,4548,8943
"31743","NAIROBI","DAGORETTI","6",4367,4531,8898
"31744","NAIROBI","DAGORETTI","7",4465,4340,8805
"31745","NAIROBI","DAGORETTI","8",4112,4220,8332
"31746","NAIROBI","DAGORETTI","9",4186,4392,8578
"31747","NAIROBI","DAGORETTI","5-9",21525,22031,43556
"31748","NAIROBI","DAGORETTI","10",4070,4185,8255
"31749","NAIROBI","DAGORETTI","11",3528,3671,7199
"31750","NAIROBI","DAGORETTI","12",3791,4076,7867
"31751","NAIROBI","DAGORETTI","13",3848,3984,7832
"31752","NAIROBI","DAGORETTI","14",3410,3695,7105
"31753","NAIROBI","DAGORETTI","10 -14",18647,19611,38258
"31754","NAIROBI","DAGORETTI","15",3028,3461,6489
"31755","NAIROBI","DAGORETTI","16",3024,3490,6514
"31756","NAIROBI","DAGORETTI","17",3263,3711,6974
"31757","NAIROBI","DAGORETTI","18",2857,3368,6225
"31758","NAIROBI","DAGORETTI","19",3529,4371,7900
"31759","NAIROBI","DAGORETTI","15-19",15701,18401,34102
"31760","NAIROBI","DAGORETTI","20",3764,5189,8953
"31761","NAIROBI","DAGORETTI","21",4323,5574,9897
"31762","NAIROBI","DAGORETTI","22",4786,5822,10608
"31763","NAIROBI","DAGORETTI","23",5487,6626,12113
"31764","NAIROBI","DAGORETTI","24",5800,6511,12311
"31765","NAIROBI","DAGORETTI","20-24",24160,29722,53882
"31766","NAIROBI","DAGORETTI","25",6281,6717,12998
"31767","NAIROBI","DAGORETTI","26",5814,6117,11931
"31768","NAIROBI","DAGORETTI","27",5969,6067,12036
"31769","NAIROBI","DAGORETTI","28",5298,5196,10494
"31770","NAIROBI","DAGORETTI","29",5559,5425,10984
"31771","NAIROBI","DAGORETTI","25-29",28921,29522,58443
"31772","NAIROBI","DAGORETTI","30",6402,6357,12759
"31773","NAIROBI","DAGORETTI","31",4555,4159,8714
"31774","NAIROBI","DAGORETTI","32",5708,5365,11073
"31775","NAIROBI","DAGORETTI","33",4322,4168,8490
"31776","NAIROBI","DAGORETTI","34",4009,3833,7842
"31777","NAIROBI","DAGORETTI","30-34",24996,23882,48878
"31778","NAIROBI","DAGORETTI","35",4847,4267,9114
"31779","NAIROBI","DAGORETTI","36",3588,3264,6852
"31780","NAIROBI","DAGORETTI","37",3415,3021,6436
"31781","NAIROBI","DAGORETTI","38",2918,2810,5728
"31782","NAIROBI","DAGORETTI","39",3015,2666,5681
"31783","NAIROBI","DAGORETTI","35-39",17783,16028,33811
"31784","NAIROBI","DAGORETTI","40",3534,3056,6590
"31785","NAIROBI","DAGORETTI","41",2908,2383,5291
"31786","NAIROBI","DAGORETTI","42",2916,2333,5249
"31787","NAIROBI","DAGORETTI","43",2377,2028,4405
"31788","NAIROBI","DAGORETTI","44",1881,1549,3430
"31789","NAIROBI","DAGORETTI","40-44",13616,11349,24965
"31790","NAIROBI","DAGORETTI","45",2722,2138,4860
"31791","NAIROBI","DAGORETTI","46",2002,1485,3487
"31792","NAIROBI","DAGORETTI","47",2092,1460,3552
"31793","NAIROBI","DAGORETTI","48",1490,1096,2586
"31794","NAIROBI","DAGORETTI","49",1685,1146,2831
"31795","NAIROBI","DAGORETTI","45-49",9991,7325,17316
"31796","NAIROBI","DAGORETTI","50",1775,1291,3066
"31797","NAIROBI","DAGORETTI","51",1297,901,2198
"31798","NAIROBI","DAGORETTI","52",1281,881,2162
"31799","NAIROBI","DAGORETTI","53",998,667,1665
"31800","NAIROBI","DAGORETTI","54",999,750,1749
"31801","NAIROBI","DAGORETTI","50-54",6350,4490,10840
"31802","NAIROBI","DAGORETTI","55",1031,674,1705
"31803","NAIROBI","DAGORETTI","56",944,640,1584
"31804","NAIROBI","DAGORETTI","57",843,613,1456
"31805","NAIROBI","DAGORETTI","58",606,461,1067
"31806","NAIROBI","DAGORETTI","59",682,480,1162
"31807","NAIROBI","DAGORETTI","55-59",4106,2868,6974
"31808","NAIROBI","DAGORETTI","60",733,571,1304
"31809","NAIROBI","DAGORETTI","61",468,335,803
"31810","NAIROBI","DAGORETTI","62",461,312,773
"31811","NAIROBI","DAGORETTI","63",383,266,649
"31812","NAIROBI","DAGORETTI","64",258,193,451
"31813","NAIROBI","DAGORETTI","60-64",2303,1677,3980
"31814","NAIROBI","DAGORETTI","65",336,276,612
"31815","NAIROBI","DAGORETTI","66",186,187,373
"31816","NAIROBI","DAGORETTI","67",351,236,587
"31817","NAIROBI","DAGORETTI","68",132,126,258
"31818","NAIROBI","DAGORETTI","69",204,171,375
"31819","NAIROBI","DAGORETTI","65-69",1209,996,2205
"31820","NAIROBI","DAGORETTI","70",238,200,438
"31821","NAIROBI","DAGORETTI","71",148,155,303
"31822","NAIROBI","DAGORETTI","72",146,117,263
"31823","NAIROBI","DAGORETTI","73",107,90,197
"31824","NAIROBI","DAGORETTI","74",94,106,200
"31825","NAIROBI","DAGORETTI","70-74",733,668,1401
"31826","NAIROBI","DAGORETTI","75",62,97,159
"31827","NAIROBI","DAGORETTI","76",84,114,198
"31828","NAIROBI","DAGORETTI","77",58,86,144
"31829","NAIROBI","DAGORETTI","78",45,55,100
"31830","NAIROBI","DAGORETTI","79",56,72,128
"31831","NAIROBI","DAGORETTI","75-79",305,424,729
"31832","NAIROBI","DAGORETTI","80",52,97,149
"31833","NAIROBI","DAGORETTI","81",23,49,72
"31834","NAIROBI","DAGORETTI","82",27,35,62
"31835","NAIROBI","DAGORETTI","83",31,42,73
"31836","NAIROBI","DAGORETTI","84",27,38,65
"31837","NAIROBI","DAGORETTI","80-84",160,261,421
"31838","NAIROBI","DAGORETTI","85",24,44,68
"31839","NAIROBI","DAGORETTI","86",17,37,54
"31840","NAIROBI","DAGORETTI","87",15,27,42
"31841","NAIROBI","DAGORETTI","88",9,12,21
"31842","NAIROBI","DAGORETTI","89",9,26,35
"31843","NAIROBI","DAGORETTI","85-89",74,146,220
"31844","NAIROBI","DAGORETTI","90",13,27,40
"31845","NAIROBI","DAGORETTI","91",7,14,21
"31846","NAIROBI","DAGORETTI","92",2,13,15
"31847","NAIROBI","DAGORETTI","93",4,9,13
"31848","NAIROBI","DAGORETTI","94",5,14,19
"31849","NAIROBI","DAGORETTI","90-94",31,77,108
"31850","NAIROBI","DAGORETTI","95",6,19,25
"31851","NAIROBI","DAGORETTI","96",1,10,11
"31852","NAIROBI","DAGORETTI","97",1,8,9
"31853","NAIROBI","DAGORETTI","98",2,3,5
"31854","NAIROBI","DAGORETTI","99",1,4,5
"31855","NAIROBI","DAGORETTI","95-99",11,44,55
"31856","NAIROBI","DAGORETTI","100+",2,24,26
"31857","NAIROBI","DAGORETTI","Not Stated",11,7,18
"31858","NAIROBI","EMBAKASI","Total",492476,496270,988746
"31859","NAIROBI","EMBAKASI","0",13913,13982,27895
"31860","NAIROBI","EMBAKASI","1",13420,13073,26493
"31861","NAIROBI","EMBAKASI","2",12537,12367,24904
"31862","NAIROBI","EMBAKASI","3",12206,12172,24378
"31863","NAIROBI","EMBAKASI","4",11112,11176,22288
"31864","NAIROBI","EMBAKASI","0 - 4",63188,62770,125958
"31865","NAIROBI","EMBAKASI","5",10638,10405,21043
"31866","NAIROBI","EMBAKASI","6",10083,10174,20257
"31867","NAIROBI","EMBAKASI","7",9841,9890,19731
"31868","NAIROBI","EMBAKASI","8",9246,9295,18541
"31869","NAIROBI","EMBAKASI","9",9305,9657,18962
"31870","NAIROBI","EMBAKASI","5-9",49113,49421,98534
"31871","NAIROBI","EMBAKASI","10",8910,8981,17891
"31872","NAIROBI","EMBAKASI","11",7704,8195,15899
"31873","NAIROBI","EMBAKASI","12",8037,8494,16531
"31874","NAIROBI","EMBAKASI","13",7570,8222,15792
"31875","NAIROBI","EMBAKASI","14",6850,7477,14327
"31876","NAIROBI","EMBAKASI","10 -14",39071,41369,80440
"31877","NAIROBI","EMBAKASI","15",6120,7280,13400
"31878","NAIROBI","EMBAKASI","16",5990,7300,13290
"31879","NAIROBI","EMBAKASI","17",6150,7956,14106
"31880","NAIROBI","EMBAKASI","18",5634,7839,13473
"31881","NAIROBI","EMBAKASI","19",7073,10781,17854
"31882","NAIROBI","EMBAKASI","15-19",30967,41156,72123
"31883","NAIROBI","EMBAKASI","20",7990,12731,20721
"31884","NAIROBI","EMBAKASI","21",9271,13386,22657
"31885","NAIROBI","EMBAKASI","22",10153,14570,24723
"31886","NAIROBI","EMBAKASI","23",12570,17129,29699
"31887","NAIROBI","EMBAKASI","24",13336,16815,30151
"31888","NAIROBI","EMBAKASI","20-24",53320,74631,127951
"31889","NAIROBI","EMBAKASI","25",15569,17820,33389
"31890","NAIROBI","EMBAKASI","26",14107,15890,29997
"31891","NAIROBI","EMBAKASI","27",14536,15293,29829
"31892","NAIROBI","EMBAKASI","28",12787,13686,26473
"31893","NAIROBI","EMBAKASI","29",14254,14202,28456
"31894","NAIROBI","EMBAKASI","25-29",71253,76891,148144
"31895","NAIROBI","EMBAKASI","30",16747,16733,33480
"31896","NAIROBI","EMBAKASI","31",11696,10539,22235
"31897","NAIROBI","EMBAKASI","32",14601,13359,27960
"31898","NAIROBI","EMBAKASI","33",11258,10233,21491
"31899","NAIROBI","EMBAKASI","34",10524,9316,19840
"31900","NAIROBI","EMBAKASI","30-34",64826,60180,125006
"31901","NAIROBI","EMBAKASI","35",12339,9964,22303
"31902","NAIROBI","EMBAKASI","36",8738,7599,16337
"31903","NAIROBI","EMBAKASI","37",8459,6785,15244
"31904","NAIROBI","EMBAKASI","38",7508,6386,13894
"31905","NAIROBI","EMBAKASI","39",7684,6103,13787
"31906","NAIROBI","EMBAKASI","35-39",44728,36837,81565
"31907","NAIROBI","EMBAKASI","40",8537,6398,14935
"31908","NAIROBI","EMBAKASI","41",6853,4782,11635
"31909","NAIROBI","EMBAKASI","42",6402,4581,10983
"31910","NAIROBI","EMBAKASI","43",5460,3811,9271
"31911","NAIROBI","EMBAKASI","44",4259,3058,7317
"31912","NAIROBI","EMBAKASI","40-44",31511,22630,54141
"31913","NAIROBI","EMBAKASI","45",6003,3805,9808
"31914","NAIROBI","EMBAKASI","46",4003,2577,6580
"31915","NAIROBI","EMBAKASI","47",4020,2550,6570
"31916","NAIROBI","EMBAKASI","48",2966,1890,4856
"31917","NAIROBI","EMBAKASI","49",3268,2020,5288
"31918","NAIROBI","EMBAKASI","45-49",20260,12842,33102
"31919","NAIROBI","EMBAKASI","50",3393,2237,5630
"31920","NAIROBI","EMBAKASI","51",2313,1461,3774
"31921","NAIROBI","EMBAKASI","52",2193,1370,3563
"31922","NAIROBI","EMBAKASI","53",1617,1358,2975
"31923","NAIROBI","EMBAKASI","54",1871,1093,2964
"31924","NAIROBI","EMBAKASI","50-54",11387,7519,18906
"31925","NAIROBI","EMBAKASI","55",1675,1029,2704
"31926","NAIROBI","EMBAKASI","56",1493,1069,2562
"31927","NAIROBI","EMBAKASI","57",1273,952,2225
"31928","NAIROBI","EMBAKASI","58",976,734,1710
"31929","NAIROBI","EMBAKASI","59",1112,782,1894
"31930","NAIROBI","EMBAKASI","55-59",6529,4566,11095
"31931","NAIROBI","EMBAKASI","60",1037,830,1867
"31932","NAIROBI","EMBAKASI","61",739,520,1259
"31933","NAIROBI","EMBAKASI","62",668,430,1098
"31934","NAIROBI","EMBAKASI","63",507,356,863
"31935","NAIROBI","EMBAKASI","64",428,284,712
"31936","NAIROBI","EMBAKASI","60-64",3379,2420,5799
"31937","NAIROBI","EMBAKASI","65",434,398,832
"31938","NAIROBI","EMBAKASI","66",298,267,565
"31939","NAIROBI","EMBAKASI","67",370,351,721
"31940","NAIROBI","EMBAKASI","68",199,176,375
"31941","NAIROBI","EMBAKASI","69",279,227,506
"31942","NAIROBI","EMBAKASI","65-69",1580,1419,2999
"31943","NAIROBI","EMBAKASI","70",293,317,610
"31944","NAIROBI","EMBAKASI","71",192,170,362
"31945","NAIROBI","EMBAKASI","72",157,135,292
"31946","NAIROBI","EMBAKASI","73",128,96,224
"31947","NAIROBI","EMBAKASI","74",97,88,185
"31948","NAIROBI","EMBAKASI","70-74",867,806,1673
"31949","NAIROBI","EMBAKASI","75",87,108,195
"31950","NAIROBI","EMBAKASI","76",53,72,125
"31951","NAIROBI","EMBAKASI","77",45,58,103
"31952","NAIROBI","EMBAKASI","78",31,64,95
"31953","NAIROBI","EMBAKASI","79",51,51,102
"31954","NAIROBI","EMBAKASI","75-79",267,353,620
"31955","NAIROBI","EMBAKASI","80",54,89,143
"31956","NAIROBI","EMBAKASI","81",19,30,49
"31957","NAIROBI","EMBAKASI","82",20,29,49
"31958","NAIROBI","EMBAKASI","83",22,30,52
"31959","NAIROBI","EMBAKASI","84",19,42,61
"31960","NAIROBI","EMBAKASI","80-84",134,220,354
"31961","NAIROBI","EMBAKASI","85",16,28,44
"31962","NAIROBI","EMBAKASI","86",8,19,27
"31963","NAIROBI","EMBAKASI","87",15,32,47
"31964","NAIROBI","EMBAKASI","88",7,7,14
"31965","NAIROBI","EMBAKASI","89",9,19,28
"31966","NAIROBI","EMBAKASI","85-89",55,105,160
"31967","NAIROBI","EMBAKASI","90",6,30,36
"31968","NAIROBI","EMBAKASI","91",1,17,18
"31969","NAIROBI","EMBAKASI","92",4,6,10
"31970","NAIROBI","EMBAKASI","93",2,4,6
"31971","NAIROBI","EMBAKASI","94",2,8,10
"31972","NAIROBI","EMBAKASI","90-94",15,65,80
"31973","NAIROBI","EMBAKASI","95",2,18,20
"31974","NAIROBI","EMBAKASI","96",2,4,6
"31975","NAIROBI","EMBAKASI","97",2,3,5
"31976","NAIROBI","EMBAKASI","98",1,2,3
"31977","NAIROBI","EMBAKASI","99",1,9,10
"31978","NAIROBI","EMBAKASI","95-99",8,36,44
"31979","NAIROBI","EMBAKASI","100+",4,22,26
"31980","NAIROBI","EMBAKASI","Not Stated",14,12,26
"31981","NAIROBI","KAMUKUNJI","Total",136670,131599,268269
"31982","NAIROBI","KAMUKUNJI","0",3769,3723,7492
"31983","NAIROBI","KAMUKUNJI","1",3560,3428,6988
"31984","NAIROBI","KAMUKUNJI","2",3454,3260,6714
"31985","NAIROBI","KAMUKUNJI","3",3397,3191,6588
"31986","NAIROBI","KAMUKUNJI","4",3133,3072,6205
"31987","NAIROBI","KAMUKUNJI","0 - 4",17313,16674,33987
"31988","NAIROBI","KAMUKUNJI","5",3145,2926,6071
"31989","NAIROBI","KAMUKUNJI","6",2802,2818,5620
"31990","NAIROBI","KAMUKUNJI","7",2802,2831,5633
"31991","NAIROBI","KAMUKUNJI","8",2590,2583,5173
"31992","NAIROBI","KAMUKUNJI","9",2647,2642,5289
"31993","NAIROBI","KAMUKUNJI","5-9",13986,13800,27786
"31994","NAIROBI","KAMUKUNJI","10",2604,2576,5180
"31995","NAIROBI","KAMUKUNJI","11",2243,2336,4579
"31996","NAIROBI","KAMUKUNJI","12",2347,2413,4760
"31997","NAIROBI","KAMUKUNJI","13",2338,2524,4862
"31998","NAIROBI","KAMUKUNJI","14",2328,2340,4668
"31999","NAIROBI","KAMUKUNJI","10 -14",11860,12189,24049
"32000","NAIROBI","KAMUKUNJI","15",2118,2391,4509
"32001","NAIROBI","KAMUKUNJI","16",2208,2573,4781
"32002","NAIROBI","KAMUKUNJI","17",2419,2673,5092
"32003","NAIROBI","KAMUKUNJI","18",2216,2515,4731
"32004","NAIROBI","KAMUKUNJI","19",2643,3163,5806
"32005","NAIROBI","KAMUKUNJI","15-19",11604,13315,24919
"32006","NAIROBI","KAMUKUNJI","20",3109,3791,6900
"32007","NAIROBI","KAMUKUNJI","21",3410,3615,7025
"32008","NAIROBI","KAMUKUNJI","22",3699,4005,7704
"32009","NAIROBI","KAMUKUNJI","23",4019,4142,8161
"32010","NAIROBI","KAMUKUNJI","24",3922,3906,7828
"32011","NAIROBI","KAMUKUNJI","20-24",18159,19459,37618
"32012","NAIROBI","KAMUKUNJI","25",4345,4145,8490
"32013","NAIROBI","KAMUKUNJI","26",3572,3544,7116
"32014","NAIROBI","KAMUKUNJI","27",3541,3361,6902
"32015","NAIROBI","KAMUKUNJI","28",3087,2938,6025
"32016","NAIROBI","KAMUKUNJI","29",2965,2836,5801
"32017","NAIROBI","KAMUKUNJI","25-29",17510,16824,34334
"32018","NAIROBI","KAMUKUNJI","30",3654,3663,7317
"32019","NAIROBI","KAMUKUNJI","31",2486,2246,4732
"32020","NAIROBI","KAMUKUNJI","32",3036,2909,5945
"32021","NAIROBI","KAMUKUNJI","33",2374,2258,4632
"32022","NAIROBI","KAMUKUNJI","34",2184,2063,4247
"32023","NAIROBI","KAMUKUNJI","30-34",13734,13139,26873
"32024","NAIROBI","KAMUKUNJI","35",2840,2417,5257
"32025","NAIROBI","KAMUKUNJI","36",1918,1684,3602
"32026","NAIROBI","KAMUKUNJI","37",1832,1643,3475
"32027","NAIROBI","KAMUKUNJI","38",1624,1369,2993
"32028","NAIROBI","KAMUKUNJI","39",1726,1357,3083
"32029","NAIROBI","KAMUKUNJI","35-39",9940,8470,18410
"32030","NAIROBI","KAMUKUNJI","40",2241,1733,3974
"32031","NAIROBI","KAMUKUNJI","41",1614,1207,2821
"32032","NAIROBI","KAMUKUNJI","42",1560,1165,2725
"32033","NAIROBI","KAMUKUNJI","43",1323,1016,2339
"32034","NAIROBI","KAMUKUNJI","44",1002,822,1824
"32035","NAIROBI","KAMUKUNJI","40-44",7740,5943,13683
"32036","NAIROBI","KAMUKUNJI","45",1634,1265,2899
"32037","NAIROBI","KAMUKUNJI","46",1082,764,1846
"32038","NAIROBI","KAMUKUNJI","47",1048,763,1811
"32039","NAIROBI","KAMUKUNJI","48",797,596,1393
"32040","NAIROBI","KAMUKUNJI","49",904,689,1593
"32041","NAIROBI","KAMUKUNJI","45-49",5465,4077,9542
"32042","NAIROBI","KAMUKUNJI","50",1054,826,1880
"32043","NAIROBI","KAMUKUNJI","51",680,478,1158
"32044","NAIROBI","KAMUKUNJI","52",722,486,1208
"32045","NAIROBI","KAMUKUNJI","53",527,421,948
"32046","NAIROBI","KAMUKUNJI","54",605,423,1028
"32047","NAIROBI","KAMUKUNJI","50-54",3588,2634,6222
"32048","NAIROBI","KAMUKUNJI","55",623,457,1080
"32049","NAIROBI","KAMUKUNJI","56",516,411,927
"32050","NAIROBI","KAMUKUNJI","57",510,379,889
"32051","NAIROBI","KAMUKUNJI","58",378,265,643
"32052","NAIROBI","KAMUKUNJI","59",401,338,739
"32053","NAIROBI","KAMUKUNJI","55-59",2428,1850,4278
"32054","NAIROBI","KAMUKUNJI","60",476,503,979
"32055","NAIROBI","KAMUKUNJI","61",273,239,512
"32056","NAIROBI","KAMUKUNJI","62",267,218,485
"32057","NAIROBI","KAMUKUNJI","63",241,187,428
"32058","NAIROBI","KAMUKUNJI","64",165,161,326
"32059","NAIROBI","KAMUKUNJI","60-64",1422,1308,2730
"32060","NAIROBI","KAMUKUNJI","65",259,283,542
"32061","NAIROBI","KAMUKUNJI","66",155,127,282
"32062","NAIROBI","KAMUKUNJI","67",201,175,376
"32063","NAIROBI","KAMUKUNJI","68",100,96,196
"32064","NAIROBI","KAMUKUNJI","69",133,150,283
"32065","NAIROBI","KAMUKUNJI","65-69",848,831,1679
"32066","NAIROBI","KAMUKUNJI","70",234,252,486
"32067","NAIROBI","KAMUKUNJI","71",120,106,226
"32068","NAIROBI","KAMUKUNJI","72",127,94,221
"32069","NAIROBI","KAMUKUNJI","73",102,63,165
"32070","NAIROBI","KAMUKUNJI","74",88,68,156
"32071","NAIROBI","KAMUKUNJI","70-74",671,583,1254
"32072","NAIROBI","KAMUKUNJI","75",67,91,158
"32073","NAIROBI","KAMUKUNJI","76",50,60,110
"32074","NAIROBI","KAMUKUNJI","77",43,44,87
"32075","NAIROBI","KAMUKUNJI","78",40,23,63
"32076","NAIROBI","KAMUKUNJI","79",28,31,59
"32077","NAIROBI","KAMUKUNJI","75-79",228,249,477
"32078","NAIROBI","KAMUKUNJI","80",39,80,119
"32079","NAIROBI","KAMUKUNJI","81",24,19,43
"32080","NAIROBI","KAMUKUNJI","82",18,14,32
"32081","NAIROBI","KAMUKUNJI","83",17,11,28
"32082","NAIROBI","KAMUKUNJI","84",17,21,38
"32083","NAIROBI","KAMUKUNJI","80-84",115,145,260
"32084","NAIROBI","KAMUKUNJI","85",16,18,34
"32085","NAIROBI","KAMUKUNJI","86",8,8,16
"32086","NAIROBI","KAMUKUNJI","87",5,13,18
"32087","NAIROBI","KAMUKUNJI","88",1,3,4
"32088","NAIROBI","KAMUKUNJI","89",5,9,14
"32089","NAIROBI","KAMUKUNJI","85-89",35,51,86
"32090","NAIROBI","KAMUKUNJI","90",4,18,22
"32091","NAIROBI","KAMUKUNJI","91",5,11,16
"32092","NAIROBI","KAMUKUNJI","92",1,5,6
"32093","NAIROBI","KAMUKUNJI","93",2,2,4
"32094","NAIROBI","KAMUKUNJI","94",NA,2,2
"32095","NAIROBI","KAMUKUNJI","90-94",12,38,50
"32096","NAIROBI","KAMUKUNJI","95",NA,4,4
"32097","NAIROBI","KAMUKUNJI","96",1,NA,1
"32098","NAIROBI","KAMUKUNJI","97",2,NA,2
"32099","NAIROBI","KAMUKUNJI","98",NA,2,2
"32100","NAIROBI","KAMUKUNJI","99",NA,1,1
"32101","NAIROBI","KAMUKUNJI","95-99",3,7,10
"32102","NAIROBI","KAMUKUNJI","100+",1,9,10
"32103","NAIROBI","KAMUKUNJI","Not Stated",8,4,12
"32104","NAIROBI","KASARANI","Total",381234,399385,780619
"32105","NAIROBI","KASARANI","0",10662,10899,21561
"32106","NAIROBI","KASARANI","1",10525,10281,20806
"32107","NAIROBI","KASARANI","2",9741,9825,19566
"32108","NAIROBI","KASARANI","3",9252,9393,18645
"32109","NAIROBI","KASARANI","4",8631,8463,17094
"32110","NAIROBI","KASARANI","0 - 4",48811,48861,97672
"32111","NAIROBI","KASARANI","5",8166,8085,16251
"32112","NAIROBI","KASARANI","6",7940,7967,15907
"32113","NAIROBI","KASARANI","7",7720,7957,15677
"32114","NAIROBI","KASARANI","8",7296,7508,14804
"32115","NAIROBI","KASARANI","9",7397,7595,14992
"32116","NAIROBI","KASARANI","5-9",38519,39112,77631
"32117","NAIROBI","KASARANI","10",7258,7176,14434
"32118","NAIROBI","KASARANI","11",6234,6701,12935
"32119","NAIROBI","KASARANI","12",6617,6988,13605
"32120","NAIROBI","KASARANI","13",6519,7094,13613
"32121","NAIROBI","KASARANI","14",6014,6352,12366
"32122","NAIROBI","KASARANI","10 -14",32642,34311,66953
"32123","NAIROBI","KASARANI","15",5429,6215,11644
"32124","NAIROBI","KASARANI","16",5158,6194,11352
"32125","NAIROBI","KASARANI","17",5547,6686,12233
"32126","NAIROBI","KASARANI","18",4870,6478,11348
"32127","NAIROBI","KASARANI","19",6269,8667,14936
"32128","NAIROBI","KASARANI","15-19",27273,34240,61513
"32129","NAIROBI","KASARANI","20",6517,10050,16567
"32130","NAIROBI","KASARANI","21",7526,10640,18166
"32131","NAIROBI","KASARANI","22",8486,11820,20306
"32132","NAIROBI","KASARANI","23",10215,13444,23659
"32133","NAIROBI","KASARANI","24",10358,13147,23505
"32134","NAIROBI","KASARANI","20-24",43102,59101,102203
"32135","NAIROBI","KASARANI","25",11221,13488,24709
"32136","NAIROBI","KASARANI","26",10052,12207,22259
"32137","NAIROBI","KASARANI","27",10716,11797,22513
"32138","NAIROBI","KASARANI","28",9375,10611,19986
"32139","NAIROBI","KASARANI","29",10137,10524,20661
"32140","NAIROBI","KASARANI","25-29",51501,58627,110128
"32141","NAIROBI","KASARANI","30",11814,12495,24309
"32142","NAIROBI","KASARANI","31",8111,8079,16190
"32143","NAIROBI","KASARANI","32",10036,10207,20243
"32144","NAIROBI","KASARANI","33",7854,8082,15936
"32145","NAIROBI","KASARANI","34",7425,7514,14939
"32146","NAIROBI","KASARANI","30-34",45240,46377,91617
"32147","NAIROBI","KASARANI","35",8575,7957,16532
"32148","NAIROBI","KASARANI","36",6147,5943,12090
"32149","NAIROBI","KASARANI","37",6040,5405,11445
"32150","NAIROBI","KASARANI","38",5226,5114,10340
"32151","NAIROBI","KASARANI","39",5360,4743,10103
"32152","NAIROBI","KASARANI","35-39",31348,29162,60510
"32153","NAIROBI","KASARANI","40",6333,5222,11555
"32154","NAIROBI","KASARANI","41",4817,3960,8777
"32155","NAIROBI","KASARANI","42",4632,3721,8353
"32156","NAIROBI","KASARANI","43",3818,3296,7114
"32157","NAIROBI","KASARANI","44",3023,2641,5664
"32158","NAIROBI","KASARANI","40-44",22623,18840,41463
"32159","NAIROBI","KASARANI","45",4271,3520,7791
"32160","NAIROBI","KASARANI","46",3035,2375,5410
"32161","NAIROBI","KASARANI","47",3251,2400,5651
"32162","NAIROBI","KASARANI","48",2421,1841,4262
"32163","NAIROBI","KASARANI","49",2585,1853,4438
"32164","NAIROBI","KASARANI","45-49",15563,11989,27552
"32165","NAIROBI","KASARANI","50",2874,2279,5153
"32166","NAIROBI","KASARANI","51",1996,1428,3424
"32167","NAIROBI","KASARANI","52",2177,1506,3683
"32168","NAIROBI","KASARANI","53",1522,1134,2656
"32169","NAIROBI","KASARANI","54",1744,1259,3003
"32170","NAIROBI","KASARANI","50-54",10313,7606,17919
"32171","NAIROBI","KASARANI","55",1747,1180,2927
"32172","NAIROBI","KASARANI","56",1649,1154,2803
"32173","NAIROBI","KASARANI","57",1331,1013,2344
"32174","NAIROBI","KASARANI","58",1121,745,1866
"32175","NAIROBI","KASARANI","59",1102,796,1898
"32176","NAIROBI","KASARANI","55-59",6950,4888,11838
"32177","NAIROBI","KASARANI","60",1204,863,2067
"32178","NAIROBI","KASARANI","61",739,575,1314
"32179","NAIROBI","KASARANI","62",666,482,1148
"32180","NAIROBI","KASARANI","63",569,449,1018
"32181","NAIROBI","KASARANI","64",423,308,731
"32182","NAIROBI","KASARANI","60-64",3601,2677,6278
"32183","NAIROBI","KASARANI","65",590,446,1036
"32184","NAIROBI","KASARANI","66",362,276,638
"32185","NAIROBI","KASARANI","67",507,389,896
"32186","NAIROBI","KASARANI","68",244,189,433
"32187","NAIROBI","KASARANI","69",303,268,571
"32188","NAIROBI","KASARANI","65-69",2006,1568,3574
"32189","NAIROBI","KASARANI","70",336,349,685
"32190","NAIROBI","KASARANI","71",239,174,413
"32191","NAIROBI","KASARANI","72",207,146,353
"32192","NAIROBI","KASARANI","73",154,120,274
"32193","NAIROBI","KASARANI","74",126,141,267
"32194","NAIROBI","KASARANI","70-74",1062,930,1992
"32195","NAIROBI","KASARANI","75",82,121,203
"32196","NAIROBI","KASARANI","76",91,114,205
"32197","NAIROBI","KASARANI","77",75,74,149
"32198","NAIROBI","KASARANI","78",47,53,100
"32199","NAIROBI","KASARANI","79",52,84,136
"32200","NAIROBI","KASARANI","75-79",347,446,793
"32201","NAIROBI","KASARANI","80",73,119,192
"32202","NAIROBI","KASARANI","81",24,56,80
"32203","NAIROBI","KASARANI","82",23,40,63
"32204","NAIROBI","KASARANI","83",31,50,81
"32205","NAIROBI","KASARANI","84",28,53,81
"32206","NAIROBI","KASARANI","80-84",179,318,497
"32207","NAIROBI","KASARANI","85",23,36,59
"32208","NAIROBI","KASARANI","86",16,25,41
"32209","NAIROBI","KASARANI","87",10,35,45
"32210","NAIROBI","KASARANI","88",13,14,27
"32211","NAIROBI","KASARANI","89",18,41,59
"32212","NAIROBI","KASARANI","85-89",80,151,231
"32213","NAIROBI","KASARANI","90",5,28,33
"32214","NAIROBI","KASARANI","91",14,19,33
"32215","NAIROBI","KASARANI","92",8,15,23
"32216","NAIROBI","KASARANI","93",5,9,14
"32217","NAIROBI","KASARANI","94",2,11,13
"32218","NAIROBI","KASARANI","90-94",34,82,116
"32219","NAIROBI","KASARANI","95",3,17,20
"32220","NAIROBI","KASARANI","96",5,10,15
"32221","NAIROBI","KASARANI","97",5,9,14
"32222","NAIROBI","KASARANI","98",6,6,12
"32223","NAIROBI","KASARANI","99",1,11,12
"32224","NAIROBI","KASARANI","95-99",20,53,73
"32225","NAIROBI","KASARANI","100+",10,30,40
"32226","NAIROBI","KASARANI","Not Stated",10,16,26
"32227","NAIROBI","KIBRA","Total",94199,91569,185768
"32228","NAIROBI","KIBRA","0",2163,2134,4297
"32229","NAIROBI","KIBRA","1",2107,2030,4137
"32230","NAIROBI","KIBRA","2",2011,2023,4034
"32231","NAIROBI","KIBRA","3",1979,1995,3974
"32232","NAIROBI","KIBRA","4",1812,1897,3709
"32233","NAIROBI","KIBRA","0 - 4",10072,10079,20151
"32234","NAIROBI","KIBRA","5",1791,1801,3592
"32235","NAIROBI","KIBRA","6",1860,1858,3718
"32236","NAIROBI","KIBRA","7",1885,1836,3721
"32237","NAIROBI","KIBRA","8",1785,1876,3661
"32238","NAIROBI","KIBRA","9",1861,1944,3805
"32239","NAIROBI","KIBRA","5-9",9182,9315,18497
"32240","NAIROBI","KIBRA","10",1903,1996,3899
"32241","NAIROBI","KIBRA","11",1751,1865,3616
"32242","NAIROBI","KIBRA","12",1850,2065,3915
"32243","NAIROBI","KIBRA","13",1911,2071,3982
"32244","NAIROBI","KIBRA","14",1781,1784,3565
"32245","NAIROBI","KIBRA","10 -14",9196,9781,18977
"32246","NAIROBI","KIBRA","15",1630,1733,3363
"32247","NAIROBI","KIBRA","16",1525,1754,3279
"32248","NAIROBI","KIBRA","17",1674,1883,3557
"32249","NAIROBI","KIBRA","18",1457,1668,3125
"32250","NAIROBI","KIBRA","19",1752,2088,3840
"32251","NAIROBI","KIBRA","15-19",8038,9126,17164
"32252","NAIROBI","KIBRA","20",1890,2264,4154
"32253","NAIROBI","KIBRA","21",1994,2240,4234
"32254","NAIROBI","KIBRA","22",2223,2399,4622
"32255","NAIROBI","KIBRA","23",2373,2639,5012
"32256","NAIROBI","KIBRA","24",2336,2403,4739
"32257","NAIROBI","KIBRA","20-24",10816,11945,22761
"32258","NAIROBI","KIBRA","25",2448,2347,4795
"32259","NAIROBI","KIBRA","26",2017,2176,4193
"32260","NAIROBI","KIBRA","27",2049,2270,4319
"32261","NAIROBI","KIBRA","28",1820,1797,3617
"32262","NAIROBI","KIBRA","29",1793,1871,3664
"32263","NAIROBI","KIBRA","25-29",10127,10461,20588
"32264","NAIROBI","KIBRA","30",2289,2488,4777
"32265","NAIROBI","KIBRA","31",1468,1544,3012
"32266","NAIROBI","KIBRA","32",2000,2118,4118
"32267","NAIROBI","KIBRA","33",1577,1589,3166
"32268","NAIROBI","KIBRA","34",1488,1658,3146
"32269","NAIROBI","KIBRA","30-34",8822,9397,18219
"32270","NAIROBI","KIBRA","35",1971,1839,3810
"32271","NAIROBI","KIBRA","36",1395,1335,2730
"32272","NAIROBI","KIBRA","37",1388,1233,2621
"32273","NAIROBI","KIBRA","38",1170,1155,2325
"32274","NAIROBI","KIBRA","39",1309,1166,2475
"32275","NAIROBI","KIBRA","35-39",7233,6728,13961
"32276","NAIROBI","KIBRA","40",1661,1413,3074
"32277","NAIROBI","KIBRA","41",1358,1137,2495
"32278","NAIROBI","KIBRA","42",1232,1093,2325
"32279","NAIROBI","KIBRA","43",1183,895,2078
"32280","NAIROBI","KIBRA","44",866,739,1605
"32281","NAIROBI","KIBRA","40-44",6300,5277,11577
"32282","NAIROBI","KIBRA","45",1389,970,2359
"32283","NAIROBI","KIBRA","46",1035,732,1767
"32284","NAIROBI","KIBRA","47",988,701,1689
"32285","NAIROBI","KIBRA","48",756,569,1325
"32286","NAIROBI","KIBRA","49",793,532,1325
"32287","NAIROBI","KIBRA","45-49",4961,3504,8465
"32288","NAIROBI","KIBRA","50",1052,695,1747
"32289","NAIROBI","KIBRA","51",736,462,1198
"32290","NAIROBI","KIBRA","52",664,408,1072
"32291","NAIROBI","KIBRA","53",547,336,883
"32292","NAIROBI","KIBRA","54",660,382,1042
"32293","NAIROBI","KIBRA","50-54",3659,2283,5942
"32294","NAIROBI","KIBRA","55",673,330,1003
"32295","NAIROBI","KIBRA","56",592,399,991
"32296","NAIROBI","KIBRA","57",570,363,933
"32297","NAIROBI","KIBRA","58",415,245,660
"32298","NAIROBI","KIBRA","59",429,254,683
"32299","NAIROBI","KIBRA","55-59",2679,1591,4270
"32300","NAIROBI","KIBRA","60",533,298,831
"32301","NAIROBI","KIBRA","61",341,190,531
"32302","NAIROBI","KIBRA","62",307,155,462
"32303","NAIROBI","KIBRA","63",250,159,409
"32304","NAIROBI","KIBRA","64",177,128,305
"32305","NAIROBI","KIBRA","60-64",1608,930,2538
"32306","NAIROBI","KIBRA","65",247,137,384
"32307","NAIROBI","KIBRA","66",129,113,242
"32308","NAIROBI","KIBRA","67",200,130,330
"32309","NAIROBI","KIBRA","68",107,73,180
"32310","NAIROBI","KIBRA","69",133,92,225
"32311","NAIROBI","KIBRA","65-69",816,545,1361
"32312","NAIROBI","KIBRA","70",133,110,243
"32313","NAIROBI","KIBRA","71",82,60,142
"32314","NAIROBI","KIBRA","72",75,48,123
"32315","NAIROBI","KIBRA","73",62,60,122
"32316","NAIROBI","KIBRA","74",52,51,103
"32317","NAIROBI","KIBRA","70-74",404,329,733
"32318","NAIROBI","KIBRA","75",52,44,96
"32319","NAIROBI","KIBRA","76",42,33,75
"32320","NAIROBI","KIBRA","77",24,30,54
"32321","NAIROBI","KIBRA","78",21,12,33
"32322","NAIROBI","KIBRA","79",21,23,44
"32323","NAIROBI","KIBRA","75-79",160,142,302
"32324","NAIROBI","KIBRA","80",22,20,42
"32325","NAIROBI","KIBRA","81",14,15,29
"32326","NAIROBI","KIBRA","82",18,12,30
"32327","NAIROBI","KIBRA","83",18,3,21
"32328","NAIROBI","KIBRA","84",9,14,23
"32329","NAIROBI","KIBRA","80-84",81,64,145
"32330","NAIROBI","KIBRA","85",7,5,12
"32331","NAIROBI","KIBRA","86",7,11,18
"32332","NAIROBI","KIBRA","87",3,4,7
"32333","NAIROBI","KIBRA","88",4,3,7
"32334","NAIROBI","KIBRA","89",6,9,15
"32335","NAIROBI","KIBRA","85-89",27,32,59
"32336","NAIROBI","KIBRA","90",3,3,6
"32337","NAIROBI","KIBRA","91",1,4,5
"32338","NAIROBI","KIBRA","92",2,3,5
"32339","NAIROBI","KIBRA","93",2,5,7
"32340","NAIROBI","KIBRA","94",4,1,5
"32341","NAIROBI","KIBRA","90-94",12,16,28
"32342","NAIROBI","KIBRA","95",1,3,4
"32343","NAIROBI","KIBRA","96",2,NA,2
"32344","NAIROBI","KIBRA","97",NA,NA,NA
"32345","NAIROBI","KIBRA","98",NA,1,1
"32346","NAIROBI","KIBRA","99",NA,5,5
"32347","NAIROBI","KIBRA","95-99",3,9,12
"32348","NAIROBI","KIBRA","100+",NA,11,11
"32349","NAIROBI","KIBRA","Not Stated",3,4,7
"32350","NAIROBI","LANG'ATA","Total",96698,100774,197472
"32351","NAIROBI","LANG'ATA","0",1828,1707,3535
"32352","NAIROBI","LANG'ATA","1",1857,1827,3684
"32353","NAIROBI","LANG'ATA","2",1822,1777,3599
"32354","NAIROBI","LANG'ATA","3",1796,1847,3643
"32355","NAIROBI","LANG'ATA","4",1759,1695,3454
"32356","NAIROBI","LANG'ATA","0 - 4",9062,8853,17915
"32357","NAIROBI","LANG'ATA","5",1765,1743,3508
"32358","NAIROBI","LANG'ATA","6",1735,1667,3402
"32359","NAIROBI","LANG'ATA","7",1769,1687,3456
"32360","NAIROBI","LANG'ATA","8",1705,1652,3357
"32361","NAIROBI","LANG'ATA","9",1728,1729,3457
"32362","NAIROBI","LANG'ATA","5-9",8702,8478,17180
"32363","NAIROBI","LANG'ATA","10",1659,1650,3309
"32364","NAIROBI","LANG'ATA","11",1552,1617,3169
"32365","NAIROBI","LANG'ATA","12",1608,1632,3240
"32366","NAIROBI","LANG'ATA","13",1528,1701,3229
"32367","NAIROBI","LANG'ATA","14",1558,1618,3176
"32368","NAIROBI","LANG'ATA","10 -14",7905,8218,16123
"32369","NAIROBI","LANG'ATA","15",1391,1573,2964
"32370","NAIROBI","LANG'ATA","16",1482,1720,3202
"32371","NAIROBI","LANG'ATA","17",1512,1683,3195
"32372","NAIROBI","LANG'ATA","18",1470,1836,3306
"32373","NAIROBI","LANG'ATA","19",1792,2303,4095
"32374","NAIROBI","LANG'ATA","15-19",7647,9115,16762
"32375","NAIROBI","LANG'ATA","20",1986,2541,4527
"32376","NAIROBI","LANG'ATA","21",2121,2652,4773
"32377","NAIROBI","LANG'ATA","22",2157,2700,4857
"32378","NAIROBI","LANG'ATA","23",2447,2878,5325
"32379","NAIROBI","LANG'ATA","24",2492,2681,5173
"32380","NAIROBI","LANG'ATA","20-24",11203,13452,24655
"32381","NAIROBI","LANG'ATA","25",2452,2680,5132
"32382","NAIROBI","LANG'ATA","26",2095,2440,4535
"32383","NAIROBI","LANG'ATA","27",2122,2318,4440
"32384","NAIROBI","LANG'ATA","28",1943,2077,4020
"32385","NAIROBI","LANG'ATA","29",1940,2226,4166
"32386","NAIROBI","LANG'ATA","25-29",10552,11741,22293
"32387","NAIROBI","LANG'ATA","30",2205,2604,4809
"32388","NAIROBI","LANG'ATA","31",1676,1867,3543
"32389","NAIROBI","LANG'ATA","32",2021,2295,4316
"32390","NAIROBI","LANG'ATA","33",1740,1890,3630
"32391","NAIROBI","LANG'ATA","34",1642,1790,3432
"32392","NAIROBI","LANG'ATA","30-34",9284,10446,19730
"32393","NAIROBI","LANG'ATA","35",1906,2089,3995
"32394","NAIROBI","LANG'ATA","36",1508,1594,3102
"32395","NAIROBI","LANG'ATA","37",1515,1534,3049
"32396","NAIROBI","LANG'ATA","38",1338,1502,2840
"32397","NAIROBI","LANG'ATA","39",1384,1517,2901
"32398","NAIROBI","LANG'ATA","35-39",7651,8236,15887
"32399","NAIROBI","LANG'ATA","40",1573,1750,3323
"32400","NAIROBI","LANG'ATA","41",1413,1310,2723
"32401","NAIROBI","LANG'ATA","42",1389,1379,2768
"32402","NAIROBI","LANG'ATA","43",1189,1248,2437
"32403","NAIROBI","LANG'ATA","44",1051,1028,2079
"32404","NAIROBI","LANG'ATA","40-44",6615,6715,13330
"32405","NAIROBI","LANG'ATA","45",1449,1323,2772
"32406","NAIROBI","LANG'ATA","46",1073,976,2049
"32407","NAIROBI","LANG'ATA","47",1151,997,2148
"32408","NAIROBI","LANG'ATA","48",925,789,1714
"32409","NAIROBI","LANG'ATA","49",1030,826,1856
"32410","NAIROBI","LANG'ATA","45-49",5628,4911,10539
"32411","NAIROBI","LANG'ATA","50",1171,967,2138
"32412","NAIROBI","LANG'ATA","51",777,656,1433
"32413","NAIROBI","LANG'ATA","52",895,658,1553
"32414","NAIROBI","LANG'ATA","53",689,595,1284
"32415","NAIROBI","LANG'ATA","54",709,602,1311
"32416","NAIROBI","LANG'ATA","50-54",4241,3478,7719
"32417","NAIROBI","LANG'ATA","55",723,520,1243
"32418","NAIROBI","LANG'ATA","56",722,582,1304
"32419","NAIROBI","LANG'ATA","57",678,509,1187
"32420","NAIROBI","LANG'ATA","58",593,445,1038
"32421","NAIROBI","LANG'ATA","59",614,476,1090
"32422","NAIROBI","LANG'ATA","55-59",3330,2532,5862
"32423","NAIROBI","LANG'ATA","60",539,536,1075
"32424","NAIROBI","LANG'ATA","61",383,339,722
"32425","NAIROBI","LANG'ATA","62",402,362,764
"32426","NAIROBI","LANG'ATA","63",323,342,665
"32427","NAIROBI","LANG'ATA","64",277,249,526
"32428","NAIROBI","LANG'ATA","60-64",1924,1828,3752
"32429","NAIROBI","LANG'ATA","65",327,281,608
"32430","NAIROBI","LANG'ATA","66",258,230,488
"32431","NAIROBI","LANG'ATA","67",324,234,558
"32432","NAIROBI","LANG'ATA","68",196,185,381
"32433","NAIROBI","LANG'ATA","69",230,222,452
"32434","NAIROBI","LANG'ATA","65-69",1335,1152,2487
"32435","NAIROBI","LANG'ATA","70",240,247,487
"32436","NAIROBI","LANG'ATA","71",189,173,362
"32437","NAIROBI","LANG'ATA","72",164,137,301
"32438","NAIROBI","LANG'ATA","73",133,125,258
"32439","NAIROBI","LANG'ATA","74",123,113,236
"32440","NAIROBI","LANG'ATA","70-74",849,795,1644
"32441","NAIROBI","LANG'ATA","75",108,112,220
"32442","NAIROBI","LANG'ATA","76",99,86,185
"32443","NAIROBI","LANG'ATA","77",76,97,173
"32444","NAIROBI","LANG'ATA","78",63,63,126
"32445","NAIROBI","LANG'ATA","79",71,49,120
"32446","NAIROBI","LANG'ATA","75-79",417,407,824
"32447","NAIROBI","LANG'ATA","80",62,84,146
"32448","NAIROBI","LANG'ATA","81",37,42,79
"32449","NAIROBI","LANG'ATA","82",47,51,98
"32450","NAIROBI","LANG'ATA","83",43,37,80
"32451","NAIROBI","LANG'ATA","84",35,33,68
"32452","NAIROBI","LANG'ATA","80-84",224,247,471
"32453","NAIROBI","LANG'ATA","85",23,23,46
"32454","NAIROBI","LANG'ATA","86",17,19,36
"32455","NAIROBI","LANG'ATA","87",12,19,31
"32456","NAIROBI","LANG'ATA","88",12,12,24
"32457","NAIROBI","LANG'ATA","89",8,18,26
"32458","NAIROBI","LANG'ATA","85-89",72,91,163
"32459","NAIROBI","LANG'ATA","90",14,15,29
"32460","NAIROBI","LANG'ATA","91",9,13,22
"32461","NAIROBI","LANG'ATA","92",4,7,11
"32462","NAIROBI","LANG'ATA","93",4,5,9
"32463","NAIROBI","LANG'ATA","94",4,4,8
"32464","NAIROBI","LANG'ATA","90-94",35,44,79
"32465","NAIROBI","LANG'ATA","95",3,2,5
"32466","NAIROBI","LANG'ATA","96",5,7,12
"32467","NAIROBI","LANG'ATA","97",3,3,6
"32468","NAIROBI","LANG'ATA","98",1,3,4
"32469","NAIROBI","LANG'ATA","99",2,4,6
"32470","NAIROBI","LANG'ATA","95-99",14,19,33
"32471","NAIROBI","LANG'ATA","100+",3,15,18
"32472","NAIROBI","LANG'ATA","Not Stated",5,1,6
"32473","NAIROBI","MAKADARA","Total",96369,93157,189526
"32474","NAIROBI","MAKADARA","0",2255,2044,4299
"32475","NAIROBI","MAKADARA","1",2203,2019,4222
"32476","NAIROBI","MAKADARA","2",2078,1932,4010
"32477","NAIROBI","MAKADARA","3",2010,1986,3996
"32478","NAIROBI","MAKADARA","4",1869,1852,3721
"32479","NAIROBI","MAKADARA","0 - 4",10415,9833,20248
"32480","NAIROBI","MAKADARA","5",1717,1747,3464
"32481","NAIROBI","MAKADARA","6",1724,1680,3404
"32482","NAIROBI","MAKADARA","7",1612,1753,3365
"32483","NAIROBI","MAKADARA","8",1617,1641,3258
"32484","NAIROBI","MAKADARA","9",1644,1722,3366
"32485","NAIROBI","MAKADARA","5-9",8314,8543,16857
"32486","NAIROBI","MAKADARA","10",1656,1633,3289
"32487","NAIROBI","MAKADARA","11",1461,1485,2946
"32488","NAIROBI","MAKADARA","12",1572,1600,3172
"32489","NAIROBI","MAKADARA","13",1565,1595,3160
"32490","NAIROBI","MAKADARA","14",1435,1464,2899
"32491","NAIROBI","MAKADARA","10 -14",7689,7777,15466
"32492","NAIROBI","MAKADARA","15",1262,1440,2702
"32493","NAIROBI","MAKADARA","16",1281,1465,2746
"32494","NAIROBI","MAKADARA","17",1330,1529,2859
"32495","NAIROBI","MAKADARA","18",1222,1547,2769
"32496","NAIROBI","MAKADARA","19",1609,2033,3642
"32497","NAIROBI","MAKADARA","15-19",6704,8014,14718
"32498","NAIROBI","MAKADARA","20",1843,2435,4278
"32499","NAIROBI","MAKADARA","21",2077,2546,4623
"32500","NAIROBI","MAKADARA","22",2416,2635,5051
"32501","NAIROBI","MAKADARA","23",2762,3023,5785
"32502","NAIROBI","MAKADARA","24",2716,2767,5483
"32503","NAIROBI","MAKADARA","20-24",11814,13406,25220
"32504","NAIROBI","MAKADARA","25",2876,2983,5859
"32505","NAIROBI","MAKADARA","26",2512,2601,5113
"32506","NAIROBI","MAKADARA","27",2414,2418,4832
"32507","NAIROBI","MAKADARA","28",2103,2168,4271
"32508","NAIROBI","MAKADARA","29",2315,2273,4588
"32509","NAIROBI","MAKADARA","25-29",12220,12443,24663
"32510","NAIROBI","MAKADARA","30",2688,2625,5313
"32511","NAIROBI","MAKADARA","31",1791,1779,3570
"32512","NAIROBI","MAKADARA","32",2356,2319,4675
"32513","NAIROBI","MAKADARA","33",1814,1839,3653
"32514","NAIROBI","MAKADARA","34",1746,1697,3443
"32515","NAIROBI","MAKADARA","30-34",10395,10259,20654
"32516","NAIROBI","MAKADARA","35",2171,1910,4081
"32517","NAIROBI","MAKADARA","36",1595,1486,3081
"32518","NAIROBI","MAKADARA","37",1586,1392,2978
"32519","NAIROBI","MAKADARA","38",1354,1259,2613
"32520","NAIROBI","MAKADARA","39",1440,1245,2685
"32521","NAIROBI","MAKADARA","35-39",8146,7292,15438
"32522","NAIROBI","MAKADARA","40",1735,1395,3130
"32523","NAIROBI","MAKADARA","41",1473,1146,2619
"32524","NAIROBI","MAKADARA","42",1367,1097,2464
"32525","NAIROBI","MAKADARA","43",1168,921,2089
"32526","NAIROBI","MAKADARA","44",998,814,1812
"32527","NAIROBI","MAKADARA","40-44",6741,5373,12114
"32528","NAIROBI","MAKADARA","45",1443,1015,2458
"32529","NAIROBI","MAKADARA","46",988,762,1750
"32530","NAIROBI","MAKADARA","47",1052,699,1751
"32531","NAIROBI","MAKADARA","48",802,594,1396
"32532","NAIROBI","MAKADARA","49",849,637,1486
"32533","NAIROBI","MAKADARA","45-49",5134,3707,8841
"32534","NAIROBI","MAKADARA","50",971,715,1686
"32535","NAIROBI","MAKADARA","51",649,477,1126
"32536","NAIROBI","MAKADARA","52",712,489,1201
"32537","NAIROBI","MAKADARA","53",510,356,866
"32538","NAIROBI","MAKADARA","54",587,376,963
"32539","NAIROBI","MAKADARA","50-54",3429,2413,5842
"32540","NAIROBI","MAKADARA","55",562,387,949
"32541","NAIROBI","MAKADARA","56",521,394,915
"32542","NAIROBI","MAKADARA","57",510,340,850
"32543","NAIROBI","MAKADARA","58",396,271,667
"32544","NAIROBI","MAKADARA","59",434,249,683
"32545","NAIROBI","MAKADARA","55-59",2423,1641,4064
"32546","NAIROBI","MAKADARA","60",425,306,731
"32547","NAIROBI","MAKADARA","61",255,214,469
"32548","NAIROBI","MAKADARA","62",229,169,398
"32549","NAIROBI","MAKADARA","63",196,149,345
"32550","NAIROBI","MAKADARA","64",161,117,278
"32551","NAIROBI","MAKADARA","60-64",1266,955,2221
"32552","NAIROBI","MAKADARA","65",206,177,383
"32553","NAIROBI","MAKADARA","66",148,112,260
"32554","NAIROBI","MAKADARA","67",214,167,381
"32555","NAIROBI","MAKADARA","68",112,94,206
"32556","NAIROBI","MAKADARA","69",127,123,250
"32557","NAIROBI","MAKADARA","65-69",807,673,1480
"32558","NAIROBI","MAKADARA","70",177,143,320
"32559","NAIROBI","MAKADARA","71",118,76,194
"32560","NAIROBI","MAKADARA","72",105,72,177
"32561","NAIROBI","MAKADARA","73",76,60,136
"32562","NAIROBI","MAKADARA","74",58,64,122
"32563","NAIROBI","MAKADARA","70-74",534,415,949
"32564","NAIROBI","MAKADARA","75",59,44,103
"32565","NAIROBI","MAKADARA","76",43,49,92
"32566","NAIROBI","MAKADARA","77",38,35,73
"32567","NAIROBI","MAKADARA","78",25,28,53
"32568","NAIROBI","MAKADARA","79",29,39,68
"32569","NAIROBI","MAKADARA","75-79",194,195,389
"32570","NAIROBI","MAKADARA","80",33,46,79
"32571","NAIROBI","MAKADARA","81",13,14,27
"32572","NAIROBI","MAKADARA","82",15,22,37
"32573","NAIROBI","MAKADARA","83",14,15,29
"32574","NAIROBI","MAKADARA","84",15,11,26
"32575","NAIROBI","MAKADARA","80-84",90,108,198
"32576","NAIROBI","MAKADARA","85",8,18,26
"32577","NAIROBI","MAKADARA","86",9,13,22
"32578","NAIROBI","MAKADARA","87",8,10,18
"32579","NAIROBI","MAKADARA","88",5,5,10
"32580","NAIROBI","MAKADARA","89",5,14,19
"32581","NAIROBI","MAKADARA","85-89",35,60,95
"32582","NAIROBI","MAKADARA","90",6,9,15
"32583","NAIROBI","MAKADARA","91",2,5,7
"32584","NAIROBI","MAKADARA","92",1,6,7
"32585","NAIROBI","MAKADARA","93",1,4,5
"32586","NAIROBI","MAKADARA","94",NA,4,4
"32587","NAIROBI","MAKADARA","90-94",10,28,38
"32588","NAIROBI","MAKADARA","95",2,4,6
"32589","NAIROBI","MAKADARA","96",2,3,5
"32590","NAIROBI","MAKADARA","97",NA,2,2
"32591","NAIROBI","MAKADARA","98",1,1,2
"32592","NAIROBI","MAKADARA","99",NA,3,3
"32593","NAIROBI","MAKADARA","95-99",5,13,18
"32594","NAIROBI","MAKADARA","100+",2,8,10
"32595","NAIROBI","MAKADARA","Not Stated",2,1,3
"32596","NAIROBI","MATHARE","Total",106522,100028,206550
"32597","NAIROBI","MATHARE","0",2621,2810,5431
"32598","NAIROBI","MATHARE","1",2747,2703,5450
"32599","NAIROBI","MATHARE","2",2551,2451,5002
"32600","NAIROBI","MATHARE","3",2444,2522,4966
"32601","NAIROBI","MATHARE","4",2233,2275,4508
"32602","NAIROBI","MATHARE","0 - 4",12596,12761,25357
"32603","NAIROBI","MATHARE","5",2097,2152,4249
"32604","NAIROBI","MATHARE","6",2102,2191,4293
"32605","NAIROBI","MATHARE","7",2076,2094,4170
"32606","NAIROBI","MATHARE","8",2008,1948,3956
"32607","NAIROBI","MATHARE","9",2104,2097,4201
"32608","NAIROBI","MATHARE","5-9",10387,10482,20869
"32609","NAIROBI","MATHARE","10",1905,2002,3907
"32610","NAIROBI","MATHARE","11",1649,1836,3485
"32611","NAIROBI","MATHARE","12",1981,1988,3969
"32612","NAIROBI","MATHARE","13",1760,1965,3725
"32613","NAIROBI","MATHARE","14",1605,1807,3412
"32614","NAIROBI","MATHARE","10 -14",8900,9598,18498
"32615","NAIROBI","MATHARE","15",1538,1684,3222
"32616","NAIROBI","MATHARE","16",1496,1595,3091
"32617","NAIROBI","MATHARE","17",1644,1847,3491
"32618","NAIROBI","MATHARE","18",1514,1799,3313
"32619","NAIROBI","MATHARE","19",1910,2187,4097
"32620","NAIROBI","MATHARE","15-19",8102,9112,17214
"32621","NAIROBI","MATHARE","20",2200,2814,5014
"32622","NAIROBI","MATHARE","21",2539,2668,5207
"32623","NAIROBI","MATHARE","22",2696,2991,5687
"32624","NAIROBI","MATHARE","23",3062,3271,6333
"32625","NAIROBI","MATHARE","24",3085,3043,6128
"32626","NAIROBI","MATHARE","20-24",13582,14787,28369
"32627","NAIROBI","MATHARE","25",3289,3135,6424
"32628","NAIROBI","MATHARE","26",2786,2693,5479
"32629","NAIROBI","MATHARE","27",2771,2592,5363
"32630","NAIROBI","MATHARE","28",2413,2232,4645
"32631","NAIROBI","MATHARE","29",2522,2310,4832
"32632","NAIROBI","MATHARE","25-29",13781,12962,26743
"32633","NAIROBI","MATHARE","30",3079,2945,6024
"32634","NAIROBI","MATHARE","31",1978,1807,3785
"32635","NAIROBI","MATHARE","32",2693,2480,5173
"32636","NAIROBI","MATHARE","33",1968,1857,3825
"32637","NAIROBI","MATHARE","34",1859,1665,3524
"32638","NAIROBI","MATHARE","30-34",11577,10754,22331
"32639","NAIROBI","MATHARE","35",2315,1962,4277
"32640","NAIROBI","MATHARE","36",1690,1398,3088
"32641","NAIROBI","MATHARE","37",1697,1373,3070
"32642","NAIROBI","MATHARE","38",1417,1146,2563
"32643","NAIROBI","MATHARE","39",1462,1176,2638
"32644","NAIROBI","MATHARE","35-39",8581,7055,15636
"32645","NAIROBI","MATHARE","40",1744,1436,3180
"32646","NAIROBI","MATHARE","41",1409,1083,2492
"32647","NAIROBI","MATHARE","42",1416,1010,2426
"32648","NAIROBI","MATHARE","43",1145,833,1978
"32649","NAIROBI","MATHARE","44",915,676,1591
"32650","NAIROBI","MATHARE","40-44",6629,5038,11667
"32651","NAIROBI","MATHARE","45",1379,876,2255
"32652","NAIROBI","MATHARE","46",951,618,1569
"32653","NAIROBI","MATHARE","47",978,631,1609
"32654","NAIROBI","MATHARE","48",744,441,1185
"32655","NAIROBI","MATHARE","49",797,456,1253
"32656","NAIROBI","MATHARE","45-49",4849,3022,7871
"32657","NAIROBI","MATHARE","50",945,587,1532
"32658","NAIROBI","MATHARE","51",607,372,979
"32659","NAIROBI","MATHARE","52",611,329,940
"32660","NAIROBI","MATHARE","53",421,277,698
"32661","NAIROBI","MATHARE","54",544,263,807
"32662","NAIROBI","MATHARE","50-54",3128,1828,4956
"32663","NAIROBI","MATHARE","55",520,267,787
"32664","NAIROBI","MATHARE","56",530,281,811
"32665","NAIROBI","MATHARE","57",397,241,638
"32666","NAIROBI","MATHARE","58",333,160,493
"32667","NAIROBI","MATHARE","59",328,211,539
"32668","NAIROBI","MATHARE","55-59",2108,1160,3268
"32669","NAIROBI","MATHARE","60",362,241,603
"32670","NAIROBI","MATHARE","61",261,128,389
"32671","NAIROBI","MATHARE","62",197,120,317
"32672","NAIROBI","MATHARE","63",183,99,282
"32673","NAIROBI","MATHARE","64",141,68,209
"32674","NAIROBI","MATHARE","60-64",1144,656,1800
"32675","NAIROBI","MATHARE","65",192,120,312
"32676","NAIROBI","MATHARE","66",129,58,187
"32677","NAIROBI","MATHARE","67",183,101,284
"32678","NAIROBI","MATHARE","68",82,43,125
"32679","NAIROBI","MATHARE","69",89,68,157
"32680","NAIROBI","MATHARE","65-69",675,390,1065
"32681","NAIROBI","MATHARE","70",120,93,213
"32682","NAIROBI","MATHARE","71",66,44,110
"32683","NAIROBI","MATHARE","72",61,27,88
"32684","NAIROBI","MATHARE","73",48,20,68
"32685","NAIROBI","MATHARE","74",28,22,50
"32686","NAIROBI","MATHARE","70-74",323,206,529
"32687","NAIROBI","MATHARE","75",22,25,47
"32688","NAIROBI","MATHARE","76",26,20,46
"32689","NAIROBI","MATHARE","77",17,16,33
"32690","NAIROBI","MATHARE","78",14,12,26
"32691","NAIROBI","MATHARE","79",14,18,32
"32692","NAIROBI","MATHARE","75-79",93,91,184
"32693","NAIROBI","MATHARE","80",20,33,53
"32694","NAIROBI","MATHARE","81",6,11,17
"32695","NAIROBI","MATHARE","82",4,4,8
"32696","NAIROBI","MATHARE","83",10,5,15
"32697","NAIROBI","MATHARE","84",4,12,16
"32698","NAIROBI","MATHARE","80-84",44,65,109
"32699","NAIROBI","MATHARE","85",5,7,12
"32700","NAIROBI","MATHARE","86",4,7,11
"32701","NAIROBI","MATHARE","87",4,4,8
"32702","NAIROBI","MATHARE","88",1,4,5
"32703","NAIROBI","MATHARE","89",3,8,11
"32704","NAIROBI","MATHARE","85-89",17,30,47
"32705","NAIROBI","MATHARE","90",2,2,4
"32706","NAIROBI","MATHARE","91",NA,3,3
"32707","NAIROBI","MATHARE","92",NA,5,5
"32708","NAIROBI","MATHARE","93",NA,4,4
"32709","NAIROBI","MATHARE","94",1,1,2
"32710","NAIROBI","MATHARE","90-94",3,15,18
"32711","NAIROBI","MATHARE","95",NA,2,2
"32712","NAIROBI","MATHARE","96",1,5,6
"32713","NAIROBI","MATHARE","97",NA,2,2
"32714","NAIROBI","MATHARE","98",NA,NA,NA
"32715","NAIROBI","MATHARE","99",NA,2,2
"32716","NAIROBI","MATHARE","95-99",1,11,12
"32717","NAIROBI","MATHARE","100+",1,3,4
"32718","NAIROBI","MATHARE","Not Stated",1,2,3
"32719","NAIROBI","NJIRU","Total",307642,318809,626451
"32720","NAIROBI","NJIRU","0",8859,8336,17195
"32721","NAIROBI","NJIRU","1",8533,8346,16879
"32722","NAIROBI","NJIRU","2",8128,7888,16016
"32723","NAIROBI","NJIRU","3",8045,7843,15888
"32724","NAIROBI","NJIRU","4",7353,7347,14700
"32725","NAIROBI","NJIRU","0 - 4",40918,39760,80678
"32726","NAIROBI","NJIRU","5",6984,6981,13965
"32727","NAIROBI","NJIRU","6",6781,6942,13723
"32728","NAIROBI","NJIRU","7",6970,6977,13947
"32729","NAIROBI","NJIRU","8",6468,6816,13284
"32730","NAIROBI","NJIRU","9",6823,7066,13889
"32731","NAIROBI","NJIRU","5-9",34026,34782,68808
"32732","NAIROBI","NJIRU","10",6664,6525,13189
"32733","NAIROBI","NJIRU","11",5660,5880,11540
"32734","NAIROBI","NJIRU","12",6136,6236,12372
"32735","NAIROBI","NJIRU","13",5689,6173,11862
"32736","NAIROBI","NJIRU","14",5322,5711,11033
"32737","NAIROBI","NJIRU","10 -14",29471,30525,59996
"32738","NAIROBI","NJIRU","15",4887,5612,10499
"32739","NAIROBI","NJIRU","16",4762,5585,10347
"32740","NAIROBI","NJIRU","17",5072,5827,10899
"32741","NAIROBI","NJIRU","18",4307,5308,9615
"32742","NAIROBI","NJIRU","19",5130,6711,11841
"32743","NAIROBI","NJIRU","15-19",24158,29043,53201
"32744","NAIROBI","NJIRU","20",5312,7493,12805
"32745","NAIROBI","NJIRU","21",5766,7829,13595
"32746","NAIROBI","NJIRU","22",6086,8239,14325
"32747","NAIROBI","NJIRU","23",6952,9303,16255
"32748","NAIROBI","NJIRU","24",7039,9092,16131
"32749","NAIROBI","NJIRU","20-24",31155,41956,73111
"32750","NAIROBI","NJIRU","25",7724,9147,16871
"32751","NAIROBI","NJIRU","26",6825,8191,15016
"32752","NAIROBI","NJIRU","27",7202,8031,15233
"32753","NAIROBI","NJIRU","28",6348,7180,13528
"32754","NAIROBI","NJIRU","29",6865,7530,14395
"32755","NAIROBI","NJIRU","25-29",34964,40079,75043
"32756","NAIROBI","NJIRU","30",8336,9028,17364
"32757","NAIROBI","NJIRU","31",5847,5739,11586
"32758","NAIROBI","NJIRU","32",7514,7777,15291
"32759","NAIROBI","NJIRU","33",5868,5972,11840
"32760","NAIROBI","NJIRU","34",5544,5688,11232
"32761","NAIROBI","NJIRU","30-34",33109,34204,67313
"32762","NAIROBI","NJIRU","35",6571,6334,12905
"32763","NAIROBI","NJIRU","36",4791,4742,9533
"32764","NAIROBI","NJIRU","37",4793,4464,9257
"32765","NAIROBI","NJIRU","38",4352,4189,8541
"32766","NAIROBI","NJIRU","39",4335,4021,8356
"32767","NAIROBI","NJIRU","35-39",24842,23750,48592
"32768","NAIROBI","NJIRU","40",5255,4565,9820
"32769","NAIROBI","NJIRU","41",4053,3475,7528
"32770","NAIROBI","NJIRU","42",3971,3315,7286
"32771","NAIROBI","NJIRU","43",3419,2900,6319
"32772","NAIROBI","NJIRU","44",2689,2479,5168
"32773","NAIROBI","NJIRU","40-44",19387,16734,36121
"32774","NAIROBI","NJIRU","45",3940,3021,6961
"32775","NAIROBI","NJIRU","46",2723,2311,5034
"32776","NAIROBI","NJIRU","47",2887,2221,5108
"32777","NAIROBI","NJIRU","48",2137,1725,3862
"32778","NAIROBI","NJIRU","49",2390,1735,4125
"32779","NAIROBI","NJIRU","45-49",14077,11013,25090
"32780","NAIROBI","NJIRU","50",2587,2056,4643
"32781","NAIROBI","NJIRU","51",1827,1289,3116
"32782","NAIROBI","NJIRU","52",1992,1364,3356
"32783","NAIROBI","NJIRU","53",1330,1010,2340
"32784","NAIROBI","NJIRU","54",1595,1165,2760
"32785","NAIROBI","NJIRU","50-54",9331,6884,16215
"32786","NAIROBI","NJIRU","55",1472,1003,2475
"32787","NAIROBI","NJIRU","56",1409,1061,2470
"32788","NAIROBI","NJIRU","57",1177,923,2100
"32789","NAIROBI","NJIRU","58",920,713,1633
"32790","NAIROBI","NJIRU","59",957,712,1669
"32791","NAIROBI","NJIRU","55-59",5935,4412,10347
"32792","NAIROBI","NJIRU","60",975,779,1754
"32793","NAIROBI","NJIRU","61",706,548,1254
"32794","NAIROBI","NJIRU","62",614,395,1009
"32795","NAIROBI","NJIRU","63",499,374,873
"32796","NAIROBI","NJIRU","64",368,264,632
"32797","NAIROBI","NJIRU","60-64",3162,2360,5522
"32798","NAIROBI","NJIRU","65",461,373,834
"32799","NAIROBI","NJIRU","66",298,242,540
"32800","NAIROBI","NJIRU","67",412,365,777
"32801","NAIROBI","NJIRU","68",205,168,373
"32802","NAIROBI","NJIRU","69",277,244,521
"32803","NAIROBI","NJIRU","65-69",1653,1392,3045
"32804","NAIROBI","NJIRU","70",284,312,596
"32805","NAIROBI","NJIRU","71",186,200,386
"32806","NAIROBI","NJIRU","72",188,141,329
"32807","NAIROBI","NJIRU","73",116,130,246
"32808","NAIROBI","NJIRU","74",102,114,216
"32809","NAIROBI","NJIRU","70-74",876,897,1773
"32810","NAIROBI","NJIRU","75",76,103,179
"32811","NAIROBI","NJIRU","76",92,115,207
"32812","NAIROBI","NJIRU","77",67,76,143
"32813","NAIROBI","NJIRU","78",42,40,82
"32814","NAIROBI","NJIRU","79",45,70,115
"32815","NAIROBI","NJIRU","75-79",322,404,726
"32816","NAIROBI","NJIRU","80",41,98,139
"32817","NAIROBI","NJIRU","81",18,48,66
"32818","NAIROBI","NJIRU","82",33,39,72
"32819","NAIROBI","NJIRU","83",24,51,75
"32820","NAIROBI","NJIRU","84",18,55,73
"32821","NAIROBI","NJIRU","80-84",134,291,425
"32822","NAIROBI","NJIRU","85",19,26,45
"32823","NAIROBI","NJIRU","86",17,37,54
"32824","NAIROBI","NJIRU","87",14,27,41
"32825","NAIROBI","NJIRU","88",11,13,24
"32826","NAIROBI","NJIRU","89",11,48,59
"32827","NAIROBI","NJIRU","85-89",72,151,223
"32828","NAIROBI","NJIRU","90",4,28,32
"32829","NAIROBI","NJIRU","91",7,23,30
"32830","NAIROBI","NJIRU","92",3,13,16
"32831","NAIROBI","NJIRU","93",5,10,15
"32832","NAIROBI","NJIRU","94",4,8,12
"32833","NAIROBI","NJIRU","90-94",23,82,105
"32834","NAIROBI","NJIRU","95",6,13,19
"32835","NAIROBI","NJIRU","96",3,10,13
"32836","NAIROBI","NJIRU","97",2,9,11
"32837","NAIROBI","NJIRU","98",2,7,9
"32838","NAIROBI","NJIRU","99",2,12,14
"32839","NAIROBI","NJIRU","95-99",15,51,66
"32840","NAIROBI","NJIRU","100+",1,27,28
"32841","NAIROBI","NJIRU","Not Stated",11,12,23
"32842","NAIROBI","STAREHE","Total",109173,101238,210411
"32843","NAIROBI","STAREHE","0",2213,2128,4341
"32844","NAIROBI","STAREHE","1",2174,2105,4279
"32845","NAIROBI","STAREHE","2",2077,2068,4145
"32846","NAIROBI","STAREHE","3",2016,1940,3956
"32847","NAIROBI","STAREHE","4",1787,1794,3581
"32848","NAIROBI","STAREHE","0 - 4",10267,10035,20302
"32849","NAIROBI","STAREHE","5",1857,1750,3607
"32850","NAIROBI","STAREHE","6",1724,1757,3481
"32851","NAIROBI","STAREHE","7",1707,1657,3364
"32852","NAIROBI","STAREHE","8",1637,1620,3257
"32853","NAIROBI","STAREHE","9",1666,1804,3470
"32854","NAIROBI","STAREHE","5-9",8591,8588,17179
"32855","NAIROBI","STAREHE","10",1710,1661,3371
"32856","NAIROBI","STAREHE","11",1488,1588,3076
"32857","NAIROBI","STAREHE","12",1658,1682,3340
"32858","NAIROBI","STAREHE","13",1611,1644,3255
"32859","NAIROBI","STAREHE","14",1535,1524,3059
"32860","NAIROBI","STAREHE","10 -14",8002,8099,16101
"32861","NAIROBI","STAREHE","15",1412,1615,3027
"32862","NAIROBI","STAREHE","16",1517,1612,3129
"32863","NAIROBI","STAREHE","17",1703,1753,3456
"32864","NAIROBI","STAREHE","18",1668,1870,3538
"32865","NAIROBI","STAREHE","19",2232,2638,4870
"32866","NAIROBI","STAREHE","15-19",8532,9488,18020
"32867","NAIROBI","STAREHE","20",2724,3072,5796
"32868","NAIROBI","STAREHE","21",3084,3303,6387
"32869","NAIROBI","STAREHE","22",3340,3557,6897
"32870","NAIROBI","STAREHE","23",3681,3655,7336
"32871","NAIROBI","STAREHE","24",3613,3239,6852
"32872","NAIROBI","STAREHE","20-24",16442,16826,33268
"32873","NAIROBI","STAREHE","25",3670,3314,6984
"32874","NAIROBI","STAREHE","26",2952,2779,5731
"32875","NAIROBI","STAREHE","27",2960,2668,5628
"32876","NAIROBI","STAREHE","28",2534,2453,4987
"32877","NAIROBI","STAREHE","29",2582,2270,4852
"32878","NAIROBI","STAREHE","25-29",14698,13484,28182
"32879","NAIROBI","STAREHE","30",3130,2895,6025
"32880","NAIROBI","STAREHE","31",2098,1907,4005
"32881","NAIROBI","STAREHE","32",2605,2430,5035
"32882","NAIROBI","STAREHE","33",1956,1893,3849
"32883","NAIROBI","STAREHE","34",1962,1776,3738
"32884","NAIROBI","STAREHE","30-34",11751,10901,22652
"32885","NAIROBI","STAREHE","35",2378,2009,4387
"32886","NAIROBI","STAREHE","36",1740,1530,3270
"32887","NAIROBI","STAREHE","37",1643,1400,3043
"32888","NAIROBI","STAREHE","38",1508,1281,2789
"32889","NAIROBI","STAREHE","39",1517,1223,2740
"32890","NAIROBI","STAREHE","35-39",8786,7443,16229
"32891","NAIROBI","STAREHE","40",1913,1376,3289
"32892","NAIROBI","STAREHE","41",1480,1086,2566
"32893","NAIROBI","STAREHE","42",1469,1094,2563
"32894","NAIROBI","STAREHE","43",1157,936,2093
"32895","NAIROBI","STAREHE","44",953,793,1746
"32896","NAIROBI","STAREHE","40-44",6972,5285,12257
"32897","NAIROBI","STAREHE","45",1560,1056,2616
"32898","NAIROBI","STAREHE","46",983,745,1728
"32899","NAIROBI","STAREHE","47",1000,683,1683
"32900","NAIROBI","STAREHE","48",865,570,1435
"32901","NAIROBI","STAREHE","49",907,609,1516
"32902","NAIROBI","STAREHE","45-49",5315,3663,8978
"32903","NAIROBI","STAREHE","50",1044,786,1830
"32904","NAIROBI","STAREHE","51",739,485,1224
"32905","NAIROBI","STAREHE","52",726,497,1223
"32906","NAIROBI","STAREHE","53",549,419,968
"32907","NAIROBI","STAREHE","54",677,423,1100
"32908","NAIROBI","STAREHE","50-54",3735,2610,6345
"32909","NAIROBI","STAREHE","55",612,418,1030
"32910","NAIROBI","STAREHE","56",594,421,1015
"32911","NAIROBI","STAREHE","57",536,405,941
"32912","NAIROBI","STAREHE","58",446,300,746
"32913","NAIROBI","STAREHE","59",498,322,820
"32914","NAIROBI","STAREHE","55-59",2686,1866,4552
"32915","NAIROBI","STAREHE","60",497,399,896
"32916","NAIROBI","STAREHE","61",310,209,519
"32917","NAIROBI","STAREHE","62",291,208,499
"32918","NAIROBI","STAREHE","63",230,187,417
"32919","NAIROBI","STAREHE","64",194,171,365
"32920","NAIROBI","STAREHE","60-64",1522,1174,2696
"32921","NAIROBI","STAREHE","65",287,185,472
"32922","NAIROBI","STAREHE","66",154,134,288
"32923","NAIROBI","STAREHE","67",223,150,373
"32924","NAIROBI","STAREHE","68",135,105,240
"32925","NAIROBI","STAREHE","69",139,172,311
"32926","NAIROBI","STAREHE","65-69",938,746,1684
"32927","NAIROBI","STAREHE","70",161,194,355
"32928","NAIROBI","STAREHE","71",98,90,188
"32929","NAIROBI","STAREHE","72",98,76,174
"32930","NAIROBI","STAREHE","73",81,70,151
"32931","NAIROBI","STAREHE","74",74,80,154
"32932","NAIROBI","STAREHE","70-74",512,510,1022
"32933","NAIROBI","STAREHE","75",59,74,133
"32934","NAIROBI","STAREHE","76",61,56,117
"32935","NAIROBI","STAREHE","77",48,56,104
"32936","NAIROBI","STAREHE","78",27,28,55
"32937","NAIROBI","STAREHE","79",33,47,80
"32938","NAIROBI","STAREHE","75-79",228,261,489
"32939","NAIROBI","STAREHE","80",48,57,105
"32940","NAIROBI","STAREHE","81",22,21,43
"32941","NAIROBI","STAREHE","82",21,20,41
"32942","NAIROBI","STAREHE","83",19,23,42
"32943","NAIROBI","STAREHE","84",14,17,31
"32944","NAIROBI","STAREHE","80-84",124,138,262
"32945","NAIROBI","STAREHE","85",15,20,35
"32946","NAIROBI","STAREHE","86",9,11,20
"32947","NAIROBI","STAREHE","87",12,18,30
"32948","NAIROBI","STAREHE","88",6,10,16
"32949","NAIROBI","STAREHE","89",3,8,11
"32950","NAIROBI","STAREHE","85-89",45,67,112
"32951","NAIROBI","STAREHE","90",7,17,24
"32952","NAIROBI","STAREHE","91",2,3,5
"32953","NAIROBI","STAREHE","92",1,3,4
"32954","NAIROBI","STAREHE","93",1,6,7
"32955","NAIROBI","STAREHE","94",NA,3,3
"32956","NAIROBI","STAREHE","90-94",11,32,43
"32957","NAIROBI","STAREHE","95",3,7,10
"32958","NAIROBI","STAREHE","96",1,2,3
"32959","NAIROBI","STAREHE","97",2,2,4
"32960","NAIROBI","STAREHE","98",NA,1,1
"32961","NAIROBI","STAREHE","99",NA,1,1
"32962","NAIROBI","STAREHE","95-99",6,13,19
"32963","NAIROBI","STAREHE","100+",4,6,10
"32964","NAIROBI","STAREHE","Not Stated",6,3,9
"32965","NAIROBI","WESTLANDS","Total",153818,155021,308839
"32966","NAIROBI","WESTLANDS","0",2978,2940,5918
"32967","NAIROBI","WESTLANDS","1",3108,3074,6182
"32968","NAIROBI","WESTLANDS","2",2878,2795,5673
"32969","NAIROBI","WESTLANDS","3",2798,2853,5651
"32970","NAIROBI","WESTLANDS","4",2679,2627,5306
"32971","NAIROBI","WESTLANDS","0 - 4",14441,14289,28730
"32972","NAIROBI","WESTLANDS","5",2648,2573,5221
"32973","NAIROBI","WESTLANDS","6",2517,2641,5158
"32974","NAIROBI","WESTLANDS","7",2660,2633,5293
"32975","NAIROBI","WESTLANDS","8",2452,2456,4908
"32976","NAIROBI","WESTLANDS","9",2608,2627,5235
"32977","NAIROBI","WESTLANDS","5-9",12885,12930,25815
"32978","NAIROBI","WESTLANDS","10",2452,2507,4959
"32979","NAIROBI","WESTLANDS","11",2311,2339,4650
"32980","NAIROBI","WESTLANDS","12",2310,2448,4758
"32981","NAIROBI","WESTLANDS","13",2362,2506,4868
"32982","NAIROBI","WESTLANDS","14",2190,2264,4454
"32983","NAIROBI","WESTLANDS","10 -14",11625,12064,23689
"32984","NAIROBI","WESTLANDS","15",2104,2132,4236
"32985","NAIROBI","WESTLANDS","16",1965,2311,4276
"32986","NAIROBI","WESTLANDS","17",2099,2317,4416
"32987","NAIROBI","WESTLANDS","18",1887,2187,4074
"32988","NAIROBI","WESTLANDS","19",2317,2798,5115
"32989","NAIROBI","WESTLANDS","15-19",10372,11745,22117
"32990","NAIROBI","WESTLANDS","20",2518,3245,5763
"32991","NAIROBI","WESTLANDS","21",2941,3485,6426
"32992","NAIROBI","WESTLANDS","22",3144,3600,6744
"32993","NAIROBI","WESTLANDS","23",3611,4042,7653
"32994","NAIROBI","WESTLANDS","24",3567,3828,7395
"32995","NAIROBI","WESTLANDS","20-24",15781,18200,33981
"32996","NAIROBI","WESTLANDS","25",3818,3904,7722
"32997","NAIROBI","WESTLANDS","26",3442,3650,7092
"32998","NAIROBI","WESTLANDS","27",3484,3568,7052
"32999","NAIROBI","WESTLANDS","28",3084,3225,6309
"33000","NAIROBI","WESTLANDS","29",3348,3464,6812
"33001","NAIROBI","WESTLANDS","25-29",17176,17811,34987
"33002","NAIROBI","WESTLANDS","30",3726,3924,7650
"33003","NAIROBI","WESTLANDS","31",2895,2871,5766
"33004","NAIROBI","WESTLANDS","32",3445,3699,7144
"33005","NAIROBI","WESTLANDS","33",2825,2980,5805
"33006","NAIROBI","WESTLANDS","34",2851,2981,5832
"33007","NAIROBI","WESTLANDS","30-34",15742,16455,32197
"33008","NAIROBI","WESTLANDS","35",3140,3304,6444
"33009","NAIROBI","WESTLANDS","36",2500,2556,5056
"33010","NAIROBI","WESTLANDS","37",2467,2421,4888
"33011","NAIROBI","WESTLANDS","38",2295,2393,4688
"33012","NAIROBI","WESTLANDS","39",2361,2320,4681
"33013","NAIROBI","WESTLANDS","35-39",12763,12994,25757
"33014","NAIROBI","WESTLANDS","40",2703,2626,5329
"33015","NAIROBI","WESTLANDS","41",2241,2124,4365
"33016","NAIROBI","WESTLANDS","42",2303,2189,4492
"33017","NAIROBI","WESTLANDS","43",2039,2014,4053
"33018","NAIROBI","WESTLANDS","44",1858,1747,3605
"33019","NAIROBI","WESTLANDS","40-44",11144,10700,21844
"33020","NAIROBI","WESTLANDS","45",2347,2122,4469
"33021","NAIROBI","WESTLANDS","46",1874,1624,3498
"33022","NAIROBI","WESTLANDS","47",1931,1636,3567
"33023","NAIROBI","WESTLANDS","48",1544,1361,2905
"33024","NAIROBI","WESTLANDS","49",1780,1417,3197
"33025","NAIROBI","WESTLANDS","45-49",9476,8160,17636
"33026","NAIROBI","WESTLANDS","50",1833,1593,3426
"33027","NAIROBI","WESTLANDS","51",1340,1103,2443
"33028","NAIROBI","WESTLANDS","52",1408,1191,2599
"33029","NAIROBI","WESTLANDS","53",1195,1038,2233
"33030","NAIROBI","WESTLANDS","54",1280,1062,2342
"33031","NAIROBI","WESTLANDS","50-54",7056,5987,13043
"33032","NAIROBI","WESTLANDS","55",1231,998,2229
"33033","NAIROBI","WESTLANDS","56",1209,958,2167
"33034","NAIROBI","WESTLANDS","57",1141,939,2080
"33035","NAIROBI","WESTLANDS","58",980,808,1788
"33036","NAIROBI","WESTLANDS","59",1004,785,1789
"33037","NAIROBI","WESTLANDS","55-59",5565,4488,10053
"33038","NAIROBI","WESTLANDS","60",913,822,1735
"33039","NAIROBI","WESTLANDS","61",722,651,1373
"33040","NAIROBI","WESTLANDS","62",751,596,1347
"33041","NAIROBI","WESTLANDS","63",670,535,1205
"33042","NAIROBI","WESTLANDS","64",514,494,1008
"33043","NAIROBI","WESTLANDS","60-64",3570,3098,6668
"33044","NAIROBI","WESTLANDS","65",653,580,1233
"33045","NAIROBI","WESTLANDS","66",474,445,919
"33046","NAIROBI","WESTLANDS","67",568,464,1032
"33047","NAIROBI","WESTLANDS","68",402,357,759
"33048","NAIROBI","WESTLANDS","69",494,367,861
"33049","NAIROBI","WESTLANDS","65-69",2591,2213,4804
"33050","NAIROBI","WESTLANDS","70",460,436,896
"33051","NAIROBI","WESTLANDS","71",359,293,652
"33052","NAIROBI","WESTLANDS","72",344,383,727
"33053","NAIROBI","WESTLANDS","73",288,285,573
"33054","NAIROBI","WESTLANDS","74",287,249,536
"33055","NAIROBI","WESTLANDS","70-74",1738,1646,3384
"33056","NAIROBI","WESTLANDS","75",235,265,500
"33057","NAIROBI","WESTLANDS","76",208,228,436
"33058","NAIROBI","WESTLANDS","77",191,191,382
"33059","NAIROBI","WESTLANDS","78",150,138,288
"33060","NAIROBI","WESTLANDS","79",130,168,298
"33061","NAIROBI","WESTLANDS","75-79",914,990,1904
"33062","NAIROBI","WESTLANDS","80",159,194,353
"33063","NAIROBI","WESTLANDS","81",102,127,229
"33064","NAIROBI","WESTLANDS","82",115,142,257
"33065","NAIROBI","WESTLANDS","83",106,121,227
"33066","NAIROBI","WESTLANDS","84",89,88,177
"33067","NAIROBI","WESTLANDS","80-84",571,672,1243
"33068","NAIROBI","WESTLANDS","85",87,110,197
"33069","NAIROBI","WESTLANDS","86",60,81,141
"33070","NAIROBI","WESTLANDS","87",57,81,138
"33071","NAIROBI","WESTLANDS","88",42,49,91
"33072","NAIROBI","WESTLANDS","89",39,48,87
"33073","NAIROBI","WESTLANDS","85-89",285,369,654
"33074","NAIROBI","WESTLANDS","90",25,41,66
"33075","NAIROBI","WESTLANDS","91",17,23,40
"33076","NAIROBI","WESTLANDS","92",21,22,43
"33077","NAIROBI","WESTLANDS","93",13,17,30
"33078","NAIROBI","WESTLANDS","94",8,21,29
"33079","NAIROBI","WESTLANDS","90-94",84,124,208
"33080","NAIROBI","WESTLANDS","95",6,19,25
"33081","NAIROBI","WESTLANDS","96",6,14,20
"33082","NAIROBI","WESTLANDS","97",5,8,13
"33083","NAIROBI","WESTLANDS","98",3,8,11
"33084","NAIROBI","WESTLANDS","99",9,14,23
"33085","NAIROBI","WESTLANDS","95-99",29,63,92
"33086","NAIROBI","WESTLANDS","100+",7,16,23
"33087","NAIROBI","WESTLANDS","Not Stated",3,7,10
"33088","NAKURU","ALL","Total",1077272,1084835,2162107
"33089","NAKURU","ALL","0",27196,26886,54082
"33090","NAKURU","ALL","1",26974,26476,53450
"33091","NAKURU","ALL","2",27336,26854,54190
"33092","NAKURU","ALL","3",28270,27946,56216
"33093","NAKURU","ALL","4",28241,27152,55393
"33094","NAKURU","ALL","0 - 4",138017,135314,273331
"33095","NAKURU","ALL","5",26946,25929,52875
"33096","NAKURU","ALL","6",26457,26385,52842
"33097","NAKURU","ALL","7",27631,26722,54353
"33098","NAKURU","ALL","8",25485,25310,50795
"33099","NAKURU","ALL","9",28733,27896,56629
"33100","NAKURU","ALL","5-9",135252,132242,267494
"33101","NAKURU","ALL","10",28343,27620,55963
"33102","NAKURU","ALL","11",25485,25664,51149
"33103","NAKURU","ALL","12",29006,28231,57237
"33104","NAKURU","ALL","13",28429,28386,56815
"33105","NAKURU","ALL","14",27008,26318,53326
"33106","NAKURU","ALL","10 -14",138271,136219,274490
"33107","NAKURU","ALL","15",26199,25490,51689
"33108","NAKURU","ALL","16",24407,24099,48506
"33109","NAKURU","ALL","17",25189,24070,49259
"33110","NAKURU","ALL","18",20105,19523,39628
"33111","NAKURU","ALL","19",23380,22996,46376
"33112","NAKURU","ALL","15-19",119280,116178,235458
"33113","NAKURU","ALL","20",20917,21851,42768
"33114","NAKURU","ALL","21",21174,21651,42825
"33115","NAKURU","ALL","22",20478,21641,42119
"33116","NAKURU","ALL","23",21271,22940,44211
"33117","NAKURU","ALL","24",19486,20847,40333
"33118","NAKURU","ALL","20-24",103326,108930,212256
"33119","NAKURU","ALL","25",20354,21848,42202
"33120","NAKURU","ALL","26",16834,19057,35891
"33121","NAKURU","ALL","27",18272,19292,37564
"33122","NAKURU","ALL","28",14628,16287,30915
"33123","NAKURU","ALL","29",16414,17831,34245
"33124","NAKURU","ALL","25-29",86502,94315,180817
"33125","NAKURU","ALL","30",19939,22209,42148
"33126","NAKURU","ALL","31",14157,15241,29398
"33127","NAKURU","ALL","32",18360,20169,38529
"33128","NAKURU","ALL","33",14845,16588,31433
"33129","NAKURU","ALL","34",13978,15291,29269
"33130","NAKURU","ALL","30-34",81279,89498,170777
"33131","NAKURU","ALL","35",18655,18933,37588
"33132","NAKURU","ALL","36",12652,12610,25262
"33133","NAKURU","ALL","37",12681,11926,24607
"33134","NAKURU","ALL","38",10240,10080,20320
"33135","NAKURU","ALL","39",11470,10931,22401
"33136","NAKURU","ALL","35-39",65698,64480,130178
"33137","NAKURU","ALL","40",13886,12898,26784
"33138","NAKURU","ALL","41",13365,11726,25091
"33139","NAKURU","ALL","42",11828,10575,22403
"33140","NAKURU","ALL","43",9386,9268,18654
"33141","NAKURU","ALL","44",7582,7457,15039
"33142","NAKURU","ALL","40-44",56047,51924,107971
"33143","NAKURU","ALL","45",13045,11829,24874
"33144","NAKURU","ALL","46",8451,8174,16625
"33145","NAKURU","ALL","47",9619,8858,18477
"33146","NAKURU","ALL","48",6647,6325,12972
"33147","NAKURU","ALL","49",7856,7428,15284
"33148","NAKURU","ALL","45-49",45618,42614,88232
"33149","NAKURU","ALL","50",8829,8699,17528
"33150","NAKURU","ALL","51",6679,6376,13055
"33151","NAKURU","ALL","52",6506,6045,12551
"33152","NAKURU","ALL","53",4553,4588,9141
"33153","NAKURU","ALL","54",5480,5257,10737
"33154","NAKURU","ALL","50-54",32047,30965,63012
"33155","NAKURU","ALL","55",5689,5193,10882
"33156","NAKURU","ALL","56",5694,5583,11277
"33157","NAKURU","ALL","57",4730,5070,9800
"33158","NAKURU","ALL","58",4522,5026,9548
"33159","NAKURU","ALL","59",4687,4504,9191
"33160","NAKURU","ALL","55-59",25322,25376,50698
"33161","NAKURU","ALL","60",5111,5131,10242
"33162","NAKURU","ALL","61",3595,3740,7335
"33163","NAKURU","ALL","62",3207,3118,6325
"33164","NAKURU","ALL","63",2781,2840,5621
"33165","NAKURU","ALL","64",2087,2230,4317
"33166","NAKURU","ALL","60-64",16781,17059,33840
"33167","NAKURU","ALL","65",3431,3390,6821
"33168","NAKURU","ALL","66",2182,2112,4294
"33169","NAKURU","ALL","67",3582,3626,7208
"33170","NAKURU","ALL","68",1602,1599,3201
"33171","NAKURU","ALL","69",2462,2568,5030
"33172","NAKURU","ALL","65-69",13259,13295,26554
"33173","NAKURU","ALL","70",2940,3575,6515
"33174","NAKURU","ALL","71",2119,2086,4205
"33175","NAKURU","ALL","72",1918,1645,3563
"33176","NAKURU","ALL","73",1440,1443,2883
"33177","NAKURU","ALL","74",1308,1572,2880
"33178","NAKURU","ALL","70-74",9725,10321,20046
"33179","NAKURU","ALL","75",1164,1674,2838
"33180","NAKURU","ALL","76",1226,1937,3163
"33181","NAKURU","ALL","77",982,1141,2123
"33182","NAKURU","ALL","78",675,788,1463
"33183","NAKURU","ALL","79",816,1232,2048
"33184","NAKURU","ALL","75-79",4863,6772,11635
"33185","NAKURU","ALL","80",952,1504,2456
"33186","NAKURU","ALL","81",547,721,1268
"33187","NAKURU","ALL","82",560,555,1115
"33188","NAKURU","ALL","83",564,660,1224
"33189","NAKURU","ALL","84",546,807,1353
"33190","NAKURU","ALL","80-84",3169,4247,7416
"33191","NAKURU","ALL","85",415,666,1081
"33192","NAKURU","ALL","86",283,521,804
"33193","NAKURU","ALL","87",343,500,843
"33194","NAKURU","ALL","88",216,260,476
"33195","NAKURU","ALL","89",373,720,1093
"33196","NAKURU","ALL","85-89",1630,2667,4297
"33197","NAKURU","ALL","90",209,469,678
"33198","NAKURU","ALL","91",179,291,470
"33199","NAKURU","ALL","92",101,173,274
"33200","NAKURU","ALL","93",86,154,240
"33201","NAKURU","ALL","94",66,160,226
"33202","NAKURU","ALL","90-94",641,1247,1888
"33203","NAKURU","ALL","95",113,235,348
"33204","NAKURU","ALL","96",71,122,193
"33205","NAKURU","ALL","97",88,129,217
"33206","NAKURU","ALL","98",50,77,127
"33207","NAKURU","ALL","99",65,170,235
"33208","NAKURU","ALL","95-99",387,733,1120
"33209","NAKURU","ALL","100+",127,429,556
"33210","NAKURU","ALL","Not Stated",31,10,41
"33211","NAKURU","GILGIL","Total",92955,92247,185202
"33212","NAKURU","GILGIL","0",2235,2266,4501
"33213","NAKURU","GILGIL","1",2273,2205,4478
"33214","NAKURU","GILGIL","2",2230,2178,4408
"33215","NAKURU","GILGIL","3",2235,2243,4478
"33216","NAKURU","GILGIL","4",2293,2146,4439
"33217","NAKURU","GILGIL","0 - 4",11266,11038,22304
"33218","NAKURU","GILGIL","5",2159,2162,4321
"33219","NAKURU","GILGIL","6",2184,2224,4408
"33220","NAKURU","GILGIL","7",2376,2229,4605
"33221","NAKURU","GILGIL","8",2203,2175,4378
"33222","NAKURU","GILGIL","9",2491,2249,4740
"33223","NAKURU","GILGIL","5-9",11413,11039,22452
"33224","NAKURU","GILGIL","10",2425,2305,4730
"33225","NAKURU","GILGIL","11",2061,2082,4143
"33226","NAKURU","GILGIL","12",2392,2353,4745
"33227","NAKURU","GILGIL","13",2531,2373,4904
"33228","NAKURU","GILGIL","14",2230,2196,4426
"33229","NAKURU","GILGIL","10 -14",11639,11309,22948
"33230","NAKURU","GILGIL","15",2209,2153,4362
"33231","NAKURU","GILGIL","16",2101,2080,4181
"33232","NAKURU","GILGIL","17",2097,2055,4152
"33233","NAKURU","GILGIL","18",1857,1754,3611
"33234","NAKURU","GILGIL","19",2728,2207,4935
"33235","NAKURU","GILGIL","15-19",10992,10249,21241
"33236","NAKURU","GILGIL","20",2742,2115,4857
"33237","NAKURU","GILGIL","21",2695,1929,4624
"33238","NAKURU","GILGIL","22",2288,1867,4155
"33239","NAKURU","GILGIL","23",2100,1790,3890
"33240","NAKURU","GILGIL","24",1716,1652,3368
"33241","NAKURU","GILGIL","20-24",11541,9353,20894
"33242","NAKURU","GILGIL","25",1527,1585,3112
"33243","NAKURU","GILGIL","26",1235,1459,2694
"33244","NAKURU","GILGIL","27",1262,1436,2698
"33245","NAKURU","GILGIL","28",1076,1320,2396
"33246","NAKURU","GILGIL","29",1220,1384,2604
"33247","NAKURU","GILGIL","25-29",6320,7184,13504
"33248","NAKURU","GILGIL","30",1487,1833,3320
"33249","NAKURU","GILGIL","31",1068,1204,2272
"33250","NAKURU","GILGIL","32",1416,1577,2993
"33251","NAKURU","GILGIL","33",1138,1324,2462
"33252","NAKURU","GILGIL","34",1125,1280,2405
"33253","NAKURU","GILGIL","30-34",6234,7218,13452
"33254","NAKURU","GILGIL","35",1473,1547,3020
"33255","NAKURU","GILGIL","36",1025,1066,2091
"33256","NAKURU","GILGIL","37",1026,1001,2027
"33257","NAKURU","GILGIL","38",855,870,1725
"33258","NAKURU","GILGIL","39",902,966,1868
"33259","NAKURU","GILGIL","35-39",5281,5450,10731
"33260","NAKURU","GILGIL","40",1096,1070,2166
"33261","NAKURU","GILGIL","41",1031,940,1971
"33262","NAKURU","GILGIL","42",895,860,1755
"33263","NAKURU","GILGIL","43",770,820,1590
"33264","NAKURU","GILGIL","44",571,588,1159
"33265","NAKURU","GILGIL","40-44",4363,4278,8641
"33266","NAKURU","GILGIL","45",980,966,1946
"33267","NAKURU","GILGIL","46",676,712,1388
"33268","NAKURU","GILGIL","47",830,768,1598
"33269","NAKURU","GILGIL","48",592,610,1202
"33270","NAKURU","GILGIL","49",628,668,1296
"33271","NAKURU","GILGIL","45-49",3706,3724,7430
"33272","NAKURU","GILGIL","50",750,831,1581
"33273","NAKURU","GILGIL","51",549,561,1110
"33274","NAKURU","GILGIL","52",595,605,1200
"33275","NAKURU","GILGIL","53",395,463,858
"33276","NAKURU","GILGIL","54",485,525,1010
"33277","NAKURU","GILGIL","50-54",2774,2985,5759
"33278","NAKURU","GILGIL","55",535,563,1098
"33279","NAKURU","GILGIL","56",571,555,1126
"33280","NAKURU","GILGIL","57",415,483,898
"33281","NAKURU","GILGIL","58",372,441,813
"33282","NAKURU","GILGIL","59",390,449,839
"33283","NAKURU","GILGIL","55-59",2283,2491,4774
"33284","NAKURU","GILGIL","60",446,517,963
"33285","NAKURU","GILGIL","61",330,392,722
"33286","NAKURU","GILGIL","62",339,303,642
"33287","NAKURU","GILGIL","63",264,278,542
"33288","NAKURU","GILGIL","64",198,238,436
"33289","NAKURU","GILGIL","60-64",1577,1728,3305
"33290","NAKURU","GILGIL","65",344,324,668
"33291","NAKURU","GILGIL","66",229,197,426
"33292","NAKURU","GILGIL","67",374,375,749
"33293","NAKURU","GILGIL","68",174,150,324
"33294","NAKURU","GILGIL","69",262,282,544
"33295","NAKURU","GILGIL","65-69",1383,1328,2711
"33296","NAKURU","GILGIL","70",300,390,690
"33297","NAKURU","GILGIL","71",207,220,427
"33298","NAKURU","GILGIL","72",204,179,383
"33299","NAKURU","GILGIL","73",170,147,317
"33300","NAKURU","GILGIL","74",146,171,317
"33301","NAKURU","GILGIL","70-74",1027,1107,2134
"33302","NAKURU","GILGIL","75",126,185,311
"33303","NAKURU","GILGIL","76",143,212,355
"33304","NAKURU","GILGIL","77",93,143,236
"33305","NAKURU","GILGIL","78",73,91,164
"33306","NAKURU","GILGIL","79",79,159,238
"33307","NAKURU","GILGIL","75-79",514,790,1304
"33308","NAKURU","GILGIL","80",113,161,274
"33309","NAKURU","GILGIL","81",61,75,136
"33310","NAKURU","GILGIL","82",49,53,102
"33311","NAKURU","GILGIL","83",66,70,136
"33312","NAKURU","GILGIL","84",64,73,137
"33313","NAKURU","GILGIL","80-84",353,432,785
"33314","NAKURU","GILGIL","85",45,58,103
"33315","NAKURU","GILGIL","86",30,58,88
"33316","NAKURU","GILGIL","87",38,42,80
"33317","NAKURU","GILGIL","88",21,32,53
"33318","NAKURU","GILGIL","89",45,72,117
"33319","NAKURU","GILGIL","85-89",179,262,441
"33320","NAKURU","GILGIL","90",21,53,74
"33321","NAKURU","GILGIL","91",15,29,44
"33322","NAKURU","GILGIL","92",7,25,32
"33323","NAKURU","GILGIL","93",6,23,29
"33324","NAKURU","GILGIL","94",3,16,19
"33325","NAKURU","GILGIL","90-94",52,146,198
"33326","NAKURU","GILGIL","95",14,28,42
"33327","NAKURU","GILGIL","96",5,10,15
"33328","NAKURU","GILGIL","97",14,11,25
"33329","NAKURU","GILGIL","98",6,10,16
"33330","NAKURU","GILGIL","99",5,20,25
"33331","NAKURU","GILGIL","95-99",44,79,123
"33332","NAKURU","GILGIL","100+",8,54,62
"33333","NAKURU","GILGIL","Not Stated",6,3,9
"33334","NAKURU","KURESOI NORTH","Total",87472,87599,175071
"33335","NAKURU","KURESOI NORTH","0",2148,2119,4267
"33336","NAKURU","KURESOI NORTH","1",2244,2246,4490
"33337","NAKURU","KURESOI NORTH","2",2398,2335,4733
"33338","NAKURU","KURESOI NORTH","3",2655,2527,5182
"33339","NAKURU","KURESOI NORTH","4",2753,2600,5353
"33340","NAKURU","KURESOI NORTH","0 - 4",12198,11827,24025
"33341","NAKURU","KURESOI NORTH","5",2575,2534,5109
"33342","NAKURU","KURESOI NORTH","6",2622,2573,5195
"33343","NAKURU","KURESOI NORTH","7",2586,2653,5239
"33344","NAKURU","KURESOI NORTH","8",2363,2415,4778
"33345","NAKURU","KURESOI NORTH","9",2998,2907,5905
"33346","NAKURU","KURESOI NORTH","5-9",13144,13082,26226
"33347","NAKURU","KURESOI NORTH","10",2746,2713,5459
"33348","NAKURU","KURESOI NORTH","11",2502,2518,5020
"33349","NAKURU","KURESOI NORTH","12",2961,2815,5776
"33350","NAKURU","KURESOI NORTH","13",2763,2720,5483
"33351","NAKURU","KURESOI NORTH","14",2733,2564,5297
"33352","NAKURU","KURESOI NORTH","10 -14",13705,13330,27035
"33353","NAKURU","KURESOI NORTH","15",2629,2493,5122
"33354","NAKURU","KURESOI NORTH","16",2374,2141,4515
"33355","NAKURU","KURESOI NORTH","17",2293,2029,4322
"33356","NAKURU","KURESOI NORTH","18",1749,1513,3262
"33357","NAKURU","KURESOI NORTH","19",1899,1888,3787
"33358","NAKURU","KURESOI NORTH","15-19",10944,10064,21008
"33359","NAKURU","KURESOI NORTH","20",1467,1577,3044
"33360","NAKURU","KURESOI NORTH","21",1421,1553,2974
"33361","NAKURU","KURESOI NORTH","22",1349,1460,2809
"33362","NAKURU","KURESOI NORTH","23",1357,1453,2810
"33363","NAKURU","KURESOI NORTH","24",1216,1313,2529
"33364","NAKURU","KURESOI NORTH","20-24",6810,7356,14166
"33365","NAKURU","KURESOI NORTH","25",1411,1568,2979
"33366","NAKURU","KURESOI NORTH","26",1070,1214,2284
"33367","NAKURU","KURESOI NORTH","27",1310,1486,2796
"33368","NAKURU","KURESOI NORTH","28",847,953,1800
"33369","NAKURU","KURESOI NORTH","29",989,1139,2128
"33370","NAKURU","KURESOI NORTH","25-29",5627,6360,11987
"33371","NAKURU","KURESOI NORTH","30",1238,1473,2711
"33372","NAKURU","KURESOI NORTH","31",979,1153,2132
"33373","NAKURU","KURESOI NORTH","32",1142,1424,2566
"33374","NAKURU","KURESOI NORTH","33",1045,1167,2212
"33375","NAKURU","KURESOI NORTH","34",903,1048,1951
"33376","NAKURU","KURESOI NORTH","30-34",5307,6265,11572
"33377","NAKURU","KURESOI NORTH","35",1251,1322,2573
"33378","NAKURU","KURESOI NORTH","36",794,695,1489
"33379","NAKURU","KURESOI NORTH","37",841,784,1625
"33380","NAKURU","KURESOI NORTH","38",563,524,1087
"33381","NAKURU","KURESOI NORTH","39",737,632,1369
"33382","NAKURU","KURESOI NORTH","35-39",4186,3957,8143
"33383","NAKURU","KURESOI NORTH","40",869,769,1638
"33384","NAKURU","KURESOI NORTH","41",1016,905,1921
"33385","NAKURU","KURESOI NORTH","42",794,770,1564
"33386","NAKURU","KURESOI NORTH","43",568,621,1189
"33387","NAKURU","KURESOI NORTH","44",482,516,998
"33388","NAKURU","KURESOI NORTH","40-44",3729,3581,7310
"33389","NAKURU","KURESOI NORTH","45",1078,944,2022
"33390","NAKURU","KURESOI NORTH","46",606,619,1225
"33391","NAKURU","KURESOI NORTH","47",721,720,1441
"33392","NAKURU","KURESOI NORTH","48",429,421,850
"33393","NAKURU","KURESOI NORTH","49",589,608,1197
"33394","NAKURU","KURESOI NORTH","45-49",3423,3312,6735
"33395","NAKURU","KURESOI NORTH","50",612,651,1263
"33396","NAKURU","KURESOI NORTH","51",540,485,1025
"33397","NAKURU","KURESOI NORTH","52",426,377,803
"33398","NAKURU","KURESOI NORTH","53",308,317,625
"33399","NAKURU","KURESOI NORTH","54",385,287,672
"33400","NAKURU","KURESOI NORTH","50-54",2271,2117,4388
"33401","NAKURU","KURESOI NORTH","55",379,353,732
"33402","NAKURU","KURESOI NORTH","56",365,398,763
"33403","NAKURU","KURESOI NORTH","57",352,396,748
"33404","NAKURU","KURESOI NORTH","58",407,520,927
"33405","NAKURU","KURESOI NORTH","59",375,341,716
"33406","NAKURU","KURESOI NORTH","55-59",1878,2008,3886
"33407","NAKURU","KURESOI NORTH","60",407,417,824
"33408","NAKURU","KURESOI NORTH","61",337,357,694
"33409","NAKURU","KURESOI NORTH","62",240,234,474
"33410","NAKURU","KURESOI NORTH","63",226,232,458
"33411","NAKURU","KURESOI NORTH","64",164,179,343
"33412","NAKURU","KURESOI NORTH","60-64",1374,1419,2793
"33413","NAKURU","KURESOI NORTH","65",289,288,577
"33414","NAKURU","KURESOI NORTH","66",179,144,323
"33415","NAKURU","KURESOI NORTH","67",331,284,615
"33416","NAKURU","KURESOI NORTH","68",132,119,251
"33417","NAKURU","KURESOI NORTH","69",209,204,413
"33418","NAKURU","KURESOI NORTH","65-69",1140,1039,2179
"33419","NAKURU","KURESOI NORTH","70",250,277,527
"33420","NAKURU","KURESOI NORTH","71",193,173,366
"33421","NAKURU","KURESOI NORTH","72",175,123,298
"33422","NAKURU","KURESOI NORTH","73",128,96,224
"33423","NAKURU","KURESOI NORTH","74",103,105,208
"33424","NAKURU","KURESOI NORTH","70-74",849,774,1623
"33425","NAKURU","KURESOI NORTH","75",91,115,206
"33426","NAKURU","KURESOI NORTH","76",100,95,195
"33427","NAKURU","KURESOI NORTH","77",100,78,178
"33428","NAKURU","KURESOI NORTH","78",65,58,123
"33429","NAKURU","KURESOI NORTH","79",79,94,173
"33430","NAKURU","KURESOI NORTH","75-79",435,440,875
"33431","NAKURU","KURESOI NORTH","80",64,111,175
"33432","NAKURU","KURESOI NORTH","81",45,57,102
"33433","NAKURU","KURESOI NORTH","82",40,37,77
"33434","NAKURU","KURESOI NORTH","83",48,45,93
"33435","NAKURU","KURESOI NORTH","84",37,54,91
"33436","NAKURU","KURESOI NORTH","80-84",234,304,538
"33437","NAKURU","KURESOI NORTH","85",25,41,66
"33438","NAKURU","KURESOI NORTH","86",17,26,43
"33439","NAKURU","KURESOI NORTH","87",32,42,74
"33440","NAKURU","KURESOI NORTH","88",11,27,38
"33441","NAKURU","KURESOI NORTH","89",30,70,100
"33442","NAKURU","KURESOI NORTH","85-89",115,206,321
"33443","NAKURU","KURESOI NORTH","90",18,32,50
"33444","NAKURU","KURESOI NORTH","91",19,18,37
"33445","NAKURU","KURESOI NORTH","92",8,9,17
"33446","NAKURU","KURESOI NORTH","93",4,14,18
"33447","NAKURU","KURESOI NORTH","94",9,11,20
"33448","NAKURU","KURESOI NORTH","90-94",58,84,142
"33449","NAKURU","KURESOI NORTH","95",13,13,26
"33450","NAKURU","KURESOI NORTH","96",4,9,13
"33451","NAKURU","KURESOI NORTH","97",8,5,13
"33452","NAKURU","KURESOI NORTH","98",4,7,11
"33453","NAKURU","KURESOI NORTH","99",8,14,22
"33454","NAKURU","KURESOI NORTH","95-99",37,48,85
"33455","NAKURU","KURESOI NORTH","100+",7,25,32
"33456","NAKURU","KURESOI NORTH","Not Stated",1,1,2
"33457","NAKURU","KURESOI SOUTH","Total",78204,77117,155321
"33458","NAKURU","KURESOI SOUTH","0",1979,1897,3876
"33459","NAKURU","KURESOI SOUTH","1",2080,2050,4130
"33460","NAKURU","KURESOI SOUTH","2",2235,2146,4381
"33461","NAKURU","KURESOI SOUTH","3",2339,2240,4579
"33462","NAKURU","KURESOI SOUTH","4",2349,2375,4724
"33463","NAKURU","KURESOI SOUTH","0 - 4",10982,10708,21690
"33464","NAKURU","KURESOI SOUTH","5",2444,2237,4681
"33465","NAKURU","KURESOI SOUTH","6",2301,2264,4565
"33466","NAKURU","KURESOI SOUTH","7",2507,2388,4895
"33467","NAKURU","KURESOI SOUTH","8",2059,2033,4092
"33468","NAKURU","KURESOI SOUTH","9",2562,2556,5118
"33469","NAKURU","KURESOI SOUTH","5-9",11873,11478,23351
"33470","NAKURU","KURESOI SOUTH","10",2530,2384,4914
"33471","NAKURU","KURESOI SOUTH","11",2330,2303,4633
"33472","NAKURU","KURESOI SOUTH","12",2651,2455,5106
"33473","NAKURU","KURESOI SOUTH","13",2350,2428,4778
"33474","NAKURU","KURESOI SOUTH","14",2282,2214,4496
"33475","NAKURU","KURESOI SOUTH","10 -14",12143,11784,23927
"33476","NAKURU","KURESOI SOUTH","15",2348,2160,4508
"33477","NAKURU","KURESOI SOUTH","16",1903,1840,3743
"33478","NAKURU","KURESOI SOUTH","17",1968,1658,3626
"33479","NAKURU","KURESOI SOUTH","18",1463,1297,2760
"33480","NAKURU","KURESOI SOUTH","19",1726,1816,3542
"33481","NAKURU","KURESOI SOUTH","15-19",9408,8771,18179
"33482","NAKURU","KURESOI SOUTH","20",1365,1435,2800
"33483","NAKURU","KURESOI SOUTH","21",1316,1511,2827
"33484","NAKURU","KURESOI SOUTH","22",1263,1402,2665
"33485","NAKURU","KURESOI SOUTH","23",1269,1583,2852
"33486","NAKURU","KURESOI SOUTH","24",1108,1287,2395
"33487","NAKURU","KURESOI SOUTH","20-24",6321,7218,13539
"33488","NAKURU","KURESOI SOUTH","25",1366,1371,2737
"33489","NAKURU","KURESOI SOUTH","26",1036,1117,2153
"33490","NAKURU","KURESOI SOUTH","27",1215,1293,2508
"33491","NAKURU","KURESOI SOUTH","28",767,890,1657
"33492","NAKURU","KURESOI SOUTH","29",938,1102,2040
"33493","NAKURU","KURESOI SOUTH","25-29",5322,5773,11095
"33494","NAKURU","KURESOI SOUTH","30",1136,1390,2526
"33495","NAKURU","KURESOI SOUTH","31",914,1028,1942
"33496","NAKURU","KURESOI SOUTH","32",1104,1210,2314
"33497","NAKURU","KURESOI SOUTH","33",1037,1096,2133
"33498","NAKURU","KURESOI SOUTH","34",898,967,1865
"33499","NAKURU","KURESOI SOUTH","30-34",5089,5691,10780
"33500","NAKURU","KURESOI SOUTH","35",1167,1034,2201
"33501","NAKURU","KURESOI SOUTH","36",705,565,1270
"33502","NAKURU","KURESOI SOUTH","37",824,662,1486
"33503","NAKURU","KURESOI SOUTH","38",411,398,809
"33504","NAKURU","KURESOI SOUTH","39",623,491,1114
"33505","NAKURU","KURESOI SOUTH","35-39",3730,3150,6880
"33506","NAKURU","KURESOI SOUTH","40",825,724,1549
"33507","NAKURU","KURESOI SOUTH","41",1052,845,1897
"33508","NAKURU","KURESOI SOUTH","42",752,599,1351
"33509","NAKURU","KURESOI SOUTH","43",556,588,1144
"33510","NAKURU","KURESOI SOUTH","44",404,465,869
"33511","NAKURU","KURESOI SOUTH","40-44",3589,3221,6810
"33512","NAKURU","KURESOI SOUTH","45",1079,872,1951
"33513","NAKURU","KURESOI SOUTH","46",551,495,1046
"33514","NAKURU","KURESOI SOUTH","47",579,606,1185
"33515","NAKURU","KURESOI SOUTH","48",314,287,601
"33516","NAKURU","KURESOI SOUTH","49",476,462,938
"33517","NAKURU","KURESOI SOUTH","45-49",2999,2722,5721
"33518","NAKURU","KURESOI SOUTH","50",458,413,871
"33519","NAKURU","KURESOI SOUTH","51",476,449,925
"33520","NAKURU","KURESOI SOUTH","52",294,308,602
"33521","NAKURU","KURESOI SOUTH","53",230,205,435
"33522","NAKURU","KURESOI SOUTH","54",260,263,523
"33523","NAKURU","KURESOI SOUTH","50-54",1718,1638,3356
"33524","NAKURU","KURESOI SOUTH","55",230,243,473
"33525","NAKURU","KURESOI SOUTH","56",281,270,551
"33526","NAKURU","KURESOI SOUTH","57",266,309,575
"33527","NAKURU","KURESOI SOUTH","58",395,562,957
"33528","NAKURU","KURESOI SOUTH","59",342,280,622
"33529","NAKURU","KURESOI SOUTH","55-59",1514,1664,3178
"33530","NAKURU","KURESOI SOUTH","60",356,332,688
"33531","NAKURU","KURESOI SOUTH","61",240,242,482
"33532","NAKURU","KURESOI SOUTH","62",235,199,434
"33533","NAKURU","KURESOI SOUTH","63",203,217,420
"33534","NAKURU","KURESOI SOUTH","64",141,136,277
"33535","NAKURU","KURESOI SOUTH","60-64",1175,1126,2301
"33536","NAKURU","KURESOI SOUTH","65",264,260,524
"33537","NAKURU","KURESOI SOUTH","66",154,133,287
"33538","NAKURU","KURESOI SOUTH","67",290,233,523
"33539","NAKURU","KURESOI SOUTH","68",95,93,188
"33540","NAKURU","KURESOI SOUTH","69",180,136,316
"33541","NAKURU","KURESOI SOUTH","65-69",983,855,1838
"33542","NAKURU","KURESOI SOUTH","70",181,196,377
"33543","NAKURU","KURESOI SOUTH","71",180,147,327
"33544","NAKURU","KURESOI SOUTH","72",122,71,193
"33545","NAKURU","KURESOI SOUTH","73",103,60,163
"33546","NAKURU","KURESOI SOUTH","74",93,96,189
"33547","NAKURU","KURESOI SOUTH","70-74",679,570,1249
"33548","NAKURU","KURESOI SOUTH","75",75,85,160
"33549","NAKURU","KURESOI SOUTH","76",59,52,111
"33550","NAKURU","KURESOI SOUTH","77",92,48,140
"33551","NAKURU","KURESOI SOUTH","78",47,36,83
"33552","NAKURU","KURESOI SOUTH","79",54,73,127
"33553","NAKURU","KURESOI SOUTH","75-79",327,294,621
"33554","NAKURU","KURESOI SOUTH","80",47,75,122
"33555","NAKURU","KURESOI SOUTH","81",34,36,70
"33556","NAKURU","KURESOI SOUTH","82",30,21,51
"33557","NAKURU","KURESOI SOUTH","83",29,32,61
"33558","NAKURU","KURESOI SOUTH","84",29,41,70
"33559","NAKURU","KURESOI SOUTH","80-84",169,205,374
"33560","NAKURU","KURESOI SOUTH","85",19,28,47
"33561","NAKURU","KURESOI SOUTH","86",29,20,49
"33562","NAKURU","KURESOI SOUTH","87",24,21,45
"33563","NAKURU","KURESOI SOUTH","88",12,12,24
"33564","NAKURU","KURESOI SOUTH","89",29,50,79
"33565","NAKURU","KURESOI SOUTH","85-89",113,131,244
"33566","NAKURU","KURESOI SOUTH","90",11,26,37
"33567","NAKURU","KURESOI SOUTH","91",8,14,22
"33568","NAKURU","KURESOI SOUTH","92",6,11,17
"33569","NAKURU","KURESOI SOUTH","93",9,3,12
"33570","NAKURU","KURESOI SOUTH","94",5,10,15
"33571","NAKURU","KURESOI SOUTH","90-94",39,64,103
"33572","NAKURU","KURESOI SOUTH","95",8,15,23
"33573","NAKURU","KURESOI SOUTH","96",3,5,8
"33574","NAKURU","KURESOI SOUTH","97",1,7,8
"33575","NAKURU","KURESOI SOUTH","98",3,1,4
"33576","NAKURU","KURESOI SOUTH","99",2,8,10
"33577","NAKURU","KURESOI SOUTH","95-99",17,36,53
"33578","NAKURU","KURESOI SOUTH","100+",14,17,31
"33579","NAKURU","KURESOI SOUTH","Not Stated",NA,1,1
"33580","NAKURU","MOLO","Total",78129,78598,156727
"33581","NAKURU","MOLO","0",1857,1952,3809
"33582","NAKURU","MOLO","1",1925,1811,3736
"33583","NAKURU","MOLO","2",1960,1907,3867
"33584","NAKURU","MOLO","3",2102,2095,4197
"33585","NAKURU","MOLO","4",2109,2091,4200
"33586","NAKURU","MOLO","0 - 4",9953,9856,19809
"33587","NAKURU","MOLO","5",2042,2016,4058
"33588","NAKURU","MOLO","6",2014,1974,3988
"33589","NAKURU","MOLO","7",2078,2045,4123
"33590","NAKURU","MOLO","8",1963,1943,3906
"33591","NAKURU","MOLO","9",2244,2089,4333
"33592","NAKURU","MOLO","5-9",10341,10067,20408
"33593","NAKURU","MOLO","10",2208,2089,4297
"33594","NAKURU","MOLO","11",2010,1989,3999
"33595","NAKURU","MOLO","12",2351,2240,4591
"33596","NAKURU","MOLO","13",2369,2282,4651
"33597","NAKURU","MOLO","14",2169,2046,4215
"33598","NAKURU","MOLO","10 -14",11107,10646,21753
"33599","NAKURU","MOLO","15",2107,2043,4150
"33600","NAKURU","MOLO","16",2058,2005,4063
"33601","NAKURU","MOLO","17",2076,1929,4005
"33602","NAKURU","MOLO","18",1600,1460,3060
"33603","NAKURU","MOLO","19",1672,1562,3234
"33604","NAKURU","MOLO","15-19",9513,8999,18512
"33605","NAKURU","MOLO","20",1302,1326,2628
"33606","NAKURU","MOLO","21",1264,1313,2577
"33607","NAKURU","MOLO","22",1270,1330,2600
"33608","NAKURU","MOLO","23",1205,1357,2562
"33609","NAKURU","MOLO","24",1174,1227,2401
"33610","NAKURU","MOLO","20-24",6215,6553,12768
"33611","NAKURU","MOLO","25",1221,1331,2552
"33612","NAKURU","MOLO","26",980,1134,2114
"33613","NAKURU","MOLO","27",1197,1225,2422
"33614","NAKURU","MOLO","28",907,992,1899
"33615","NAKURU","MOLO","29",1014,1164,2178
"33616","NAKURU","MOLO","25-29",5319,5846,11165
"33617","NAKURU","MOLO","30",1236,1438,2674
"33618","NAKURU","MOLO","31",890,1016,1906
"33619","NAKURU","MOLO","32",1281,1278,2559
"33620","NAKURU","MOLO","33",955,1104,2059
"33621","NAKURU","MOLO","34",950,1057,2007
"33622","NAKURU","MOLO","30-34",5312,5893,11205
"33623","NAKURU","MOLO","35",1274,1357,2631
"33624","NAKURU","MOLO","36",873,829,1702
"33625","NAKURU","MOLO","37",834,826,1660
"33626","NAKURU","MOLO","38",650,674,1324
"33627","NAKURU","MOLO","39",795,713,1508
"33628","NAKURU","MOLO","35-39",4426,4399,8825
"33629","NAKURU","MOLO","40",923,854,1777
"33630","NAKURU","MOLO","41",960,853,1813
"33631","NAKURU","MOLO","42",856,763,1619
"33632","NAKURU","MOLO","43",648,671,1319
"33633","NAKURU","MOLO","44",536,567,1103
"33634","NAKURU","MOLO","40-44",3923,3708,7631
"33635","NAKURU","MOLO","45",961,920,1881
"33636","NAKURU","MOLO","46",625,625,1250
"33637","NAKURU","MOLO","47",727,677,1404
"33638","NAKURU","MOLO","48",465,492,957
"33639","NAKURU","MOLO","49",616,573,1189
"33640","NAKURU","MOLO","45-49",3394,3287,6681
"33641","NAKURU","MOLO","50",687,694,1381
"33642","NAKURU","MOLO","51",541,523,1064
"33643","NAKURU","MOLO","52",447,477,924
"33644","NAKURU","MOLO","53",336,345,681
"33645","NAKURU","MOLO","54",435,394,829
"33646","NAKURU","MOLO","50-54",2446,2433,4879
"33647","NAKURU","MOLO","55",465,429,894
"33648","NAKURU","MOLO","56",432,421,853
"33649","NAKURU","MOLO","57",395,415,810
"33650","NAKURU","MOLO","58",381,407,788
"33651","NAKURU","MOLO","59",406,381,787
"33652","NAKURU","MOLO","55-59",2079,2053,4132
"33653","NAKURU","MOLO","60",442,417,859
"33654","NAKURU","MOLO","61",265,321,586
"33655","NAKURU","MOLO","62",252,255,507
"33656","NAKURU","MOLO","63",216,209,425
"33657","NAKURU","MOLO","64",172,192,364
"33658","NAKURU","MOLO","60-64",1347,1394,2741
"33659","NAKURU","MOLO","65",276,275,551
"33660","NAKURU","MOLO","66",180,185,365
"33661","NAKURU","MOLO","67",311,281,592
"33662","NAKURU","MOLO","68",123,148,271
"33663","NAKURU","MOLO","69",202,226,428
"33664","NAKURU","MOLO","65-69",1092,1115,2207
"33665","NAKURU","MOLO","70",239,308,547
"33666","NAKURU","MOLO","71",176,183,359
"33667","NAKURU","MOLO","72",152,128,280
"33668","NAKURU","MOLO","73",107,117,224
"33669","NAKURU","MOLO","74",113,140,253
"33670","NAKURU","MOLO","70-74",787,876,1663
"33671","NAKURU","MOLO","75",90,133,223
"33672","NAKURU","MOLO","76",99,195,294
"33673","NAKURU","MOLO","77",73,109,182
"33674","NAKURU","MOLO","78",57,70,127
"33675","NAKURU","MOLO","79",68,96,164
"33676","NAKURU","MOLO","75-79",387,603,990
"33677","NAKURU","MOLO","80",89,151,240
"33678","NAKURU","MOLO","81",43,68,111
"33679","NAKURU","MOLO","82",35,58,93
"33680","NAKURU","MOLO","83",44,73,117
"33681","NAKURU","MOLO","84",49,66,115
"33682","NAKURU","MOLO","80-84",260,416,676
"33683","NAKURU","MOLO","85",32,60,92
"33684","NAKURU","MOLO","86",25,37,62
"33685","NAKURU","MOLO","87",29,53,82
"33686","NAKURU","MOLO","88",22,22,44
"33687","NAKURU","MOLO","89",34,65,99
"33688","NAKURU","MOLO","85-89",142,237,379
"33689","NAKURU","MOLO","90",16,35,51
"33690","NAKURU","MOLO","91",13,42,55
"33691","NAKURU","MOLO","92",7,11,18
"33692","NAKURU","MOLO","93",8,15,23
"33693","NAKURU","MOLO","94",5,11,16
"33694","NAKURU","MOLO","90-94",49,114,163
"33695","NAKURU","MOLO","95",10,24,34
"33696","NAKURU","MOLO","96",3,15,18
"33697","NAKURU","MOLO","97",5,8,13
"33698","NAKURU","MOLO","98",4,8,12
"33699","NAKURU","MOLO","99",4,13,17
"33700","NAKURU","MOLO","95-99",26,68,94
"33701","NAKURU","MOLO","100+",10,35,45
"33702","NAKURU","MOLO","Not Stated",1,NA,1
"33703","NAKURU","NAIVASHA","Total",179222,176132,355354
"33704","NAKURU","NAIVASHA","0",4817,4625,9442
"33705","NAKURU","NAIVASHA","1",4358,4181,8539
"33706","NAKURU","NAIVASHA","2",4242,4260,8502
"33707","NAKURU","NAIVASHA","3",4502,4331,8833
"33708","NAKURU","NAIVASHA","4",4230,4150,8380
"33709","NAKURU","NAIVASHA","0 - 4",22149,21547,43696
"33710","NAKURU","NAIVASHA","5",4027,3892,7919
"33711","NAKURU","NAIVASHA","6",4065,3906,7971
"33712","NAKURU","NAIVASHA","7",4039,4042,8081
"33713","NAKURU","NAIVASHA","8",3787,3827,7614
"33714","NAKURU","NAIVASHA","9",4181,4260,8441
"33715","NAKURU","NAIVASHA","5-9",20099,19927,40026
"33716","NAKURU","NAIVASHA","10",4120,4136,8256
"33717","NAKURU","NAIVASHA","11",3734,3844,7578
"33718","NAKURU","NAIVASHA","12",4114,4025,8139
"33719","NAKURU","NAIVASHA","13",4102,4156,8258
"33720","NAKURU","NAIVASHA","14",3918,3809,7727
"33721","NAKURU","NAIVASHA","10 -14",19988,19970,39958
"33722","NAKURU","NAIVASHA","15",3579,3538,7117
"33723","NAKURU","NAIVASHA","16",3280,3443,6723
"33724","NAKURU","NAIVASHA","17",3521,3469,6990
"33725","NAKURU","NAIVASHA","18",2966,2950,5916
"33726","NAKURU","NAIVASHA","19",3615,3713,7328
"33727","NAKURU","NAIVASHA","15-19",16961,17113,34074
"33728","NAKURU","NAIVASHA","20",3642,3927,7569
"33729","NAKURU","NAIVASHA","21",3851,3813,7664
"33730","NAKURU","NAIVASHA","22",3807,3958,7765
"33731","NAKURU","NAIVASHA","23",4086,4200,8286
"33732","NAKURU","NAIVASHA","24",3894,3806,7700
"33733","NAKURU","NAIVASHA","20-24",19280,19704,38984
"33734","NAKURU","NAIVASHA","25",3888,4127,8015
"33735","NAKURU","NAIVASHA","26",3436,3670,7106
"33736","NAKURU","NAIVASHA","27",3420,3382,6802
"33737","NAKURU","NAIVASHA","28",2970,3022,5992
"33738","NAKURU","NAIVASHA","29",3258,3267,6525
"33739","NAKURU","NAIVASHA","25-29",16972,17468,34440
"33740","NAKURU","NAIVASHA","30",4045,4125,8170
"33741","NAKURU","NAIVASHA","31",2686,2707,5393
"33742","NAKURU","NAIVASHA","32",3511,3710,7221
"33743","NAKURU","NAIVASHA","33",2811,2937,5748
"33744","NAKURU","NAIVASHA","34",2642,2684,5326
"33745","NAKURU","NAIVASHA","30-34",15695,16163,31858
"33746","NAKURU","NAIVASHA","35",3558,3544,7102
"33747","NAKURU","NAIVASHA","36",2553,2355,4908
"33748","NAKURU","NAIVASHA","37",2461,2230,4691
"33749","NAKURU","NAIVASHA","38",2180,2001,4181
"33750","NAKURU","NAIVASHA","39",2264,2048,4312
"33751","NAKURU","NAIVASHA","35-39",13016,12178,25194
"33752","NAKURU","NAIVASHA","40",2760,2383,5143
"33753","NAKURU","NAIVASHA","41",2396,2056,4452
"33754","NAKURU","NAIVASHA","42",2259,1884,4143
"33755","NAKURU","NAIVASHA","43",1748,1590,3338
"33756","NAKURU","NAIVASHA","44",1410,1321,2731
"33757","NAKURU","NAIVASHA","40-44",10573,9234,19807
"33758","NAKURU","NAIVASHA","45",2335,1992,4327
"33759","NAKURU","NAIVASHA","46",1605,1370,2975
"33760","NAKURU","NAIVASHA","47",1775,1368,3143
"33761","NAKURU","NAIVASHA","48",1315,1068,2383
"33762","NAKURU","NAIVASHA","49",1371,1120,2491
"33763","NAKURU","NAIVASHA","45-49",8401,6918,15319
"33764","NAKURU","NAIVASHA","50",1595,1357,2952
"33765","NAKURU","NAIVASHA","51",1080,910,1990
"33766","NAKURU","NAIVASHA","52",1170,1026,2196
"33767","NAKURU","NAIVASHA","53",793,697,1490
"33768","NAKURU","NAIVASHA","54",897,812,1709
"33769","NAKURU","NAIVASHA","50-54",5535,4802,10337
"33770","NAKURU","NAIVASHA","55",940,807,1747
"33771","NAKURU","NAIVASHA","56",923,836,1759
"33772","NAKURU","NAIVASHA","57",725,671,1396
"33773","NAKURU","NAIVASHA","58",599,516,1115
"33774","NAKURU","NAIVASHA","59",649,541,1190
"33775","NAKURU","NAIVASHA","55-59",3836,3371,7207
"33776","NAKURU","NAIVASHA","60",742,693,1435
"33777","NAKURU","NAIVASHA","61",497,500,997
"33778","NAKURU","NAIVASHA","62",409,413,822
"33779","NAKURU","NAIVASHA","63",370,335,705
"33780","NAKURU","NAIVASHA","64",246,251,497
"33781","NAKURU","NAIVASHA","60-64",2264,2192,4456
"33782","NAKURU","NAIVASHA","65",443,402,845
"33783","NAKURU","NAIVASHA","66",264,296,560
"33784","NAKURU","NAIVASHA","67",442,496,938
"33785","NAKURU","NAIVASHA","68",199,229,428
"33786","NAKURU","NAIVASHA","69",306,331,637
"33787","NAKURU","NAIVASHA","65-69",1654,1754,3408
"33788","NAKURU","NAIVASHA","70",413,503,916
"33789","NAKURU","NAIVASHA","71",264,280,544
"33790","NAKURU","NAIVASHA","72",262,245,507
"33791","NAKURU","NAIVASHA","73",184,226,410
"33792","NAKURU","NAIVASHA","74",166,216,382
"33793","NAKURU","NAIVASHA","70-74",1289,1470,2759
"33794","NAKURU","NAIVASHA","75",157,238,395
"33795","NAKURU","NAIVASHA","76",172,311,483
"33796","NAKURU","NAIVASHA","77",120,144,264
"33797","NAKURU","NAIVASHA","78",86,137,223
"33798","NAKURU","NAIVASHA","79",116,167,283
"33799","NAKURU","NAIVASHA","75-79",651,997,1648
"33800","NAKURU","NAIVASHA","80",131,213,344
"33801","NAKURU","NAIVASHA","81",79,99,178
"33802","NAKURU","NAIVASHA","82",80,78,158
"33803","NAKURU","NAIVASHA","83",84,94,178
"33804","NAKURU","NAIVASHA","84",77,119,196
"33805","NAKURU","NAIVASHA","80-84",451,603,1054
"33806","NAKURU","NAIVASHA","85",70,113,183
"33807","NAKURU","NAIVASHA","86",32,85,117
"33808","NAKURU","NAIVASHA","87",45,78,123
"33809","NAKURU","NAIVASHA","88",36,32,68
"33810","NAKURU","NAIVASHA","89",47,87,134
"33811","NAKURU","NAIVASHA","85-89",230,395,625
"33812","NAKURU","NAIVASHA","90",31,72,103
"33813","NAKURU","NAIVASHA","91",21,38,59
"33814","NAKURU","NAIVASHA","92",17,24,41
"33815","NAKURU","NAIVASHA","93",10,17,27
"33816","NAKURU","NAIVASHA","94",10,18,28
"33817","NAKURU","NAIVASHA","90-94",89,169,258
"33818","NAKURU","NAIVASHA","95",18,36,54
"33819","NAKURU","NAIVASHA","96",13,14,27
"33820","NAKURU","NAIVASHA","97",13,16,29
"33821","NAKURU","NAIVASHA","98",7,11,18
"33822","NAKURU","NAIVASHA","99",9,32,41
"33823","NAKURU","NAIVASHA","95-99",60,109,169
"33824","NAKURU","NAIVASHA","100+",18,47,65
"33825","NAKURU","NAIVASHA","Not Stated",11,1,12
"33826","NAKURU","NAKURU EAST","Total",92956,100960,193916
"33827","NAKURU","NAKURU EAST","0",2454,2415,4869
"33828","NAKURU","NAKURU EAST","1",2361,2283,4644
"33829","NAKURU","NAKURU EAST","2",2346,2337,4683
"33830","NAKURU","NAKURU EAST","3",2347,2280,4627
"33831","NAKURU","NAKURU EAST","4",2237,2180,4417
"33832","NAKURU","NAKURU EAST","0 - 4",11745,11495,23240
"33833","NAKURU","NAKURU EAST","5",2041,2009,4050
"33834","NAKURU","NAKURU EAST","6",1961,2025,3986
"33835","NAKURU","NAKURU EAST","7",2042,1987,4029
"33836","NAKURU","NAKURU EAST","8",1951,1990,3941
"33837","NAKURU","NAKURU EAST","9",2128,2057,4185
"33838","NAKURU","NAKURU EAST","5-9",10123,10068,20191
"33839","NAKURU","NAKURU EAST","10",2085,2049,4134
"33840","NAKURU","NAKURU EAST","11",1836,1958,3794
"33841","NAKURU","NAKURU EAST","12",1990,2071,4061
"33842","NAKURU","NAKURU EAST","13",2066,2169,4235
"33843","NAKURU","NAKURU EAST","14",1970,2015,3985
"33844","NAKURU","NAKURU EAST","10 -14",9947,10262,20209
"33845","NAKURU","NAKURU EAST","15",1825,1989,3814
"33846","NAKURU","NAKURU EAST","16",1876,1968,3844
"33847","NAKURU","NAKURU EAST","17",2039,2125,4164
"33848","NAKURU","NAKURU EAST","18",1706,1833,3539
"33849","NAKURU","NAKURU EAST","19",1901,2326,4227
"33850","NAKURU","NAKURU EAST","15-19",9347,10241,19588
"33851","NAKURU","NAKURU EAST","20",1793,2305,4098
"33852","NAKURU","NAKURU EAST","21",1943,2333,4276
"33853","NAKURU","NAKURU EAST","22",1904,2370,4274
"33854","NAKURU","NAKURU EAST","23",2043,2504,4547
"33855","NAKURU","NAKURU EAST","24",1876,2437,4313
"33856","NAKURU","NAKURU EAST","20-24",9559,11949,21508
"33857","NAKURU","NAKURU EAST","25",2034,2459,4493
"33858","NAKURU","NAKURU EAST","26",1733,2261,3994
"33859","NAKURU","NAKURU EAST","27",1807,2173,3980
"33860","NAKURU","NAKURU EAST","28",1576,2010,3586
"33861","NAKURU","NAKURU EAST","29",1748,2187,3935
"33862","NAKURU","NAKURU EAST","25-29",8898,11090,19988
"33863","NAKURU","NAKURU EAST","30",2008,2585,4593
"33864","NAKURU","NAKURU EAST","31",1459,1708,3167
"33865","NAKURU","NAKURU EAST","32",1895,2295,4190
"33866","NAKURU","NAKURU EAST","33",1494,1926,3420
"33867","NAKURU","NAKURU EAST","34",1497,1731,3228
"33868","NAKURU","NAKURU EAST","30-34",8353,10245,18598
"33869","NAKURU","NAKURU EAST","35",1787,2103,3890
"33870","NAKURU","NAKURU EAST","36",1343,1528,2871
"33871","NAKURU","NAKURU EAST","37",1326,1408,2734
"33872","NAKURU","NAKURU EAST","38",1189,1320,2509
"33873","NAKURU","NAKURU EAST","39",1278,1308,2586
"33874","NAKURU","NAKURU EAST","35-39",6923,7667,14590
"33875","NAKURU","NAKURU EAST","40",1440,1505,2945
"33876","NAKURU","NAKURU EAST","41",1134,1171,2305
"33877","NAKURU","NAKURU EAST","42",1210,1110,2320
"33878","NAKURU","NAKURU EAST","43",960,989,1949
"33879","NAKURU","NAKURU EAST","44",777,791,1568
"33880","NAKURU","NAKURU EAST","40-44",5521,5566,11087
"33881","NAKURU","NAKURU EAST","45",1093,1076,2169
"33882","NAKURU","NAKURU EAST","46",812,790,1602
"33883","NAKURU","NAKURU EAST","47",867,770,1637
"33884","NAKURU","NAKURU EAST","48",610,638,1248
"33885","NAKURU","NAKURU EAST","49",720,716,1436
"33886","NAKURU","NAKURU EAST","45-49",4102,3990,8092
"33887","NAKURU","NAKURU EAST","50",825,820,1645
"33888","NAKURU","NAKURU EAST","51",589,583,1172
"33889","NAKURU","NAKURU EAST","52",611,587,1198
"33890","NAKURU","NAKURU EAST","53",463,434,897
"33891","NAKURU","NAKURU EAST","54",514,486,1000
"33892","NAKURU","NAKURU EAST","50-54",3002,2910,5912
"33893","NAKURU","NAKURU EAST","55",557,469,1026
"33894","NAKURU","NAKURU EAST","56",515,502,1017
"33895","NAKURU","NAKURU EAST","57",437,443,880
"33896","NAKURU","NAKURU EAST","58",348,344,692
"33897","NAKURU","NAKURU EAST","59",385,377,762
"33898","NAKURU","NAKURU EAST","55-59",2242,2135,4377
"33899","NAKURU","NAKURU EAST","60",420,414,834
"33900","NAKURU","NAKURU EAST","61",262,255,517
"33901","NAKURU","NAKURU EAST","62",272,259,531
"33902","NAKURU","NAKURU EAST","63",227,216,443
"33903","NAKURU","NAKURU EAST","64",186,184,370
"33904","NAKURU","NAKURU EAST","60-64",1367,1328,2695
"33905","NAKURU","NAKURU EAST","65",238,210,448
"33906","NAKURU","NAKURU EAST","66",151,150,301
"33907","NAKURU","NAKURU EAST","67",230,216,446
"33908","NAKURU","NAKURU EAST","68",119,112,231
"33909","NAKURU","NAKURU EAST","69",148,131,279
"33910","NAKURU","NAKURU EAST","65-69",886,819,1705
"33911","NAKURU","NAKURU EAST","70",153,184,337
"33912","NAKURU","NAKURU EAST","71",110,115,225
"33913","NAKURU","NAKURU EAST","72",111,102,213
"33914","NAKURU","NAKURU EAST","73",69,62,131
"33915","NAKURU","NAKURU EAST","74",70,68,138
"33916","NAKURU","NAKURU EAST","70-74",513,531,1044
"33917","NAKURU","NAKURU EAST","75",53,71,124
"33918","NAKURU","NAKURU EAST","76",50,71,121
"33919","NAKURU","NAKURU EAST","77",40,54,94
"33920","NAKURU","NAKURU EAST","78",34,34,68
"33921","NAKURU","NAKURU EAST","79",27,37,64
"33922","NAKURU","NAKURU EAST","75-79",204,267,471
"33923","NAKURU","NAKURU EAST","80",41,62,103
"33924","NAKURU","NAKURU EAST","81",21,41,62
"33925","NAKURU","NAKURU EAST","82",21,28,49
"33926","NAKURU","NAKURU EAST","83",18,32,50
"33927","NAKURU","NAKURU EAST","84",21,34,55
"33928","NAKURU","NAKURU EAST","80-84",122,197,319
"33929","NAKURU","NAKURU EAST","85",19,25,44
"33930","NAKURU","NAKURU EAST","86",16,29,45
"33931","NAKURU","NAKURU EAST","87",12,18,30
"33932","NAKURU","NAKURU EAST","88",8,8,16
"33933","NAKURU","NAKURU EAST","89",10,18,28
"33934","NAKURU","NAKURU EAST","85-89",65,98,163
"33935","NAKURU","NAKURU EAST","90",2,16,18
"33936","NAKURU","NAKURU EAST","91",4,15,19
"33937","NAKURU","NAKURU EAST","92",2,8,10
"33938","NAKURU","NAKURU EAST","93",2,6,8
"33939","NAKURU","NAKURU EAST","94",3,5,8
"33940","NAKURU","NAKURU EAST","90-94",13,50,63
"33941","NAKURU","NAKURU EAST","95",2,6,8
"33942","NAKURU","NAKURU EAST","96",1,9,10
"33943","NAKURU","NAKURU EAST","97",4,9,13
"33944","NAKURU","NAKURU EAST","98",1,1,2
"33945","NAKURU","NAKURU EAST","99",4,6,10
"33946","NAKURU","NAKURU EAST","95-99",12,31,43
"33947","NAKURU","NAKURU EAST","100+",6,21,27
"33948","NAKURU","NAKURU EAST","Not Stated",6,NA,6
"33949","NAKURU","NAKURU NORTH","Total",106155,111880,218035
"33950","NAKURU","NAKURU NORTH","0",2783,2633,5416
"33951","NAKURU","NAKURU NORTH","1",2713,2753,5466
"33952","NAKURU","NAKURU NORTH","2",2675,2707,5382
"33953","NAKURU","NAKURU NORTH","3",2772,2735,5507
"33954","NAKURU","NAKURU NORTH","4",2733,2627,5360
"33955","NAKURU","NAKURU NORTH","0 - 4",13676,13455,27131
"33956","NAKURU","NAKURU NORTH","5",2573,2435,5008
"33957","NAKURU","NAKURU NORTH","6",2472,2573,5045
"33958","NAKURU","NAKURU NORTH","7",2639,2526,5165
"33959","NAKURU","NAKURU NORTH","8",2509,2423,4932
"33960","NAKURU","NAKURU NORTH","9",2740,2686,5426
"33961","NAKURU","NAKURU NORTH","5-9",12933,12643,25576
"33962","NAKURU","NAKURU NORTH","10",2625,2590,5215
"33963","NAKURU","NAKURU NORTH","11",2418,2294,4712
"33964","NAKURU","NAKURU NORTH","12",2729,2731,5460
"33965","NAKURU","NAKURU NORTH","13",2741,2706,5447
"33966","NAKURU","NAKURU NORTH","14",2555,2631,5186
"33967","NAKURU","NAKURU NORTH","10 -14",13068,12952,26020
"33968","NAKURU","NAKURU NORTH","15",2570,2620,5190
"33969","NAKURU","NAKURU NORTH","16",2559,2449,5008
"33970","NAKURU","NAKURU NORTH","17",2546,2492,5038
"33971","NAKURU","NAKURU NORTH","18",2096,2127,4223
"33972","NAKURU","NAKURU NORTH","19",2155,2153,4308
"33973","NAKURU","NAKURU NORTH","15-19",11926,11841,23767
"33974","NAKURU","NAKURU NORTH","20",1834,2001,3835
"33975","NAKURU","NAKURU NORTH","21",1842,2026,3868
"33976","NAKURU","NAKURU NORTH","22",1793,2006,3799
"33977","NAKURU","NAKURU NORTH","23",1852,2364,4216
"33978","NAKURU","NAKURU NORTH","24",1747,2058,3805
"33979","NAKURU","NAKURU NORTH","20-24",9068,10455,19523
"33980","NAKURU","NAKURU NORTH","25",1836,2089,3925
"33981","NAKURU","NAKURU NORTH","26",1577,1919,3496
"33982","NAKURU","NAKURU NORTH","27",1662,1825,3487
"33983","NAKURU","NAKURU NORTH","28",1361,1735,3096
"33984","NAKURU","NAKURU NORTH","29",1588,1795,3383
"33985","NAKURU","NAKURU NORTH","25-29",8024,9363,17387
"33986","NAKURU","NAKURU NORTH","30",1993,2243,4236
"33987","NAKURU","NAKURU NORTH","31",1351,1465,2816
"33988","NAKURU","NAKURU NORTH","32",1795,2082,3877
"33989","NAKURU","NAKURU NORTH","33",1440,1728,3168
"33990","NAKURU","NAKURU NORTH","34",1337,1700,3037
"33991","NAKURU","NAKURU NORTH","30-34",7916,9218,17134
"33992","NAKURU","NAKURU NORTH","35",1824,1901,3725
"33993","NAKURU","NAKURU NORTH","36",1282,1452,2734
"33994","NAKURU","NAKURU NORTH","37",1254,1286,2540
"33995","NAKURU","NAKURU NORTH","38",1153,1158,2311
"33996","NAKURU","NAKURU NORTH","39",1202,1336,2538
"33997","NAKURU","NAKURU NORTH","35-39",6715,7133,13848
"33998","NAKURU","NAKURU NORTH","40",1424,1498,2922
"33999","NAKURU","NAKURU NORTH","41",1288,1226,2514
"34000","NAKURU","NAKURU NORTH","42",1218,1144,2362
"34001","NAKURU","NAKURU NORTH","43",991,1017,2008
"34002","NAKURU","NAKURU NORTH","44",828,823,1651
"34003","NAKURU","NAKURU NORTH","40-44",5749,5708,11457
"34004","NAKURU","NAKURU NORTH","45",1266,1263,2529
"34005","NAKURU","NAKURU NORTH","46",834,906,1740
"34006","NAKURU","NAKURU NORTH","47",1050,1074,2124
"34007","NAKURU","NAKURU NORTH","48",742,853,1595
"34008","NAKURU","NAKURU NORTH","49",848,866,1714
"34009","NAKURU","NAKURU NORTH","45-49",4740,4962,9702
"34010","NAKURU","NAKURU NORTH","50",952,1047,1999
"34011","NAKURU","NAKURU NORTH","51",711,772,1483
"34012","NAKURU","NAKURU NORTH","52",797,775,1572
"34013","NAKURU","NAKURU NORTH","53",527,607,1134
"34014","NAKURU","NAKURU NORTH","54",666,696,1362
"34015","NAKURU","NAKURU NORTH","50-54",3653,3897,7550
"34016","NAKURU","NAKURU NORTH","55",691,635,1326
"34017","NAKURU","NAKURU NORTH","56",668,726,1394
"34018","NAKURU","NAKURU NORTH","57",529,614,1143
"34019","NAKURU","NAKURU NORTH","58",448,465,913
"34020","NAKURU","NAKURU NORTH","59",509,578,1087
"34021","NAKURU","NAKURU NORTH","55-59",2845,3018,5863
"34022","NAKURU","NAKURU NORTH","60",572,565,1137
"34023","NAKURU","NAKURU NORTH","61",394,407,801
"34024","NAKURU","NAKURU NORTH","62",348,381,729
"34025","NAKURU","NAKURU NORTH","63",330,381,711
"34026","NAKURU","NAKURU NORTH","64",238,277,515
"34027","NAKURU","NAKURU NORTH","60-64",1882,2011,3893
"34028","NAKURU","NAKURU NORTH","65",403,434,837
"34029","NAKURU","NAKURU NORTH","66",228,245,473
"34030","NAKURU","NAKURU NORTH","67",375,477,852
"34031","NAKURU","NAKURU NORTH","68",181,169,350
"34032","NAKURU","NAKURU NORTH","69",268,348,616
"34033","NAKURU","NAKURU NORTH","65-69",1455,1673,3128
"34034","NAKURU","NAKURU NORTH","70",347,465,812
"34035","NAKURU","NAKURU NORTH","71",244,266,510
"34036","NAKURU","NAKURU NORTH","72",245,216,461
"34037","NAKURU","NAKURU NORTH","73",175,224,399
"34038","NAKURU","NAKURU NORTH","74",154,199,353
"34039","NAKURU","NAKURU NORTH","70-74",1165,1370,2535
"34040","NAKURU","NAKURU NORTH","75",162,232,394
"34041","NAKURU","NAKURU NORTH","76",150,271,421
"34042","NAKURU","NAKURU NORTH","77",104,151,255
"34043","NAKURU","NAKURU NORTH","78",79,106,185
"34044","NAKURU","NAKURU NORTH","79",89,151,240
"34045","NAKURU","NAKURU NORTH","75-79",584,911,1495
"34046","NAKURU","NAKURU NORTH","80",119,196,315
"34047","NAKURU","NAKURU NORTH","81",63,107,170
"34048","NAKURU","NAKURU NORTH","82",75,82,157
"34049","NAKURU","NAKURU NORTH","83",69,84,153
"34050","NAKURU","NAKURU NORTH","84",77,119,196
"34051","NAKURU","NAKURU NORTH","80-84",403,588,991
"34052","NAKURU","NAKURU NORTH","85",58,85,143
"34053","NAKURU","NAKURU NORTH","86",39,80,119
"34054","NAKURU","NAKURU NORTH","87",50,65,115
"34055","NAKURU","NAKURU NORTH","88",21,36,57
"34056","NAKURU","NAKURU NORTH","89",46,88,134
"34057","NAKURU","NAKURU NORTH","85-89",214,354,568
"34058","NAKURU","NAKURU NORTH","90",21,58,79
"34059","NAKURU","NAKURU NORTH","91",30,29,59
"34060","NAKURU","NAKURU NORTH","92",11,22,33
"34061","NAKURU","NAKURU NORTH","93",9,22,31
"34062","NAKURU","NAKURU NORTH","94",6,26,32
"34063","NAKURU","NAKURU NORTH","90-94",77,157,234
"34064","NAKURU","NAKURU NORTH","95",11,31,42
"34065","NAKURU","NAKURU NORTH","96",12,16,28
"34066","NAKURU","NAKURU NORTH","97",11,20,31
"34067","NAKURU","NAKURU NORTH","98",6,14,20
"34068","NAKURU","NAKURU NORTH","99",5,17,22
"34069","NAKURU","NAKURU NORTH","95-99",45,98,143
"34070","NAKURU","NAKURU NORTH","100+",15,72,87
"34071","NAKURU","NAKURU NORTH","Not Stated",2,1,3
"34072","NAKURU","NAKURU WEST","Total",101797,96854,198651
"34073","NAKURU","NAKURU WEST","0",2667,2711,5378
"34074","NAKURU","NAKURU WEST","1",2530,2468,4998
"34075","NAKURU","NAKURU WEST","2",2566,2526,5092
"34076","NAKURU","NAKURU WEST","3",2481,2509,4990
"34077","NAKURU","NAKURU WEST","4",2403,2298,4701
"34078","NAKURU","NAKURU WEST","0 - 4",12647,12512,25159
"34079","NAKURU","NAKURU WEST","5",2127,2143,4270
"34080","NAKURU","NAKURU WEST","6",2173,2175,4348
"34081","NAKURU","NAKURU WEST","7",2185,2141,4326
"34082","NAKURU","NAKURU WEST","8",2092,2097,4189
"34083","NAKURU","NAKURU WEST","9",2189,2189,4378
"34084","NAKURU","NAKURU WEST","5-9",10766,10745,21511
"34085","NAKURU","NAKURU WEST","10",2190,2138,4328
"34086","NAKURU","NAKURU WEST","11",1854,1987,3841
"34087","NAKURU","NAKURU WEST","12",2126,2226,4352
"34088","NAKURU","NAKURU WEST","13",2020,2155,4175
"34089","NAKURU","NAKURU WEST","14",1877,1962,3839
"34090","NAKURU","NAKURU WEST","10 -14",10067,10468,20535
"34091","NAKURU","NAKURU WEST","15",1793,1910,3703
"34092","NAKURU","NAKURU WEST","16",1747,1888,3635
"34093","NAKURU","NAKURU WEST","17",1911,1904,3815
"34094","NAKURU","NAKURU WEST","18",1637,1729,3366
"34095","NAKURU","NAKURU WEST","19",1970,2104,4074
"34096","NAKURU","NAKURU WEST","15-19",9058,9535,18593
"34097","NAKURU","NAKURU WEST","20",2021,2301,4322
"34098","NAKURU","NAKURU WEST","21",2155,2422,4577
"34099","NAKURU","NAKURU WEST","22",2318,2688,5006
"34100","NAKURU","NAKURU WEST","23",2678,2874,5552
"34101","NAKURU","NAKURU WEST","24",2614,2784,5398
"34102","NAKURU","NAKURU WEST","20-24",11786,13069,24855
"34103","NAKURU","NAKURU WEST","25",2855,2835,5690
"34104","NAKURU","NAKURU WEST","26",2344,2539,4883
"34105","NAKURU","NAKURU WEST","27",2540,2392,4932
"34106","NAKURU","NAKURU WEST","28",2093,2005,4098
"34107","NAKURU","NAKURU WEST","29",2269,2106,4375
"34108","NAKURU","NAKURU WEST","25-29",12101,11877,23978
"34109","NAKURU","NAKURU WEST","30",2680,2611,5291
"34110","NAKURU","NAKURU WEST","31",1851,1674,3525
"34111","NAKURU","NAKURU WEST","32",2353,2277,4630
"34112","NAKURU","NAKURU WEST","33",1762,1678,3440
"34113","NAKURU","NAKURU WEST","34",1659,1554,3213
"34114","NAKURU","NAKURU WEST","30-34",10305,9794,20099
"34115","NAKURU","NAKURU WEST","35",2161,1742,3903
"34116","NAKURU","NAKURU WEST","36",1461,1276,2737
"34117","NAKURU","NAKURU WEST","37",1386,1141,2527
"34118","NAKURU","NAKURU WEST","38",1186,975,2161
"34119","NAKURU","NAKURU WEST","39",1242,944,2186
"34120","NAKURU","NAKURU WEST","35-39",7436,6078,13514
"34121","NAKURU","NAKURU WEST","40",1541,1236,2777
"34122","NAKURU","NAKURU WEST","41",1371,845,2216
"34123","NAKURU","NAKURU WEST","42",1216,917,2133
"34124","NAKURU","NAKURU WEST","43",1013,736,1749
"34125","NAKURU","NAKURU WEST","44",770,579,1349
"34126","NAKURU","NAKURU WEST","40-44",5911,4313,10224
"34127","NAKURU","NAKURU WEST","45",1245,840,2085
"34128","NAKURU","NAKURU WEST","46",766,576,1342
"34129","NAKURU","NAKURU WEST","47",850,598,1448
"34130","NAKURU","NAKURU WEST","48",591,439,1030
"34131","NAKURU","NAKURU WEST","49",714,470,1184
"34132","NAKURU","NAKURU WEST","45-49",4166,2923,7089
"34133","NAKURU","NAKURU WEST","50",851,615,1466
"34134","NAKURU","NAKURU WEST","51",610,385,995
"34135","NAKURU","NAKURU WEST","52",540,357,897
"34136","NAKURU","NAKURU WEST","53",378,302,680
"34137","NAKURU","NAKURU WEST","54",426,324,750
"34138","NAKURU","NAKURU WEST","50-54",2805,1983,4788
"34139","NAKURU","NAKURU WEST","55",466,294,760
"34140","NAKURU","NAKURU WEST","56",487,339,826
"34141","NAKURU","NAKURU WEST","57",401,312,713
"34142","NAKURU","NAKURU WEST","58",348,219,567
"34143","NAKURU","NAKURU WEST","59",333,226,559
"34144","NAKURU","NAKURU WEST","55-59",2035,1390,3425
"34145","NAKURU","NAKURU WEST","60",370,263,633
"34146","NAKURU","NAKURU WEST","61",241,174,415
"34147","NAKURU","NAKURU WEST","62",199,154,353
"34148","NAKURU","NAKURU WEST","63",189,145,334
"34149","NAKURU","NAKURU WEST","64",153,107,260
"34150","NAKURU","NAKURU WEST","60-64",1152,843,1995
"34151","NAKURU","NAKURU WEST","65",220,136,356
"34152","NAKURU","NAKURU WEST","66",120,84,204
"34153","NAKURU","NAKURU WEST","67",185,147,332
"34154","NAKURU","NAKURU WEST","68",95,71,166
"34155","NAKURU","NAKURU WEST","69",120,97,217
"34156","NAKURU","NAKURU WEST","65-69",740,535,1275
"34157","NAKURU","NAKURU WEST","70",148,128,276
"34158","NAKURU","NAKURU WEST","71",96,71,167
"34159","NAKURU","NAKURU WEST","72",83,55,138
"34160","NAKURU","NAKURU WEST","73",55,41,96
"34161","NAKURU","NAKURU WEST","74",62,45,107
"34162","NAKURU","NAKURU WEST","70-74",444,340,784
"34163","NAKURU","NAKURU WEST","75",42,62,104
"34164","NAKURU","NAKURU WEST","76",56,45,101
"34165","NAKURU","NAKURU WEST","77",30,40,70
"34166","NAKURU","NAKURU WEST","78",27,20,47
"34167","NAKURU","NAKURU WEST","79",26,30,56
"34168","NAKURU","NAKURU WEST","75-79",181,197,378
"34169","NAKURU","NAKURU WEST","80",32,39,71
"34170","NAKURU","NAKURU WEST","81",16,22,38
"34171","NAKURU","NAKURU WEST","82",31,11,42
"34172","NAKURU","NAKURU WEST","83",22,20,42
"34173","NAKURU","NAKURU WEST","84",15,25,40
"34174","NAKURU","NAKURU WEST","80-84",116,117,233
"34175","NAKURU","NAKURU WEST","85",13,18,31
"34176","NAKURU","NAKURU WEST","86",10,15,25
"34177","NAKURU","NAKURU WEST","87",9,13,22
"34178","NAKURU","NAKURU WEST","88",3,7,10
"34179","NAKURU","NAKURU WEST","89",6,21,27
"34180","NAKURU","NAKURU WEST","85-89",41,74,115
"34181","NAKURU","NAKURU WEST","90",7,8,15
"34182","NAKURU","NAKURU WEST","91",6,7,13
"34183","NAKURU","NAKURU WEST","92",7,8,15
"34184","NAKURU","NAKURU WEST","93",2,4,6
"34185","NAKURU","NAKURU WEST","94",2,1,3
"34186","NAKURU","NAKURU WEST","90-94",24,28,52
"34187","NAKURU","NAKURU WEST","95",1,11,12
"34188","NAKURU","NAKURU WEST","96",2,4,6
"34189","NAKURU","NAKURU WEST","97",2,2,4
"34190","NAKURU","NAKURU WEST","98",3,NA,3
"34191","NAKURU","NAKURU WEST","99",3,6,9
"34192","NAKURU","NAKURU WEST","95-99",11,23,34
"34193","NAKURU","NAKURU WEST","100+",5,10,15
"34194","NAKURU","NAKURU WEST","Not Stated",NA,NA,NA
"34195","NAKURU","NJORO","Total",118361,120408,238769
"34196","NAKURU","NJORO","0",2961,2991,5952
"34197","NAKURU","NJORO","1",3050,3040,6090
"34198","NAKURU","NJORO","2",3081,3087,6168
"34199","NAKURU","NJORO","3",3163,3270,6433
"34200","NAKURU","NJORO","4",3319,3168,6487
"34201","NAKURU","NJORO","0 - 4",15574,15556,31130
"34202","NAKURU","NJORO","5",3300,3225,6525
"34203","NAKURU","NJORO","6",3172,3210,6382
"34204","NAKURU","NJORO","7",3473,3226,6699
"34205","NAKURU","NJORO","8",3056,3009,6065
"34206","NAKURU","NJORO","9",3555,3334,6889
"34207","NAKURU","NJORO","5-9",16556,16004,32560
"34208","NAKURU","NJORO","10",3500,3438,6938
"34209","NAKURU","NJORO","11",3286,3214,6500
"34210","NAKURU","NJORO","12",3711,3414,7125
"34211","NAKURU","NJORO","13",3571,3476,7047
"34212","NAKURU","NJORO","14",3484,3266,6750
"34213","NAKURU","NJORO","10 -14",17552,16808,34360
"34214","NAKURU","NJORO","15",3354,3042,6396
"34215","NAKURU","NJORO","16",3048,2889,5937
"34216","NAKURU","NJORO","17",3082,2824,5906
"34217","NAKURU","NJORO","18",2266,2154,4420
"34218","NAKURU","NJORO","19",2443,2275,4718
"34219","NAKURU","NJORO","15-19",14193,13184,27377
"34220","NAKURU","NJORO","20",2039,2132,4171
"34221","NAKURU","NJORO","21",1974,2133,4107
"34222","NAKURU","NJORO","22",2005,2063,4068
"34223","NAKURU","NJORO","23",2106,2128,4234
"34224","NAKURU","NJORO","24",1757,1861,3618
"34225","NAKURU","NJORO","20-24",9881,10317,20198
"34226","NAKURU","NJORO","25",1837,1950,3787
"34227","NAKURU","NJORO","26",1455,1650,3105
"34228","NAKURU","NJORO","27",1724,1845,3569
"34229","NAKURU","NJORO","28",1402,1541,2943
"34230","NAKURU","NJORO","29",1524,1685,3209
"34231","NAKURU","NJORO","25-29",7942,8671,16613
"34232","NAKURU","NJORO","30",1747,2011,3758
"34233","NAKURU","NJORO","31",1361,1538,2899
"34234","NAKURU","NJORO","32",1731,1972,3703
"34235","NAKURU","NJORO","33",1404,1688,3092
"34236","NAKURU","NJORO","34",1348,1476,2824
"34237","NAKURU","NJORO","30-34",7591,8685,16276
"34238","NAKURU","NJORO","35",1887,2004,3891
"34239","NAKURU","NJORO","36",1132,1255,2387
"34240","NAKURU","NJORO","37",1221,1178,2399
"34241","NAKURU","NJORO","38",894,921,1815
"34242","NAKURU","NJORO","39",1075,1163,2238
"34243","NAKURU","NJORO","35-39",6209,6521,12730
"34244","NAKURU","NJORO","40",1318,1309,2627
"34245","NAKURU","NJORO","41",1434,1340,2774
"34246","NAKURU","NJORO","42",1129,1134,2263
"34247","NAKURU","NJORO","43",922,965,1887
"34248","NAKURU","NJORO","44",764,779,1543
"34249","NAKURU","NJORO","40-44",5567,5527,11094
"34250","NAKURU","NJORO","45",1320,1329,2649
"34251","NAKURU","NJORO","46",909,912,1821
"34252","NAKURU","NJORO","47",982,1042,2024
"34253","NAKURU","NJORO","48",697,673,1370
"34254","NAKURU","NJORO","49",808,893,1701
"34255","NAKURU","NJORO","45-49",4716,4849,9565
"34256","NAKURU","NJORO","50",918,940,1858
"34257","NAKURU","NJORO","51",673,741,1414
"34258","NAKURU","NJORO","52",689,683,1372
"34259","NAKURU","NJORO","53",456,533,989
"34260","NAKURU","NJORO","54",605,630,1235
"34261","NAKURU","NJORO","50-54",3341,3527,6868
"34262","NAKURU","NJORO","55",589,572,1161
"34263","NAKURU","NJORO","56",625,667,1292
"34264","NAKURU","NJORO","57",476,597,1073
"34265","NAKURU","NJORO","58",526,662,1188
"34266","NAKURU","NJORO","59",582,585,1167
"34267","NAKURU","NJORO","55-59",2798,3083,5881
"34268","NAKURU","NJORO","60",563,617,1180
"34269","NAKURU","NJORO","61",432,490,922
"34270","NAKURU","NJORO","62",401,396,797
"34271","NAKURU","NJORO","63",315,350,665
"34272","NAKURU","NJORO","64",265,274,539
"34273","NAKURU","NJORO","60-64",1976,2127,4103
"34274","NAKURU","NJORO","65",402,458,860
"34275","NAKURU","NJORO","66",315,304,619
"34276","NAKURU","NJORO","67",449,513,962
"34277","NAKURU","NJORO","68",210,215,425
"34278","NAKURU","NJORO","69",331,357,688
"34279","NAKURU","NJORO","65-69",1707,1847,3554
"34280","NAKURU","NJORO","70",377,483,860
"34281","NAKURU","NJORO","71",284,271,555
"34282","NAKURU","NJORO","72",237,210,447
"34283","NAKURU","NJORO","73",200,198,398
"34284","NAKURU","NJORO","74",183,216,399
"34285","NAKURU","NJORO","70-74",1281,1378,2659
"34286","NAKURU","NJORO","75",136,253,389
"34287","NAKURU","NJORO","76",178,337,515
"34288","NAKURU","NJORO","77",136,164,300
"34289","NAKURU","NJORO","78",84,102,186
"34290","NAKURU","NJORO","79",119,165,284
"34291","NAKURU","NJORO","75-79",653,1021,1674
"34292","NAKURU","NJORO","80",139,193,332
"34293","NAKURU","NJORO","81",73,93,166
"34294","NAKURU","NJORO","82",79,81,160
"34295","NAKURU","NJORO","83",78,95,173
"34296","NAKURU","NJORO","84",68,117,185
"34297","NAKURU","NJORO","80-84",437,579,1016
"34298","NAKURU","NJORO","85",55,94,149
"34299","NAKURU","NJORO","86",31,91,122
"34300","NAKURU","NJORO","87",41,68,109
"34301","NAKURU","NJORO","88",29,41,70
"34302","NAKURU","NJORO","89",55,101,156
"34303","NAKURU","NJORO","85-89",211,395,606
"34304","NAKURU","NJORO","90",37,64,101
"34305","NAKURU","NJORO","91",25,45,70
"34306","NAKURU","NJORO","92",14,19,33
"34307","NAKURU","NJORO","93",13,20,33
"34308","NAKURU","NJORO","94",6,26,32
"34309","NAKURU","NJORO","90-94",95,174,269
"34310","NAKURU","NJORO","95",18,26,44
"34311","NAKURU","NJORO","96",14,14,28
"34312","NAKURU","NJORO","97",13,19,32
"34313","NAKURU","NJORO","98",10,8,18
"34314","NAKURU","NJORO","99",10,22,32
"34315","NAKURU","NJORO","95-99",65,89,154
"34316","NAKURU","NJORO","100+",15,66,81
"34317","NAKURU","NJORO","Not Stated",1,NA,1
"34318","NAKURU","RONGAI","Total",99976,99922,199898
"34319","NAKURU","RONGAI","0",2329,2370,4699
"34320","NAKURU","RONGAI","1",2449,2448,4897
"34321","NAKURU","RONGAI","2",2549,2375,4924
"34322","NAKURU","RONGAI","3",2575,2637,5212
"34323","NAKURU","RONGAI","4",2701,2520,5221
"34324","NAKURU","RONGAI","0 - 4",12603,12350,24953
"34325","NAKURU","RONGAI","5",2609,2306,4915
"34326","NAKURU","RONGAI","6",2406,2479,4885
"34327","NAKURU","RONGAI","7",2624,2454,5078
"34328","NAKURU","RONGAI","8",2459,2333,4792
"34329","NAKURU","RONGAI","9",2472,2529,5001
"34330","NAKURU","RONGAI","5-9",12570,12101,24671
"34331","NAKURU","RONGAI","10",2708,2595,5303
"34332","NAKURU","RONGAI","11",2331,2363,4694
"34333","NAKURU","RONGAI","12",2681,2648,5329
"34334","NAKURU","RONGAI","13",2642,2700,5342
"34335","NAKURU","RONGAI","14",2501,2392,4893
"34336","NAKURU","RONGAI","10 -14",12863,12698,25561
"34337","NAKURU","RONGAI","15",2479,2403,4882
"34338","NAKURU","RONGAI","16",2278,2312,4590
"34339","NAKURU","RONGAI","17",2429,2436,4865
"34340","NAKURU","RONGAI","18",1871,1852,3723
"34341","NAKURU","RONGAI","19",2293,2133,4426
"34342","NAKURU","RONGAI","15-19",11350,11136,22486
"34343","NAKURU","RONGAI","20",1972,2091,4063
"34344","NAKURU","RONGAI","21",2047,1992,4039
"34345","NAKURU","RONGAI","22",1906,1905,3811
"34346","NAKURU","RONGAI","23",1962,2056,4018
"34347","NAKURU","RONGAI","24",1853,1871,3724
"34348","NAKURU","RONGAI","20-24",9740,9915,19655
"34349","NAKURU","RONGAI","25",1854,1969,3823
"34350","NAKURU","RONGAI","26",1530,1620,3150
"34351","NAKURU","RONGAI","27",1675,1706,3381
"34352","NAKURU","RONGAI","28",1268,1385,2653
"34353","NAKURU","RONGAI","29",1444,1543,2987
"34354","NAKURU","RONGAI","25-29",7771,8223,15994
"34355","NAKURU","RONGAI","30",1827,1894,3721
"34356","NAKURU","RONGAI","31",1234,1321,2555
"34357","NAKURU","RONGAI","32",1644,1781,3425
"34358","NAKURU","RONGAI","33",1343,1414,2757
"34359","NAKURU","RONGAI","34",1174,1306,2480
"34360","NAKURU","RONGAI","30-34",7222,7716,14938
"34361","NAKURU","RONGAI","35",1681,1700,3381
"34362","NAKURU","RONGAI","36",1097,1115,2212
"34363","NAKURU","RONGAI","37",1121,983,2104
"34364","NAKURU","RONGAI","38",826,898,1724
"34365","NAKURU","RONGAI","39",999,928,1927
"34366","NAKURU","RONGAI","35-39",5724,5624,11348
"34367","NAKURU","RONGAI","40",1245,1113,2358
"34368","NAKURU","RONGAI","41",1245,1111,2356
"34369","NAKURU","RONGAI","42",1062,927,1989
"34370","NAKURU","RONGAI","43",832,873,1705
"34371","NAKURU","RONGAI","44",749,696,1445
"34372","NAKURU","RONGAI","40-44",5133,4720,9853
"34373","NAKURU","RONGAI","45",1245,1062,2307
"34374","NAKURU","RONGAI","46",754,760,1514
"34375","NAKURU","RONGAI","47",853,810,1663
"34376","NAKURU","RONGAI","48",599,528,1127
"34377","NAKURU","RONGAI","49",746,683,1429
"34378","NAKURU","RONGAI","45-49",4197,3843,8040
"34379","NAKURU","RONGAI","50",793,836,1629
"34380","NAKURU","RONGAI","51",607,623,1230
"34381","NAKURU","RONGAI","52",601,533,1134
"34382","NAKURU","RONGAI","53",442,405,847
"34383","NAKURU","RONGAI","54",522,523,1045
"34384","NAKURU","RONGAI","50-54",2965,2920,5885
"34385","NAKURU","RONGAI","55",542,540,1082
"34386","NAKURU","RONGAI","56",518,535,1053
"34387","NAKURU","RONGAI","57",481,532,1013
"34388","NAKURU","RONGAI","58",481,589,1070
"34389","NAKURU","RONGAI","59",496,468,964
"34390","NAKURU","RONGAI","55-59",2518,2664,5182
"34391","NAKURU","RONGAI","60",524,579,1103
"34392","NAKURU","RONGAI","61",381,380,761
"34393","NAKURU","RONGAI","62",343,329,672
"34394","NAKURU","RONGAI","63",294,313,607
"34395","NAKURU","RONGAI","64",201,246,447
"34396","NAKURU","RONGAI","60-64",1743,1847,3590
"34397","NAKURU","RONGAI","65",340,386,726
"34398","NAKURU","RONGAI","66",210,220,430
"34399","NAKURU","RONGAI","67",365,362,727
"34400","NAKURU","RONGAI","68",171,182,353
"34401","NAKURU","RONGAI","69",255,268,523
"34402","NAKURU","RONGAI","65-69",1341,1418,2759
"34403","NAKURU","RONGAI","70",324,392,716
"34404","NAKURU","RONGAI","71",229,200,429
"34405","NAKURU","RONGAI","72",193,175,368
"34406","NAKURU","RONGAI","73",145,158,303
"34407","NAKURU","RONGAI","74",143,175,318
"34408","NAKURU","RONGAI","70-74",1034,1100,2134
"34409","NAKURU","RONGAI","75",146,166,312
"34410","NAKURU","RONGAI","76",116,176,292
"34411","NAKURU","RONGAI","77",112,112,224
"34412","NAKURU","RONGAI","78",63,68,131
"34413","NAKURU","RONGAI","79",99,135,234
"34414","NAKURU","RONGAI","75-79",536,657,1193
"34415","NAKURU","RONGAI","80",104,157,261
"34416","NAKURU","RONGAI","81",59,72,131
"34417","NAKURU","RONGAI","82",62,58,120
"34418","NAKURU","RONGAI","83",55,55,110
"34419","NAKURU","RONGAI","84",57,86,143
"34420","NAKURU","RONGAI","80-84",337,428,765
"34421","NAKURU","RONGAI","85",49,82,131
"34422","NAKURU","RONGAI","86",28,43,71
"34423","NAKURU","RONGAI","87",31,57,88
"34424","NAKURU","RONGAI","88",29,23,52
"34425","NAKURU","RONGAI","89",38,76,114
"34426","NAKURU","RONGAI","85-89",175,281,456
"34427","NAKURU","RONGAI","90",24,67,91
"34428","NAKURU","RONGAI","91",19,28,47
"34429","NAKURU","RONGAI","92",14,23,37
"34430","NAKURU","RONGAI","93",17,15,32
"34431","NAKURU","RONGAI","94",10,23,33
"34432","NAKURU","RONGAI","90-94",84,156,240
"34433","NAKURU","RONGAI","95",12,27,39
"34434","NAKURU","RONGAI","96",10,15,25
"34435","NAKURU","RONGAI","97",10,13,23
"34436","NAKURU","RONGAI","98",3,12,15
"34437","NAKURU","RONGAI","99",12,15,27
"34438","NAKURU","RONGAI","95-99",47,82,129
"34439","NAKURU","RONGAI","100+",20,43,63
"34440","NAKURU","RONGAI","Not Stated",3,NA,3
"34441","NAKURU","SUBUKIA","Total",42045,43118,85163
"34442","NAKURU","SUBUKIA","0",966,907,1873
"34443","NAKURU","SUBUKIA","1",991,991,1982
"34444","NAKURU","SUBUKIA","2",1054,996,2050
"34445","NAKURU","SUBUKIA","3",1099,1079,2178
"34446","NAKURU","SUBUKIA","4",1114,997,2111
"34447","NAKURU","SUBUKIA","0 - 4",5224,4970,10194
"34448","NAKURU","SUBUKIA","5",1049,970,2019
"34449","NAKURU","SUBUKIA","6",1087,982,2069
"34450","NAKURU","SUBUKIA","7",1082,1031,2113
"34451","NAKURU","SUBUKIA","8",1043,1065,2108
"34452","NAKURU","SUBUKIA","9",1173,1040,2213
"34453","NAKURU","SUBUKIA","5-9",5434,5088,10522
"34454","NAKURU","SUBUKIA","10",1206,1183,2389
"34455","NAKURU","SUBUKIA","11",1123,1112,2235
"34456","NAKURU","SUBUKIA","12",1300,1253,2553
"34457","NAKURU","SUBUKIA","13",1274,1221,2495
"34458","NAKURU","SUBUKIA","14",1289,1223,2512
"34459","NAKURU","SUBUKIA","10 -14",6192,5992,12184
"34460","NAKURU","SUBUKIA","15",1306,1139,2445
"34461","NAKURU","SUBUKIA","16",1183,1084,2267
"34462","NAKURU","SUBUKIA","17",1227,1149,2376
"34463","NAKURU","SUBUKIA","18",894,854,1748
"34464","NAKURU","SUBUKIA","19",978,819,1797
"34465","NAKURU","SUBUKIA","15-19",5588,5045,10633
"34466","NAKURU","SUBUKIA","20",740,641,1381
"34467","NAKURU","SUBUKIA","21",666,626,1292
"34468","NAKURU","SUBUKIA","22",575,592,1167
"34469","NAKURU","SUBUKIA","23",613,631,1244
"34470","NAKURU","SUBUKIA","24",531,551,1082
"34471","NAKURU","SUBUKIA","20-24",3125,3041,6166
"34472","NAKURU","SUBUKIA","25",525,564,1089
"34473","NAKURU","SUBUKIA","26",438,474,912
"34474","NAKURU","SUBUKIA","27",460,529,989
"34475","NAKURU","SUBUKIA","28",361,434,795
"34476","NAKURU","SUBUKIA","29",422,459,881
"34477","NAKURU","SUBUKIA","25-29",2206,2460,4666
"34478","NAKURU","SUBUKIA","30",542,606,1148
"34479","NAKURU","SUBUKIA","31",364,427,791
"34480","NAKURU","SUBUKIA","32",488,563,1051
"34481","NAKURU","SUBUKIA","33",416,526,942
"34482","NAKURU","SUBUKIA","34",445,488,933
"34483","NAKURU","SUBUKIA","30-34",2255,2610,4865
"34484","NAKURU","SUBUKIA","35",592,679,1271
"34485","NAKURU","SUBUKIA","36",387,474,861
"34486","NAKURU","SUBUKIA","37",387,427,814
"34487","NAKURU","SUBUKIA","38",333,341,674
"34488","NAKURU","SUBUKIA","39",353,402,755
"34489","NAKURU","SUBUKIA","35-39",2052,2323,4375
"34490","NAKURU","SUBUKIA","40",445,437,882
"34491","NAKURU","SUBUKIA","41",438,434,872
"34492","NAKURU","SUBUKIA","42",437,467,904
"34493","NAKURU","SUBUKIA","43",378,398,776
"34494","NAKURU","SUBUKIA","44",291,332,623
"34495","NAKURU","SUBUKIA","40-44",1989,2068,4057
"34496","NAKURU","SUBUKIA","45",443,565,1008
"34497","NAKURU","SUBUKIA","46",313,409,722
"34498","NAKURU","SUBUKIA","47",385,425,810
"34499","NAKURU","SUBUKIA","48",293,316,609
"34500","NAKURU","SUBUKIA","49",340,369,709
"34501","NAKURU","SUBUKIA","45-49",1774,2084,3858
"34502","NAKURU","SUBUKIA","50",388,495,883
"34503","NAKURU","SUBUKIA","51",303,344,647
"34504","NAKURU","SUBUKIA","52",336,317,653
"34505","NAKURU","SUBUKIA","53",225,280,505
"34506","NAKURU","SUBUKIA","54",285,317,602
"34507","NAKURU","SUBUKIA","50-54",1537,1753,3290
"34508","NAKURU","SUBUKIA","55",295,288,583
"34509","NAKURU","SUBUKIA","56",309,334,643
"34510","NAKURU","SUBUKIA","57",253,298,551
"34511","NAKURU","SUBUKIA","58",217,301,518
"34512","NAKURU","SUBUKIA","59",220,278,498
"34513","NAKURU","SUBUKIA","55-59",1294,1499,2793
"34514","NAKURU","SUBUKIA","60",269,317,586
"34515","NAKURU","SUBUKIA","61",216,222,438
"34516","NAKURU","SUBUKIA","62",169,195,364
"34517","NAKURU","SUBUKIA","63",147,164,311
"34518","NAKURU","SUBUKIA","64",123,146,269
"34519","NAKURU","SUBUKIA","60-64",924,1044,1968
"34520","NAKURU","SUBUKIA","65",212,217,429
"34521","NAKURU","SUBUKIA","66",152,154,306
"34522","NAKURU","SUBUKIA","67",230,242,472
"34523","NAKURU","SUBUKIA","68",103,111,214
"34524","NAKURU","SUBUKIA","69",181,188,369
"34525","NAKURU","SUBUKIA","65-69",878,912,1790
"34526","NAKURU","SUBUKIA","70",208,249,457
"34527","NAKURU","SUBUKIA","71",136,160,296
"34528","NAKURU","SUBUKIA","72",134,141,275
"34529","NAKURU","SUBUKIA","73",104,114,218
"34530","NAKURU","SUBUKIA","74",75,141,216
"34531","NAKURU","SUBUKIA","70-74",657,805,1462
"34532","NAKURU","SUBUKIA","75",86,134,220
"34533","NAKURU","SUBUKIA","76",103,172,275
"34534","NAKURU","SUBUKIA","77",82,98,180
"34535","NAKURU","SUBUKIA","78",60,66,126
"34536","NAKURU","SUBUKIA","79",60,125,185
"34537","NAKURU","SUBUKIA","75-79",391,595,986
"34538","NAKURU","SUBUKIA","80",73,146,219
"34539","NAKURU","SUBUKIA","81",53,51,104
"34540","NAKURU","SUBUKIA","82",58,48,106
"34541","NAKURU","SUBUKIA","83",51,60,111
"34542","NAKURU","SUBUKIA","84",52,73,125
"34543","NAKURU","SUBUKIA","80-84",287,378,665
"34544","NAKURU","SUBUKIA","85",30,62,92
"34545","NAKURU","SUBUKIA","86",26,37,63
"34546","NAKURU","SUBUKIA","87",32,43,75
"34547","NAKURU","SUBUKIA","88",24,20,44
"34548","NAKURU","SUBUKIA","89",33,72,105
"34549","NAKURU","SUBUKIA","85-89",145,234,379
"34550","NAKURU","SUBUKIA","90",21,38,59
"34551","NAKURU","SUBUKIA","91",19,26,45
"34552","NAKURU","SUBUKIA","92",8,13,21
"34553","NAKURU","SUBUKIA","93",6,15,21
"34554","NAKURU","SUBUKIA","94",7,13,20
"34555","NAKURU","SUBUKIA","90-94",61,105,166
"34556","NAKURU","SUBUKIA","95",6,18,24
"34557","NAKURU","SUBUKIA","96",4,11,15
"34558","NAKURU","SUBUKIA","97",7,19,26
"34559","NAKURU","SUBUKIA","98",3,5,8
"34560","NAKURU","SUBUKIA","99",3,17,20
"34561","NAKURU","SUBUKIA","95-99",23,70,93
"34562","NAKURU","SUBUKIA","100+",9,39,48
"34563","NAKURU","SUBUKIA","Not Stated",NA,3,3
"34564","NANDI","ALL","Total",441259,444430,885689
"34565","NANDI","ALL","0",9988,9702,19690
"34566","NANDI","ALL","1",10385,10273,20658
"34567","NANDI","ALL","2",10656,10567,21223
"34568","NANDI","ALL","3",10882,11079,21961
"34569","NANDI","ALL","4",11380,11058,22438
"34570","NANDI","ALL","0 - 4",53291,52679,105970
"34571","NANDI","ALL","5",11229,10884,22113
"34572","NANDI","ALL","6",11161,11334,22495
"34573","NANDI","ALL","7",11877,11488,23365
"34574","NANDI","ALL","8",11553,11266,22819
"34575","NANDI","ALL","9",12691,12651,25342
"34576","NANDI","ALL","5-9",58511,57623,116134
"34577","NANDI","ALL","10",12503,11883,24386
"34578","NANDI","ALL","11",12018,12318,24336
"34579","NANDI","ALL","12",13564,13007,26571
"34580","NANDI","ALL","13",13155,12994,26149
"34581","NANDI","ALL","14",12483,12188,24671
"34582","NANDI","ALL","10 -14",63723,62390,126113
"34583","NANDI","ALL","15",12209,11959,24168
"34584","NANDI","ALL","16",11471,11194,22665
"34585","NANDI","ALL","17",11775,11228,23003
"34586","NANDI","ALL","18",9290,8945,18235
"34587","NANDI","ALL","19",10625,10045,20670
"34588","NANDI","ALL","15-19",55370,53371,108741
"34589","NANDI","ALL","20",8768,8942,17710
"34590","NANDI","ALL","21",8425,8483,16908
"34591","NANDI","ALL","22",7533,7904,15437
"34592","NANDI","ALL","23",7583,8530,16113
"34593","NANDI","ALL","24",6829,7448,14277
"34594","NANDI","ALL","20-24",39138,41307,80445
"34595","NANDI","ALL","25",7361,7735,15096
"34596","NANDI","ALL","26",6084,7036,13120
"34597","NANDI","ALL","27",6605,7132,13737
"34598","NANDI","ALL","28",4946,5691,10637
"34599","NANDI","ALL","29",5978,6772,12750
"34600","NANDI","ALL","25-29",30974,34366,65340
"34601","NANDI","ALL","30",6706,7501,14207
"34602","NANDI","ALL","31",5595,6216,11811
"34603","NANDI","ALL","32",6815,7750,14565
"34604","NANDI","ALL","33",6088,7130,13218
"34605","NANDI","ALL","34",5372,5934,11306
"34606","NANDI","ALL","30-34",30576,34531,65107
"34607","NANDI","ALL","35",6733,6692,13425
"34608","NANDI","ALL","36",4605,3936,8541
"34609","NANDI","ALL","37",4926,3989,8915
"34610","NANDI","ALL","38",3399,2847,6246
"34611","NANDI","ALL","39",4292,3680,7972
"34612","NANDI","ALL","35-39",23955,21144,45099
"34613","NANDI","ALL","40",4399,4019,8418
"34614","NANDI","ALL","41",4780,4158,8938
"34615","NANDI","ALL","42",4434,4072,8506
"34616","NANDI","ALL","43",4149,4245,8394
"34617","NANDI","ALL","44",3394,3240,6634
"34618","NANDI","ALL","40-44",21156,19734,40890
"34619","NANDI","ALL","45",4774,4402,9176
"34620","NANDI","ALL","46",3657,3446,7103
"34621","NANDI","ALL","47",3699,3616,7315
"34622","NANDI","ALL","48",2332,2324,4656
"34623","NANDI","ALL","49",3183,3178,6361
"34624","NANDI","ALL","45-49",17645,16966,34611
"34625","NANDI","ALL","50",2946,3018,5964
"34626","NANDI","ALL","51",2739,2720,5459
"34627","NANDI","ALL","52",2170,2253,4423
"34628","NANDI","ALL","53",1868,2034,3902
"34629","NANDI","ALL","54",2100,1957,4057
"34630","NANDI","ALL","50-54",11823,11982,23805
"34631","NANDI","ALL","55",2203,1822,4025
"34632","NANDI","ALL","56",1998,2010,4008
"34633","NANDI","ALL","57",1976,2590,4566
"34634","NANDI","ALL","58",2005,2448,4453
"34635","NANDI","ALL","59",2173,2211,4384
"34636","NANDI","ALL","55-59",10355,11081,21436
"34637","NANDI","ALL","60",2213,2189,4402
"34638","NANDI","ALL","61",1832,1753,3585
"34639","NANDI","ALL","62",1496,1375,2871
"34640","NANDI","ALL","63",1397,1537,2934
"34641","NANDI","ALL","64",1105,1151,2256
"34642","NANDI","ALL","60-64",8043,8005,16048
"34643","NANDI","ALL","65",1588,1742,3330
"34644","NANDI","ALL","66",937,1049,1986
"34645","NANDI","ALL","67",1663,1709,3372
"34646","NANDI","ALL","68",677,746,1423
"34647","NANDI","ALL","69",1186,1339,2525
"34648","NANDI","ALL","65-69",6051,6585,12636
"34649","NANDI","ALL","70",1172,1449,2621
"34650","NANDI","ALL","71",1056,1042,2098
"34651","NANDI","ALL","72",819,733,1552
"34652","NANDI","ALL","73",667,681,1348
"34653","NANDI","ALL","74",635,785,1420
"34654","NANDI","ALL","70-74",4349,4690,9039
"34655","NANDI","ALL","75",678,744,1422
"34656","NANDI","ALL","76",639,774,1413
"34657","NANDI","ALL","77",646,648,1294
"34658","NANDI","ALL","78",323,327,650
"34659","NANDI","ALL","79",472,738,1210
"34660","NANDI","ALL","75-79",2758,3231,5989
"34661","NANDI","ALL","80",496,658,1154
"34662","NANDI","ALL","81",295,354,649
"34663","NANDI","ALL","82",304,236,540
"34664","NANDI","ALL","83",335,347,682
"34665","NANDI","ALL","84",254,367,621
"34666","NANDI","ALL","80-84",1684,1962,3646
"34667","NANDI","ALL","85",227,284,511
"34668","NANDI","ALL","86",219,229,448
"34669","NANDI","ALL","87",210,272,482
"34670","NANDI","ALL","88",107,121,228
"34671","NANDI","ALL","89",227,469,696
"34672","NANDI","ALL","85-89",990,1375,2365
"34673","NANDI","ALL","90",131,218,349
"34674","NANDI","ALL","91",97,145,242
"34675","NANDI","ALL","92",84,99,183
"34676","NANDI","ALL","93",89,93,182
"34677","NANDI","ALL","94",71,121,192
"34678","NANDI","ALL","90-94",472,676,1148
"34679","NANDI","ALL","95",142,211,353
"34680","NANDI","ALL","96",37,39,76
"34681","NANDI","ALL","97",52,64,116
"34682","NANDI","ALL","98",28,45,73
"34683","NANDI","ALL","99",57,133,190
"34684","NANDI","ALL","95-99",316,492,808
"34685","NANDI","ALL","100+",79,238,317
"34686","NANDI","ALL","Not Stated",NA,2,2
"34687","NANDI","CHESUMEI","Total",80949,83180,164129
"34688","NANDI","CHESUMEI","0",1751,1774,3525
"34689","NANDI","CHESUMEI","1",1978,1908,3886
"34690","NANDI","CHESUMEI","2",1973,1953,3926
"34691","NANDI","CHESUMEI","3",1869,2020,3889
"34692","NANDI","CHESUMEI","4",1988,1936,3924
"34693","NANDI","CHESUMEI","0 - 4",9559,9591,19150
"34694","NANDI","CHESUMEI","5",1960,1834,3794
"34695","NANDI","CHESUMEI","6",1857,1935,3792
"34696","NANDI","CHESUMEI","7",2015,1929,3944
"34697","NANDI","CHESUMEI","8",1927,1970,3897
"34698","NANDI","CHESUMEI","9",2124,2207,4331
"34699","NANDI","CHESUMEI","5-9",9883,9875,19758
"34700","NANDI","CHESUMEI","10",2143,1971,4114
"34701","NANDI","CHESUMEI","11",2082,2067,4149
"34702","NANDI","CHESUMEI","12",2395,2349,4744
"34703","NANDI","CHESUMEI","13",2296,2309,4605
"34704","NANDI","CHESUMEI","14",2148,2103,4251
"34705","NANDI","CHESUMEI","10 -14",11064,10799,21863
"34706","NANDI","CHESUMEI","15",2146,2145,4291
"34707","NANDI","CHESUMEI","16",1959,2090,4049
"34708","NANDI","CHESUMEI","17",2093,2041,4134
"34709","NANDI","CHESUMEI","18",1752,1775,3527
"34710","NANDI","CHESUMEI","19",1997,2011,4008
"34711","NANDI","CHESUMEI","15-19",9947,10062,20009
"34712","NANDI","CHESUMEI","20",1745,1787,3532
"34713","NANDI","CHESUMEI","21",1693,1698,3391
"34714","NANDI","CHESUMEI","22",1504,1546,3050
"34715","NANDI","CHESUMEI","23",1478,1660,3138
"34716","NANDI","CHESUMEI","24",1395,1530,2925
"34717","NANDI","CHESUMEI","20-24",7815,8221,16036
"34718","NANDI","CHESUMEI","25",1454,1497,2951
"34719","NANDI","CHESUMEI","26",1203,1398,2601
"34720","NANDI","CHESUMEI","27",1399,1482,2881
"34721","NANDI","CHESUMEI","28",984,1119,2103
"34722","NANDI","CHESUMEI","29",1183,1374,2557
"34723","NANDI","CHESUMEI","25-29",6223,6870,13093
"34724","NANDI","CHESUMEI","30",1362,1440,2802
"34725","NANDI","CHESUMEI","31",1066,1195,2261
"34726","NANDI","CHESUMEI","32",1284,1471,2755
"34727","NANDI","CHESUMEI","33",1138,1321,2459
"34728","NANDI","CHESUMEI","34",1048,1154,2202
"34729","NANDI","CHESUMEI","30-34",5898,6581,12479
"34730","NANDI","CHESUMEI","35",1315,1326,2641
"34731","NANDI","CHESUMEI","36",873,813,1686
"34732","NANDI","CHESUMEI","37",943,814,1757
"34733","NANDI","CHESUMEI","38",627,577,1204
"34734","NANDI","CHESUMEI","39",876,819,1695
"34735","NANDI","CHESUMEI","35-39",4634,4349,8983
"34736","NANDI","CHESUMEI","40",928,853,1781
"34737","NANDI","CHESUMEI","41",880,783,1663
"34738","NANDI","CHESUMEI","42",782,816,1598
"34739","NANDI","CHESUMEI","43",773,801,1574
"34740","NANDI","CHESUMEI","44",606,606,1212
"34741","NANDI","CHESUMEI","40-44",3969,3859,7828
"34742","NANDI","CHESUMEI","45",888,840,1728
"34743","NANDI","CHESUMEI","46",646,673,1319
"34744","NANDI","CHESUMEI","47",663,668,1331
"34745","NANDI","CHESUMEI","48",445,474,919
"34746","NANDI","CHESUMEI","49",600,626,1226
"34747","NANDI","CHESUMEI","45-49",3242,3281,6523
"34748","NANDI","CHESUMEI","50",614,621,1235
"34749","NANDI","CHESUMEI","51",493,540,1033
"34750","NANDI","CHESUMEI","52",416,456,872
"34751","NANDI","CHESUMEI","53",369,396,765
"34752","NANDI","CHESUMEI","54",419,383,802
"34753","NANDI","CHESUMEI","50-54",2311,2396,4707
"34754","NANDI","CHESUMEI","55",419,337,756
"34755","NANDI","CHESUMEI","56",383,373,756
"34756","NANDI","CHESUMEI","57",391,565,956
"34757","NANDI","CHESUMEI","58",351,470,821
"34758","NANDI","CHESUMEI","59",440,428,868
"34759","NANDI","CHESUMEI","55-59",1984,2173,4157
"34760","NANDI","CHESUMEI","60",438,422,860
"34761","NANDI","CHESUMEI","61",350,344,694
"34762","NANDI","CHESUMEI","62",284,258,542
"34763","NANDI","CHESUMEI","63",246,291,537
"34764","NANDI","CHESUMEI","64",224,216,440
"34765","NANDI","CHESUMEI","60-64",1542,1531,3073
"34766","NANDI","CHESUMEI","65",276,319,595
"34767","NANDI","CHESUMEI","66",147,208,355
"34768","NANDI","CHESUMEI","67",260,301,561
"34769","NANDI","CHESUMEI","68",110,123,233
"34770","NANDI","CHESUMEI","69",234,249,483
"34771","NANDI","CHESUMEI","65-69",1027,1200,2227
"34772","NANDI","CHESUMEI","70",228,255,483
"34773","NANDI","CHESUMEI","71",174,196,370
"34774","NANDI","CHESUMEI","72",146,146,292
"34775","NANDI","CHESUMEI","73",114,137,251
"34776","NANDI","CHESUMEI","74",114,167,281
"34777","NANDI","CHESUMEI","70-74",776,901,1677
"34778","NANDI","CHESUMEI","75",117,131,248
"34779","NANDI","CHESUMEI","76",114,143,257
"34780","NANDI","CHESUMEI","77",105,115,220
"34781","NANDI","CHESUMEI","78",56,49,105
"34782","NANDI","CHESUMEI","79",79,126,205
"34783","NANDI","CHESUMEI","75-79",471,564,1035
"34784","NANDI","CHESUMEI","80",84,121,205
"34785","NANDI","CHESUMEI","81",57,76,133
"34786","NANDI","CHESUMEI","82",58,45,103
"34787","NANDI","CHESUMEI","83",58,60,118
"34788","NANDI","CHESUMEI","84",43,80,123
"34789","NANDI","CHESUMEI","80-84",300,382,682
"34790","NANDI","CHESUMEI","85",34,69,103
"34791","NANDI","CHESUMEI","86",38,35,73
"34792","NANDI","CHESUMEI","87",28,55,83
"34793","NANDI","CHESUMEI","88",18,22,40
"34794","NANDI","CHESUMEI","89",36,86,122
"34795","NANDI","CHESUMEI","85-89",154,267,421
"34796","NANDI","CHESUMEI","90",24,48,72
"34797","NANDI","CHESUMEI","91",12,28,40
"34798","NANDI","CHESUMEI","92",16,18,34
"34799","NANDI","CHESUMEI","93",13,16,29
"34800","NANDI","CHESUMEI","94",17,21,38
"34801","NANDI","CHESUMEI","90-94",82,131,213
"34802","NANDI","CHESUMEI","95",24,31,55
"34803","NANDI","CHESUMEI","96",5,9,14
"34804","NANDI","CHESUMEI","97",7,12,19
"34805","NANDI","CHESUMEI","98",7,12,19
"34806","NANDI","CHESUMEI","99",12,29,41
"34807","NANDI","CHESUMEI","95-99",55,93,148
"34808","NANDI","CHESUMEI","100+",13,54,67
"34809","NANDI","CHESUMEI","Not Stated",NA,NA,NA
"34810","NANDI","NANDI CENTRAL","Total",73291,74255,147546
"34811","NANDI","NANDI CENTRAL","0",1695,1665,3360
"34812","NANDI","NANDI CENTRAL","1",1694,1683,3377
"34813","NANDI","NANDI CENTRAL","2",1724,1687,3411
"34814","NANDI","NANDI CENTRAL","3",1696,1798,3494
"34815","NANDI","NANDI CENTRAL","4",1829,1790,3619
"34816","NANDI","NANDI CENTRAL","0 - 4",8638,8623,17261
"34817","NANDI","NANDI CENTRAL","5",1709,1730,3439
"34818","NANDI","NANDI CENTRAL","6",1813,1778,3591
"34819","NANDI","NANDI CENTRAL","7",1913,1863,3776
"34820","NANDI","NANDI CENTRAL","8",1974,1813,3787
"34821","NANDI","NANDI CENTRAL","9",1928,1977,3905
"34822","NANDI","NANDI CENTRAL","5-9",9337,9161,18498
"34823","NANDI","NANDI CENTRAL","10",2042,2002,4044
"34824","NANDI","NANDI CENTRAL","11",1967,1943,3910
"34825","NANDI","NANDI CENTRAL","12",2196,2122,4318
"34826","NANDI","NANDI CENTRAL","13",2113,2118,4231
"34827","NANDI","NANDI CENTRAL","14",2021,2005,4026
"34828","NANDI","NANDI CENTRAL","10 -14",10339,10190,20529
"34829","NANDI","NANDI CENTRAL","15",1893,1894,3787
"34830","NANDI","NANDI CENTRAL","16",1913,1870,3783
"34831","NANDI","NANDI CENTRAL","17",1952,1875,3827
"34832","NANDI","NANDI CENTRAL","18",1640,1510,3150
"34833","NANDI","NANDI CENTRAL","19",1696,1681,3377
"34834","NANDI","NANDI CENTRAL","15-19",9094,8830,17924
"34835","NANDI","NANDI CENTRAL","20",1471,1564,3035
"34836","NANDI","NANDI CENTRAL","21",1462,1477,2939
"34837","NANDI","NANDI CENTRAL","22",1309,1284,2593
"34838","NANDI","NANDI CENTRAL","23",1328,1440,2768
"34839","NANDI","NANDI CENTRAL","24",1144,1279,2423
"34840","NANDI","NANDI CENTRAL","20-24",6714,7044,13758
"34841","NANDI","NANDI CENTRAL","25",1269,1269,2538
"34842","NANDI","NANDI CENTRAL","26",1028,1143,2171
"34843","NANDI","NANDI CENTRAL","27",1102,1140,2242
"34844","NANDI","NANDI CENTRAL","28",893,1053,1946
"34845","NANDI","NANDI CENTRAL","29",1040,1186,2226
"34846","NANDI","NANDI CENTRAL","25-29",5332,5791,11123
"34847","NANDI","NANDI CENTRAL","30",1211,1350,2561
"34848","NANDI","NANDI CENTRAL","31",951,1022,1973
"34849","NANDI","NANDI CENTRAL","32",1205,1348,2553
"34850","NANDI","NANDI CENTRAL","33",1020,1229,2249
"34851","NANDI","NANDI CENTRAL","34",946,1030,1976
"34852","NANDI","NANDI CENTRAL","30-34",5333,5979,11312
"34853","NANDI","NANDI CENTRAL","35",1141,1162,2303
"34854","NANDI","NANDI CENTRAL","36",802,747,1549
"34855","NANDI","NANDI CENTRAL","37",824,692,1516
"34856","NANDI","NANDI CENTRAL","38",630,578,1208
"34857","NANDI","NANDI CENTRAL","39",699,626,1325
"34858","NANDI","NANDI CENTRAL","35-39",4096,3805,7901
"34859","NANDI","NANDI CENTRAL","40",757,689,1446
"34860","NANDI","NANDI CENTRAL","41",804,692,1496
"34861","NANDI","NANDI CENTRAL","42",773,689,1462
"34862","NANDI","NANDI CENTRAL","43",707,701,1408
"34863","NANDI","NANDI CENTRAL","44",562,564,1126
"34864","NANDI","NANDI CENTRAL","40-44",3603,3335,6938
"34865","NANDI","NANDI CENTRAL","45",756,768,1524
"34866","NANDI","NANDI CENTRAL","46",602,578,1180
"34867","NANDI","NANDI CENTRAL","47",599,642,1241
"34868","NANDI","NANDI CENTRAL","48",430,384,814
"34869","NANDI","NANDI CENTRAL","49",525,516,1041
"34870","NANDI","NANDI CENTRAL","45-49",2912,2888,5800
"34871","NANDI","NANDI CENTRAL","50",501,537,1038
"34872","NANDI","NANDI CENTRAL","51",471,463,934
"34873","NANDI","NANDI CENTRAL","52",362,374,736
"34874","NANDI","NANDI CENTRAL","53",318,350,668
"34875","NANDI","NANDI CENTRAL","54",355,309,664
"34876","NANDI","NANDI CENTRAL","50-54",2007,2033,4040
"34877","NANDI","NANDI CENTRAL","55",371,313,684
"34878","NANDI","NANDI CENTRAL","56",354,398,752
"34879","NANDI","NANDI CENTRAL","57",298,416,714
"34880","NANDI","NANDI CENTRAL","58",370,384,754
"34881","NANDI","NANDI CENTRAL","59",372,429,801
"34882","NANDI","NANDI CENTRAL","55-59",1765,1940,3705
"34883","NANDI","NANDI CENTRAL","60",353,369,722
"34884","NANDI","NANDI CENTRAL","61",309,315,624
"34885","NANDI","NANDI CENTRAL","62",251,251,502
"34886","NANDI","NANDI CENTRAL","63",260,300,560
"34887","NANDI","NANDI CENTRAL","64",205,205,410
"34888","NANDI","NANDI CENTRAL","60-64",1378,1440,2818
"34889","NANDI","NANDI CENTRAL","65",305,295,600
"34890","NANDI","NANDI CENTRAL","66",174,168,342
"34891","NANDI","NANDI CENTRAL","67",292,299,591
"34892","NANDI","NANDI CENTRAL","68",131,138,269
"34893","NANDI","NANDI CENTRAL","69",187,214,401
"34894","NANDI","NANDI CENTRAL","65-69",1089,1114,2203
"34895","NANDI","NANDI CENTRAL","70",185,228,413
"34896","NANDI","NANDI CENTRAL","71",158,165,323
"34897","NANDI","NANDI CENTRAL","72",136,118,254
"34898","NANDI","NANDI CENTRAL","73",108,97,205
"34899","NANDI","NANDI CENTRAL","74",85,159,244
"34900","NANDI","NANDI CENTRAL","70-74",672,767,1439
"34901","NANDI","NANDI CENTRAL","75",112,130,242
"34902","NANDI","NANDI CENTRAL","76",102,143,245
"34903","NANDI","NANDI CENTRAL","77",87,101,188
"34904","NANDI","NANDI CENTRAL","78",53,69,122
"34905","NANDI","NANDI CENTRAL","79",61,124,185
"34906","NANDI","NANDI CENTRAL","75-79",415,567,982
"34907","NANDI","NANDI CENTRAL","80",88,102,190
"34908","NANDI","NANDI CENTRAL","81",42,49,91
"34909","NANDI","NANDI CENTRAL","82",45,28,73
"34910","NANDI","NANDI CENTRAL","83",58,71,129
"34911","NANDI","NANDI CENTRAL","84",40,62,102
"34912","NANDI","NANDI CENTRAL","80-84",273,312,585
"34913","NANDI","NANDI CENTRAL","85",48,46,94
"34914","NANDI","NANDI CENTRAL","86",29,43,72
"34915","NANDI","NANDI CENTRAL","87",31,33,64
"34916","NANDI","NANDI CENTRAL","88",13,22,35
"34917","NANDI","NANDI CENTRAL","89",29,76,105
"34918","NANDI","NANDI CENTRAL","85-89",150,220,370
"34919","NANDI","NANDI CENTRAL","90",24,33,57
"34920","NANDI","NANDI CENTRAL","91",13,20,33
"34921","NANDI","NANDI CENTRAL","92",11,20,31
"34922","NANDI","NANDI CENTRAL","93",18,19,37
"34923","NANDI","NANDI CENTRAL","94",13,20,33
"34924","NANDI","NANDI CENTRAL","90-94",79,112,191
"34925","NANDI","NANDI CENTRAL","95",23,23,46
"34926","NANDI","NANDI CENTRAL","96",8,4,12
"34927","NANDI","NANDI CENTRAL","97",11,12,23
"34928","NANDI","NANDI CENTRAL","98",7,10,17
"34929","NANDI","NANDI CENTRAL","99",4,17,21
"34930","NANDI","NANDI CENTRAL","95-99",53,66,119
"34931","NANDI","NANDI CENTRAL","100+",12,38,50
"34932","NANDI","NANDI CENTRAL","Not Stated",NA,NA,NA
"34933","NANDI","NANDI EAST","Total",59899,59271,119170
"34934","NANDI","NANDI EAST","0",1352,1289,2641
"34935","NANDI","NANDI EAST","1",1373,1347,2720
"34936","NANDI","NANDI EAST","2",1402,1417,2819
"34937","NANDI","NANDI EAST","3",1516,1486,3002
"34938","NANDI","NANDI EAST","4",1583,1604,3187
"34939","NANDI","NANDI EAST","0 - 4",7226,7143,14369
"34940","NANDI","NANDI EAST","5",1568,1514,3082
"34941","NANDI","NANDI EAST","6",1524,1535,3059
"34942","NANDI","NANDI EAST","7",1559,1457,3016
"34943","NANDI","NANDI EAST","8",1448,1515,2963
"34944","NANDI","NANDI EAST","9",1690,1656,3346
"34945","NANDI","NANDI EAST","5-9",7789,7677,15466
"34946","NANDI","NANDI EAST","10",1652,1575,3227
"34947","NANDI","NANDI EAST","11",1600,1676,3276
"34948","NANDI","NANDI EAST","12",1772,1675,3447
"34949","NANDI","NANDI EAST","13",1654,1802,3456
"34950","NANDI","NANDI EAST","14",1577,1625,3202
"34951","NANDI","NANDI EAST","10 -14",8255,8353,16608
"34952","NANDI","NANDI EAST","15",1567,1550,3117
"34953","NANDI","NANDI EAST","16",1441,1438,2879
"34954","NANDI","NANDI EAST","17",1485,1450,2935
"34955","NANDI","NANDI EAST","18",1128,1105,2233
"34956","NANDI","NANDI EAST","19",1307,1332,2639
"34957","NANDI","NANDI EAST","15-19",6928,6875,13803
"34958","NANDI","NANDI EAST","20",1047,1104,2151
"34959","NANDI","NANDI EAST","21",1065,1141,2206
"34960","NANDI","NANDI EAST","22",1051,1106,2157
"34961","NANDI","NANDI EAST","23",1035,1255,2290
"34962","NANDI","NANDI EAST","24",1004,1092,2096
"34963","NANDI","NANDI EAST","20-24",5202,5698,10900
"34964","NANDI","NANDI EAST","25",1064,1183,2247
"34965","NANDI","NANDI EAST","26",923,1006,1929
"34966","NANDI","NANDI EAST","27",921,1056,1977
"34967","NANDI","NANDI EAST","28",767,852,1619
"34968","NANDI","NANDI EAST","29",910,941,1851
"34969","NANDI","NANDI EAST","25-29",4585,5038,9623
"34970","NANDI","NANDI EAST","30",927,1130,2057
"34971","NANDI","NANDI EAST","31",852,975,1827
"34972","NANDI","NANDI EAST","32",1035,1129,2164
"34973","NANDI","NANDI EAST","33",875,1019,1894
"34974","NANDI","NANDI EAST","34",760,835,1595
"34975","NANDI","NANDI EAST","30-34",4449,5088,9537
"34976","NANDI","NANDI EAST","35",989,956,1945
"34977","NANDI","NANDI EAST","36",732,497,1229
"34978","NANDI","NANDI EAST","37",756,585,1341
"34979","NANDI","NANDI EAST","38",534,410,944
"34980","NANDI","NANDI EAST","39",689,525,1214
"34981","NANDI","NANDI EAST","35-39",3700,2973,6673
"34982","NANDI","NANDI EAST","40",681,584,1265
"34983","NANDI","NANDI EAST","41",781,630,1411
"34984","NANDI","NANDI EAST","42",670,565,1235
"34985","NANDI","NANDI EAST","43",666,596,1262
"34986","NANDI","NANDI EAST","44",533,464,997
"34987","NANDI","NANDI EAST","40-44",3331,2839,6170
"34988","NANDI","NANDI EAST","45",725,568,1293
"34989","NANDI","NANDI EAST","46",628,468,1096
"34990","NANDI","NANDI EAST","47",584,490,1074
"34991","NANDI","NANDI EAST","48",355,289,644
"34992","NANDI","NANDI EAST","49",491,387,878
"34993","NANDI","NANDI EAST","45-49",2783,2202,4985
"34994","NANDI","NANDI EAST","50",381,349,730
"34995","NANDI","NANDI EAST","51",385,298,683
"34996","NANDI","NANDI EAST","52",321,280,601
"34997","NANDI","NANDI EAST","53",292,257,549
"34998","NANDI","NANDI EAST","54",295,257,552
"34999","NANDI","NANDI EAST","50-54",1674,1441,3115
"35000","NANDI","NANDI EAST","55",298,177,475
"35001","NANDI","NANDI EAST","56",230,207,437
"35002","NANDI","NANDI EAST","57",250,253,503
"35003","NANDI","NANDI EAST","58",255,320,575
"35004","NANDI","NANDI EAST","59",224,233,457
"35005","NANDI","NANDI EAST","55-59",1257,1190,2447
"35006","NANDI","NANDI EAST","60",253,225,478
"35007","NANDI","NANDI EAST","61",187,195,382
"35008","NANDI","NANDI EAST","62",193,126,319
"35009","NANDI","NANDI EAST","63",138,150,288
"35010","NANDI","NANDI EAST","64",107,109,216
"35011","NANDI","NANDI EAST","60-64",878,805,1683
"35012","NANDI","NANDI EAST","65",182,161,343
"35013","NANDI","NANDI EAST","66",94,92,186
"35014","NANDI","NANDI EAST","67",198,176,374
"35015","NANDI","NANDI EAST","68",68,78,146
"35016","NANDI","NANDI EAST","69",121,138,259
"35017","NANDI","NANDI EAST","65-69",663,645,1308
"35018","NANDI","NANDI EAST","70",103,144,247
"35019","NANDI","NANDI EAST","71",132,119,251
"35020","NANDI","NANDI EAST","72",75,70,145
"35021","NANDI","NANDI EAST","73",69,79,148
"35022","NANDI","NANDI EAST","74",61,79,140
"35023","NANDI","NANDI EAST","70-74",440,491,931
"35024","NANDI","NANDI EAST","75",73,81,154
"35025","NANDI","NANDI EAST","76",78,62,140
"35026","NANDI","NANDI EAST","77",71,71,142
"35027","NANDI","NANDI EAST","78",38,32,70
"35028","NANDI","NANDI EAST","79",60,84,144
"35029","NANDI","NANDI EAST","75-79",320,330,650
"35030","NANDI","NANDI EAST","80",60,76,136
"35031","NANDI","NANDI EAST","81",36,48,84
"35032","NANDI","NANDI EAST","82",39,33,72
"35033","NANDI","NANDI EAST","83",32,28,60
"35034","NANDI","NANDI EAST","84",30,45,75
"35035","NANDI","NANDI EAST","80-84",197,230,427
"35036","NANDI","NANDI EAST","85",22,17,39
"35037","NANDI","NANDI EAST","86",28,20,48
"35038","NANDI","NANDI EAST","87",29,23,52
"35039","NANDI","NANDI EAST","88",15,19,34
"35040","NANDI","NANDI EAST","89",40,56,96
"35041","NANDI","NANDI EAST","85-89",134,135,269
"35042","NANDI","NANDI EAST","90",12,20,32
"35043","NANDI","NANDI EAST","91",14,14,28
"35044","NANDI","NANDI EAST","92",6,6,12
"35045","NANDI","NANDI EAST","93",12,10,22
"35046","NANDI","NANDI EAST","94",6,12,18
"35047","NANDI","NANDI EAST","90-94",50,62,112
"35048","NANDI","NANDI EAST","95",16,21,37
"35049","NANDI","NANDI EAST","96",2,4,6
"35050","NANDI","NANDI EAST","97",5,5,10
"35051","NANDI","NANDI EAST","98",2,1,3
"35052","NANDI","NANDI EAST","99",8,9,17
"35053","NANDI","NANDI EAST","95-99",33,40,73
"35054","NANDI","NANDI EAST","100+",5,15,20
"35055","NANDI","NANDI EAST","Not Stated",NA,1,1
"35056","NANDI","NANDI NORTH","Total",82512,83656,166168
"35057","NANDI","NANDI NORTH","0",1868,1830,3698
"35058","NANDI","NANDI NORTH","1",1989,1930,3919
"35059","NANDI","NANDI NORTH","2",1964,1995,3959
"35060","NANDI","NANDI NORTH","3",2101,2078,4179
"35061","NANDI","NANDI NORTH","4",2151,2125,4276
"35062","NANDI","NANDI NORTH","0 - 4",10073,9958,20031
"35063","NANDI","NANDI NORTH","5",2132,2090,4222
"35064","NANDI","NANDI NORTH","6",2177,2206,4383
"35065","NANDI","NANDI NORTH","7",2340,2348,4688
"35066","NANDI","NANDI NORTH","8",2216,2153,4369
"35067","NANDI","NANDI NORTH","9",2583,2461,5044
"35068","NANDI","NANDI NORTH","5-9",11448,11258,22706
"35069","NANDI","NANDI NORTH","10",2378,2190,4568
"35070","NANDI","NANDI NORTH","11",2295,2346,4641
"35071","NANDI","NANDI NORTH","12",2670,2508,5178
"35072","NANDI","NANDI NORTH","13",2605,2476,5081
"35073","NANDI","NANDI NORTH","14",2418,2358,4776
"35074","NANDI","NANDI NORTH","10 -14",12366,11878,24244
"35075","NANDI","NANDI NORTH","15",2342,2260,4602
"35076","NANDI","NANDI NORTH","16",2293,2159,4452
"35077","NANDI","NANDI NORTH","17",2369,2155,4524
"35078","NANDI","NANDI NORTH","18",1707,1642,3349
"35079","NANDI","NANDI NORTH","19",2065,1835,3900
"35080","NANDI","NANDI NORTH","15-19",10776,10051,20827
"35081","NANDI","NANDI NORTH","20",1633,1630,3263
"35082","NANDI","NANDI NORTH","21",1488,1531,3019
"35083","NANDI","NANDI NORTH","22",1270,1408,2678
"35084","NANDI","NANDI NORTH","23",1299,1444,2743
"35085","NANDI","NANDI NORTH","24",1179,1277,2456
"35086","NANDI","NANDI NORTH","20-24",6869,7290,14159
"35087","NANDI","NANDI NORTH","25",1233,1314,2547
"35088","NANDI","NANDI NORTH","26",1021,1287,2308
"35089","NANDI","NANDI NORTH","27",1147,1237,2384
"35090","NANDI","NANDI NORTH","28",812,919,1731
"35091","NANDI","NANDI NORTH","29",993,1204,2197
"35092","NANDI","NANDI NORTH","25-29",5206,5961,11167
"35093","NANDI","NANDI NORTH","30",1163,1267,2430
"35094","NANDI","NANDI NORTH","31",933,1108,2041
"35095","NANDI","NANDI NORTH","32",1190,1446,2636
"35096","NANDI","NANDI NORTH","33",1135,1392,2527
"35097","NANDI","NANDI NORTH","34",922,1108,2030
"35098","NANDI","NANDI NORTH","30-34",5343,6321,11664
"35099","NANDI","NANDI NORTH","35",1198,1240,2438
"35100","NANDI","NANDI NORTH","36",794,759,1553
"35101","NANDI","NANDI NORTH","37",886,691,1577
"35102","NANDI","NANDI NORTH","38",566,454,1020
"35103","NANDI","NANDI NORTH","39",741,720,1461
"35104","NANDI","NANDI NORTH","35-39",4185,3864,8049
"35105","NANDI","NANDI NORTH","40",790,737,1527
"35106","NANDI","NANDI NORTH","41",877,759,1636
"35107","NANDI","NANDI NORTH","42",877,754,1631
"35108","NANDI","NANDI NORTH","43",724,777,1501
"35109","NANDI","NANDI NORTH","44",640,621,1261
"35110","NANDI","NANDI NORTH","40-44",3908,3648,7556
"35111","NANDI","NANDI NORTH","45",894,824,1718
"35112","NANDI","NANDI NORTH","46",680,720,1400
"35113","NANDI","NANDI NORTH","47",710,681,1391
"35114","NANDI","NANDI NORTH","48",413,454,867
"35115","NANDI","NANDI NORTH","49",582,647,1229
"35116","NANDI","NANDI NORTH","45-49",3279,3326,6605
"35117","NANDI","NANDI NORTH","50",537,604,1141
"35118","NANDI","NANDI NORTH","51",539,538,1077
"35119","NANDI","NANDI NORTH","52",413,450,863
"35120","NANDI","NANDI NORTH","53",349,380,729
"35121","NANDI","NANDI NORTH","54",372,372,744
"35122","NANDI","NANDI NORTH","50-54",2210,2344,4554
"35123","NANDI","NANDI NORTH","55",360,355,715
"35124","NANDI","NANDI NORTH","56",401,391,792
"35125","NANDI","NANDI NORTH","57",416,552,968
"35126","NANDI","NANDI NORTH","58",376,437,813
"35127","NANDI","NANDI NORTH","59",401,394,795
"35128","NANDI","NANDI NORTH","55-59",1954,2129,4083
"35129","NANDI","NANDI NORTH","60",436,383,819
"35130","NANDI","NANDI NORTH","61",345,316,661
"35131","NANDI","NANDI NORTH","62",266,262,528
"35132","NANDI","NANDI NORTH","63",251,291,542
"35133","NANDI","NANDI NORTH","64",194,243,437
"35134","NANDI","NANDI NORTH","60-64",1492,1495,2987
"35135","NANDI","NANDI NORTH","65",282,337,619
"35136","NANDI","NANDI NORTH","66",159,221,380
"35137","NANDI","NANDI NORTH","67",326,360,686
"35138","NANDI","NANDI NORTH","68",114,147,261
"35139","NANDI","NANDI NORTH","69",240,270,510
"35140","NANDI","NANDI NORTH","65-69",1121,1335,2456
"35141","NANDI","NANDI NORTH","70",220,315,535
"35142","NANDI","NANDI NORTH","71",200,221,421
"35143","NANDI","NANDI NORTH","72",178,162,340
"35144","NANDI","NANDI NORTH","73",152,167,319
"35145","NANDI","NANDI NORTH","74",135,138,273
"35146","NANDI","NANDI NORTH","70-74",885,1003,1888
"35147","NANDI","NANDI NORTH","75",143,177,320
"35148","NANDI","NANDI NORTH","76",144,177,321
"35149","NANDI","NANDI NORTH","77",164,151,315
"35150","NANDI","NANDI NORTH","78",66,73,139
"35151","NANDI","NANDI NORTH","79",118,147,265
"35152","NANDI","NANDI NORTH","75-79",635,725,1360
"35153","NANDI","NANDI NORTH","80",106,129,235
"35154","NANDI","NANDI NORTH","81",58,63,121
"35155","NANDI","NANDI NORTH","82",75,42,117
"35156","NANDI","NANDI NORTH","83",70,82,152
"35157","NANDI","NANDI NORTH","84",52,60,112
"35158","NANDI","NANDI NORTH","80-84",361,376,737
"35159","NANDI","NANDI NORTH","85",48,64,112
"35160","NANDI","NANDI NORTH","86",54,50,104
"35161","NANDI","NANDI NORTH","87",45,59,104
"35162","NANDI","NANDI NORTH","88",22,24,46
"35163","NANDI","NANDI NORTH","89",27,108,135
"35164","NANDI","NANDI NORTH","85-89",196,305,501
"35165","NANDI","NANDI NORTH","90",32,44,76
"35166","NANDI","NANDI NORTH","91",26,44,70
"35167","NANDI","NANDI NORTH","92",21,25,46
"35168","NANDI","NANDI NORTH","93",26,29,55
"35169","NANDI","NANDI NORTH","94",12,29,41
"35170","NANDI","NANDI NORTH","90-94",117,171,288
"35171","NANDI","NANDI NORTH","95",41,70,111
"35172","NANDI","NANDI NORTH","96",7,8,15
"35173","NANDI","NANDI NORTH","97",9,16,25
"35174","NANDI","NANDI NORTH","98",3,12,15
"35175","NANDI","NANDI NORTH","99",11,45,56
"35176","NANDI","NANDI NORTH","95-99",71,151,222
"35177","NANDI","NANDI NORTH","100+",17,66,83
"35178","NANDI","NANDI NORTH","Not Stated",NA,1,1
"35179","NANDI","NANDI SOUTH","Total",85718,87029,172747
"35180","NANDI","NANDI SOUTH","0",1941,1871,3812
"35181","NANDI","NANDI SOUTH","1",1888,1971,3859
"35182","NANDI","NANDI SOUTH","2",2103,2008,4111
"35183","NANDI","NANDI SOUTH","3",2135,2141,4276
"35184","NANDI","NANDI SOUTH","4",2178,2026,4204
"35185","NANDI","NANDI SOUTH","0 - 4",10245,10017,20262
"35186","NANDI","NANDI SOUTH","5",2188,2097,4285
"35187","NANDI","NANDI SOUTH","6",2178,2301,4479
"35188","NANDI","NANDI SOUTH","7",2355,2301,4656
"35189","NANDI","NANDI SOUTH","8",2287,2239,4526
"35190","NANDI","NANDI SOUTH","9",2518,2527,5045
"35191","NANDI","NANDI SOUTH","5-9",11526,11465,22991
"35192","NANDI","NANDI SOUTH","10",2578,2395,4973
"35193","NANDI","NANDI SOUTH","11",2367,2519,4886
"35194","NANDI","NANDI SOUTH","12",2686,2528,5214
"35195","NANDI","NANDI SOUTH","13",2694,2530,5224
"35196","NANDI","NANDI SOUTH","14",2548,2432,4980
"35197","NANDI","NANDI SOUTH","10 -14",12873,12404,25277
"35198","NANDI","NANDI SOUTH","15",2455,2453,4908
"35199","NANDI","NANDI SOUTH","16",2282,2215,4497
"35200","NANDI","NANDI SOUTH","17",2347,2269,4616
"35201","NANDI","NANDI SOUTH","18",1932,1789,3721
"35202","NANDI","NANDI SOUTH","19",2115,1885,4000
"35203","NANDI","NANDI SOUTH","15-19",11131,10611,21742
"35204","NANDI","NANDI SOUTH","20",1736,1736,3472
"35205","NANDI","NANDI SOUTH","21",1577,1534,3111
"35206","NANDI","NANDI SOUTH","22",1392,1547,2939
"35207","NANDI","NANDI SOUTH","23",1408,1576,2984
"35208","NANDI","NANDI SOUTH","24",1210,1310,2520
"35209","NANDI","NANDI SOUTH","20-24",7323,7703,15026
"35210","NANDI","NANDI SOUTH","25",1347,1470,2817
"35211","NANDI","NANDI SOUTH","26",1086,1316,2402
"35212","NANDI","NANDI SOUTH","27",1211,1301,2512
"35213","NANDI","NANDI SOUTH","28",905,1038,1943
"35214","NANDI","NANDI SOUTH","29",1082,1203,2285
"35215","NANDI","NANDI SOUTH","25-29",5631,6328,11959
"35216","NANDI","NANDI SOUTH","30",1228,1430,2658
"35217","NANDI","NANDI SOUTH","31",999,1109,2108
"35218","NANDI","NANDI SOUTH","32",1226,1392,2618
"35219","NANDI","NANDI SOUTH","33",1100,1299,2399
"35220","NANDI","NANDI SOUTH","34",955,1093,2048
"35221","NANDI","NANDI SOUTH","30-34",5508,6323,11831
"35222","NANDI","NANDI SOUTH","35",1259,1213,2472
"35223","NANDI","NANDI SOUTH","36",806,726,1532
"35224","NANDI","NANDI SOUTH","37",917,759,1676
"35225","NANDI","NANDI SOUTH","38",617,534,1151
"35226","NANDI","NANDI SOUTH","39",805,645,1450
"35227","NANDI","NANDI SOUTH","35-39",4404,3877,8281
"35228","NANDI","NANDI SOUTH","40",743,729,1472
"35229","NANDI","NANDI SOUTH","41",812,795,1607
"35230","NANDI","NANDI SOUTH","42",792,794,1586
"35231","NANDI","NANDI SOUTH","43",798,902,1700
"35232","NANDI","NANDI SOUTH","44",617,633,1250
"35233","NANDI","NANDI SOUTH","40-44",3762,3853,7615
"35234","NANDI","NANDI SOUTH","45",904,871,1775
"35235","NANDI","NANDI SOUTH","46",646,639,1285
"35236","NANDI","NANDI SOUTH","47",673,718,1391
"35237","NANDI","NANDI SOUTH","48",416,477,893
"35238","NANDI","NANDI SOUTH","49",589,669,1258
"35239","NANDI","NANDI SOUTH","45-49",3228,3374,6602
"35240","NANDI","NANDI SOUTH","50",558,595,1153
"35241","NANDI","NANDI SOUTH","51",536,549,1085
"35242","NANDI","NANDI SOUTH","52",399,454,853
"35243","NANDI","NANDI SOUTH","53",335,449,784
"35244","NANDI","NANDI SOUTH","54",424,423,847
"35245","NANDI","NANDI SOUTH","50-54",2252,2470,4722
"35246","NANDI","NANDI SOUTH","55",458,428,886
"35247","NANDI","NANDI SOUTH","56",417,457,874
"35248","NANDI","NANDI SOUTH","57",423,543,966
"35249","NANDI","NANDI SOUTH","58",402,466,868
"35250","NANDI","NANDI SOUTH","59",498,483,981
"35251","NANDI","NANDI SOUTH","55-59",2198,2377,4575
"35252","NANDI","NANDI SOUTH","60",487,528,1015
"35253","NANDI","NANDI SOUTH","61",416,369,785
"35254","NANDI","NANDI SOUTH","62",319,317,636
"35255","NANDI","NANDI SOUTH","63",310,341,651
"35256","NANDI","NANDI SOUTH","64",245,253,498
"35257","NANDI","NANDI SOUTH","60-64",1777,1808,3585
"35258","NANDI","NANDI SOUTH","65",379,443,822
"35259","NANDI","NANDI SOUTH","66",252,257,509
"35260","NANDI","NANDI SOUTH","67",373,365,738
"35261","NANDI","NANDI SOUTH","68",170,182,352
"35262","NANDI","NANDI SOUTH","69",260,320,580
"35263","NANDI","NANDI SOUTH","65-69",1434,1567,3001
"35264","NANDI","NANDI SOUTH","70",267,357,624
"35265","NANDI","NANDI SOUTH","71",234,243,477
"35266","NANDI","NANDI SOUTH","72",188,162,350
"35267","NANDI","NANDI SOUTH","73",148,137,285
"35268","NANDI","NANDI SOUTH","74",170,168,338
"35269","NANDI","NANDI SOUTH","70-74",1007,1067,2074
"35270","NANDI","NANDI SOUTH","75",163,153,316
"35271","NANDI","NANDI SOUTH","76",145,191,336
"35272","NANDI","NANDI SOUTH","77",140,148,288
"35273","NANDI","NANDI SOUTH","78",75,64,139
"35274","NANDI","NANDI SOUTH","79",95,166,261
"35275","NANDI","NANDI SOUTH","75-79",618,722,1340
"35276","NANDI","NANDI SOUTH","80",105,160,265
"35277","NANDI","NANDI SOUTH","81",76,92,168
"35278","NANDI","NANDI SOUTH","82",61,69,130
"35279","NANDI","NANDI SOUTH","83",88,74,162
"35280","NANDI","NANDI SOUTH","84",62,79,141
"35281","NANDI","NANDI SOUTH","80-84",392,474,866
"35282","NANDI","NANDI SOUTH","85",50,60,110
"35283","NANDI","NANDI SOUTH","86",44,59,103
"35284","NANDI","NANDI SOUTH","87",52,82,134
"35285","NANDI","NANDI SOUTH","88",24,26,50
"35286","NANDI","NANDI SOUTH","89",64,97,161
"35287","NANDI","NANDI SOUTH","85-89",234,324,558
"35288","NANDI","NANDI SOUTH","90",22,43,65
"35289","NANDI","NANDI SOUTH","91",22,25,47
"35290","NANDI","NANDI SOUTH","92",22,21,43
"35291","NANDI","NANDI SOUTH","93",16,11,27
"35292","NANDI","NANDI SOUTH","94",13,27,40
"35293","NANDI","NANDI SOUTH","90-94",95,127,222
"35294","NANDI","NANDI SOUTH","95",25,50,75
"35295","NANDI","NANDI SOUTH","96",8,5,13
"35296","NANDI","NANDI SOUTH","97",9,15,24
"35297","NANDI","NANDI SOUTH","98",6,9,15
"35298","NANDI","NANDI SOUTH","99",13,23,36
"35299","NANDI","NANDI SOUTH","95-99",61,102,163
"35300","NANDI","NANDI SOUTH","100+",19,36,55
"35301","NANDI","NANDI SOUTH","Not Stated",NA,NA,NA
"35302","NANDI","TINDERET","Total",58890,57039,115929
"35303","NANDI","TINDERET","0",1381,1273,2654
"35304","NANDI","TINDERET","1",1463,1434,2897
"35305","NANDI","TINDERET","2",1490,1507,2997
"35306","NANDI","TINDERET","3",1565,1556,3121
"35307","NANDI","TINDERET","4",1651,1577,3228
"35308","NANDI","TINDERET","0 - 4",7550,7347,14897
"35309","NANDI","TINDERET","5",1672,1619,3291
"35310","NANDI","TINDERET","6",1612,1579,3191
"35311","NANDI","TINDERET","7",1695,1590,3285
"35312","NANDI","TINDERET","8",1701,1576,3277
"35313","NANDI","TINDERET","9",1848,1823,3671
"35314","NANDI","TINDERET","5-9",8528,8187,16715
"35315","NANDI","TINDERET","10",1710,1750,3460
"35316","NANDI","TINDERET","11",1707,1767,3474
"35317","NANDI","TINDERET","12",1845,1825,3670
"35318","NANDI","TINDERET","13",1793,1759,3552
"35319","NANDI","TINDERET","14",1771,1665,3436
"35320","NANDI","TINDERET","10 -14",8826,8766,17592
"35321","NANDI","TINDERET","15",1806,1657,3463
"35322","NANDI","TINDERET","16",1583,1422,3005
"35323","NANDI","TINDERET","17",1529,1438,2967
"35324","NANDI","TINDERET","18",1131,1124,2255
"35325","NANDI","TINDERET","19",1445,1301,2746
"35326","NANDI","TINDERET","15-19",7494,6942,14436
"35327","NANDI","TINDERET","20",1136,1121,2257
"35328","NANDI","TINDERET","21",1140,1102,2242
"35329","NANDI","TINDERET","22",1007,1013,2020
"35330","NANDI","TINDERET","23",1035,1155,2190
"35331","NANDI","TINDERET","24",897,960,1857
"35332","NANDI","TINDERET","20-24",5215,5351,10566
"35333","NANDI","TINDERET","25",994,1002,1996
"35334","NANDI","TINDERET","26",823,886,1709
"35335","NANDI","TINDERET","27",825,916,1741
"35336","NANDI","TINDERET","28",585,710,1295
"35337","NANDI","TINDERET","29",770,864,1634
"35338","NANDI","TINDERET","25-29",3997,4378,8375
"35339","NANDI","TINDERET","30",815,884,1699
"35340","NANDI","TINDERET","31",794,807,1601
"35341","NANDI","TINDERET","32",875,964,1839
"35342","NANDI","TINDERET","33",820,870,1690
"35343","NANDI","TINDERET","34",741,714,1455
"35344","NANDI","TINDERET","30-34",4045,4239,8284
"35345","NANDI","TINDERET","35",831,795,1626
"35346","NANDI","TINDERET","36",598,394,992
"35347","NANDI","TINDERET","37",600,448,1048
"35348","NANDI","TINDERET","38",425,294,719
"35349","NANDI","TINDERET","39",482,345,827
"35350","NANDI","TINDERET","35-39",2936,2276,5212
"35351","NANDI","TINDERET","40",500,427,927
"35352","NANDI","TINDERET","41",626,499,1125
"35353","NANDI","TINDERET","42",540,454,994
"35354","NANDI","TINDERET","43",481,468,949
"35355","NANDI","TINDERET","44",436,352,788
"35356","NANDI","TINDERET","40-44",2583,2200,4783
"35357","NANDI","TINDERET","45",607,531,1138
"35358","NANDI","TINDERET","46",455,368,823
"35359","NANDI","TINDERET","47",470,417,887
"35360","NANDI","TINDERET","48",273,246,519
"35361","NANDI","TINDERET","49",396,333,729
"35362","NANDI","TINDERET","45-49",2201,1895,4096
"35363","NANDI","TINDERET","50",355,312,667
"35364","NANDI","TINDERET","51",315,332,647
"35365","NANDI","TINDERET","52",259,239,498
"35366","NANDI","TINDERET","53",205,202,407
"35367","NANDI","TINDERET","54",235,213,448
"35368","NANDI","TINDERET","50-54",1369,1298,2667
"35369","NANDI","TINDERET","55",297,212,509
"35370","NANDI","TINDERET","56",213,184,397
"35371","NANDI","TINDERET","57",198,261,459
"35372","NANDI","TINDERET","58",251,371,622
"35373","NANDI","TINDERET","59",238,244,482
"35374","NANDI","TINDERET","55-59",1197,1272,2469
"35375","NANDI","TINDERET","60",246,262,508
"35376","NANDI","TINDERET","61",225,214,439
"35377","NANDI","TINDERET","62",183,161,344
"35378","NANDI","TINDERET","63",192,164,356
"35379","NANDI","TINDERET","64",130,125,255
"35380","NANDI","TINDERET","60-64",976,926,1902
"35381","NANDI","TINDERET","65",164,187,351
"35382","NANDI","TINDERET","66",111,103,214
"35383","NANDI","TINDERET","67",214,208,422
"35384","NANDI","TINDERET","68",84,78,162
"35385","NANDI","TINDERET","69",144,148,292
"35386","NANDI","TINDERET","65-69",717,724,1441
"35387","NANDI","TINDERET","70",169,150,319
"35388","NANDI","TINDERET","71",158,98,256
"35389","NANDI","TINDERET","72",96,75,171
"35390","NANDI","TINDERET","73",76,64,140
"35391","NANDI","TINDERET","74",70,74,144
"35392","NANDI","TINDERET","70-74",569,461,1030
"35393","NANDI","TINDERET","75",70,72,142
"35394","NANDI","TINDERET","76",56,58,114
"35395","NANDI","TINDERET","77",79,62,141
"35396","NANDI","TINDERET","78",35,40,75
"35397","NANDI","TINDERET","79",59,91,150
"35398","NANDI","TINDERET","75-79",299,323,622
"35399","NANDI","TINDERET","80",53,70,123
"35400","NANDI","TINDERET","81",26,26,52
"35401","NANDI","TINDERET","82",26,19,45
"35402","NANDI","TINDERET","83",29,32,61
"35403","NANDI","TINDERET","84",27,41,68
"35404","NANDI","TINDERET","80-84",161,188,349
"35405","NANDI","TINDERET","85",25,28,53
"35406","NANDI","TINDERET","86",26,22,48
"35407","NANDI","TINDERET","87",25,20,45
"35408","NANDI","TINDERET","88",15,8,23
"35409","NANDI","TINDERET","89",31,46,77
"35410","NANDI","TINDERET","85-89",122,124,246
"35411","NANDI","TINDERET","90",17,30,47
"35412","NANDI","TINDERET","91",10,14,24
"35413","NANDI","TINDERET","92",8,9,17
"35414","NANDI","TINDERET","93",4,8,12
"35415","NANDI","TINDERET","94",10,12,22
"35416","NANDI","TINDERET","90-94",49,73,122
"35417","NANDI","TINDERET","95",13,16,29
"35418","NANDI","TINDERET","96",7,9,16
"35419","NANDI","TINDERET","97",11,4,15
"35420","NANDI","TINDERET","98",3,1,4
"35421","NANDI","TINDERET","99",9,10,19
"35422","NANDI","TINDERET","95-99",43,40,83
"35423","NANDI","TINDERET","100+",13,29,42
"35424","NANDI","TINDERET","Not Stated",NA,NA,NA
"35425","NAROK","ALL","Total",579042,578805,1157847
"35426","NAROK","ALL","0",16272,16257,32529
"35427","NAROK","ALL","1",17399,17038,34437
"35428","NAROK","ALL","2",18876,18696,37572
"35429","NAROK","ALL","3",20419,20420,40839
"35430","NAROK","ALL","4",21445,21074,42519
"35431","NAROK","ALL","0 - 4",94411,93485,187896
"35432","NAROK","ALL","5",21324,20563,41887
"35433","NAROK","ALL","6",21289,20931,42220
"35434","NAROK","ALL","7",19564,19491,39055
"35435","NAROK","ALL","8",19753,19293,39046
"35436","NAROK","ALL","9",18591,18238,36829
"35437","NAROK","ALL","5-9",100521,98516,199037
"35438","NAROK","ALL","10",22039,21166,43205
"35439","NAROK","ALL","11",15701,15991,31692
"35440","NAROK","ALL","12",20230,18589,38819
"35441","NAROK","ALL","13",17151,16901,34052
"35442","NAROK","ALL","14",15932,15717,31649
"35443","NAROK","ALL","10 -14",91053,88364,179417
"35444","NAROK","ALL","15",16300,15334,31634
"35445","NAROK","ALL","16",13253,12322,25575
"35446","NAROK","ALL","17",12879,11086,23965
"35447","NAROK","ALL","18",11034,9980,21014
"35448","NAROK","ALL","19",11317,11318,22635
"35449","NAROK","ALL","15-19",64783,60040,124823
"35450","NAROK","ALL","20",11643,13467,25110
"35451","NAROK","ALL","21",8724,10043,18767
"35452","NAROK","ALL","22",9454,10773,20227
"35453","NAROK","ALL","23",9059,10059,19118
"35454","NAROK","ALL","24",8408,8983,17391
"35455","NAROK","ALL","20-24",47288,53325,100613
"35456","NAROK","ALL","25",10358,11304,21662
"35457","NAROK","ALL","26",7627,8620,16247
"35458","NAROK","ALL","27",7937,8916,16853
"35459","NAROK","ALL","28",6693,7880,14573
"35460","NAROK","ALL","29",6353,7267,13620
"35461","NAROK","ALL","25-29",38968,43987,82955
"35462","NAROK","ALL","30",10428,11695,22123
"35463","NAROK","ALL","31",5708,6426,12134
"35464","NAROK","ALL","32",7786,8306,16092
"35465","NAROK","ALL","33",5875,6510,12385
"35466","NAROK","ALL","34",5420,5148,10568
"35467","NAROK","ALL","30-34",35217,38085,73302
"35468","NAROK","ALL","35",8926,8364,17290
"35469","NAROK","ALL","36",4434,3826,8260
"35470","NAROK","ALL","37",4934,4243,9177
"35471","NAROK","ALL","38",3604,3231,6835
"35472","NAROK","ALL","39",3815,3310,7125
"35473","NAROK","ALL","35-39",25713,22974,48687
"35474","NAROK","ALL","40",6221,5752,11973
"35475","NAROK","ALL","41",4945,4751,9696
"35476","NAROK","ALL","42",4514,4163,8677
"35477","NAROK","ALL","43",3416,3409,6825
"35478","NAROK","ALL","44",2553,2491,5044
"35479","NAROK","ALL","40-44",21649,20566,42215
"35480","NAROK","ALL","45",5905,5278,11183
"35481","NAROK","ALL","46",3430,3148,6578
"35482","NAROK","ALL","47",3683,3676,7359
"35483","NAROK","ALL","48",2308,1969,4277
"35484","NAROK","ALL","49",2635,2575,5210
"35485","NAROK","ALL","45-49",17961,16646,34607
"35486","NAROK","ALL","50",4240,4431,8671
"35487","NAROK","ALL","51",2260,2132,4392
"35488","NAROK","ALL","52",2123,1869,3992
"35489","NAROK","ALL","53",1519,1334,2853
"35490","NAROK","ALL","54",1910,1684,3594
"35491","NAROK","ALL","50-54",12052,11450,23502
"35492","NAROK","ALL","55",2058,1970,4028
"35493","NAROK","ALL","56",1892,1797,3689
"35494","NAROK","ALL","57",1560,1600,3160
"35495","NAROK","ALL","58",1769,2221,3990
"35496","NAROK","ALL","59",1610,1876,3486
"35497","NAROK","ALL","55-59",8889,9464,18353
"35498","NAROK","ALL","60",2613,2849,5462
"35499","NAROK","ALL","61",1232,1386,2618
"35500","NAROK","ALL","62",1148,1074,2222
"35501","NAROK","ALL","63",1104,1276,2380
"35502","NAROK","ALL","64",861,830,1691
"35503","NAROK","ALL","60-64",6958,7415,14373
"35504","NAROK","ALL","65",1640,1625,3265
"35505","NAROK","ALL","66",664,515,1179
"35506","NAROK","ALL","67",1228,1008,2236
"35507","NAROK","ALL","68",553,540,1093
"35508","NAROK","ALL","69",908,962,1870
"35509","NAROK","ALL","65-69",4993,4650,9643
"35510","NAROK","ALL","70",1426,1874,3300
"35511","NAROK","ALL","71",727,685,1412
"35512","NAROK","ALL","72",630,552,1182
"35513","NAROK","ALL","73",526,472,998
"35514","NAROK","ALL","74",549,612,1161
"35515","NAROK","ALL","70-74",3858,4195,8053
"35516","NAROK","ALL","75",624,684,1308
"35517","NAROK","ALL","76",361,338,699
"35518","NAROK","ALL","77",373,355,728
"35519","NAROK","ALL","78",284,248,532
"35520","NAROK","ALL","79",423,525,948
"35521","NAROK","ALL","75-79",2065,2150,4215
"35522","NAROK","ALL","80",578,849,1427
"35523","NAROK","ALL","81",218,219,437
"35524","NAROK","ALL","82",191,164,355
"35525","NAROK","ALL","83",163,163,326
"35526","NAROK","ALL","84",183,271,454
"35527","NAROK","ALL","80-84",1333,1666,2999
"35528","NAROK","ALL","85",198,228,426
"35529","NAROK","ALL","86",94,116,210
"35530","NAROK","ALL","87",131,157,288
"35531","NAROK","ALL","88",72,76,148
"35532","NAROK","ALL","89",185,287,472
"35533","NAROK","ALL","85-89",680,864,1544
"35534","NAROK","ALL","90",129,248,377
"35535","NAROK","ALL","91",48,56,104
"35536","NAROK","ALL","92",55,49,104
"35537","NAROK","ALL","93",39,43,82
"35538","NAROK","ALL","94",55,59,114
"35539","NAROK","ALL","90-94",326,455,781
"35540","NAROK","ALL","95",80,104,184
"35541","NAROK","ALL","96",20,34,54
"35542","NAROK","ALL","97",35,27,62
"35543","NAROK","ALL","98",21,30,51
"35544","NAROK","ALL","99",43,65,108
"35545","NAROK","ALL","95-99",199,260,459
"35546","NAROK","ALL","100+",118,244,362
"35547","NAROK","ALL","Not Stated",7,4,11
"35548","NAROK","NAROK EAST","Total",58699,56617,115316
"35549","NAROK","NAROK EAST","0",1592,1554,3146
"35550","NAROK","NAROK EAST","1",1706,1654,3360
"35551","NAROK","NAROK EAST","2",1903,1829,3732
"35552","NAROK","NAROK EAST","3",2082,2022,4104
"35553","NAROK","NAROK EAST","4",2085,2061,4146
"35554","NAROK","NAROK EAST","0 - 4",9368,9120,18488
"35555","NAROK","NAROK EAST","5",2220,2112,4332
"35556","NAROK","NAROK EAST","6",2209,2017,4226
"35557","NAROK","NAROK EAST","7",2020,1954,3974
"35558","NAROK","NAROK EAST","8",2052,1987,4039
"35559","NAROK","NAROK EAST","9",1826,1789,3615
"35560","NAROK","NAROK EAST","5-9",10327,9859,20186
"35561","NAROK","NAROK EAST","10",2413,2176,4589
"35562","NAROK","NAROK EAST","11",1411,1484,2895
"35563","NAROK","NAROK EAST","12",2133,1851,3984
"35564","NAROK","NAROK EAST","13",1686,1703,3389
"35565","NAROK","NAROK EAST","14",1624,1542,3166
"35566","NAROK","NAROK EAST","10 -14",9267,8756,18023
"35567","NAROK","NAROK EAST","15",1632,1530,3162
"35568","NAROK","NAROK EAST","16",1330,1249,2579
"35569","NAROK","NAROK EAST","17",1262,1102,2364
"35570","NAROK","NAROK EAST","18",1113,979,2092
"35571","NAROK","NAROK EAST","19",1028,985,2013
"35572","NAROK","NAROK EAST","15-19",6365,5845,12210
"35573","NAROK","NAROK EAST","20",1225,1380,2605
"35574","NAROK","NAROK EAST","21",867,870,1737
"35575","NAROK","NAROK EAST","22",931,1017,1948
"35576","NAROK","NAROK EAST","23",807,874,1681
"35577","NAROK","NAROK EAST","24",757,788,1545
"35578","NAROK","NAROK EAST","20-24",4587,4929,9516
"35579","NAROK","NAROK EAST","25",1084,1162,2246
"35580","NAROK","NAROK EAST","26",688,730,1418
"35581","NAROK","NAROK EAST","27",730,813,1543
"35582","NAROK","NAROK EAST","28",706,810,1516
"35583","NAROK","NAROK EAST","29",545,588,1133
"35584","NAROK","NAROK EAST","25-29",3753,4103,7856
"35585","NAROK","NAROK EAST","30",1113,1229,2342
"35586","NAROK","NAROK EAST","31",479,482,961
"35587","NAROK","NAROK EAST","32",785,746,1531
"35588","NAROK","NAROK EAST","33",566,589,1155
"35589","NAROK","NAROK EAST","34",556,497,1053
"35590","NAROK","NAROK EAST","30-34",3499,3543,7042
"35591","NAROK","NAROK EAST","35",1112,1061,2173
"35592","NAROK","NAROK EAST","36",417,367,784
"35593","NAROK","NAROK EAST","37",490,422,912
"35594","NAROK","NAROK EAST","38",436,344,780
"35595","NAROK","NAROK EAST","39",396,306,702
"35596","NAROK","NAROK EAST","35-39",2851,2500,5351
"35597","NAROK","NAROK EAST","40",852,692,1544
"35598","NAROK","NAROK EAST","41",488,439,927
"35599","NAROK","NAROK EAST","42",488,405,893
"35600","NAROK","NAROK EAST","43",350,293,643
"35601","NAROK","NAROK EAST","44",226,210,436
"35602","NAROK","NAROK EAST","40-44",2404,2039,4443
"35603","NAROK","NAROK EAST","45",621,561,1182
"35604","NAROK","NAROK EAST","46",350,301,651
"35605","NAROK","NAROK EAST","47",323,292,615
"35606","NAROK","NAROK EAST","48",247,183,430
"35607","NAROK","NAROK EAST","49",231,205,436
"35608","NAROK","NAROK EAST","45-49",1772,1542,3314
"35609","NAROK","NAROK EAST","50",494,487,981
"35610","NAROK","NAROK EAST","51",237,197,434
"35611","NAROK","NAROK EAST","52",268,230,498
"35612","NAROK","NAROK EAST","53",185,137,322
"35613","NAROK","NAROK EAST","54",228,204,432
"35614","NAROK","NAROK EAST","50-54",1412,1255,2667
"35615","NAROK","NAROK EAST","55",242,257,499
"35616","NAROK","NAROK EAST","56",249,210,459
"35617","NAROK","NAROK EAST","57",145,139,284
"35618","NAROK","NAROK EAST","58",132,107,239
"35619","NAROK","NAROK EAST","59",156,180,336
"35620","NAROK","NAROK EAST","55-59",924,893,1817
"35621","NAROK","NAROK EAST","60",336,300,636
"35622","NAROK","NAROK EAST","61",118,131,249
"35623","NAROK","NAROK EAST","62",104,95,199
"35624","NAROK","NAROK EAST","63",95,117,212
"35625","NAROK","NAROK EAST","64",80,79,159
"35626","NAROK","NAROK EAST","60-64",733,722,1455
"35627","NAROK","NAROK EAST","65",177,126,303
"35628","NAROK","NAROK EAST","66",46,50,96
"35629","NAROK","NAROK EAST","67",106,111,217
"35630","NAROK","NAROK EAST","68",64,69,133
"35631","NAROK","NAROK EAST","69",90,98,188
"35632","NAROK","NAROK EAST","65-69",483,454,937
"35633","NAROK","NAROK EAST","70",195,216,411
"35634","NAROK","NAROK EAST","71",80,58,138
"35635","NAROK","NAROK EAST","72",64,55,119
"35636","NAROK","NAROK EAST","73",44,56,100
"35637","NAROK","NAROK EAST","74",60,65,125
"35638","NAROK","NAROK EAST","70-74",443,450,893
"35639","NAROK","NAROK EAST","75",66,79,145
"35640","NAROK","NAROK EAST","76",40,45,85
"35641","NAROK","NAROK EAST","77",37,33,70
"35642","NAROK","NAROK EAST","78",25,27,52
"35643","NAROK","NAROK EAST","79",51,51,102
"35644","NAROK","NAROK EAST","75-79",219,235,454
"35645","NAROK","NAROK EAST","80",74,112,186
"35646","NAROK","NAROK EAST","81",27,20,47
"35647","NAROK","NAROK EAST","82",16,13,29
"35648","NAROK","NAROK EAST","83",17,15,32
"35649","NAROK","NAROK EAST","84",16,30,46
"35650","NAROK","NAROK EAST","80-84",150,190,340
"35651","NAROK","NAROK EAST","85",27,24,51
"35652","NAROK","NAROK EAST","86",9,6,15
"35653","NAROK","NAROK EAST","87",5,18,23
"35654","NAROK","NAROK EAST","88",6,4,10
"35655","NAROK","NAROK EAST","89",19,24,43
"35656","NAROK","NAROK EAST","85-89",66,76,142
"35657","NAROK","NAROK EAST","90",19,25,44
"35658","NAROK","NAROK EAST","91",3,7,10
"35659","NAROK","NAROK EAST","92",5,8,13
"35660","NAROK","NAROK EAST","93",6,6,12
"35661","NAROK","NAROK EAST","94",1,4,5
"35662","NAROK","NAROK EAST","90-94",34,50,84
"35663","NAROK","NAROK EAST","95",10,6,16
"35664","NAROK","NAROK EAST","96",1,2,3
"35665","NAROK","NAROK EAST","97",3,2,5
"35666","NAROK","NAROK EAST","98",NA,3,3
"35667","NAROK","NAROK EAST","99",7,8,15
"35668","NAROK","NAROK EAST","95-99",21,21,42
"35669","NAROK","NAROK EAST","100+",21,35,56
"35670","NAROK","NAROK EAST","Not Stated",NA,NA,NA
"35671","NAROK","NAROK NORTH","Total",128024,123829,251853
"35672","NAROK","NAROK NORTH","0",3496,3437,6933
"35673","NAROK","NAROK NORTH","1",3825,3860,7685
"35674","NAROK","NAROK NORTH","2",4001,3899,7900
"35675","NAROK","NAROK NORTH","3",4213,4098,8311
"35676","NAROK","NAROK NORTH","4",4346,4216,8562
"35677","NAROK","NAROK NORTH","0 - 4",19881,19510,39391
"35678","NAROK","NAROK NORTH","5",4126,3966,8092
"35679","NAROK","NAROK NORTH","6",4160,4061,8221
"35680","NAROK","NAROK NORTH","7",3939,3756,7695
"35681","NAROK","NAROK NORTH","8",3754,3763,7517
"35682","NAROK","NAROK NORTH","9",3698,3626,7324
"35683","NAROK","NAROK NORTH","5-9",19677,19172,38849
"35684","NAROK","NAROK NORTH","10",4270,4141,8411
"35685","NAROK","NAROK NORTH","11",3173,3229,6402
"35686","NAROK","NAROK NORTH","12",4001,3590,7591
"35687","NAROK","NAROK NORTH","13",3390,3443,6833
"35688","NAROK","NAROK NORTH","14",3145,3174,6319
"35689","NAROK","NAROK NORTH","10 -14",17979,17577,35556
"35690","NAROK","NAROK NORTH","15",3129,3039,6168
"35691","NAROK","NAROK NORTH","16",2534,2657,5191
"35692","NAROK","NAROK NORTH","17",2789,2454,5243
"35693","NAROK","NAROK NORTH","18",2288,2086,4374
"35694","NAROK","NAROK NORTH","19",2350,2483,4833
"35695","NAROK","NAROK NORTH","15-19",13090,12719,25809
"35696","NAROK","NAROK NORTH","20",2617,2954,5571
"35697","NAROK","NAROK NORTH","21",2115,2376,4491
"35698","NAROK","NAROK NORTH","22",2352,2739,5091
"35699","NAROK","NAROK NORTH","23",2300,2468,4768
"35700","NAROK","NAROK NORTH","24",2167,2356,4523
"35701","NAROK","NAROK NORTH","20-24",11551,12893,24444
"35702","NAROK","NAROK NORTH","25",2639,2645,5284
"35703","NAROK","NAROK NORTH","26",2084,2096,4180
"35704","NAROK","NAROK NORTH","27",2129,2187,4316
"35705","NAROK","NAROK NORTH","28",1766,1855,3621
"35706","NAROK","NAROK NORTH","29",1692,1709,3401
"35707","NAROK","NAROK NORTH","25-29",10310,10492,20802
"35708","NAROK","NAROK NORTH","30",2587,2611,5198
"35709","NAROK","NAROK NORTH","31",1537,1378,2915
"35710","NAROK","NAROK NORTH","32",2066,2035,4101
"35711","NAROK","NAROK NORTH","33",1663,1608,3271
"35712","NAROK","NAROK NORTH","34",1586,1275,2861
"35713","NAROK","NAROK NORTH","30-34",9439,8907,18346
"35714","NAROK","NAROK NORTH","35",2212,1889,4101
"35715","NAROK","NAROK NORTH","36",1275,1046,2321
"35716","NAROK","NAROK NORTH","37",1286,1121,2407
"35717","NAROK","NAROK NORTH","38",1068,914,1982
"35718","NAROK","NAROK NORTH","39",1082,919,2001
"35719","NAROK","NAROK NORTH","35-39",6923,5889,12812
"35720","NAROK","NAROK NORTH","40",1579,1390,2969
"35721","NAROK","NAROK NORTH","41",1377,1276,2653
"35722","NAROK","NAROK NORTH","42",1154,892,2046
"35723","NAROK","NAROK NORTH","43",839,727,1566
"35724","NAROK","NAROK NORTH","44",611,512,1123
"35725","NAROK","NAROK NORTH","40-44",5560,4797,10357
"35726","NAROK","NAROK NORTH","45",1448,1033,2481
"35727","NAROK","NAROK NORTH","46",841,690,1531
"35728","NAROK","NAROK NORTH","47",878,710,1588
"35729","NAROK","NAROK NORTH","48",572,450,1022
"35730","NAROK","NAROK NORTH","49",669,520,1189
"35731","NAROK","NAROK NORTH","45-49",4408,3403,7811
"35732","NAROK","NAROK NORTH","50",999,983,1982
"35733","NAROK","NAROK NORTH","51",600,448,1048
"35734","NAROK","NAROK NORTH","52",549,424,973
"35735","NAROK","NAROK NORTH","53",376,289,665
"35736","NAROK","NAROK NORTH","54",507,446,953
"35737","NAROK","NAROK NORTH","50-54",3031,2590,5621
"35738","NAROK","NAROK NORTH","55",506,460,966
"35739","NAROK","NAROK NORTH","56",489,430,919
"35740","NAROK","NAROK NORTH","57",401,330,731
"35741","NAROK","NAROK NORTH","58",331,294,625
"35742","NAROK","NAROK NORTH","59",352,362,714
"35743","NAROK","NAROK NORTH","55-59",2079,1876,3955
"35744","NAROK","NAROK NORTH","60",515,545,1060
"35745","NAROK","NAROK NORTH","61",246,247,493
"35746","NAROK","NAROK NORTH","62",218,190,408
"35747","NAROK","NAROK NORTH","63",232,236,468
"35748","NAROK","NAROK NORTH","64",188,151,339
"35749","NAROK","NAROK NORTH","60-64",1399,1369,2768
"35750","NAROK","NAROK NORTH","65",313,282,595
"35751","NAROK","NAROK NORTH","66",157,105,262
"35752","NAROK","NAROK NORTH","67",272,184,456
"35753","NAROK","NAROK NORTH","68",103,93,196
"35754","NAROK","NAROK NORTH","69",200,181,381
"35755","NAROK","NAROK NORTH","65-69",1045,845,1890
"35756","NAROK","NAROK NORTH","70",262,372,634
"35757","NAROK","NAROK NORTH","71",129,118,247
"35758","NAROK","NAROK NORTH","72",128,102,230
"35759","NAROK","NAROK NORTH","73",114,93,207
"35760","NAROK","NAROK NORTH","74",105,138,243
"35761","NAROK","NAROK NORTH","70-74",738,823,1561
"35762","NAROK","NAROK NORTH","75",125,121,246
"35763","NAROK","NAROK NORTH","76",72,80,152
"35764","NAROK","NAROK NORTH","77",85,55,140
"35765","NAROK","NAROK NORTH","78",60,41,101
"35766","NAROK","NAROK NORTH","79",89,70,159
"35767","NAROK","NAROK NORTH","75-79",431,367,798
"35768","NAROK","NAROK NORTH","80",104,167,271
"35769","NAROK","NAROK NORTH","81",42,28,70
"35770","NAROK","NAROK NORTH","82",41,29,70
"35771","NAROK","NAROK NORTH","83",20,23,43
"35772","NAROK","NAROK NORTH","84",37,39,76
"35773","NAROK","NAROK NORTH","80-84",244,286,530
"35774","NAROK","NAROK NORTH","85",38,47,85
"35775","NAROK","NAROK NORTH","86",13,27,40
"35776","NAROK","NAROK NORTH","87",18,21,39
"35777","NAROK","NAROK NORTH","88",13,8,21
"35778","NAROK","NAROK NORTH","89",26,38,64
"35779","NAROK","NAROK NORTH","85-89",108,141,249
"35780","NAROK","NAROK NORTH","90",28,50,78
"35781","NAROK","NAROK NORTH","91",8,7,15
"35782","NAROK","NAROK NORTH","92",20,10,30
"35783","NAROK","NAROK NORTH","93",6,11,17
"35784","NAROK","NAROK NORTH","94",10,8,18
"35785","NAROK","NAROK NORTH","90-94",72,86,158
"35786","NAROK","NAROK NORTH","95",13,15,28
"35787","NAROK","NAROK NORTH","96",1,7,8
"35788","NAROK","NAROK NORTH","97",7,7,14
"35789","NAROK","NAROK NORTH","98",5,6,11
"35790","NAROK","NAROK NORTH","99",7,12,19
"35791","NAROK","NAROK NORTH","95-99",33,47,80
"35792","NAROK","NAROK NORTH","100+",25,39,64
"35793","NAROK","NAROK NORTH","Not Stated",1,1,2
"35794","NAROK","NAROK SOUTH","Total",118441,120029,238470
"35795","NAROK","NAROK SOUTH","0",3431,3455,6886
"35796","NAROK","NAROK SOUTH","1",3780,3772,7552
"35797","NAROK","NAROK SOUTH","2",4215,4159,8374
"35798","NAROK","NAROK SOUTH","3",4529,4686,9215
"35799","NAROK","NAROK SOUTH","4",4632,4648,9280
"35800","NAROK","NAROK SOUTH","0 - 4",20587,20720,41307
"35801","NAROK","NAROK SOUTH","5",4699,4603,9302
"35802","NAROK","NAROK SOUTH","6",4661,4625,9286
"35803","NAROK","NAROK SOUTH","7",4183,4253,8436
"35804","NAROK","NAROK SOUTH","8",4301,4182,8483
"35805","NAROK","NAROK SOUTH","9",3957,3866,7823
"35806","NAROK","NAROK SOUTH","5-9",21801,21529,43330
"35807","NAROK","NAROK SOUTH","10",4833,4561,9394
"35808","NAROK","NAROK SOUTH","11",3222,3321,6543
"35809","NAROK","NAROK SOUTH","12",4333,3977,8310
"35810","NAROK","NAROK SOUTH","13",3538,3355,6893
"35811","NAROK","NAROK SOUTH","14",3300,3198,6498
"35812","NAROK","NAROK SOUTH","10 -14",19226,18412,37638
"35813","NAROK","NAROK SOUTH","15",3486,3108,6594
"35814","NAROK","NAROK SOUTH","16",2811,2375,5186
"35815","NAROK","NAROK SOUTH","17",2534,2225,4759
"35816","NAROK","NAROK SOUTH","18",2211,2044,4255
"35817","NAROK","NAROK SOUTH","19",2296,2235,4531
"35818","NAROK","NAROK SOUTH","15-19",13338,11987,25325
"35819","NAROK","NAROK SOUTH","20",2381,2756,5137
"35820","NAROK","NAROK SOUTH","21",1627,1912,3539
"35821","NAROK","NAROK SOUTH","22",1806,2037,3843
"35822","NAROK","NAROK SOUTH","23",1634,1907,3541
"35823","NAROK","NAROK SOUTH","24",1630,1708,3338
"35824","NAROK","NAROK SOUTH","20-24",9078,10320,19398
"35825","NAROK","NAROK SOUTH","25",1873,2190,4063
"35826","NAROK","NAROK SOUTH","26",1416,1731,3147
"35827","NAROK","NAROK SOUTH","27",1438,1640,3078
"35828","NAROK","NAROK SOUTH","28",1185,1442,2627
"35829","NAROK","NAROK SOUTH","29",1132,1264,2396
"35830","NAROK","NAROK SOUTH","25-29",7044,8267,15311
"35831","NAROK","NAROK SOUTH","30",1964,2239,4203
"35832","NAROK","NAROK SOUTH","31",985,1215,2200
"35833","NAROK","NAROK SOUTH","32",1411,1651,3062
"35834","NAROK","NAROK SOUTH","33",1086,1316,2402
"35835","NAROK","NAROK SOUTH","34",1096,1050,2146
"35836","NAROK","NAROK SOUTH","30-34",6542,7471,14013
"35837","NAROK","NAROK SOUTH","35",1774,1748,3522
"35838","NAROK","NAROK SOUTH","36",793,684,1477
"35839","NAROK","NAROK SOUTH","37",841,781,1622
"35840","NAROK","NAROK SOUTH","38",595,617,1212
"35841","NAROK","NAROK SOUTH","39",679,675,1354
"35842","NAROK","NAROK SOUTH","35-39",4682,4505,9187
"35843","NAROK","NAROK SOUTH","40",1137,1192,2329
"35844","NAROK","NAROK SOUTH","41",882,964,1846
"35845","NAROK","NAROK SOUTH","42",807,828,1635
"35846","NAROK","NAROK SOUTH","43",652,664,1316
"35847","NAROK","NAROK SOUTH","44",493,510,1003
"35848","NAROK","NAROK SOUTH","40-44",3971,4158,8129
"35849","NAROK","NAROK SOUTH","45",1063,1126,2189
"35850","NAROK","NAROK SOUTH","46",585,602,1187
"35851","NAROK","NAROK SOUTH","47",644,736,1380
"35852","NAROK","NAROK SOUTH","48",430,427,857
"35853","NAROK","NAROK SOUTH","49",504,583,1087
"35854","NAROK","NAROK SOUTH","45-49",3226,3474,6700
"35855","NAROK","NAROK SOUTH","50",876,1006,1882
"35856","NAROK","NAROK SOUTH","51",420,495,915
"35857","NAROK","NAROK SOUTH","52",413,406,819
"35858","NAROK","NAROK SOUTH","53",287,319,606
"35859","NAROK","NAROK SOUTH","54",402,356,758
"35860","NAROK","NAROK SOUTH","50-54",2398,2582,4980
"35861","NAROK","NAROK SOUTH","55",425,394,819
"35862","NAROK","NAROK SOUTH","56",382,383,765
"35863","NAROK","NAROK SOUTH","57",297,327,624
"35864","NAROK","NAROK SOUTH","58",431,527,958
"35865","NAROK","NAROK SOUTH","59",356,334,690
"35866","NAROK","NAROK SOUTH","55-59",1891,1965,3856
"35867","NAROK","NAROK SOUTH","60",585,625,1210
"35868","NAROK","NAROK SOUTH","61",307,298,605
"35869","NAROK","NAROK SOUTH","62",239,233,472
"35870","NAROK","NAROK SOUTH","63",255,237,492
"35871","NAROK","NAROK SOUTH","64",177,184,361
"35872","NAROK","NAROK SOUTH","60-64",1563,1577,3140
"35873","NAROK","NAROK SOUTH","65",401,413,814
"35874","NAROK","NAROK SOUTH","66",163,111,274
"35875","NAROK","NAROK SOUTH","67",297,227,524
"35876","NAROK","NAROK SOUTH","68",136,110,246
"35877","NAROK","NAROK SOUTH","69",198,197,395
"35878","NAROK","NAROK SOUTH","65-69",1195,1058,2253
"35879","NAROK","NAROK SOUTH","70",343,448,791
"35880","NAROK","NAROK SOUTH","71",166,141,307
"35881","NAROK","NAROK SOUTH","72",146,94,240
"35882","NAROK","NAROK SOUTH","73",113,101,214
"35883","NAROK","NAROK SOUTH","74",118,105,223
"35884","NAROK","NAROK SOUTH","70-74",886,889,1775
"35885","NAROK","NAROK SOUTH","75",158,153,311
"35886","NAROK","NAROK SOUTH","76",74,72,146
"35887","NAROK","NAROK SOUTH","77",69,92,161
"35888","NAROK","NAROK SOUTH","78",60,54,114
"35889","NAROK","NAROK SOUTH","79",88,100,188
"35890","NAROK","NAROK SOUTH","75-79",449,471,920
"35891","NAROK","NAROK SOUTH","80",148,191,339
"35892","NAROK","NAROK SOUTH","81",42,41,83
"35893","NAROK","NAROK SOUTH","82",46,24,70
"35894","NAROK","NAROK SOUTH","83",41,27,68
"35895","NAROK","NAROK SOUTH","84",30,36,66
"35896","NAROK","NAROK SOUTH","80-84",307,319,626
"35897","NAROK","NAROK SOUTH","85",46,56,102
"35898","NAROK","NAROK SOUTH","86",21,25,46
"35899","NAROK","NAROK SOUTH","87",30,30,60
"35900","NAROK","NAROK SOUTH","88",13,10,23
"35901","NAROK","NAROK SOUTH","89",39,46,85
"35902","NAROK","NAROK SOUTH","85-89",149,167,316
"35903","NAROK","NAROK SOUTH","90",25,43,68
"35904","NAROK","NAROK SOUTH","91",13,4,17
"35905","NAROK","NAROK SOUTH","92",6,6,12
"35906","NAROK","NAROK SOUTH","93",6,4,10
"35907","NAROK","NAROK SOUTH","94",8,11,19
"35908","NAROK","NAROK SOUTH","90-94",58,68,126
"35909","NAROK","NAROK SOUTH","95",16,21,37
"35910","NAROK","NAROK SOUTH","96",1,3,4
"35911","NAROK","NAROK SOUTH","97",4,4,8
"35912","NAROK","NAROK SOUTH","98",3,9,12
"35913","NAROK","NAROK SOUTH","99",5,11,16
"35914","NAROK","NAROK SOUTH","95-99",29,48,77
"35915","NAROK","NAROK SOUTH","100+",19,40,59
"35916","NAROK","NAROK SOUTH","Not Stated",2,2,4
"35917","NAROK","NAROK WEST","Total",97085,98198,195283
"35918","NAROK","NAROK WEST","0",2779,2803,5582
"35919","NAROK","NAROK WEST","1",3060,2916,5976
"35920","NAROK","NAROK WEST","2",3308,3413,6721
"35921","NAROK","NAROK WEST","3",3754,3645,7399
"35922","NAROK","NAROK WEST","4",4022,3840,7862
"35923","NAROK","NAROK WEST","0 - 4",16923,16617,33540
"35924","NAROK","NAROK WEST","5",3993,3828,7821
"35925","NAROK","NAROK WEST","6",3936,3952,7888
"35926","NAROK","NAROK WEST","7",3520,3429,6949
"35927","NAROK","NAROK WEST","8",3728,3534,7262
"35928","NAROK","NAROK WEST","9",3019,2983,6002
"35929","NAROK","NAROK WEST","5-9",18196,17726,35922
"35930","NAROK","NAROK WEST","10",4099,3931,8030
"35931","NAROK","NAROK WEST","11",2400,2533,4933
"35932","NAROK","NAROK WEST","12",3439,3191,6630
"35933","NAROK","NAROK WEST","13",2826,2561,5387
"35934","NAROK","NAROK WEST","14",2561,2355,4916
"35935","NAROK","NAROK WEST","10 -14",15325,14571,29896
"35936","NAROK","NAROK WEST","15",2790,2532,5322
"35937","NAROK","NAROK WEST","16",2059,1892,3951
"35938","NAROK","NAROK WEST","17",1890,1532,3422
"35939","NAROK","NAROK WEST","18",1846,1644,3490
"35940","NAROK","NAROK WEST","19",1723,1710,3433
"35941","NAROK","NAROK WEST","15-19",10308,9310,19618
"35942","NAROK","NAROK WEST","20",2110,2502,4612
"35943","NAROK","NAROK WEST","21",1361,1662,3023
"35944","NAROK","NAROK WEST","22",1526,1713,3239
"35945","NAROK","NAROK WEST","23",1482,1632,3114
"35946","NAROK","NAROK WEST","24",1381,1519,2900
"35947","NAROK","NAROK WEST","20-24",7860,9028,16888
"35948","NAROK","NAROK WEST","25",1764,2151,3915
"35949","NAROK","NAROK WEST","26",1238,1459,2697
"35950","NAROK","NAROK WEST","27",1221,1423,2644
"35951","NAROK","NAROK WEST","28",1154,1429,2583
"35952","NAROK","NAROK WEST","29",1059,1242,2301
"35953","NAROK","NAROK WEST","25-29",6436,7704,14140
"35954","NAROK","NAROK WEST","30",1994,2246,4240
"35955","NAROK","NAROK WEST","31",792,936,1728
"35956","NAROK","NAROK WEST","32",1151,1265,2416
"35957","NAROK","NAROK WEST","33",896,1032,1928
"35958","NAROK","NAROK WEST","34",848,811,1659
"35959","NAROK","NAROK WEST","30-34",5681,6290,11971
"35960","NAROK","NAROK WEST","35",1543,1606,3149
"35961","NAROK","NAROK WEST","36",648,639,1287
"35962","NAROK","NAROK WEST","37",637,572,1209
"35963","NAROK","NAROK WEST","38",560,545,1105
"35964","NAROK","NAROK WEST","39",472,406,878
"35965","NAROK","NAROK WEST","35-39",3860,3768,7628
"35966","NAROK","NAROK WEST","40",1033,1151,2184
"35967","NAROK","NAROK WEST","41",759,759,1518
"35968","NAROK","NAROK WEST","42",634,569,1203
"35969","NAROK","NAROK WEST","43",518,594,1112
"35970","NAROK","NAROK WEST","44",370,393,763
"35971","NAROK","NAROK WEST","40-44",3314,3466,6780
"35972","NAROK","NAROK WEST","45",956,894,1850
"35973","NAROK","NAROK WEST","46",499,464,963
"35974","NAROK","NAROK WEST","47",533,513,1046
"35975","NAROK","NAROK WEST","48",389,310,699
"35976","NAROK","NAROK WEST","49",416,373,789
"35977","NAROK","NAROK WEST","45-49",2793,2554,5347
"35978","NAROK","NAROK WEST","50",767,845,1612
"35979","NAROK","NAROK WEST","51",277,281,558
"35980","NAROK","NAROK WEST","52",321,260,581
"35981","NAROK","NAROK WEST","53",232,222,454
"35982","NAROK","NAROK WEST","54",274,228,502
"35983","NAROK","NAROK WEST","50-54",1871,1836,3707
"35984","NAROK","NAROK WEST","55",301,358,659
"35985","NAROK","NAROK WEST","56",265,279,544
"35986","NAROK","NAROK WEST","57",182,215,397
"35987","NAROK","NAROK WEST","58",259,354,613
"35988","NAROK","NAROK WEST","59",188,282,470
"35989","NAROK","NAROK WEST","55-59",1195,1488,2683
"35990","NAROK","NAROK WEST","60",513,552,1065
"35991","NAROK","NAROK WEST","61",158,188,346
"35992","NAROK","NAROK WEST","62",176,176,352
"35993","NAROK","NAROK WEST","63",159,222,381
"35994","NAROK","NAROK WEST","64",143,140,283
"35995","NAROK","NAROK WEST","60-64",1149,1278,2427
"35996","NAROK","NAROK WEST","65",258,297,555
"35997","NAROK","NAROK WEST","66",89,73,162
"35998","NAROK","NAROK WEST","67",185,143,328
"35999","NAROK","NAROK WEST","68",98,85,183
"36000","NAROK","NAROK WEST","69",138,148,286
"36001","NAROK","NAROK WEST","65-69",768,746,1514
"36002","NAROK","NAROK WEST","70",286,383,669
"36003","NAROK","NAROK WEST","71",89,104,193
"36004","NAROK","NAROK WEST","72",95,99,194
"36005","NAROK","NAROK WEST","73",82,87,169
"36006","NAROK","NAROK WEST","74",81,94,175
"36007","NAROK","NAROK WEST","70-74",633,767,1400
"36008","NAROK","NAROK WEST","75",99,140,239
"36009","NAROK","NAROK WEST","76",63,65,128
"36010","NAROK","NAROK WEST","77",60,58,118
"36011","NAROK","NAROK WEST","78",45,48,93
"36012","NAROK","NAROK WEST","79",67,97,164
"36013","NAROK","NAROK WEST","75-79",334,408,742
"36014","NAROK","NAROK WEST","80",114,170,284
"36015","NAROK","NAROK WEST","81",30,28,58
"36016","NAROK","NAROK WEST","82",24,31,55
"36017","NAROK","NAROK WEST","83",25,29,54
"36018","NAROK","NAROK WEST","84",24,47,71
"36019","NAROK","NAROK WEST","80-84",217,305,522
"36020","NAROK","NAROK WEST","85",28,28,56
"36021","NAROK","NAROK WEST","86",20,22,42
"36022","NAROK","NAROK WEST","87",18,25,43
"36023","NAROK","NAROK WEST","88",17,22,39
"36024","NAROK","NAROK WEST","89",28,46,74
"36025","NAROK","NAROK WEST","85-89",111,143,254
"36026","NAROK","NAROK WEST","90",22,50,72
"36027","NAROK","NAROK WEST","91",5,8,13
"36028","NAROK","NAROK WEST","92",6,11,17
"36029","NAROK","NAROK WEST","93",7,7,14
"36030","NAROK","NAROK WEST","94",8,12,20
"36031","NAROK","NAROK WEST","90-94",48,88,136
"36032","NAROK","NAROK WEST","95",10,20,30
"36033","NAROK","NAROK WEST","96",5,3,8
"36034","NAROK","NAROK WEST","97",7,6,13
"36035","NAROK","NAROK WEST","98",6,6,12
"36036","NAROK","NAROK WEST","99",7,7,14
"36037","NAROK","NAROK WEST","95-99",35,42,77
"36038","NAROK","NAROK WEST","100+",26,62,88
"36039","NAROK","NAROK WEST","Not Stated",2,1,3
"36040","NAROK","TRANS MARA EAST","Total",54545,56637,111182
"36041","NAROK","TRANS MARA EAST","0",1399,1361,2760
"36042","NAROK","TRANS MARA EAST","1",1385,1361,2746
"36043","NAROK","TRANS MARA EAST","2",1591,1565,3156
"36044","NAROK","TRANS MARA EAST","3",1729,1768,3497
"36045","NAROK","TRANS MARA EAST","4",2032,1919,3951
"36046","NAROK","TRANS MARA EAST","0 - 4",8136,7974,16110
"36047","NAROK","TRANS MARA EAST","5",2005,1903,3908
"36048","NAROK","TRANS MARA EAST","6",2033,1919,3952
"36049","NAROK","TRANS MARA EAST","7",1934,1899,3833
"36050","NAROK","TRANS MARA EAST","8",1941,1870,3811
"36051","NAROK","TRANS MARA EAST","9",2155,2007,4162
"36052","NAROK","TRANS MARA EAST","5-9",10068,9598,19666
"36053","NAROK","TRANS MARA EAST","10",1987,2073,4060
"36054","NAROK","TRANS MARA EAST","11",1942,1894,3836
"36055","NAROK","TRANS MARA EAST","12",2074,1957,4031
"36056","NAROK","TRANS MARA EAST","13",1926,1930,3856
"36057","NAROK","TRANS MARA EAST","14",1784,1820,3604
"36058","NAROK","TRANS MARA EAST","10 -14",9713,9674,19387
"36059","NAROK","TRANS MARA EAST","15",1801,1695,3496
"36060","NAROK","TRANS MARA EAST","16",1528,1409,2937
"36061","NAROK","TRANS MARA EAST","17",1437,1232,2669
"36062","NAROK","TRANS MARA EAST","18",1072,1030,2102
"36063","NAROK","TRANS MARA EAST","19",1302,1252,2554
"36064","NAROK","TRANS MARA EAST","15-19",7140,6618,13758
"36065","NAROK","TRANS MARA EAST","20",883,1038,1921
"36066","NAROK","TRANS MARA EAST","21",786,964,1750
"36067","NAROK","TRANS MARA EAST","22",786,915,1701
"36068","NAROK","TRANS MARA EAST","23",804,961,1765
"36069","NAROK","TRANS MARA EAST","24",714,727,1441
"36070","NAROK","TRANS MARA EAST","20-24",3973,4605,8578
"36071","NAROK","TRANS MARA EAST","25",757,868,1625
"36072","NAROK","TRANS MARA EAST","26",597,805,1402
"36073","NAROK","TRANS MARA EAST","27",630,895,1525
"36074","NAROK","TRANS MARA EAST","28",486,675,1161
"36075","NAROK","TRANS MARA EAST","29",579,825,1404
"36076","NAROK","TRANS MARA EAST","25-29",3049,4068,7117
"36077","NAROK","TRANS MARA EAST","30",773,1082,1855
"36078","NAROK","TRANS MARA EAST","31",604,811,1415
"36079","NAROK","TRANS MARA EAST","32",657,819,1476
"36080","NAROK","TRANS MARA EAST","33",557,613,1170
"36081","NAROK","TRANS MARA EAST","34",374,464,838
"36082","NAROK","TRANS MARA EAST","30-34",2965,3789,6754
"36083","NAROK","TRANS MARA EAST","35",618,547,1165
"36084","NAROK","TRANS MARA EAST","36",349,284,633
"36085","NAROK","TRANS MARA EAST","37",524,408,932
"36086","NAROK","TRANS MARA EAST","38",220,217,437
"36087","NAROK","TRANS MARA EAST","39",376,311,687
"36088","NAROK","TRANS MARA EAST","35-39",2087,1767,3854
"36089","NAROK","TRANS MARA EAST","40",385,354,739
"36090","NAROK","TRANS MARA EAST","41",431,423,854
"36091","NAROK","TRANS MARA EAST","42",341,384,725
"36092","NAROK","TRANS MARA EAST","43",297,339,636
"36093","NAROK","TRANS MARA EAST","44",311,336,647
"36094","NAROK","TRANS MARA EAST","40-44",1765,1836,3601
"36095","NAROK","TRANS MARA EAST","45",523,513,1036
"36096","NAROK","TRANS MARA EAST","46",333,331,664
"36097","NAROK","TRANS MARA EAST","47",392,429,821
"36098","NAROK","TRANS MARA EAST","48",186,184,370
"36099","NAROK","TRANS MARA EAST","49",258,360,618
"36100","NAROK","TRANS MARA EAST","45-49",1692,1817,3509
"36101","NAROK","TRANS MARA EAST","50",305,344,649
"36102","NAROK","TRANS MARA EAST","51",224,224,448
"36103","NAROK","TRANS MARA EAST","52",163,155,318
"36104","NAROK","TRANS MARA EAST","53",122,133,255
"36105","NAROK","TRANS MARA EAST","54",121,131,252
"36106","NAROK","TRANS MARA EAST","50-54",935,987,1922
"36107","NAROK","TRANS MARA EAST","55",123,144,267
"36108","NAROK","TRANS MARA EAST","56",103,140,243
"36109","NAROK","TRANS MARA EAST","57",139,198,337
"36110","NAROK","TRANS MARA EAST","58",283,520,803
"36111","NAROK","TRANS MARA EAST","59",170,245,415
"36112","NAROK","TRANS MARA EAST","55-59",818,1247,2065
"36113","NAROK","TRANS MARA EAST","60",182,273,455
"36114","NAROK","TRANS MARA EAST","61",112,202,314
"36115","NAROK","TRANS MARA EAST","62",122,128,250
"36116","NAROK","TRANS MARA EAST","63",116,165,281
"36117","NAROK","TRANS MARA EAST","64",99,103,202
"36118","NAROK","TRANS MARA EAST","60-64",631,871,1502
"36119","NAROK","TRANS MARA EAST","65",164,201,365
"36120","NAROK","TRANS MARA EAST","66",78,70,148
"36121","NAROK","TRANS MARA EAST","67",137,135,272
"36122","NAROK","TRANS MARA EAST","68",54,73,127
"36123","NAROK","TRANS MARA EAST","69",119,127,246
"36124","NAROK","TRANS MARA EAST","65-69",552,606,1158
"36125","NAROK","TRANS MARA EAST","70",116,169,285
"36126","NAROK","TRANS MARA EAST","71",120,85,205
"36127","NAROK","TRANS MARA EAST","72",71,74,145
"36128","NAROK","TRANS MARA EAST","73",66,56,122
"36129","NAROK","TRANS MARA EAST","74",55,80,135
"36130","NAROK","TRANS MARA EAST","70-74",428,464,892
"36131","NAROK","TRANS MARA EAST","75",75,69,144
"36132","NAROK","TRANS MARA EAST","76",39,38,77
"36133","NAROK","TRANS MARA EAST","77",46,45,91
"36134","NAROK","TRANS MARA EAST","78",46,27,73
"36135","NAROK","TRANS MARA EAST","79",42,83,125
"36136","NAROK","TRANS MARA EAST","75-79",248,262,510
"36137","NAROK","TRANS MARA EAST","80",45,69,114
"36138","NAROK","TRANS MARA EAST","81",24,31,55
"36139","NAROK","TRANS MARA EAST","82",27,31,58
"36140","NAROK","TRANS MARA EAST","83",18,35,53
"36141","NAROK","TRANS MARA EAST","84",31,48,79
"36142","NAROK","TRANS MARA EAST","80-84",145,214,359
"36143","NAROK","TRANS MARA EAST","85",27,21,48
"36144","NAROK","TRANS MARA EAST","86",18,13,31
"36145","NAROK","TRANS MARA EAST","87",30,26,56
"36146","NAROK","TRANS MARA EAST","88",9,13,22
"36147","NAROK","TRANS MARA EAST","89",28,47,75
"36148","NAROK","TRANS MARA EAST","85-89",112,120,232
"36149","NAROK","TRANS MARA EAST","90",15,29,44
"36150","NAROK","TRANS MARA EAST","91",8,16,24
"36151","NAROK","TRANS MARA EAST","92",6,8,14
"36152","NAROK","TRANS MARA EAST","93",3,4,7
"36153","NAROK","TRANS MARA EAST","94",15,15,30
"36154","NAROK","TRANS MARA EAST","90-94",47,72,119
"36155","NAROK","TRANS MARA EAST","95",11,14,25
"36156","NAROK","TRANS MARA EAST","96",4,5,9
"36157","NAROK","TRANS MARA EAST","97",6,2,8
"36158","NAROK","TRANS MARA EAST","98",4,1,5
"36159","NAROK","TRANS MARA EAST","99",6,6,12
"36160","NAROK","TRANS MARA EAST","95-99",31,28,59
"36161","NAROK","TRANS MARA EAST","100+",9,20,29
"36162","NAROK","TRANS MARA EAST","Not Stated",1,NA,1
"36163","NAROK","TRANS MARA WEST","Total",122220,123491,245711
"36164","NAROK","TRANS MARA WEST","0",3575,3647,7222
"36165","NAROK","TRANS MARA WEST","1",3643,3475,7118
"36166","NAROK","TRANS MARA WEST","2",3858,3831,7689
"36167","NAROK","TRANS MARA WEST","3",4112,4201,8313
"36168","NAROK","TRANS MARA WEST","4",4328,4390,8718
"36169","NAROK","TRANS MARA WEST","0 - 4",19516,19544,39060
"36170","NAROK","TRANS MARA WEST","5",4281,4151,8432
"36171","NAROK","TRANS MARA WEST","6",4290,4357,8647
"36172","NAROK","TRANS MARA WEST","7",3968,4200,8168
"36173","NAROK","TRANS MARA WEST","8",3977,3957,7934
"36174","NAROK","TRANS MARA WEST","9",3936,3967,7903
"36175","NAROK","TRANS MARA WEST","5-9",20452,20632,41084
"36176","NAROK","TRANS MARA WEST","10",4437,4284,8721
"36177","NAROK","TRANS MARA WEST","11",3553,3530,7083
"36178","NAROK","TRANS MARA WEST","12",4250,4023,8273
"36179","NAROK","TRANS MARA WEST","13",3785,3909,7694
"36180","NAROK","TRANS MARA WEST","14",3518,3628,7146
"36181","NAROK","TRANS MARA WEST","10 -14",19543,19374,38917
"36182","NAROK","TRANS MARA WEST","15",3462,3430,6892
"36183","NAROK","TRANS MARA WEST","16",2991,2740,5731
"36184","NAROK","TRANS MARA WEST","17",2967,2541,5508
"36185","NAROK","TRANS MARA WEST","18",2504,2197,4701
"36186","NAROK","TRANS MARA WEST","19",2618,2653,5271
"36187","NAROK","TRANS MARA WEST","15-19",14542,13561,28103
"36188","NAROK","TRANS MARA WEST","20",2427,2837,5264
"36189","NAROK","TRANS MARA WEST","21",1968,2259,4227
"36190","NAROK","TRANS MARA WEST","22",2053,2352,4405
"36191","NAROK","TRANS MARA WEST","23",2032,2217,4249
"36192","NAROK","TRANS MARA WEST","24",1758,1883,3641
"36193","NAROK","TRANS MARA WEST","20-24",10238,11548,21786
"36194","NAROK","TRANS MARA WEST","25",2240,2288,4528
"36195","NAROK","TRANS MARA WEST","26",1604,1799,3403
"36196","NAROK","TRANS MARA WEST","27",1787,1958,3745
"36197","NAROK","TRANS MARA WEST","28",1393,1669,3062
"36198","NAROK","TRANS MARA WEST","29",1343,1639,2982
"36199","NAROK","TRANS MARA WEST","25-29",8367,9353,17720
"36200","NAROK","TRANS MARA WEST","30",1995,2286,4281
"36201","NAROK","TRANS MARA WEST","31",1310,1604,2914
"36202","NAROK","TRANS MARA WEST","32",1716,1790,3506
"36203","NAROK","TRANS MARA WEST","33",1107,1352,2459
"36204","NAROK","TRANS MARA WEST","34",960,1051,2011
"36205","NAROK","TRANS MARA WEST","30-34",7088,8083,15171
"36206","NAROK","TRANS MARA WEST","35",1667,1513,3180
"36207","NAROK","TRANS MARA WEST","36",950,806,1756
"36208","NAROK","TRANS MARA WEST","37",1154,939,2093
"36209","NAROK","TRANS MARA WEST","38",724,594,1318
"36210","NAROK","TRANS MARA WEST","39",809,693,1502
"36211","NAROK","TRANS MARA WEST","35-39",5304,4545,9849
"36212","NAROK","TRANS MARA WEST","40",1234,973,2207
"36213","NAROK","TRANS MARA WEST","41",1008,890,1898
"36214","NAROK","TRANS MARA WEST","42",1090,1085,2175
"36215","NAROK","TRANS MARA WEST","43",759,792,1551
"36216","NAROK","TRANS MARA WEST","44",542,530,1072
"36217","NAROK","TRANS MARA WEST","40-44",4633,4270,8903
"36218","NAROK","TRANS MARA WEST","45",1294,1151,2445
"36219","NAROK","TRANS MARA WEST","46",821,760,1581
"36220","NAROK","TRANS MARA WEST","47",912,996,1908
"36221","NAROK","TRANS MARA WEST","48",482,415,897
"36222","NAROK","TRANS MARA WEST","49",555,534,1089
"36223","NAROK","TRANS MARA WEST","45-49",4064,3856,7920
"36224","NAROK","TRANS MARA WEST","50",799,766,1565
"36225","NAROK","TRANS MARA WEST","51",502,487,989
"36226","NAROK","TRANS MARA WEST","52",409,394,803
"36227","NAROK","TRANS MARA WEST","53",316,234,550
"36228","NAROK","TRANS MARA WEST","54",378,319,697
"36229","NAROK","TRANS MARA WEST","50-54",2404,2200,4604
"36230","NAROK","TRANS MARA WEST","55",461,357,818
"36231","NAROK","TRANS MARA WEST","56",404,355,759
"36232","NAROK","TRANS MARA WEST","57",396,391,787
"36233","NAROK","TRANS MARA WEST","58",333,419,752
"36234","NAROK","TRANS MARA WEST","59",388,473,861
"36235","NAROK","TRANS MARA WEST","55-59",1982,1995,3977
"36236","NAROK","TRANS MARA WEST","60",482,554,1036
"36237","NAROK","TRANS MARA WEST","61",291,320,611
"36238","NAROK","TRANS MARA WEST","62",289,252,541
"36239","NAROK","TRANS MARA WEST","63",247,299,546
"36240","NAROK","TRANS MARA WEST","64",174,173,347
"36241","NAROK","TRANS MARA WEST","60-64",1483,1598,3081
"36242","NAROK","TRANS MARA WEST","65",327,306,633
"36243","NAROK","TRANS MARA WEST","66",131,106,237
"36244","NAROK","TRANS MARA WEST","67",231,208,439
"36245","NAROK","TRANS MARA WEST","68",98,110,208
"36246","NAROK","TRANS MARA WEST","69",163,211,374
"36247","NAROK","TRANS MARA WEST","65-69",950,941,1891
"36248","NAROK","TRANS MARA WEST","70",224,286,510
"36249","NAROK","TRANS MARA WEST","71",143,179,322
"36250","NAROK","TRANS MARA WEST","72",126,128,254
"36251","NAROK","TRANS MARA WEST","73",107,79,186
"36252","NAROK","TRANS MARA WEST","74",130,130,260
"36253","NAROK","TRANS MARA WEST","70-74",730,802,1532
"36254","NAROK","TRANS MARA WEST","75",101,122,223
"36255","NAROK","TRANS MARA WEST","76",73,38,111
"36256","NAROK","TRANS MARA WEST","77",76,72,148
"36257","NAROK","TRANS MARA WEST","78",48,51,99
"36258","NAROK","TRANS MARA WEST","79",86,124,210
"36259","NAROK","TRANS MARA WEST","75-79",384,407,791
"36260","NAROK","TRANS MARA WEST","80",93,140,233
"36261","NAROK","TRANS MARA WEST","81",53,71,124
"36262","NAROK","TRANS MARA WEST","82",37,36,73
"36263","NAROK","TRANS MARA WEST","83",42,34,76
"36264","NAROK","TRANS MARA WEST","84",45,71,116
"36265","NAROK","TRANS MARA WEST","80-84",270,352,622
"36266","NAROK","TRANS MARA WEST","85",32,52,84
"36267","NAROK","TRANS MARA WEST","86",13,23,36
"36268","NAROK","TRANS MARA WEST","87",30,37,67
"36269","NAROK","TRANS MARA WEST","88",14,19,33
"36270","NAROK","TRANS MARA WEST","89",45,86,131
"36271","NAROK","TRANS MARA WEST","85-89",134,217,351
"36272","NAROK","TRANS MARA WEST","90",20,51,71
"36273","NAROK","TRANS MARA WEST","91",11,14,25
"36274","NAROK","TRANS MARA WEST","92",12,6,18
"36275","NAROK","TRANS MARA WEST","93",11,11,22
"36276","NAROK","TRANS MARA WEST","94",13,9,22
"36277","NAROK","TRANS MARA WEST","90-94",67,91,158
"36278","NAROK","TRANS MARA WEST","95",20,28,48
"36279","NAROK","TRANS MARA WEST","96",8,14,22
"36280","NAROK","TRANS MARA WEST","97",8,6,14
"36281","NAROK","TRANS MARA WEST","98",3,5,8
"36282","NAROK","TRANS MARA WEST","99",11,21,32
"36283","NAROK","TRANS MARA WEST","95-99",50,74,124
"36284","NAROK","TRANS MARA WEST","100+",18,48,66
"36285","NAROK","TRANS MARA WEST","Not Stated",1,NA,1
"36286","NAROK","MAU FOREST","Total",28,4,32
"36287","NAROK","MAU FOREST","0",NA,NA,NA
"36288","NAROK","MAU FOREST","1",NA,NA,NA
"36289","NAROK","MAU FOREST","2",NA,NA,NA
"36290","NAROK","MAU FOREST","3",NA,NA,NA
"36291","NAROK","MAU FOREST","4",NA,NA,NA
"36292","NAROK","MAU FOREST","0 - 4",NA,NA,NA
"36293","NAROK","MAU FOREST","5",NA,NA,NA
"36294","NAROK","MAU FOREST","6",NA,NA,NA
"36295","NAROK","MAU FOREST","7",NA,NA,NA
"36296","NAROK","MAU FOREST","8",NA,NA,NA
"36297","NAROK","MAU FOREST","9",NA,NA,NA
"36298","NAROK","MAU FOREST","5-9",NA,NA,NA
"36299","NAROK","MAU FOREST","10",NA,NA,NA
"36300","NAROK","MAU FOREST","11",NA,NA,NA
"36301","NAROK","MAU FOREST","12",NA,NA,NA
"36302","NAROK","MAU FOREST","13",NA,NA,NA
"36303","NAROK","MAU FOREST","14",NA,NA,NA
"36304","NAROK","MAU FOREST","10 -14",NA,NA,NA
"36305","NAROK","MAU FOREST","15",NA,NA,NA
"36306","NAROK","MAU FOREST","16",NA,NA,NA
"36307","NAROK","MAU FOREST","17",NA,NA,NA
"36308","NAROK","MAU FOREST","18",NA,NA,NA
"36309","NAROK","MAU FOREST","19",NA,NA,NA
"36310","NAROK","MAU FOREST","15-19",NA,NA,NA
"36311","NAROK","MAU FOREST","20",NA,NA,NA
"36312","NAROK","MAU FOREST","21",NA,NA,NA
"36313","NAROK","MAU FOREST","22",NA,NA,NA
"36314","NAROK","MAU FOREST","23",NA,NA,NA
"36315","NAROK","MAU FOREST","24",1,2,3
"36316","NAROK","MAU FOREST","20-24",1,2,3
"36317","NAROK","MAU FOREST","25",1,NA,1
"36318","NAROK","MAU FOREST","26",NA,NA,NA
"36319","NAROK","MAU FOREST","27",2,NA,2
"36320","NAROK","MAU FOREST","28",3,NA,3
"36321","NAROK","MAU FOREST","29",3,NA,3
"36322","NAROK","MAU FOREST","25-29",9,NA,9
"36323","NAROK","MAU FOREST","30",2,2,4
"36324","NAROK","MAU FOREST","31",1,NA,1
"36325","NAROK","MAU FOREST","32",NA,NA,NA
"36326","NAROK","MAU FOREST","33",NA,NA,NA
"36327","NAROK","MAU FOREST","34",NA,NA,NA
"36328","NAROK","MAU FOREST","30-34",3,2,5
"36329","NAROK","MAU FOREST","35",NA,NA,NA
"36330","NAROK","MAU FOREST","36",2,NA,2
"36331","NAROK","MAU FOREST","37",2,NA,2
"36332","NAROK","MAU FOREST","38",1,NA,1
"36333","NAROK","MAU FOREST","39",1,NA,1
"36334","NAROK","MAU FOREST","35-39",6,NA,6
"36335","NAROK","MAU FOREST","40",1,NA,1
"36336","NAROK","MAU FOREST","41",NA,NA,NA
"36337","NAROK","MAU FOREST","42",NA,NA,NA
"36338","NAROK","MAU FOREST","43",1,NA,1
"36339","NAROK","MAU FOREST","44",NA,NA,NA
"36340","NAROK","MAU FOREST","40-44",2,NA,2
"36341","NAROK","MAU FOREST","45",NA,NA,NA
"36342","NAROK","MAU FOREST","46",1,NA,1
"36343","NAROK","MAU FOREST","47",1,NA,1
"36344","NAROK","MAU FOREST","48",2,NA,2
"36345","NAROK","MAU FOREST","49",2,NA,2
"36346","NAROK","MAU FOREST","45-49",6,NA,6
"36347","NAROK","MAU FOREST","50",NA,NA,NA
"36348","NAROK","MAU FOREST","51",NA,NA,NA
"36349","NAROK","MAU FOREST","52",NA,NA,NA
"36350","NAROK","MAU FOREST","53",1,NA,1
"36351","NAROK","MAU FOREST","54",NA,NA,NA
"36352","NAROK","MAU FOREST","50-54",1,NA,1
"36353","NAROK","MAU FOREST","55",NA,NA,NA
"36354","NAROK","MAU FOREST","56",NA,NA,NA
"36355","NAROK","MAU FOREST","57",NA,NA,NA
"36356","NAROK","MAU FOREST","58",NA,NA,NA
"36357","NAROK","MAU FOREST","59",NA,NA,NA
"36358","NAROK","MAU FOREST","55-59",NA,NA,NA
"36359","NAROK","MAU FOREST","60",NA,NA,NA
"36360","NAROK","MAU FOREST","61",NA,NA,NA
"36361","NAROK","MAU FOREST","62",NA,NA,NA
"36362","NAROK","MAU FOREST","63",NA,NA,NA
"36363","NAROK","MAU FOREST","64",NA,NA,NA
"36364","NAROK","MAU FOREST","60-64",NA,NA,NA
"36365","NAROK","MAU FOREST","65",NA,NA,NA
"36366","NAROK","MAU FOREST","66",NA,NA,NA
"36367","NAROK","MAU FOREST","67",NA,NA,NA
"36368","NAROK","MAU FOREST","68",NA,NA,NA
"36369","NAROK","MAU FOREST","69",NA,NA,NA
"36370","NAROK","MAU FOREST","65-69",NA,NA,NA
"36371","NAROK","MAU FOREST","70",NA,NA,NA
"36372","NAROK","MAU FOREST","71",NA,NA,NA
"36373","NAROK","MAU FOREST","72",NA,NA,NA
"36374","NAROK","MAU FOREST","73",NA,NA,NA
"36375","NAROK","MAU FOREST","74",NA,NA,NA
"36376","NAROK","MAU FOREST","70-74",NA,NA,NA
"36377","NAROK","MAU FOREST","75",NA,NA,NA
"36378","NAROK","MAU FOREST","76",NA,NA,NA
"36379","NAROK","MAU FOREST","77",NA,NA,NA
"36380","NAROK","MAU FOREST","78",NA,NA,NA
"36381","NAROK","MAU FOREST","79",NA,NA,NA
"36382","NAROK","MAU FOREST","75-79",NA,NA,NA
"36383","NAROK","MAU FOREST","80",NA,NA,NA
"36384","NAROK","MAU FOREST","81",NA,NA,NA
"36385","NAROK","MAU FOREST","82",NA,NA,NA
"36386","NAROK","MAU FOREST","83",NA,NA,NA
"36387","NAROK","MAU FOREST","84",NA,NA,NA
"36388","NAROK","MAU FOREST","80-84",NA,NA,NA
"36389","NAROK","MAU FOREST","85",NA,NA,NA
"36390","NAROK","MAU FOREST","86",NA,NA,NA
"36391","NAROK","MAU FOREST","87",NA,NA,NA
"36392","NAROK","MAU FOREST","88",NA,NA,NA
"36393","NAROK","MAU FOREST","89",NA,NA,NA
"36394","NAROK","MAU FOREST","85-89",NA,NA,NA
"36395","NAROK","MAU FOREST","90",NA,NA,NA
"36396","NAROK","MAU FOREST","91",NA,NA,NA
"36397","NAROK","MAU FOREST","92",NA,NA,NA
"36398","NAROK","MAU FOREST","93",NA,NA,NA
"36399","NAROK","MAU FOREST","94",NA,NA,NA
"36400","NAROK","MAU FOREST","90-94",NA,NA,NA
"36401","NAROK","MAU FOREST","95",NA,NA,NA
"36402","NAROK","MAU FOREST","96",NA,NA,NA
"36403","NAROK","MAU FOREST","97",NA,NA,NA
"36404","NAROK","MAU FOREST","98",NA,NA,NA
"36405","NAROK","MAU FOREST","99",NA,NA,NA
"36406","NAROK","MAU FOREST","95-99",NA,NA,NA
"36407","NAROK","MAU FOREST","100+",NA,NA,NA
"36408","NAROK","MAU FOREST","Not Stated",NA,NA,NA
"36409","NYAMIRA","ALL","Total",290907,314656,605563
"36410","NYAMIRA","ALL","0",5736,5898,11634
"36411","NYAMIRA","ALL","1",6071,6115,12186
"36412","NYAMIRA","ALL","2",6340,6246,12586
"36413","NYAMIRA","ALL","3",6779,6911,13690
"36414","NYAMIRA","ALL","4",7271,7087,14358
"36415","NYAMIRA","ALL","0 - 4",32197,32257,64454
"36416","NYAMIRA","ALL","5",7344,7261,14605
"36417","NYAMIRA","ALL","6",7722,7746,15468
"36418","NYAMIRA","ALL","7",8030,7787,15817
"36419","NYAMIRA","ALL","8",7674,7613,15287
"36420","NYAMIRA","ALL","9",8834,8746,17580
"36421","NYAMIRA","ALL","5-9",39604,39153,78757
"36422","NYAMIRA","ALL","10",9855,9588,19443
"36423","NYAMIRA","ALL","11",8384,8728,17112
"36424","NYAMIRA","ALL","12",10520,9892,20412
"36425","NYAMIRA","ALL","13",9575,9574,19149
"36426","NYAMIRA","ALL","14",8892,8485,17377
"36427","NYAMIRA","ALL","10 -14",47226,46267,93493
"36428","NYAMIRA","ALL","15",8422,8317,16739
"36429","NYAMIRA","ALL","16",7673,7509,15182
"36430","NYAMIRA","ALL","17",7420,7477,14897
"36431","NYAMIRA","ALL","18",5836,5739,11575
"36432","NYAMIRA","ALL","19",6075,5925,12000
"36433","NYAMIRA","ALL","15-19",35426,34967,70393
"36434","NYAMIRA","ALL","20",4846,5396,10242
"36435","NYAMIRA","ALL","21",3958,4705,8663
"36436","NYAMIRA","ALL","22",3789,4657,8446
"36437","NYAMIRA","ALL","23",3751,4930,8681
"36438","NYAMIRA","ALL","24",3588,4686,8274
"36439","NYAMIRA","ALL","20-24",19932,24374,44306
"36440","NYAMIRA","ALL","25",4519,5782,10301
"36441","NYAMIRA","ALL","26",3267,4698,7965
"36442","NYAMIRA","ALL","27",3630,5050,8680
"36443","NYAMIRA","ALL","28",3022,4071,7093
"36444","NYAMIRA","ALL","29",3124,4535,7659
"36445","NYAMIRA","ALL","25-29",17562,24136,41698
"36446","NYAMIRA","ALL","30",4649,6873,11522
"36447","NYAMIRA","ALL","31",3352,5200,8552
"36448","NYAMIRA","ALL","32",3985,5892,9877
"36449","NYAMIRA","ALL","33",3359,4828,8187
"36450","NYAMIRA","ALL","34",3153,4255,7408
"36451","NYAMIRA","ALL","30-34",18498,27048,45546
"36452","NYAMIRA","ALL","35",4454,5076,9530
"36453","NYAMIRA","ALL","36",2842,2790,5632
"36454","NYAMIRA","ALL","37",2927,2806,5733
"36455","NYAMIRA","ALL","38",2267,2278,4545
"36456","NYAMIRA","ALL","39",2710,2625,5335
"36457","NYAMIRA","ALL","35-39",15200,15575,30775
"36458","NYAMIRA","ALL","40",3412,3688,7100
"36459","NYAMIRA","ALL","41",3598,3462,7060
"36460","NYAMIRA","ALL","42",2619,2753,5372
"36461","NYAMIRA","ALL","43",2504,2756,5260
"36462","NYAMIRA","ALL","44",1951,2160,4111
"36463","NYAMIRA","ALL","40-44",14084,14819,28903
"36464","NYAMIRA","ALL","45",3516,3799,7315
"36465","NYAMIRA","ALL","46",2213,2656,4869
"36466","NYAMIRA","ALL","47",2445,2802,5247
"36467","NYAMIRA","ALL","48",1541,1661,3202
"36468","NYAMIRA","ALL","49",1811,2209,4020
"36469","NYAMIRA","ALL","45-49",11526,13127,24653
"36470","NYAMIRA","ALL","50",2354,2692,5046
"36471","NYAMIRA","ALL","51",1879,1782,3661
"36472","NYAMIRA","ALL","52",1371,1244,2615
"36473","NYAMIRA","ALL","53",1211,971,2182
"36474","NYAMIRA","ALL","54",1413,1170,2583
"36475","NYAMIRA","ALL","50-54",8228,7859,16087
"36476","NYAMIRA","ALL","55",1757,1543,3300
"36477","NYAMIRA","ALL","56",2040,2086,4126
"36478","NYAMIRA","ALL","57",2312,2705,5017
"36479","NYAMIRA","ALL","58",1497,1612,3109
"36480","NYAMIRA","ALL","59",2255,2321,4576
"36481","NYAMIRA","ALL","55-59",9861,10267,20128
"36482","NYAMIRA","ALL","60",2417,2658,5075
"36483","NYAMIRA","ALL","61",1886,1897,3783
"36484","NYAMIRA","ALL","62",1277,1213,2490
"36485","NYAMIRA","ALL","63",1342,1444,2786
"36486","NYAMIRA","ALL","64",891,986,1877
"36487","NYAMIRA","ALL","60-64",7813,8198,16011
"36488","NYAMIRA","ALL","65",1440,1756,3196
"36489","NYAMIRA","ALL","66",720,748,1468
"36490","NYAMIRA","ALL","67",1318,1289,2607
"36491","NYAMIRA","ALL","68",605,658,1263
"36492","NYAMIRA","ALL","69",1019,1316,2335
"36493","NYAMIRA","ALL","65-69",5102,5767,10869
"36494","NYAMIRA","ALL","70",1288,1850,3138
"36495","NYAMIRA","ALL","71",983,992,1975
"36496","NYAMIRA","ALL","72",634,604,1238
"36497","NYAMIRA","ALL","73",571,486,1057
"36498","NYAMIRA","ALL","74",552,694,1246
"36499","NYAMIRA","ALL","70-74",4028,4626,8654
"36500","NYAMIRA","ALL","75",501,649,1150
"36501","NYAMIRA","ALL","76",295,300,595
"36502","NYAMIRA","ALL","77",456,468,924
"36503","NYAMIRA","ALL","78",278,258,536
"36504","NYAMIRA","ALL","79",395,664,1059
"36505","NYAMIRA","ALL","75-79",1925,2339,4264
"36506","NYAMIRA","ALL","80",419,788,1207
"36507","NYAMIRA","ALL","81",284,366,650
"36508","NYAMIRA","ALL","82",204,175,379
"36509","NYAMIRA","ALL","83",248,235,483
"36510","NYAMIRA","ALL","84",230,339,569
"36511","NYAMIRA","ALL","80-84",1385,1903,3288
"36512","NYAMIRA","ALL","85",201,311,512
"36513","NYAMIRA","ALL","86",128,142,270
"36514","NYAMIRA","ALL","87",181,207,388
"36515","NYAMIRA","ALL","88",113,69,182
"36516","NYAMIRA","ALL","89",158,388,546
"36517","NYAMIRA","ALL","85-89",781,1117,1898
"36518","NYAMIRA","ALL","90",106,235,341
"36519","NYAMIRA","ALL","91",71,91,162
"36520","NYAMIRA","ALL","92",49,55,104
"36521","NYAMIRA","ALL","93",35,43,78
"36522","NYAMIRA","ALL","94",42,60,102
"36523","NYAMIRA","ALL","90-94",303,484,787
"36524","NYAMIRA","ALL","95",71,87,158
"36525","NYAMIRA","ALL","96",14,32,46
"36526","NYAMIRA","ALL","97",30,24,54
"36527","NYAMIRA","ALL","98",24,27,51
"36528","NYAMIRA","ALL","99",31,73,104
"36529","NYAMIRA","ALL","95-99",170,243,413
"36530","NYAMIRA","ALL","100+",55,127,182
"36531","NYAMIRA","ALL","Not Stated",1,3,4
"36532","NYAMIRA","BORABU","Total",36736,36431,73167
"36533","NYAMIRA","BORABU","0",585,597,1182
"36534","NYAMIRA","BORABU","1",671,688,1359
"36535","NYAMIRA","BORABU","2",772,709,1481
"36536","NYAMIRA","BORABU","3",799,823,1622
"36537","NYAMIRA","BORABU","4",826,739,1565
"36538","NYAMIRA","BORABU","0 - 4",3653,3556,7209
"36539","NYAMIRA","BORABU","5",852,809,1661
"36540","NYAMIRA","BORABU","6",936,888,1824
"36541","NYAMIRA","BORABU","7",928,921,1849
"36542","NYAMIRA","BORABU","8",892,909,1801
"36543","NYAMIRA","BORABU","9",1014,970,1984
"36544","NYAMIRA","BORABU","5-9",4622,4497,9119
"36545","NYAMIRA","BORABU","10",1170,1143,2313
"36546","NYAMIRA","BORABU","11",956,962,1918
"36547","NYAMIRA","BORABU","12",1274,1101,2375
"36548","NYAMIRA","BORABU","13",1147,1089,2236
"36549","NYAMIRA","BORABU","14",1096,973,2069
"36550","NYAMIRA","BORABU","10 -14",5643,5268,10911
"36551","NYAMIRA","BORABU","15",1002,1031,2033
"36552","NYAMIRA","BORABU","16",930,849,1779
"36553","NYAMIRA","BORABU","17",913,890,1803
"36554","NYAMIRA","BORABU","18",682,666,1348
"36555","NYAMIRA","BORABU","19",762,649,1411
"36556","NYAMIRA","BORABU","15-19",4289,4085,8374
"36557","NYAMIRA","BORABU","20",611,630,1241
"36558","NYAMIRA","BORABU","21",553,518,1071
"36559","NYAMIRA","BORABU","22",479,489,968
"36560","NYAMIRA","BORABU","23",474,572,1046
"36561","NYAMIRA","BORABU","24",451,500,951
"36562","NYAMIRA","BORABU","20-24",2568,2709,5277
"36563","NYAMIRA","BORABU","25",563,678,1241
"36564","NYAMIRA","BORABU","26",408,557,965
"36565","NYAMIRA","BORABU","27",417,539,956
"36566","NYAMIRA","BORABU","28",364,455,819
"36567","NYAMIRA","BORABU","29",387,479,866
"36568","NYAMIRA","BORABU","25-29",2139,2708,4847
"36569","NYAMIRA","BORABU","30",613,773,1386
"36570","NYAMIRA","BORABU","31",412,554,966
"36571","NYAMIRA","BORABU","32",521,650,1171
"36572","NYAMIRA","BORABU","33",474,561,1035
"36573","NYAMIRA","BORABU","34",401,585,986
"36574","NYAMIRA","BORABU","30-34",2421,3123,5544
"36575","NYAMIRA","BORABU","35",612,746,1358
"36576","NYAMIRA","BORABU","36",393,389,782
"36577","NYAMIRA","BORABU","37",401,399,800
"36578","NYAMIRA","BORABU","38",329,328,657
"36579","NYAMIRA","BORABU","39",440,360,800
"36580","NYAMIRA","BORABU","35-39",2175,2222,4397
"36581","NYAMIRA","BORABU","40",545,515,1060
"36582","NYAMIRA","BORABU","41",510,429,939
"36583","NYAMIRA","BORABU","42",426,338,764
"36584","NYAMIRA","BORABU","43",428,377,805
"36585","NYAMIRA","BORABU","44",318,306,624
"36586","NYAMIRA","BORABU","40-44",2227,1965,4192
"36587","NYAMIRA","BORABU","45",557,462,1019
"36588","NYAMIRA","BORABU","46",340,338,678
"36589","NYAMIRA","BORABU","47",366,364,730
"36590","NYAMIRA","BORABU","48",255,234,489
"36591","NYAMIRA","BORABU","49",283,305,588
"36592","NYAMIRA","BORABU","45-49",1801,1703,3504
"36593","NYAMIRA","BORABU","50",395,362,757
"36594","NYAMIRA","BORABU","51",313,230,543
"36595","NYAMIRA","BORABU","52",240,171,411
"36596","NYAMIRA","BORABU","53",220,136,356
"36597","NYAMIRA","BORABU","54",250,181,431
"36598","NYAMIRA","BORABU","50-54",1418,1080,2498
"36599","NYAMIRA","BORABU","55",269,172,441
"36600","NYAMIRA","BORABU","56",271,226,497
"36601","NYAMIRA","BORABU","57",319,318,637
"36602","NYAMIRA","BORABU","58",210,182,392
"36603","NYAMIRA","BORABU","59",282,226,508
"36604","NYAMIRA","BORABU","55-59",1351,1124,2475
"36605","NYAMIRA","BORABU","60",283,257,540
"36606","NYAMIRA","BORABU","61",197,164,361
"36607","NYAMIRA","BORABU","62",181,108,289
"36608","NYAMIRA","BORABU","63",188,137,325
"36609","NYAMIRA","BORABU","64",110,107,217
"36610","NYAMIRA","BORABU","60-64",959,773,1732
"36611","NYAMIRA","BORABU","65",162,159,321
"36612","NYAMIRA","BORABU","66",93,68,161
"36613","NYAMIRA","BORABU","67",150,99,249
"36614","NYAMIRA","BORABU","68",77,69,146
"36615","NYAMIRA","BORABU","69",100,108,208
"36616","NYAMIRA","BORABU","65-69",582,503,1085
"36617","NYAMIRA","BORABU","70",119,167,286
"36618","NYAMIRA","BORABU","71",109,92,201
"36619","NYAMIRA","BORABU","72",48,59,107
"36620","NYAMIRA","BORABU","73",53,42,95
"36621","NYAMIRA","BORABU","74",46,69,115
"36622","NYAMIRA","BORABU","70-74",375,429,804
"36623","NYAMIRA","BORABU","75",44,72,116
"36624","NYAMIRA","BORABU","76",30,38,68
"36625","NYAMIRA","BORABU","77",31,55,86
"36626","NYAMIRA","BORABU","78",29,31,60
"36627","NYAMIRA","BORABU","79",31,59,90
"36628","NYAMIRA","BORABU","75-79",165,255,420
"36629","NYAMIRA","BORABU","80",50,64,114
"36630","NYAMIRA","BORABU","81",21,47,68
"36631","NYAMIRA","BORABU","82",16,29,45
"36632","NYAMIRA","BORABU","83",32,29,61
"36633","NYAMIRA","BORABU","84",26,40,66
"36634","NYAMIRA","BORABU","80-84",145,209,354
"36635","NYAMIRA","BORABU","85",28,34,62
"36636","NYAMIRA","BORABU","86",19,18,37
"36637","NYAMIRA","BORABU","87",30,34,64
"36638","NYAMIRA","BORABU","88",13,6,19
"36639","NYAMIRA","BORABU","89",29,42,71
"36640","NYAMIRA","BORABU","85-89",119,134,253
"36641","NYAMIRA","BORABU","90",12,29,41
"36642","NYAMIRA","BORABU","91",11,11,22
"36643","NYAMIRA","BORABU","92",10,3,13
"36644","NYAMIRA","BORABU","93",11,1,12
"36645","NYAMIRA","BORABU","94",4,4,8
"36646","NYAMIRA","BORABU","90-94",48,48,96
"36647","NYAMIRA","BORABU","95",9,12,21
"36648","NYAMIRA","BORABU","96",1,7,8
"36649","NYAMIRA","BORABU","97",6,2,8
"36650","NYAMIRA","BORABU","98",7,1,8
"36651","NYAMIRA","BORABU","99",3,8,11
"36652","NYAMIRA","BORABU","95-99",26,30,56
"36653","NYAMIRA","BORABU","100+",10,10,20
"36654","NYAMIRA","BORABU","Not Stated",NA,NA,NA
"36655","NYAMIRA","MANGA","Total",44868,49339,94207
"36656","NYAMIRA","MANGA","0",910,919,1829
"36657","NYAMIRA","MANGA","1",954,927,1881
"36658","NYAMIRA","MANGA","2",940,1002,1942
"36659","NYAMIRA","MANGA","3",1030,1023,2053
"36660","NYAMIRA","MANGA","4",1108,1053,2161
"36661","NYAMIRA","MANGA","0 - 4",4942,4924,9866
"36662","NYAMIRA","MANGA","5",1076,1097,2173
"36663","NYAMIRA","MANGA","6",1122,1182,2304
"36664","NYAMIRA","MANGA","7",1174,1195,2369
"36665","NYAMIRA","MANGA","8",1078,1122,2200
"36666","NYAMIRA","MANGA","9",1347,1393,2740
"36667","NYAMIRA","MANGA","5-9",5797,5989,11786
"36668","NYAMIRA","MANGA","10",1476,1384,2860
"36669","NYAMIRA","MANGA","11",1326,1352,2678
"36670","NYAMIRA","MANGA","12",1541,1518,3059
"36671","NYAMIRA","MANGA","13",1534,1536,3070
"36672","NYAMIRA","MANGA","14",1396,1268,2664
"36673","NYAMIRA","MANGA","10 -14",7273,7058,14331
"36674","NYAMIRA","MANGA","15",1324,1278,2602
"36675","NYAMIRA","MANGA","16",1200,1168,2368
"36676","NYAMIRA","MANGA","17",1102,1153,2255
"36677","NYAMIRA","MANGA","18",904,898,1802
"36678","NYAMIRA","MANGA","19",991,917,1908
"36679","NYAMIRA","MANGA","15-19",5521,5414,10935
"36680","NYAMIRA","MANGA","20",734,822,1556
"36681","NYAMIRA","MANGA","21",585,751,1336
"36682","NYAMIRA","MANGA","22",581,726,1307
"36683","NYAMIRA","MANGA","23",599,741,1340
"36684","NYAMIRA","MANGA","24",554,702,1256
"36685","NYAMIRA","MANGA","20-24",3053,3742,6795
"36686","NYAMIRA","MANGA","25",726,862,1588
"36687","NYAMIRA","MANGA","26",507,785,1292
"36688","NYAMIRA","MANGA","27",608,841,1449
"36689","NYAMIRA","MANGA","28",450,683,1133
"36690","NYAMIRA","MANGA","29",489,743,1232
"36691","NYAMIRA","MANGA","25-29",2780,3914,6694
"36692","NYAMIRA","MANGA","30",749,1112,1861
"36693","NYAMIRA","MANGA","31",495,833,1328
"36694","NYAMIRA","MANGA","32",615,975,1590
"36695","NYAMIRA","MANGA","33",515,794,1309
"36696","NYAMIRA","MANGA","34",501,660,1161
"36697","NYAMIRA","MANGA","30-34",2875,4374,7249
"36698","NYAMIRA","MANGA","35",729,780,1509
"36699","NYAMIRA","MANGA","36",454,453,907
"36700","NYAMIRA","MANGA","37",468,444,912
"36701","NYAMIRA","MANGA","38",352,363,715
"36702","NYAMIRA","MANGA","39",408,418,826
"36703","NYAMIRA","MANGA","35-39",2411,2458,4869
"36704","NYAMIRA","MANGA","40",506,585,1091
"36705","NYAMIRA","MANGA","41",538,537,1075
"36706","NYAMIRA","MANGA","42",426,404,830
"36707","NYAMIRA","MANGA","43",419,396,815
"36708","NYAMIRA","MANGA","44",284,346,630
"36709","NYAMIRA","MANGA","40-44",2173,2268,4441
"36710","NYAMIRA","MANGA","45",496,581,1077
"36711","NYAMIRA","MANGA","46",342,387,729
"36712","NYAMIRA","MANGA","47",375,443,818
"36713","NYAMIRA","MANGA","48",221,258,479
"36714","NYAMIRA","MANGA","49",277,332,609
"36715","NYAMIRA","MANGA","45-49",1711,2001,3712
"36716","NYAMIRA","MANGA","50",368,393,761
"36717","NYAMIRA","MANGA","51",277,282,559
"36718","NYAMIRA","MANGA","52",211,196,407
"36719","NYAMIRA","MANGA","53",161,151,312
"36720","NYAMIRA","MANGA","54",218,190,408
"36721","NYAMIRA","MANGA","50-54",1235,1212,2447
"36722","NYAMIRA","MANGA","55",302,279,581
"36723","NYAMIRA","MANGA","56",281,323,604
"36724","NYAMIRA","MANGA","57",376,512,888
"36725","NYAMIRA","MANGA","58",237,267,504
"36726","NYAMIRA","MANGA","59",325,424,749
"36727","NYAMIRA","MANGA","55-59",1521,1805,3326
"36728","NYAMIRA","MANGA","60",396,442,838
"36729","NYAMIRA","MANGA","61",329,342,671
"36730","NYAMIRA","MANGA","62",222,188,410
"36731","NYAMIRA","MANGA","63",226,267,493
"36732","NYAMIRA","MANGA","64",157,160,317
"36733","NYAMIRA","MANGA","60-64",1330,1399,2729
"36734","NYAMIRA","MANGA","65",260,288,548
"36735","NYAMIRA","MANGA","66",107,112,219
"36736","NYAMIRA","MANGA","67",216,224,440
"36737","NYAMIRA","MANGA","68",100,105,205
"36738","NYAMIRA","MANGA","69",183,189,372
"36739","NYAMIRA","MANGA","65-69",866,918,1784
"36740","NYAMIRA","MANGA","70",196,303,499
"36741","NYAMIRA","MANGA","71",149,159,308
"36742","NYAMIRA","MANGA","72",107,100,207
"36743","NYAMIRA","MANGA","73",94,82,176
"36744","NYAMIRA","MANGA","74",95,119,214
"36745","NYAMIRA","MANGA","70-74",641,763,1404
"36746","NYAMIRA","MANGA","75",72,114,186
"36747","NYAMIRA","MANGA","76",51,56,107
"36748","NYAMIRA","MANGA","77",90,87,177
"36749","NYAMIRA","MANGA","78",40,45,85
"36750","NYAMIRA","MANGA","79",68,120,188
"36751","NYAMIRA","MANGA","75-79",321,422,743
"36752","NYAMIRA","MANGA","80",75,147,222
"36753","NYAMIRA","MANGA","81",50,63,113
"36754","NYAMIRA","MANGA","82",37,35,72
"36755","NYAMIRA","MANGA","83",32,39,71
"36756","NYAMIRA","MANGA","84",34,60,94
"36757","NYAMIRA","MANGA","80-84",228,344,572
"36758","NYAMIRA","MANGA","85",30,62,92
"36759","NYAMIRA","MANGA","86",27,23,50
"36760","NYAMIRA","MANGA","87",21,31,52
"36761","NYAMIRA","MANGA","88",20,13,33
"36762","NYAMIRA","MANGA","89",26,69,95
"36763","NYAMIRA","MANGA","85-89",124,198,322
"36764","NYAMIRA","MANGA","90",19,43,62
"36765","NYAMIRA","MANGA","91",8,8,16
"36766","NYAMIRA","MANGA","92",5,8,13
"36767","NYAMIRA","MANGA","93",2,6,8
"36768","NYAMIRA","MANGA","94",3,11,14
"36769","NYAMIRA","MANGA","90-94",37,76,113
"36770","NYAMIRA","MANGA","95",11,16,27
"36771","NYAMIRA","MANGA","96",3,6,9
"36772","NYAMIRA","MANGA","97",1,4,5
"36773","NYAMIRA","MANGA","98",2,2,4
"36774","NYAMIRA","MANGA","99",3,11,14
"36775","NYAMIRA","MANGA","95-99",20,39,59
"36776","NYAMIRA","MANGA","100+",9,20,29
"36777","NYAMIRA","MANGA","Not Stated",NA,1,1
"36778","NYAMIRA","MASABA NORTH","Total",52884,58974,111858
"36779","NYAMIRA","MASABA NORTH","0",1082,1088,2170
"36780","NYAMIRA","MASABA NORTH","1",1068,1114,2182
"36781","NYAMIRA","MASABA NORTH","2",1117,1129,2246
"36782","NYAMIRA","MASABA NORTH","3",1190,1279,2469
"36783","NYAMIRA","MASABA NORTH","4",1259,1309,2568
"36784","NYAMIRA","MASABA NORTH","0 - 4",5716,5919,11635
"36785","NYAMIRA","MASABA NORTH","5",1285,1295,2580
"36786","NYAMIRA","MASABA NORTH","6",1341,1374,2715
"36787","NYAMIRA","MASABA NORTH","7",1448,1416,2864
"36788","NYAMIRA","MASABA NORTH","8",1371,1385,2756
"36789","NYAMIRA","MASABA NORTH","9",1678,1648,3326
"36790","NYAMIRA","MASABA NORTH","5-9",7123,7118,14241
"36791","NYAMIRA","MASABA NORTH","10",1713,1705,3418
"36792","NYAMIRA","MASABA NORTH","11",1552,1626,3178
"36793","NYAMIRA","MASABA NORTH","12",1946,1896,3842
"36794","NYAMIRA","MASABA NORTH","13",1733,1736,3469
"36795","NYAMIRA","MASABA NORTH","14",1647,1553,3200
"36796","NYAMIRA","MASABA NORTH","10 -14",8591,8516,17107
"36797","NYAMIRA","MASABA NORTH","15",1590,1534,3124
"36798","NYAMIRA","MASABA NORTH","16",1445,1434,2879
"36799","NYAMIRA","MASABA NORTH","17",1391,1457,2848
"36800","NYAMIRA","MASABA NORTH","18",1100,1057,2157
"36801","NYAMIRA","MASABA NORTH","19",1099,1201,2300
"36802","NYAMIRA","MASABA NORTH","15-19",6625,6683,13308
"36803","NYAMIRA","MASABA NORTH","20",923,981,1904
"36804","NYAMIRA","MASABA NORTH","21",757,871,1628
"36805","NYAMIRA","MASABA NORTH","22",712,808,1520
"36806","NYAMIRA","MASABA NORTH","23",730,909,1639
"36807","NYAMIRA","MASABA NORTH","24",666,840,1506
"36808","NYAMIRA","MASABA NORTH","20-24",3788,4409,8197
"36809","NYAMIRA","MASABA NORTH","25",837,1036,1873
"36810","NYAMIRA","MASABA NORTH","26",575,825,1400
"36811","NYAMIRA","MASABA NORTH","27",599,905,1504
"36812","NYAMIRA","MASABA NORTH","28",510,707,1217
"36813","NYAMIRA","MASABA NORTH","29",575,807,1382
"36814","NYAMIRA","MASABA NORTH","25-29",3096,4280,7376
"36815","NYAMIRA","MASABA NORTH","30",829,1297,2126
"36816","NYAMIRA","MASABA NORTH","31",602,954,1556
"36817","NYAMIRA","MASABA NORTH","32",702,1143,1845
"36818","NYAMIRA","MASABA NORTH","33",619,926,1545
"36819","NYAMIRA","MASABA NORTH","34",570,758,1328
"36820","NYAMIRA","MASABA NORTH","30-34",3322,5078,8400
"36821","NYAMIRA","MASABA NORTH","35",773,886,1659
"36822","NYAMIRA","MASABA NORTH","36",513,495,1008
"36823","NYAMIRA","MASABA NORTH","37",568,501,1069
"36824","NYAMIRA","MASABA NORTH","38",419,436,855
"36825","NYAMIRA","MASABA NORTH","39",470,476,946
"36826","NYAMIRA","MASABA NORTH","35-39",2743,2794,5537
"36827","NYAMIRA","MASABA NORTH","40",591,722,1313
"36828","NYAMIRA","MASABA NORTH","41",648,700,1348
"36829","NYAMIRA","MASABA NORTH","42",449,545,994
"36830","NYAMIRA","MASABA NORTH","43",470,565,1035
"36831","NYAMIRA","MASABA NORTH","44",396,442,838
"36832","NYAMIRA","MASABA NORTH","40-44",2554,2974,5528
"36833","NYAMIRA","MASABA NORTH","45",620,703,1323
"36834","NYAMIRA","MASABA NORTH","46",386,545,931
"36835","NYAMIRA","MASABA NORTH","47",449,515,964
"36836","NYAMIRA","MASABA NORTH","48",256,306,562
"36837","NYAMIRA","MASABA NORTH","49",325,366,691
"36838","NYAMIRA","MASABA NORTH","45-49",2036,2435,4471
"36839","NYAMIRA","MASABA NORTH","50",433,528,961
"36840","NYAMIRA","MASABA NORTH","51",359,348,707
"36841","NYAMIRA","MASABA NORTH","52",245,258,503
"36842","NYAMIRA","MASABA NORTH","53",216,208,424
"36843","NYAMIRA","MASABA NORTH","54",223,227,450
"36844","NYAMIRA","MASABA NORTH","50-54",1476,1569,3045
"36845","NYAMIRA","MASABA NORTH","55",292,286,578
"36846","NYAMIRA","MASABA NORTH","56",370,385,755
"36847","NYAMIRA","MASABA NORTH","57",430,572,1002
"36848","NYAMIRA","MASABA NORTH","58",252,315,567
"36849","NYAMIRA","MASABA NORTH","59",406,435,841
"36850","NYAMIRA","MASABA NORTH","55-59",1750,1993,3743
"36851","NYAMIRA","MASABA NORTH","60",444,513,957
"36852","NYAMIRA","MASABA NORTH","61",342,431,773
"36853","NYAMIRA","MASABA NORTH","62",220,242,462
"36854","NYAMIRA","MASABA NORTH","63",241,307,548
"36855","NYAMIRA","MASABA NORTH","64",152,182,334
"36856","NYAMIRA","MASABA NORTH","60-64",1399,1675,3074
"36857","NYAMIRA","MASABA NORTH","65",256,362,618
"36858","NYAMIRA","MASABA NORTH","66",135,152,287
"36859","NYAMIRA","MASABA NORTH","67",242,234,476
"36860","NYAMIRA","MASABA NORTH","68",105,124,229
"36861","NYAMIRA","MASABA NORTH","69",196,311,507
"36862","NYAMIRA","MASABA NORTH","65-69",934,1183,2117
"36863","NYAMIRA","MASABA NORTH","70",243,399,642
"36864","NYAMIRA","MASABA NORTH","71",222,227,449
"36865","NYAMIRA","MASABA NORTH","72",124,143,267
"36866","NYAMIRA","MASABA NORTH","73",113,115,228
"36867","NYAMIRA","MASABA NORTH","74",116,145,261
"36868","NYAMIRA","MASABA NORTH","70-74",818,1029,1847
"36869","NYAMIRA","MASABA NORTH","75",101,151,252
"36870","NYAMIRA","MASABA NORTH","76",56,75,131
"36871","NYAMIRA","MASABA NORTH","77",87,94,181
"36872","NYAMIRA","MASABA NORTH","78",52,52,104
"36873","NYAMIRA","MASABA NORTH","79",75,161,236
"36874","NYAMIRA","MASABA NORTH","75-79",371,533,904
"36875","NYAMIRA","MASABA NORTH","80",79,157,236
"36876","NYAMIRA","MASABA NORTH","81",75,73,148
"36877","NYAMIRA","MASABA NORTH","82",41,24,65
"36878","NYAMIRA","MASABA NORTH","83",59,47,106
"36879","NYAMIRA","MASABA NORTH","84",43,75,118
"36880","NYAMIRA","MASABA NORTH","80-84",297,376,673
"36881","NYAMIRA","MASABA NORTH","85",36,58,94
"36882","NYAMIRA","MASABA NORTH","86",31,37,68
"36883","NYAMIRA","MASABA NORTH","87",39,50,89
"36884","NYAMIRA","MASABA NORTH","88",26,20,46
"36885","NYAMIRA","MASABA NORTH","89",24,68,92
"36886","NYAMIRA","MASABA NORTH","85-89",156,233,389
"36887","NYAMIRA","MASABA NORTH","90",22,37,59
"36888","NYAMIRA","MASABA NORTH","91",12,16,28
"36889","NYAMIRA","MASABA NORTH","92",10,12,22
"36890","NYAMIRA","MASABA NORTH","93",4,11,15
"36891","NYAMIRA","MASABA NORTH","94",6,22,28
"36892","NYAMIRA","MASABA NORTH","90-94",54,98,152
"36893","NYAMIRA","MASABA NORTH","95",11,18,29
"36894","NYAMIRA","MASABA NORTH","96",2,5,7
"36895","NYAMIRA","MASABA NORTH","97",3,8,11
"36896","NYAMIRA","MASABA NORTH","98",4,7,11
"36897","NYAMIRA","MASABA NORTH","99",7,18,25
"36898","NYAMIRA","MASABA NORTH","95-99",27,56,83
"36899","NYAMIRA","MASABA NORTH","100+",7,23,30
"36900","NYAMIRA","MASABA NORTH","Not Stated",1,NA,1
"36901","NYAMIRA","NYAMIRA NORTH","Total",80314,86947,167261
"36902","NYAMIRA","NYAMIRA NORTH","0",1567,1610,3177
"36903","NYAMIRA","NYAMIRA NORTH","1",1652,1759,3411
"36904","NYAMIRA","NYAMIRA NORTH","2",1844,1768,3612
"36905","NYAMIRA","NYAMIRA NORTH","3",1996,1904,3900
"36906","NYAMIRA","NYAMIRA NORTH","4",2004,2009,4013
"36907","NYAMIRA","NYAMIRA NORTH","0 - 4",9063,9050,18113
"36908","NYAMIRA","NYAMIRA NORTH","5",2161,2161,4322
"36909","NYAMIRA","NYAMIRA NORTH","6",2282,2193,4475
"36910","NYAMIRA","NYAMIRA NORTH","7",2353,2220,4573
"36911","NYAMIRA","NYAMIRA NORTH","8",2287,2191,4478
"36912","NYAMIRA","NYAMIRA NORTH","9",2515,2453,4968
"36913","NYAMIRA","NYAMIRA NORTH","5-9",11598,11218,22816
"36914","NYAMIRA","NYAMIRA NORTH","10",2936,2822,5758
"36915","NYAMIRA","NYAMIRA NORTH","11",2414,2479,4893
"36916","NYAMIRA","NYAMIRA NORTH","12",3019,2851,5870
"36917","NYAMIRA","NYAMIRA NORTH","13",2776,2736,5512
"36918","NYAMIRA","NYAMIRA NORTH","14",2499,2440,4939
"36919","NYAMIRA","NYAMIRA NORTH","10 -14",13644,13328,26972
"36920","NYAMIRA","NYAMIRA NORTH","15",2358,2331,4689
"36921","NYAMIRA","NYAMIRA NORTH","16",2074,2120,4194
"36922","NYAMIRA","NYAMIRA NORTH","17",2035,2038,4073
"36923","NYAMIRA","NYAMIRA NORTH","18",1595,1612,3207
"36924","NYAMIRA","NYAMIRA NORTH","19",1614,1599,3213
"36925","NYAMIRA","NYAMIRA NORTH","15-19",9676,9700,19376
"36926","NYAMIRA","NYAMIRA NORTH","20",1305,1518,2823
"36927","NYAMIRA","NYAMIRA NORTH","21",1056,1311,2367
"36928","NYAMIRA","NYAMIRA NORTH","22",1017,1338,2355
"36929","NYAMIRA","NYAMIRA NORTH","23",963,1363,2326
"36930","NYAMIRA","NYAMIRA NORTH","24",991,1352,2343
"36931","NYAMIRA","NYAMIRA NORTH","20-24",5332,6882,12214
"36932","NYAMIRA","NYAMIRA NORTH","25",1164,1638,2802
"36933","NYAMIRA","NYAMIRA NORTH","26",868,1264,2132
"36934","NYAMIRA","NYAMIRA NORTH","27",969,1474,2443
"36935","NYAMIRA","NYAMIRA NORTH","28",821,1108,1929
"36936","NYAMIRA","NYAMIRA NORTH","29",879,1252,2131
"36937","NYAMIRA","NYAMIRA NORTH","25-29",4701,6736,11437
"36938","NYAMIRA","NYAMIRA NORTH","30",1202,1918,3120
"36939","NYAMIRA","NYAMIRA NORTH","31",952,1480,2432
"36940","NYAMIRA","NYAMIRA NORTH","32",1109,1600,2709
"36941","NYAMIRA","NYAMIRA NORTH","33",905,1320,2225
"36942","NYAMIRA","NYAMIRA NORTH","34",858,1146,2004
"36943","NYAMIRA","NYAMIRA NORTH","30-34",5026,7464,12490
"36944","NYAMIRA","NYAMIRA NORTH","35",1170,1274,2444
"36945","NYAMIRA","NYAMIRA NORTH","36",746,715,1461
"36946","NYAMIRA","NYAMIRA NORTH","37",752,685,1437
"36947","NYAMIRA","NYAMIRA NORTH","38",558,574,1132
"36948","NYAMIRA","NYAMIRA NORTH","39",699,661,1360
"36949","NYAMIRA","NYAMIRA NORTH","35-39",3925,3909,7834
"36950","NYAMIRA","NYAMIRA NORTH","40",885,974,1859
"36951","NYAMIRA","NYAMIRA NORTH","41",1033,1001,2034
"36952","NYAMIRA","NYAMIRA NORTH","42",683,790,1473
"36953","NYAMIRA","NYAMIRA NORTH","43",617,774,1391
"36954","NYAMIRA","NYAMIRA NORTH","44",474,524,998
"36955","NYAMIRA","NYAMIRA NORTH","40-44",3692,4063,7755
"36956","NYAMIRA","NYAMIRA NORTH","45",944,1031,1975
"36957","NYAMIRA","NYAMIRA NORTH","46",627,712,1339
"36958","NYAMIRA","NYAMIRA NORTH","47",644,737,1381
"36959","NYAMIRA","NYAMIRA NORTH","48",404,453,857
"36960","NYAMIRA","NYAMIRA NORTH","49",491,627,1118
"36961","NYAMIRA","NYAMIRA NORTH","45-49",3110,3560,6670
"36962","NYAMIRA","NYAMIRA NORTH","50",579,693,1272
"36963","NYAMIRA","NYAMIRA NORTH","51",467,417,884
"36964","NYAMIRA","NYAMIRA NORTH","52",371,332,703
"36965","NYAMIRA","NYAMIRA NORTH","53",310,233,543
"36966","NYAMIRA","NYAMIRA NORTH","54",369,276,645
"36967","NYAMIRA","NYAMIRA NORTH","50-54",2096,1951,4047
"36968","NYAMIRA","NYAMIRA NORTH","55",475,398,873
"36969","NYAMIRA","NYAMIRA NORTH","56",564,553,1117
"36970","NYAMIRA","NYAMIRA NORTH","57",571,606,1177
"36971","NYAMIRA","NYAMIRA NORTH","58",400,426,826
"36972","NYAMIRA","NYAMIRA NORTH","59",613,597,1210
"36973","NYAMIRA","NYAMIRA NORTH","55-59",2623,2580,5203
"36974","NYAMIRA","NYAMIRA NORTH","60",661,731,1392
"36975","NYAMIRA","NYAMIRA NORTH","61",527,453,980
"36976","NYAMIRA","NYAMIRA NORTH","62",331,338,669
"36977","NYAMIRA","NYAMIRA NORTH","63",381,348,729
"36978","NYAMIRA","NYAMIRA NORTH","64",239,271,510
"36979","NYAMIRA","NYAMIRA NORTH","60-64",2139,2141,4280
"36980","NYAMIRA","NYAMIRA NORTH","65",404,504,908
"36981","NYAMIRA","NYAMIRA NORTH","66",210,211,421
"36982","NYAMIRA","NYAMIRA NORTH","67",336,373,709
"36983","NYAMIRA","NYAMIRA NORTH","68",149,177,326
"36984","NYAMIRA","NYAMIRA NORTH","69",261,341,602
"36985","NYAMIRA","NYAMIRA NORTH","65-69",1360,1606,2966
"36986","NYAMIRA","NYAMIRA NORTH","70",375,491,866
"36987","NYAMIRA","NYAMIRA NORTH","71",260,266,526
"36988","NYAMIRA","NYAMIRA NORTH","72",169,153,322
"36989","NYAMIRA","NYAMIRA NORTH","73",141,126,267
"36990","NYAMIRA","NYAMIRA NORTH","74",149,174,323
"36991","NYAMIRA","NYAMIRA NORTH","70-74",1094,1210,2304
"36992","NYAMIRA","NYAMIRA NORTH","75",141,153,294
"36993","NYAMIRA","NYAMIRA NORTH","76",77,62,139
"36994","NYAMIRA","NYAMIRA NORTH","77",131,102,233
"36995","NYAMIRA","NYAMIRA NORTH","78",85,61,146
"36996","NYAMIRA","NYAMIRA NORTH","79",99,166,265
"36997","NYAMIRA","NYAMIRA NORTH","75-79",533,544,1077
"36998","NYAMIRA","NYAMIRA NORTH","80",100,206,306
"36999","NYAMIRA","NYAMIRA NORTH","81",76,97,173
"37000","NYAMIRA","NYAMIRA NORTH","82",56,46,102
"37001","NYAMIRA","NYAMIRA NORTH","83",57,51,108
"37002","NYAMIRA","NYAMIRA NORTH","84",73,76,149
"37003","NYAMIRA","NYAMIRA NORTH","80-84",362,476,838
"37004","NYAMIRA","NYAMIRA NORTH","85",38,70,108
"37005","NYAMIRA","NYAMIRA NORTH","86",27,36,63
"37006","NYAMIRA","NYAMIRA NORTH","87",49,50,99
"37007","NYAMIRA","NYAMIRA NORTH","88",26,17,43
"37008","NYAMIRA","NYAMIRA NORTH","89",44,118,162
"37009","NYAMIRA","NYAMIRA NORTH","85-89",184,291,475
"37010","NYAMIRA","NYAMIRA NORTH","90",32,67,99
"37011","NYAMIRA","NYAMIRA NORTH","91",19,26,45
"37012","NYAMIRA","NYAMIRA NORTH","92",11,13,24
"37013","NYAMIRA","NYAMIRA NORTH","93",10,16,26
"37014","NYAMIRA","NYAMIRA NORTH","94",16,11,27
"37015","NYAMIRA","NYAMIRA NORTH","90-94",88,133,221
"37016","NYAMIRA","NYAMIRA NORTH","95",23,23,46
"37017","NYAMIRA","NYAMIRA NORTH","96",4,6,10
"37018","NYAMIRA","NYAMIRA NORTH","97",11,6,17
"37019","NYAMIRA","NYAMIRA NORTH","98",8,9,17
"37020","NYAMIRA","NYAMIRA NORTH","99",6,21,27
"37021","NYAMIRA","NYAMIRA NORTH","95-99",52,65,117
"37022","NYAMIRA","NYAMIRA NORTH","100+",16,40,56
"37023","NYAMIRA","NYAMIRA NORTH","Not Stated",NA,NA,NA
"37024","NYAMIRA","NYAMIRA SOUTH","Total",76105,82965,159070
"37025","NYAMIRA","NYAMIRA SOUTH","0",1592,1684,3276
"37026","NYAMIRA","NYAMIRA SOUTH","1",1726,1627,3353
"37027","NYAMIRA","NYAMIRA SOUTH","2",1667,1638,3305
"37028","NYAMIRA","NYAMIRA SOUTH","3",1764,1882,3646
"37029","NYAMIRA","NYAMIRA SOUTH","4",2074,1977,4051
"37030","NYAMIRA","NYAMIRA SOUTH","0 - 4",8823,8808,17631
"37031","NYAMIRA","NYAMIRA SOUTH","5",1970,1899,3869
"37032","NYAMIRA","NYAMIRA SOUTH","6",2041,2109,4150
"37033","NYAMIRA","NYAMIRA SOUTH","7",2127,2035,4162
"37034","NYAMIRA","NYAMIRA SOUTH","8",2046,2006,4052
"37035","NYAMIRA","NYAMIRA SOUTH","9",2280,2282,4562
"37036","NYAMIRA","NYAMIRA SOUTH","5-9",10464,10331,20795
"37037","NYAMIRA","NYAMIRA SOUTH","10",2560,2534,5094
"37038","NYAMIRA","NYAMIRA SOUTH","11",2136,2309,4445
"37039","NYAMIRA","NYAMIRA SOUTH","12",2740,2526,5266
"37040","NYAMIRA","NYAMIRA SOUTH","13",2385,2477,4862
"37041","NYAMIRA","NYAMIRA SOUTH","14",2254,2251,4505
"37042","NYAMIRA","NYAMIRA SOUTH","10 -14",12075,12097,24172
"37043","NYAMIRA","NYAMIRA SOUTH","15",2148,2143,4291
"37044","NYAMIRA","NYAMIRA SOUTH","16",2024,1938,3962
"37045","NYAMIRA","NYAMIRA SOUTH","17",1979,1939,3918
"37046","NYAMIRA","NYAMIRA SOUTH","18",1555,1506,3061
"37047","NYAMIRA","NYAMIRA SOUTH","19",1609,1559,3168
"37048","NYAMIRA","NYAMIRA SOUTH","15-19",9315,9085,18400
"37049","NYAMIRA","NYAMIRA SOUTH","20",1273,1445,2718
"37050","NYAMIRA","NYAMIRA SOUTH","21",1007,1254,2261
"37051","NYAMIRA","NYAMIRA SOUTH","22",1000,1296,2296
"37052","NYAMIRA","NYAMIRA SOUTH","23",985,1345,2330
"37053","NYAMIRA","NYAMIRA SOUTH","24",926,1292,2218
"37054","NYAMIRA","NYAMIRA SOUTH","20-24",5191,6632,11823
"37055","NYAMIRA","NYAMIRA SOUTH","25",1229,1568,2797
"37056","NYAMIRA","NYAMIRA SOUTH","26",909,1267,2176
"37057","NYAMIRA","NYAMIRA SOUTH","27",1037,1291,2328
"37058","NYAMIRA","NYAMIRA SOUTH","28",877,1118,1995
"37059","NYAMIRA","NYAMIRA SOUTH","29",794,1254,2048
"37060","NYAMIRA","NYAMIRA SOUTH","25-29",4846,6498,11344
"37061","NYAMIRA","NYAMIRA SOUTH","30",1256,1773,3029
"37062","NYAMIRA","NYAMIRA SOUTH","31",891,1379,2270
"37063","NYAMIRA","NYAMIRA SOUTH","32",1038,1524,2562
"37064","NYAMIRA","NYAMIRA SOUTH","33",846,1227,2073
"37065","NYAMIRA","NYAMIRA SOUTH","34",823,1106,1929
"37066","NYAMIRA","NYAMIRA SOUTH","30-34",4854,7009,11863
"37067","NYAMIRA","NYAMIRA SOUTH","35",1170,1390,2560
"37068","NYAMIRA","NYAMIRA SOUTH","36",736,738,1474
"37069","NYAMIRA","NYAMIRA SOUTH","37",738,777,1515
"37070","NYAMIRA","NYAMIRA SOUTH","38",609,577,1186
"37071","NYAMIRA","NYAMIRA SOUTH","39",693,710,1403
"37072","NYAMIRA","NYAMIRA SOUTH","35-39",3946,4192,8138
"37073","NYAMIRA","NYAMIRA SOUTH","40",885,892,1777
"37074","NYAMIRA","NYAMIRA SOUTH","41",869,795,1664
"37075","NYAMIRA","NYAMIRA SOUTH","42",635,676,1311
"37076","NYAMIRA","NYAMIRA SOUTH","43",570,644,1214
"37077","NYAMIRA","NYAMIRA SOUTH","44",479,542,1021
"37078","NYAMIRA","NYAMIRA SOUTH","40-44",3438,3549,6987
"37079","NYAMIRA","NYAMIRA SOUTH","45",899,1022,1921
"37080","NYAMIRA","NYAMIRA SOUTH","46",518,674,1192
"37081","NYAMIRA","NYAMIRA SOUTH","47",611,743,1354
"37082","NYAMIRA","NYAMIRA SOUTH","48",405,410,815
"37083","NYAMIRA","NYAMIRA SOUTH","49",435,579,1014
"37084","NYAMIRA","NYAMIRA SOUTH","45-49",2868,3428,6296
"37085","NYAMIRA","NYAMIRA SOUTH","50",579,716,1295
"37086","NYAMIRA","NYAMIRA SOUTH","51",463,505,968
"37087","NYAMIRA","NYAMIRA SOUTH","52",304,287,591
"37088","NYAMIRA","NYAMIRA SOUTH","53",304,243,547
"37089","NYAMIRA","NYAMIRA SOUTH","54",353,296,649
"37090","NYAMIRA","NYAMIRA SOUTH","50-54",2003,2047,4050
"37091","NYAMIRA","NYAMIRA SOUTH","55",419,408,827
"37092","NYAMIRA","NYAMIRA SOUTH","56",554,599,1153
"37093","NYAMIRA","NYAMIRA SOUTH","57",616,697,1313
"37094","NYAMIRA","NYAMIRA SOUTH","58",398,422,820
"37095","NYAMIRA","NYAMIRA SOUTH","59",629,639,1268
"37096","NYAMIRA","NYAMIRA SOUTH","55-59",2616,2765,5381
"37097","NYAMIRA","NYAMIRA SOUTH","60",633,715,1348
"37098","NYAMIRA","NYAMIRA SOUTH","61",491,507,998
"37099","NYAMIRA","NYAMIRA SOUTH","62",323,337,660
"37100","NYAMIRA","NYAMIRA SOUTH","63",306,385,691
"37101","NYAMIRA","NYAMIRA SOUTH","64",233,266,499
"37102","NYAMIRA","NYAMIRA SOUTH","60-64",1986,2210,4196
"37103","NYAMIRA","NYAMIRA SOUTH","65",358,443,801
"37104","NYAMIRA","NYAMIRA SOUTH","66",175,205,380
"37105","NYAMIRA","NYAMIRA SOUTH","67",374,359,733
"37106","NYAMIRA","NYAMIRA SOUTH","68",174,183,357
"37107","NYAMIRA","NYAMIRA SOUTH","69",279,367,646
"37108","NYAMIRA","NYAMIRA SOUTH","65-69",1360,1557,2917
"37109","NYAMIRA","NYAMIRA SOUTH","70",355,490,845
"37110","NYAMIRA","NYAMIRA SOUTH","71",243,248,491
"37111","NYAMIRA","NYAMIRA SOUTH","72",186,149,335
"37112","NYAMIRA","NYAMIRA SOUTH","73",170,121,291
"37113","NYAMIRA","NYAMIRA SOUTH","74",146,187,333
"37114","NYAMIRA","NYAMIRA SOUTH","70-74",1100,1195,2295
"37115","NYAMIRA","NYAMIRA SOUTH","75",143,159,302
"37116","NYAMIRA","NYAMIRA SOUTH","76",81,69,150
"37117","NYAMIRA","NYAMIRA SOUTH","77",117,130,247
"37118","NYAMIRA","NYAMIRA SOUTH","78",72,69,141
"37119","NYAMIRA","NYAMIRA SOUTH","79",122,158,280
"37120","NYAMIRA","NYAMIRA SOUTH","75-79",535,585,1120
"37121","NYAMIRA","NYAMIRA SOUTH","80",115,214,329
"37122","NYAMIRA","NYAMIRA SOUTH","81",62,86,148
"37123","NYAMIRA","NYAMIRA SOUTH","82",54,41,95
"37124","NYAMIRA","NYAMIRA SOUTH","83",68,69,137
"37125","NYAMIRA","NYAMIRA SOUTH","84",54,88,142
"37126","NYAMIRA","NYAMIRA SOUTH","80-84",353,498,851
"37127","NYAMIRA","NYAMIRA SOUTH","85",69,87,156
"37128","NYAMIRA","NYAMIRA SOUTH","86",24,28,52
"37129","NYAMIRA","NYAMIRA SOUTH","87",42,42,84
"37130","NYAMIRA","NYAMIRA SOUTH","88",28,13,41
"37131","NYAMIRA","NYAMIRA SOUTH","89",35,91,126
"37132","NYAMIRA","NYAMIRA SOUTH","85-89",198,261,459
"37133","NYAMIRA","NYAMIRA SOUTH","90",21,59,80
"37134","NYAMIRA","NYAMIRA SOUTH","91",21,30,51
"37135","NYAMIRA","NYAMIRA SOUTH","92",13,19,32
"37136","NYAMIRA","NYAMIRA SOUTH","93",8,9,17
"37137","NYAMIRA","NYAMIRA SOUTH","94",13,12,25
"37138","NYAMIRA","NYAMIRA SOUTH","90-94",76,129,205
"37139","NYAMIRA","NYAMIRA SOUTH","95",17,18,35
"37140","NYAMIRA","NYAMIRA SOUTH","96",4,8,12
"37141","NYAMIRA","NYAMIRA SOUTH","97",9,4,13
"37142","NYAMIRA","NYAMIRA SOUTH","98",3,8,11
"37143","NYAMIRA","NYAMIRA SOUTH","99",12,15,27
"37144","NYAMIRA","NYAMIRA SOUTH","95-99",45,53,98
"37145","NYAMIRA","NYAMIRA SOUTH","100+",13,34,47
"37146","NYAMIRA","NYAMIRA SOUTH","Not Stated",NA,2,2
"37147","NYANDARUA","ALL","Total",315022,323247,638269
"37148","NYANDARUA","ALL","0",6857,6971,13828
"37149","NYANDARUA","ALL","1",6896,6743,13639
"37150","NYANDARUA","ALL","2",7097,6885,13982
"37151","NYANDARUA","ALL","3",7177,7052,14229
"37152","NYANDARUA","ALL","4",7329,6981,14310
"37153","NYANDARUA","ALL","0 - 4",35356,34632,69988
"37154","NYANDARUA","ALL","5",7314,6902,14216
"37155","NYANDARUA","ALL","6",7198,7228,14426
"37156","NYANDARUA","ALL","7",7697,7348,15045
"37157","NYANDARUA","ALL","8",7388,7315,14703
"37158","NYANDARUA","ALL","9",8366,8147,16513
"37159","NYANDARUA","ALL","5-9",37963,36940,74903
"37160","NYANDARUA","ALL","10",8235,7758,15993
"37161","NYANDARUA","ALL","11",7676,7591,15267
"37162","NYANDARUA","ALL","12",8723,8116,16839
"37163","NYANDARUA","ALL","13",8862,8483,17345
"37164","NYANDARUA","ALL","14",9044,8385,17429
"37165","NYANDARUA","ALL","10 -14",42540,40333,82873
"37166","NYANDARUA","ALL","15",8703,8040,16743
"37167","NYANDARUA","ALL","16",8462,8105,16567
"37168","NYANDARUA","ALL","17",8732,7871,16603
"37169","NYANDARUA","ALL","18",6789,6084,12873
"37170","NYANDARUA","ALL","19",6747,6035,12782
"37171","NYANDARUA","ALL","15-19",39433,36135,75568
"37172","NYANDARUA","ALL","20",5476,5218,10694
"37173","NYANDARUA","ALL","21",5152,4941,10093
"37174","NYANDARUA","ALL","22",4890,4687,9577
"37175","NYANDARUA","ALL","23",4584,4907,9491
"37176","NYANDARUA","ALL","24",4117,4491,8608
"37177","NYANDARUA","ALL","20-24",24219,24244,48463
"37178","NYANDARUA","ALL","25",4482,4373,8855
"37179","NYANDARUA","ALL","26",3541,3977,7518
"37180","NYANDARUA","ALL","27",3722,4026,7748
"37181","NYANDARUA","ALL","28",3355,3681,7036
"37182","NYANDARUA","ALL","29",3737,4032,7769
"37183","NYANDARUA","ALL","25-29",18837,20089,38926
"37184","NYANDARUA","ALL","30",4466,5129,9595
"37185","NYANDARUA","ALL","31",3529,3736,7265
"37186","NYANDARUA","ALL","32",4255,4982,9237
"37187","NYANDARUA","ALL","33",3656,4432,8088
"37188","NYANDARUA","ALL","34",3716,4130,7846
"37189","NYANDARUA","ALL","30-34",19622,22409,42031
"37190","NYANDARUA","ALL","35",5064,5363,10427
"37191","NYANDARUA","ALL","36",3518,3977,7495
"37192","NYANDARUA","ALL","37",3666,3818,7484
"37193","NYANDARUA","ALL","38",3025,3502,6527
"37194","NYANDARUA","ALL","39",3475,3816,7291
"37195","NYANDARUA","ALL","35-39",18748,20476,39224
"37196","NYANDARUA","ALL","40",4035,4282,8317
"37197","NYANDARUA","ALL","41",3761,3963,7724
"37198","NYANDARUA","ALL","42",3510,3800,7310
"37199","NYANDARUA","ALL","43",3049,3404,6453
"37200","NYANDARUA","ALL","44",2550,2740,5290
"37201","NYANDARUA","ALL","40-44",16905,18189,35094
"37202","NYANDARUA","ALL","45",3853,4141,7994
"37203","NYANDARUA","ALL","46",2979,3340,6319
"37204","NYANDARUA","ALL","47",3341,3488,6829
"37205","NYANDARUA","ALL","48",2443,2732,5175
"37206","NYANDARUA","ALL","49",2852,3060,5912
"37207","NYANDARUA","ALL","45-49",15468,16761,32229
"37208","NYANDARUA","ALL","50",3110,3458,6568
"37209","NYANDARUA","ALL","51",2529,2702,5231
"37210","NYANDARUA","ALL","52",2825,2928,5753
"37211","NYANDARUA","ALL","53",2018,2283,4301
"37212","NYANDARUA","ALL","54",2320,2561,4881
"37213","NYANDARUA","ALL","50-54",12802,13932,26734
"37214","NYANDARUA","ALL","55",2563,2605,5168
"37215","NYANDARUA","ALL","56",2537,2527,5064
"37216","NYANDARUA","ALL","57",1960,2424,4384
"37217","NYANDARUA","ALL","58",1829,1882,3711
"37218","NYANDARUA","ALL","59",1862,2067,3929
"37219","NYANDARUA","ALL","55-59",10751,11505,22256
"37220","NYANDARUA","ALL","60",2037,2150,4187
"37221","NYANDARUA","ALL","61",1489,1644,3133
"37222","NYANDARUA","ALL","62",1436,1359,2795
"37223","NYANDARUA","ALL","63",1131,1140,2271
"37224","NYANDARUA","ALL","64",766,900,1666
"37225","NYANDARUA","ALL","60-64",6859,7193,14052
"37226","NYANDARUA","ALL","65",1363,1308,2671
"37227","NYANDARUA","ALL","66",919,963,1882
"37228","NYANDARUA","ALL","67",1503,1664,3167
"37229","NYANDARUA","ALL","68",607,801,1408
"37230","NYANDARUA","ALL","69",976,1215,2191
"37231","NYANDARUA","ALL","65-69",5368,5951,11319
"37232","NYANDARUA","ALL","70",1265,1606,2871
"37233","NYANDARUA","ALL","71",893,1091,1984
"37234","NYANDARUA","ALL","72",852,966,1818
"37235","NYANDARUA","ALL","73",668,800,1468
"37236","NYANDARUA","ALL","74",656,881,1537
"37237","NYANDARUA","ALL","70-74",4334,5344,9678
"37238","NYANDARUA","ALL","75",574,886,1460
"37239","NYANDARUA","ALL","76",747,1596,2343
"37240","NYANDARUA","ALL","77",474,664,1138
"37241","NYANDARUA","ALL","78",302,466,768
"37242","NYANDARUA","ALL","79",388,617,1005
"37243","NYANDARUA","ALL","75-79",2485,4229,6714
"37244","NYANDARUA","ALL","80",527,768,1295
"37245","NYANDARUA","ALL","81",289,426,715
"37246","NYANDARUA","ALL","82",262,317,579
"37247","NYANDARUA","ALL","83",372,321,693
"37248","NYANDARUA","ALL","84",321,417,738
"37249","NYANDARUA","ALL","80-84",1771,2249,4020
"37250","NYANDARUA","ALL","85",248,352,600
"37251","NYANDARUA","ALL","86",167,296,463
"37252","NYANDARUA","ALL","87",177,248,425
"37253","NYANDARUA","ALL","88",105,133,238
"37254","NYANDARUA","ALL","89",188,355,543
"37255","NYANDARUA","ALL","85-89",885,1384,2269
"37256","NYANDARUA","ALL","90",129,223,352
"37257","NYANDARUA","ALL","91",144,181,325
"37258","NYANDARUA","ALL","92",56,104,160
"37259","NYANDARUA","ALL","93",49,72,121
"37260","NYANDARUA","ALL","94",29,104,133
"37261","NYANDARUA","ALL","90-94",407,684,1091
"37262","NYANDARUA","ALL","95",48,116,164
"37263","NYANDARUA","ALL","96",28,64,92
"37264","NYANDARUA","ALL","97",47,78,125
"37265","NYANDARUA","ALL","98",27,40,67
"37266","NYANDARUA","ALL","99",42,75,117
"37267","NYANDARUA","ALL","95-99",192,373,565
"37268","NYANDARUA","ALL","100+",73,194,267
"37269","NYANDARUA","ALL","Not Stated",4,1,5
"37270","NYANDARUA","KINANGOP","Total",54727,56679,111406
"37271","NYANDARUA","KINANGOP","0",1252,1246,2498
"37272","NYANDARUA","KINANGOP","1",1220,1189,2409
"37273","NYANDARUA","KINANGOP","2",1236,1189,2425
"37274","NYANDARUA","KINANGOP","3",1321,1288,2609
"37275","NYANDARUA","KINANGOP","4",1262,1246,2508
"37276","NYANDARUA","KINANGOP","0 - 4",6291,6158,12449
"37277","NYANDARUA","KINANGOP","5",1280,1226,2506
"37278","NYANDARUA","KINANGOP","6",1254,1217,2471
"37279","NYANDARUA","KINANGOP","7",1378,1306,2684
"37280","NYANDARUA","KINANGOP","8",1236,1344,2580
"37281","NYANDARUA","KINANGOP","9",1505,1449,2954
"37282","NYANDARUA","KINANGOP","5-9",6653,6542,13195
"37283","NYANDARUA","KINANGOP","10",1466,1389,2855
"37284","NYANDARUA","KINANGOP","11",1368,1302,2670
"37285","NYANDARUA","KINANGOP","12",1540,1402,2942
"37286","NYANDARUA","KINANGOP","13",1591,1510,3101
"37287","NYANDARUA","KINANGOP","14",1554,1510,3064
"37288","NYANDARUA","KINANGOP","10 -14",7519,7113,14632
"37289","NYANDARUA","KINANGOP","15",1529,1426,2955
"37290","NYANDARUA","KINANGOP","16",1460,1461,2921
"37291","NYANDARUA","KINANGOP","17",1510,1355,2865
"37292","NYANDARUA","KINANGOP","18",1161,1124,2285
"37293","NYANDARUA","KINANGOP","19",1150,1029,2179
"37294","NYANDARUA","KINANGOP","15-19",6810,6395,13205
"37295","NYANDARUA","KINANGOP","20",932,879,1811
"37296","NYANDARUA","KINANGOP","21",926,855,1781
"37297","NYANDARUA","KINANGOP","22",850,793,1643
"37298","NYANDARUA","KINANGOP","23",759,825,1584
"37299","NYANDARUA","KINANGOP","24",667,820,1487
"37300","NYANDARUA","KINANGOP","20-24",4134,4172,8306
"37301","NYANDARUA","KINANGOP","25",775,757,1532
"37302","NYANDARUA","KINANGOP","26",648,714,1362
"37303","NYANDARUA","KINANGOP","27",695,792,1487
"37304","NYANDARUA","KINANGOP","28",606,657,1263
"37305","NYANDARUA","KINANGOP","29",662,732,1394
"37306","NYANDARUA","KINANGOP","25-29",3386,3652,7038
"37307","NYANDARUA","KINANGOP","30",786,915,1701
"37308","NYANDARUA","KINANGOP","31",663,686,1349
"37309","NYANDARUA","KINANGOP","32",797,927,1724
"37310","NYANDARUA","KINANGOP","33",710,766,1476
"37311","NYANDARUA","KINANGOP","34",677,742,1419
"37312","NYANDARUA","KINANGOP","30-34",3633,4036,7669
"37313","NYANDARUA","KINANGOP","35",869,999,1868
"37314","NYANDARUA","KINANGOP","36",608,723,1331
"37315","NYANDARUA","KINANGOP","37",602,690,1292
"37316","NYANDARUA","KINANGOP","38",559,684,1243
"37317","NYANDARUA","KINANGOP","39",573,685,1258
"37318","NYANDARUA","KINANGOP","35-39",3211,3781,6992
"37319","NYANDARUA","KINANGOP","40",681,743,1424
"37320","NYANDARUA","KINANGOP","41",673,747,1420
"37321","NYANDARUA","KINANGOP","42",633,648,1281
"37322","NYANDARUA","KINANGOP","43",535,612,1147
"37323","NYANDARUA","KINANGOP","44",434,477,911
"37324","NYANDARUA","KINANGOP","40-44",2956,3227,6183
"37325","NYANDARUA","KINANGOP","45",676,718,1394
"37326","NYANDARUA","KINANGOP","46",543,600,1143
"37327","NYANDARUA","KINANGOP","47",588,641,1229
"37328","NYANDARUA","KINANGOP","48",427,515,942
"37329","NYANDARUA","KINANGOP","49",536,585,1121
"37330","NYANDARUA","KINANGOP","45-49",2770,3059,5829
"37331","NYANDARUA","KINANGOP","50",566,618,1184
"37332","NYANDARUA","KINANGOP","51",413,460,873
"37333","NYANDARUA","KINANGOP","52",540,541,1081
"37334","NYANDARUA","KINANGOP","53",360,420,780
"37335","NYANDARUA","KINANGOP","54",411,427,838
"37336","NYANDARUA","KINANGOP","50-54",2290,2466,4756
"37337","NYANDARUA","KINANGOP","55",444,452,896
"37338","NYANDARUA","KINANGOP","56",453,417,870
"37339","NYANDARUA","KINANGOP","57",322,410,732
"37340","NYANDARUA","KINANGOP","58",242,277,519
"37341","NYANDARUA","KINANGOP","59",298,327,625
"37342","NYANDARUA","KINANGOP","55-59",1759,1883,3642
"37343","NYANDARUA","KINANGOP","60",314,337,651
"37344","NYANDARUA","KINANGOP","61",209,264,473
"37345","NYANDARUA","KINANGOP","62",232,207,439
"37346","NYANDARUA","KINANGOP","63",175,150,325
"37347","NYANDARUA","KINANGOP","64",126,149,275
"37348","NYANDARUA","KINANGOP","60-64",1056,1107,2163
"37349","NYANDARUA","KINANGOP","65",213,198,411
"37350","NYANDARUA","KINANGOP","66",149,159,308
"37351","NYANDARUA","KINANGOP","67",222,270,492
"37352","NYANDARUA","KINANGOP","68",102,139,241
"37353","NYANDARUA","KINANGOP","69",149,200,349
"37354","NYANDARUA","KINANGOP","65-69",835,966,1801
"37355","NYANDARUA","KINANGOP","70",210,220,430
"37356","NYANDARUA","KINANGOP","71",126,153,279
"37357","NYANDARUA","KINANGOP","72",127,152,279
"37358","NYANDARUA","KINANGOP","73",95,132,227
"37359","NYANDARUA","KINANGOP","74",56,135,191
"37360","NYANDARUA","KINANGOP","70-74",614,792,1406
"37361","NYANDARUA","KINANGOP","75",71,122,193
"37362","NYANDARUA","KINANGOP","76",98,244,342
"37363","NYANDARUA","KINANGOP","77",71,111,182
"37364","NYANDARUA","KINANGOP","78",34,67,101
"37365","NYANDARUA","KINANGOP","79",59,100,159
"37366","NYANDARUA","KINANGOP","75-79",333,644,977
"37367","NYANDARUA","KINANGOP","80",85,105,190
"37368","NYANDARUA","KINANGOP","81",43,70,113
"37369","NYANDARUA","KINANGOP","82",28,51,79
"37370","NYANDARUA","KINANGOP","83",46,40,86
"37371","NYANDARUA","KINANGOP","84",52,59,111
"37372","NYANDARUA","KINANGOP","80-84",254,325,579
"37373","NYANDARUA","KINANGOP","85",44,59,103
"37374","NYANDARUA","KINANGOP","86",25,42,67
"37375","NYANDARUA","KINANGOP","87",30,25,55
"37376","NYANDARUA","KINANGOP","88",19,10,29
"37377","NYANDARUA","KINANGOP","89",27,53,80
"37378","NYANDARUA","KINANGOP","85-89",145,189,334
"37379","NYANDARUA","KINANGOP","90",12,33,45
"37380","NYANDARUA","KINANGOP","91",12,18,30
"37381","NYANDARUA","KINANGOP","92",6,16,22
"37382","NYANDARUA","KINANGOP","93",8,8,16
"37383","NYANDARUA","KINANGOP","94",4,14,18
"37384","NYANDARUA","KINANGOP","90-94",42,89,131
"37385","NYANDARUA","KINANGOP","95",5,19,24
"37386","NYANDARUA","KINANGOP","96",5,11,16
"37387","NYANDARUA","KINANGOP","97",10,10,20
"37388","NYANDARUA","KINANGOP","98",3,7,10
"37389","NYANDARUA","KINANGOP","99",7,7,14
"37390","NYANDARUA","KINANGOP","95-99",30,54,84
"37391","NYANDARUA","KINANGOP","100+",4,29,33
"37392","NYANDARUA","KINANGOP","Not Stated",2,NA,2
"37393","NYANDARUA","NYANDARUA SOUTH","Total",46157,47708,93865
"37394","NYANDARUA","NYANDARUA SOUTH","0",1006,1006,2012
"37395","NYANDARUA","NYANDARUA SOUTH","1",987,974,1961
"37396","NYANDARUA","NYANDARUA SOUTH","2",1047,1044,2091
"37397","NYANDARUA","NYANDARUA SOUTH","3",1017,978,1995
"37398","NYANDARUA","NYANDARUA SOUTH","4",1082,1099,2181
"37399","NYANDARUA","NYANDARUA SOUTH","0 - 4",5139,5101,10240
"37400","NYANDARUA","NYANDARUA SOUTH","5",1055,1004,2059
"37401","NYANDARUA","NYANDARUA SOUTH","6",1071,1069,2140
"37402","NYANDARUA","NYANDARUA SOUTH","7",1109,1071,2180
"37403","NYANDARUA","NYANDARUA SOUTH","8",1130,1040,2170
"37404","NYANDARUA","NYANDARUA SOUTH","9",1221,1154,2375
"37405","NYANDARUA","NYANDARUA SOUTH","5-9",5586,5338,10924
"37406","NYANDARUA","NYANDARUA SOUTH","10",1240,1158,2398
"37407","NYANDARUA","NYANDARUA SOUTH","11",1124,1159,2283
"37408","NYANDARUA","NYANDARUA SOUTH","12",1237,1187,2424
"37409","NYANDARUA","NYANDARUA SOUTH","13",1310,1267,2577
"37410","NYANDARUA","NYANDARUA SOUTH","14",1334,1272,2606
"37411","NYANDARUA","NYANDARUA SOUTH","10 -14",6245,6043,12288
"37412","NYANDARUA","NYANDARUA SOUTH","15",1302,1215,2517
"37413","NYANDARUA","NYANDARUA SOUTH","16",1269,1241,2510
"37414","NYANDARUA","NYANDARUA SOUTH","17",1276,1199,2475
"37415","NYANDARUA","NYANDARUA SOUTH","18",1064,936,2000
"37416","NYANDARUA","NYANDARUA SOUTH","19",1041,901,1942
"37417","NYANDARUA","NYANDARUA SOUTH","15-19",5952,5492,11444
"37418","NYANDARUA","NYANDARUA SOUTH","20",803,804,1607
"37419","NYANDARUA","NYANDARUA SOUTH","21",727,795,1522
"37420","NYANDARUA","NYANDARUA SOUTH","22",733,698,1431
"37421","NYANDARUA","NYANDARUA SOUTH","23",724,776,1500
"37422","NYANDARUA","NYANDARUA SOUTH","24",646,758,1404
"37423","NYANDARUA","NYANDARUA SOUTH","20-24",3633,3831,7464
"37424","NYANDARUA","NYANDARUA SOUTH","25",698,676,1374
"37425","NYANDARUA","NYANDARUA SOUTH","26",571,617,1188
"37426","NYANDARUA","NYANDARUA SOUTH","27",563,590,1153
"37427","NYANDARUA","NYANDARUA SOUTH","28",490,561,1051
"37428","NYANDARUA","NYANDARUA SOUTH","29",572,596,1168
"37429","NYANDARUA","NYANDARUA SOUTH","25-29",2894,3040,5934
"37430","NYANDARUA","NYANDARUA SOUTH","30",689,841,1530
"37431","NYANDARUA","NYANDARUA SOUTH","31",504,562,1066
"37432","NYANDARUA","NYANDARUA SOUTH","32",651,773,1424
"37433","NYANDARUA","NYANDARUA SOUTH","33",540,697,1237
"37434","NYANDARUA","NYANDARUA SOUTH","34",580,620,1200
"37435","NYANDARUA","NYANDARUA SOUTH","30-34",2964,3493,6457
"37436","NYANDARUA","NYANDARUA SOUTH","35",765,787,1552
"37437","NYANDARUA","NYANDARUA SOUTH","36",535,609,1144
"37438","NYANDARUA","NYANDARUA SOUTH","37",539,587,1126
"37439","NYANDARUA","NYANDARUA SOUTH","38",423,522,945
"37440","NYANDARUA","NYANDARUA SOUTH","39",511,562,1073
"37441","NYANDARUA","NYANDARUA SOUTH","35-39",2773,3067,5840
"37442","NYANDARUA","NYANDARUA SOUTH","40",614,669,1283
"37443","NYANDARUA","NYANDARUA SOUTH","41",534,606,1140
"37444","NYANDARUA","NYANDARUA SOUTH","42",568,583,1151
"37445","NYANDARUA","NYANDARUA SOUTH","43",464,510,974
"37446","NYANDARUA","NYANDARUA SOUTH","44",356,385,741
"37447","NYANDARUA","NYANDARUA SOUTH","40-44",2536,2753,5289
"37448","NYANDARUA","NYANDARUA SOUTH","45",575,664,1239
"37449","NYANDARUA","NYANDARUA SOUTH","46",432,533,965
"37450","NYANDARUA","NYANDARUA SOUTH","47",530,529,1059
"37451","NYANDARUA","NYANDARUA SOUTH","48",349,411,760
"37452","NYANDARUA","NYANDARUA SOUTH","49",410,407,817
"37453","NYANDARUA","NYANDARUA SOUTH","45-49",2296,2544,4840
"37454","NYANDARUA","NYANDARUA SOUTH","50",452,492,944
"37455","NYANDARUA","NYANDARUA SOUTH","51",364,394,758
"37456","NYANDARUA","NYANDARUA SOUTH","52",403,419,822
"37457","NYANDARUA","NYANDARUA SOUTH","53",283,321,604
"37458","NYANDARUA","NYANDARUA SOUTH","54",324,339,663
"37459","NYANDARUA","NYANDARUA SOUTH","50-54",1826,1965,3791
"37460","NYANDARUA","NYANDARUA SOUTH","55",371,325,696
"37461","NYANDARUA","NYANDARUA SOUTH","56",348,312,660
"37462","NYANDARUA","NYANDARUA SOUTH","57",276,316,592
"37463","NYANDARUA","NYANDARUA SOUTH","58",225,254,479
"37464","NYANDARUA","NYANDARUA SOUTH","59",263,279,542
"37465","NYANDARUA","NYANDARUA SOUTH","55-59",1483,1486,2969
"37466","NYANDARUA","NYANDARUA SOUTH","60",289,257,546
"37467","NYANDARUA","NYANDARUA SOUTH","61",192,205,397
"37468","NYANDARUA","NYANDARUA SOUTH","62",175,178,353
"37469","NYANDARUA","NYANDARUA SOUTH","63",146,158,304
"37470","NYANDARUA","NYANDARUA SOUTH","64",106,105,211
"37471","NYANDARUA","NYANDARUA SOUTH","60-64",908,903,1811
"37472","NYANDARUA","NYANDARUA SOUTH","65",177,150,327
"37473","NYANDARUA","NYANDARUA SOUTH","66",102,121,223
"37474","NYANDARUA","NYANDARUA SOUTH","67",161,214,375
"37475","NYANDARUA","NYANDARUA SOUTH","68",64,105,169
"37476","NYANDARUA","NYANDARUA SOUTH","69",99,159,258
"37477","NYANDARUA","NYANDARUA SOUTH","65-69",603,749,1352
"37478","NYANDARUA","NYANDARUA SOUTH","70",145,203,348
"37479","NYANDARUA","NYANDARUA SOUTH","71",125,152,277
"37480","NYANDARUA","NYANDARUA SOUTH","72",116,141,257
"37481","NYANDARUA","NYANDARUA SOUTH","73",90,101,191
"37482","NYANDARUA","NYANDARUA SOUTH","74",81,126,207
"37483","NYANDARUA","NYANDARUA SOUTH","70-74",557,723,1280
"37484","NYANDARUA","NYANDARUA SOUTH","75",71,117,188
"37485","NYANDARUA","NYANDARUA SOUTH","76",89,246,335
"37486","NYANDARUA","NYANDARUA SOUTH","77",55,94,149
"37487","NYANDARUA","NYANDARUA SOUTH","78",34,60,94
"37488","NYANDARUA","NYANDARUA SOUTH","79",54,89,143
"37489","NYANDARUA","NYANDARUA SOUTH","75-79",303,606,909
"37490","NYANDARUA","NYANDARUA SOUTH","80",78,95,173
"37491","NYANDARUA","NYANDARUA SOUTH","81",34,50,84
"37492","NYANDARUA","NYANDARUA SOUTH","82",42,46,88
"37493","NYANDARUA","NYANDARUA SOUTH","83",52,34,86
"37494","NYANDARUA","NYANDARUA SOUTH","84",47,45,92
"37495","NYANDARUA","NYANDARUA SOUTH","80-84",253,270,523
"37496","NYANDARUA","NYANDARUA SOUTH","85",31,45,76
"37497","NYANDARUA","NYANDARUA SOUTH","86",23,42,65
"37498","NYANDARUA","NYANDARUA SOUTH","87",18,34,52
"37499","NYANDARUA","NYANDARUA SOUTH","88",16,17,33
"37500","NYANDARUA","NYANDARUA SOUTH","89",25,34,59
"37501","NYANDARUA","NYANDARUA SOUTH","85-89",113,172,285
"37502","NYANDARUA","NYANDARUA SOUTH","90",21,18,39
"37503","NYANDARUA","NYANDARUA SOUTH","91",19,21,40
"37504","NYANDARUA","NYANDARUA SOUTH","92",8,14,22
"37505","NYANDARUA","NYANDARUA SOUTH","93",2,7,9
"37506","NYANDARUA","NYANDARUA SOUTH","94",6,17,23
"37507","NYANDARUA","NYANDARUA SOUTH","90-94",56,77,133
"37508","NYANDARUA","NYANDARUA SOUTH","95",5,13,18
"37509","NYANDARUA","NYANDARUA SOUTH","96",6,7,13
"37510","NYANDARUA","NYANDARUA SOUTH","97",6,6,12
"37511","NYANDARUA","NYANDARUA SOUTH","98",4,2,6
"37512","NYANDARUA","NYANDARUA SOUTH","99",3,8,11
"37513","NYANDARUA","NYANDARUA SOUTH","95-99",24,36,60
"37514","NYANDARUA","NYANDARUA SOUTH","100+",12,19,31
"37515","NYANDARUA","NYANDARUA SOUTH","Not Stated",1,NA,1
"37516","NYANDARUA","MIRANGINE","Total",33447,33766,67213
"37517","NYANDARUA","MIRANGINE","0",703,765,1468
"37518","NYANDARUA","MIRANGINE","1",740,723,1463
"37519","NYANDARUA","MIRANGINE","2",726,734,1460
"37520","NYANDARUA","MIRANGINE","3",821,765,1586
"37521","NYANDARUA","MIRANGINE","4",806,728,1534
"37522","NYANDARUA","MIRANGINE","0 - 4",3796,3715,7511
"37523","NYANDARUA","MIRANGINE","5",762,737,1499
"37524","NYANDARUA","MIRANGINE","6",776,782,1558
"37525","NYANDARUA","MIRANGINE","7",820,796,1616
"37526","NYANDARUA","MIRANGINE","8",830,836,1666
"37527","NYANDARUA","MIRANGINE","9",941,909,1850
"37528","NYANDARUA","MIRANGINE","5-9",4129,4060,8189
"37529","NYANDARUA","MIRANGINE","10",854,850,1704
"37530","NYANDARUA","MIRANGINE","11",815,874,1689
"37531","NYANDARUA","MIRANGINE","12",1000,934,1934
"37532","NYANDARUA","MIRANGINE","13",989,936,1925
"37533","NYANDARUA","MIRANGINE","14",981,911,1892
"37534","NYANDARUA","MIRANGINE","10 -14",4639,4505,9144
"37535","NYANDARUA","MIRANGINE","15",931,850,1781
"37536","NYANDARUA","MIRANGINE","16",927,907,1834
"37537","NYANDARUA","MIRANGINE","17",950,804,1754
"37538","NYANDARUA","MIRANGINE","18",764,640,1404
"37539","NYANDARUA","MIRANGINE","19",715,642,1357
"37540","NYANDARUA","MIRANGINE","15-19",4287,3843,8130
"37541","NYANDARUA","MIRANGINE","20",610,620,1230
"37542","NYANDARUA","MIRANGINE","21",643,631,1274
"37543","NYANDARUA","MIRANGINE","22",591,572,1163
"37544","NYANDARUA","MIRANGINE","23",544,587,1131
"37545","NYANDARUA","MIRANGINE","24",451,439,890
"37546","NYANDARUA","MIRANGINE","20-24",2839,2849,5688
"37547","NYANDARUA","MIRANGINE","25",507,442,949
"37548","NYANDARUA","MIRANGINE","26",364,404,768
"37549","NYANDARUA","MIRANGINE","27",414,381,795
"37550","NYANDARUA","MIRANGINE","28",342,345,687
"37551","NYANDARUA","MIRANGINE","29",382,415,797
"37552","NYANDARUA","MIRANGINE","25-29",2009,1987,3996
"37553","NYANDARUA","MIRANGINE","30",445,522,967
"37554","NYANDARUA","MIRANGINE","31",353,352,705
"37555","NYANDARUA","MIRANGINE","32",427,550,977
"37556","NYANDARUA","MIRANGINE","33",377,496,873
"37557","NYANDARUA","MIRANGINE","34",360,419,779
"37558","NYANDARUA","MIRANGINE","30-34",1962,2339,4301
"37559","NYANDARUA","MIRANGINE","35",512,551,1063
"37560","NYANDARUA","MIRANGINE","36",345,381,726
"37561","NYANDARUA","MIRANGINE","37",374,359,733
"37562","NYANDARUA","MIRANGINE","38",289,315,604
"37563","NYANDARUA","MIRANGINE","39",370,376,746
"37564","NYANDARUA","MIRANGINE","35-39",1890,1982,3872
"37565","NYANDARUA","MIRANGINE","40",398,379,777
"37566","NYANDARUA","MIRANGINE","41",375,368,743
"37567","NYANDARUA","MIRANGINE","42",370,370,740
"37568","NYANDARUA","MIRANGINE","43",351,323,674
"37569","NYANDARUA","MIRANGINE","44",240,253,493
"37570","NYANDARUA","MIRANGINE","40-44",1734,1693,3427
"37571","NYANDARUA","MIRANGINE","45",397,401,798
"37572","NYANDARUA","MIRANGINE","46",304,345,649
"37573","NYANDARUA","MIRANGINE","47",329,342,671
"37574","NYANDARUA","MIRANGINE","48",267,251,518
"37575","NYANDARUA","MIRANGINE","49",244,308,552
"37576","NYANDARUA","MIRANGINE","45-49",1541,1647,3188
"37577","NYANDARUA","MIRANGINE","50",264,309,573
"37578","NYANDARUA","MIRANGINE","51",261,268,529
"37579","NYANDARUA","MIRANGINE","52",307,291,598
"37580","NYANDARUA","MIRANGINE","53",214,204,418
"37581","NYANDARUA","MIRANGINE","54",256,238,494
"37582","NYANDARUA","MIRANGINE","50-54",1302,1310,2612
"37583","NYANDARUA","MIRANGINE","55",241,240,481
"37584","NYANDARUA","MIRANGINE","56",227,245,472
"37585","NYANDARUA","MIRANGINE","57",193,228,421
"37586","NYANDARUA","MIRANGINE","58",196,177,373
"37587","NYANDARUA","MIRANGINE","59",183,207,390
"37588","NYANDARUA","MIRANGINE","55-59",1040,1097,2137
"37589","NYANDARUA","MIRANGINE","60",192,221,413
"37590","NYANDARUA","MIRANGINE","61",170,163,333
"37591","NYANDARUA","MIRANGINE","62",160,127,287
"37592","NYANDARUA","MIRANGINE","63",109,123,232
"37593","NYANDARUA","MIRANGINE","64",67,84,151
"37594","NYANDARUA","MIRANGINE","60-64",698,718,1416
"37595","NYANDARUA","MIRANGINE","65",132,142,274
"37596","NYANDARUA","MIRANGINE","66",103,100,203
"37597","NYANDARUA","MIRANGINE","67",160,148,308
"37598","NYANDARUA","MIRANGINE","68",79,84,163
"37599","NYANDARUA","MIRANGINE","69",100,130,230
"37600","NYANDARUA","MIRANGINE","65-69",574,604,1178
"37601","NYANDARUA","MIRANGINE","70",111,155,266
"37602","NYANDARUA","MIRANGINE","71",95,117,212
"37603","NYANDARUA","MIRANGINE","72",79,102,181
"37604","NYANDARUA","MIRANGINE","73",75,82,157
"37605","NYANDARUA","MIRANGINE","74",89,101,190
"37606","NYANDARUA","MIRANGINE","70-74",449,557,1006
"37607","NYANDARUA","MIRANGINE","75",60,76,136
"37608","NYANDARUA","MIRANGINE","76",67,135,202
"37609","NYANDARUA","MIRANGINE","77",45,52,97
"37610","NYANDARUA","MIRANGINE","78",33,39,72
"37611","NYANDARUA","MIRANGINE","79",30,59,89
"37612","NYANDARUA","MIRANGINE","75-79",235,361,596
"37613","NYANDARUA","MIRANGINE","80",43,70,113
"37614","NYANDARUA","MIRANGINE","81",32,37,69
"37615","NYANDARUA","MIRANGINE","82",24,32,56
"37616","NYANDARUA","MIRANGINE","83",34,41,75
"37617","NYANDARUA","MIRANGINE","84",28,45,73
"37618","NYANDARUA","MIRANGINE","80-84",161,225,386
"37619","NYANDARUA","MIRANGINE","85",24,26,50
"37620","NYANDARUA","MIRANGINE","86",22,28,50
"37621","NYANDARUA","MIRANGINE","87",20,24,44
"37622","NYANDARUA","MIRANGINE","88",12,12,24
"37623","NYANDARUA","MIRANGINE","89",21,38,59
"37624","NYANDARUA","MIRANGINE","85-89",99,128,227
"37625","NYANDARUA","MIRANGINE","90",10,24,34
"37626","NYANDARUA","MIRANGINE","91",14,21,35
"37627","NYANDARUA","MIRANGINE","92",3,14,17
"37628","NYANDARUA","MIRANGINE","93",8,7,15
"37629","NYANDARUA","MIRANGINE","94",4,17,21
"37630","NYANDARUA","MIRANGINE","90-94",39,83,122
"37631","NYANDARUA","MIRANGINE","95",3,11,14
"37632","NYANDARUA","MIRANGINE","96",NA,8,8
"37633","NYANDARUA","MIRANGINE","97",4,8,12
"37634","NYANDARUA","MIRANGINE","98",5,6,11
"37635","NYANDARUA","MIRANGINE","99",4,11,15
"37636","NYANDARUA","MIRANGINE","95-99",16,44,60
"37637","NYANDARUA","MIRANGINE","100+",7,19,26
"37638","NYANDARUA","MIRANGINE","Not Stated",1,NA,1
"37639","NYANDARUA","KIPIPIRI","Total",46113,47740,93853
"37640","NYANDARUA","KIPIPIRI","0",935,953,1888
"37641","NYANDARUA","KIPIPIRI","1",987,970,1957
"37642","NYANDARUA","KIPIPIRI","2",947,1028,1975
"37643","NYANDARUA","KIPIPIRI","3",1051,1022,2073
"37644","NYANDARUA","KIPIPIRI","4",1054,995,2049
"37645","NYANDARUA","KIPIPIRI","0 - 4",4974,4968,9942
"37646","NYANDARUA","KIPIPIRI","5",1043,1020,2063
"37647","NYANDARUA","KIPIPIRI","6",1021,1062,2083
"37648","NYANDARUA","KIPIPIRI","7",1135,1108,2243
"37649","NYANDARUA","KIPIPIRI","8",1114,1097,2211
"37650","NYANDARUA","KIPIPIRI","9",1252,1246,2498
"37651","NYANDARUA","KIPIPIRI","5-9",5565,5533,11098
"37652","NYANDARUA","KIPIPIRI","10",1216,1179,2395
"37653","NYANDARUA","KIPIPIRI","11",1248,1179,2427
"37654","NYANDARUA","KIPIPIRI","12",1421,1264,2685
"37655","NYANDARUA","KIPIPIRI","13",1406,1395,2801
"37656","NYANDARUA","KIPIPIRI","14",1363,1305,2668
"37657","NYANDARUA","KIPIPIRI","10 -14",6654,6322,12976
"37658","NYANDARUA","KIPIPIRI","15",1419,1315,2734
"37659","NYANDARUA","KIPIPIRI","16",1371,1317,2688
"37660","NYANDARUA","KIPIPIRI","17",1413,1300,2713
"37661","NYANDARUA","KIPIPIRI","18",1055,926,1981
"37662","NYANDARUA","KIPIPIRI","19",1066,962,2028
"37663","NYANDARUA","KIPIPIRI","15-19",6324,5820,12144
"37664","NYANDARUA","KIPIPIRI","20",869,731,1600
"37665","NYANDARUA","KIPIPIRI","21",750,620,1370
"37666","NYANDARUA","KIPIPIRI","22",640,641,1281
"37667","NYANDARUA","KIPIPIRI","23",610,645,1255
"37668","NYANDARUA","KIPIPIRI","24",578,573,1151
"37669","NYANDARUA","KIPIPIRI","20-24",3447,3210,6657
"37670","NYANDARUA","KIPIPIRI","25",575,551,1126
"37671","NYANDARUA","KIPIPIRI","26",461,487,948
"37672","NYANDARUA","KIPIPIRI","27",475,503,978
"37673","NYANDARUA","KIPIPIRI","28",437,456,893
"37674","NYANDARUA","KIPIPIRI","29",489,551,1040
"37675","NYANDARUA","KIPIPIRI","25-29",2437,2548,4985
"37676","NYANDARUA","KIPIPIRI","30",543,630,1173
"37677","NYANDARUA","KIPIPIRI","31",443,561,1004
"37678","NYANDARUA","KIPIPIRI","32",555,625,1180
"37679","NYANDARUA","KIPIPIRI","33",455,635,1090
"37680","NYANDARUA","KIPIPIRI","34",515,554,1069
"37681","NYANDARUA","KIPIPIRI","30-34",2511,3005,5516
"37682","NYANDARUA","KIPIPIRI","35",656,701,1357
"37683","NYANDARUA","KIPIPIRI","36",484,526,1010
"37684","NYANDARUA","KIPIPIRI","37",550,532,1082
"37685","NYANDARUA","KIPIPIRI","38",390,483,873
"37686","NYANDARUA","KIPIPIRI","39",480,524,1004
"37687","NYANDARUA","KIPIPIRI","35-39",2560,2766,5326
"37688","NYANDARUA","KIPIPIRI","40",498,553,1051
"37689","NYANDARUA","KIPIPIRI","41",536,566,1102
"37690","NYANDARUA","KIPIPIRI","42",496,549,1045
"37691","NYANDARUA","KIPIPIRI","43",422,492,914
"37692","NYANDARUA","KIPIPIRI","44",395,460,855
"37693","NYANDARUA","KIPIPIRI","40-44",2347,2620,4967
"37694","NYANDARUA","KIPIPIRI","45",530,623,1153
"37695","NYANDARUA","KIPIPIRI","46",410,520,930
"37696","NYANDARUA","KIPIPIRI","47",488,505,993
"37697","NYANDARUA","KIPIPIRI","48",357,385,742
"37698","NYANDARUA","KIPIPIRI","49",422,420,842
"37699","NYANDARUA","KIPIPIRI","45-49",2207,2453,4660
"37700","NYANDARUA","KIPIPIRI","50",449,537,986
"37701","NYANDARUA","KIPIPIRI","51",371,407,778
"37702","NYANDARUA","KIPIPIRI","52",390,416,806
"37703","NYANDARUA","KIPIPIRI","53",283,311,594
"37704","NYANDARUA","KIPIPIRI","54",324,400,724
"37705","NYANDARUA","KIPIPIRI","50-54",1817,2071,3888
"37706","NYANDARUA","KIPIPIRI","55",384,400,784
"37707","NYANDARUA","KIPIPIRI","56",375,376,751
"37708","NYANDARUA","KIPIPIRI","57",292,388,680
"37709","NYANDARUA","KIPIPIRI","58",289,274,563
"37710","NYANDARUA","KIPIPIRI","59",262,321,583
"37711","NYANDARUA","KIPIPIRI","55-59",1602,1759,3361
"37712","NYANDARUA","KIPIPIRI","60",293,320,613
"37713","NYANDARUA","KIPIPIRI","61",236,268,504
"37714","NYANDARUA","KIPIPIRI","62",206,201,407
"37715","NYANDARUA","KIPIPIRI","63",175,178,353
"37716","NYANDARUA","KIPIPIRI","64",113,147,260
"37717","NYANDARUA","KIPIPIRI","60-64",1023,1114,2137
"37718","NYANDARUA","KIPIPIRI","65",219,186,405
"37719","NYANDARUA","KIPIPIRI","66",144,150,294
"37720","NYANDARUA","KIPIPIRI","67",251,262,513
"37721","NYANDARUA","KIPIPIRI","68",94,136,230
"37722","NYANDARUA","KIPIPIRI","69",151,202,353
"37723","NYANDARUA","KIPIPIRI","65-69",859,936,1795
"37724","NYANDARUA","KIPIPIRI","70",193,263,456
"37725","NYANDARUA","KIPIPIRI","71",148,184,332
"37726","NYANDARUA","KIPIPIRI","72",123,168,291
"37727","NYANDARUA","KIPIPIRI","73",120,149,269
"37728","NYANDARUA","KIPIPIRI","74",109,140,249
"37729","NYANDARUA","KIPIPIRI","70-74",693,904,1597
"37730","NYANDARUA","KIPIPIRI","75",91,167,258
"37731","NYANDARUA","KIPIPIRI","76",132,310,442
"37732","NYANDARUA","KIPIPIRI","77",95,113,208
"37733","NYANDARUA","KIPIPIRI","78",66,97,163
"37734","NYANDARUA","KIPIPIRI","79",72,122,194
"37735","NYANDARUA","KIPIPIRI","75-79",456,809,1265
"37736","NYANDARUA","KIPIPIRI","80",79,130,209
"37737","NYANDARUA","KIPIPIRI","81",56,70,126
"37738","NYANDARUA","KIPIPIRI","82",47,49,96
"37739","NYANDARUA","KIPIPIRI","83",90,67,157
"37740","NYANDARUA","KIPIPIRI","84",56,74,130
"37741","NYANDARUA","KIPIPIRI","80-84",328,390,718
"37742","NYANDARUA","KIPIPIRI","85",39,56,95
"37743","NYANDARUA","KIPIPIRI","86",30,59,89
"37744","NYANDARUA","KIPIPIRI","87",33,59,92
"37745","NYANDARUA","KIPIPIRI","88",19,34,53
"37746","NYANDARUA","KIPIPIRI","89",33,66,99
"37747","NYANDARUA","KIPIPIRI","85-89",154,274,428
"37748","NYANDARUA","KIPIPIRI","90",33,46,79
"37749","NYANDARUA","KIPIPIRI","91",36,33,69
"37750","NYANDARUA","KIPIPIRI","92",16,19,35
"37751","NYANDARUA","KIPIPIRI","93",9,19,28
"37752","NYANDARUA","KIPIPIRI","94",4,13,17
"37753","NYANDARUA","KIPIPIRI","90-94",98,130,228
"37754","NYANDARUA","KIPIPIRI","95",9,25,34
"37755","NYANDARUA","KIPIPIRI","96",8,12,20
"37756","NYANDARUA","KIPIPIRI","97",10,17,27
"37757","NYANDARUA","KIPIPIRI","98",5,9,14
"37758","NYANDARUA","KIPIPIRI","99",9,10,19
"37759","NYANDARUA","KIPIPIRI","95-99",41,73,114
"37760","NYANDARUA","KIPIPIRI","100+",16,35,51
"37761","NYANDARUA","KIPIPIRI","Not Stated",NA,NA,NA
"37762","NYANDARUA","NYANDARUA CENTRA","Total",37329,37931,75260
"37763","NYANDARUA","NYANDARUA CENTRA","0",874,927,1801
"37764","NYANDARUA","NYANDARUA CENTRA","1",890,866,1756
"37765","NYANDARUA","NYANDARUA CENTRA","2",886,843,1729
"37766","NYANDARUA","NYANDARUA CENTRA","3",881,833,1714
"37767","NYANDARUA","NYANDARUA CENTRA","4",842,788,1630
"37768","NYANDARUA","NYANDARUA CENTRA","0 - 4",4373,4257,8630
"37769","NYANDARUA","NYANDARUA CENTRA","5",887,808,1695
"37770","NYANDARUA","NYANDARUA CENTRA","6",910,867,1777
"37771","NYANDARUA","NYANDARUA CENTRA","7",908,824,1732
"37772","NYANDARUA","NYANDARUA CENTRA","8",850,821,1671
"37773","NYANDARUA","NYANDARUA CENTRA","9",990,942,1932
"37774","NYANDARUA","NYANDARUA CENTRA","5-9",4545,4262,8807
"37775","NYANDARUA","NYANDARUA CENTRA","10",938,880,1818
"37776","NYANDARUA","NYANDARUA CENTRA","11",876,829,1705
"37777","NYANDARUA","NYANDARUA CENTRA","12",957,949,1906
"37778","NYANDARUA","NYANDARUA CENTRA","13",996,987,1983
"37779","NYANDARUA","NYANDARUA CENTRA","14",1055,974,2029
"37780","NYANDARUA","NYANDARUA CENTRA","10 -14",4822,4619,9441
"37781","NYANDARUA","NYANDARUA CENTRA","15",962,895,1857
"37782","NYANDARUA","NYANDARUA CENTRA","16",965,908,1873
"37783","NYANDARUA","NYANDARUA CENTRA","17",984,866,1850
"37784","NYANDARUA","NYANDARUA CENTRA","18",791,666,1457
"37785","NYANDARUA","NYANDARUA CENTRA","19",795,712,1507
"37786","NYANDARUA","NYANDARUA CENTRA","15-19",4497,4047,8544
"37787","NYANDARUA","NYANDARUA CENTRA","20",614,631,1245
"37788","NYANDARUA","NYANDARUA CENTRA","21",561,605,1166
"37789","NYANDARUA","NYANDARUA CENTRA","22",592,588,1180
"37790","NYANDARUA","NYANDARUA CENTRA","23",612,639,1251
"37791","NYANDARUA","NYANDARUA CENTRA","24",543,650,1193
"37792","NYANDARUA","NYANDARUA CENTRA","20-24",2922,3113,6035
"37793","NYANDARUA","NYANDARUA CENTRA","25",570,574,1144
"37794","NYANDARUA","NYANDARUA CENTRA","26",445,543,988
"37795","NYANDARUA","NYANDARUA CENTRA","27",499,487,986
"37796","NYANDARUA","NYANDARUA CENTRA","28",450,480,930
"37797","NYANDARUA","NYANDARUA CENTRA","29",484,521,1005
"37798","NYANDARUA","NYANDARUA CENTRA","25-29",2448,2605,5053
"37799","NYANDARUA","NYANDARUA CENTRA","30",582,615,1197
"37800","NYANDARUA","NYANDARUA CENTRA","31",479,489,968
"37801","NYANDARUA","NYANDARUA CENTRA","32",547,615,1162
"37802","NYANDARUA","NYANDARUA CENTRA","33",446,512,958
"37803","NYANDARUA","NYANDARUA CENTRA","34",465,533,998
"37804","NYANDARUA","NYANDARUA CENTRA","30-34",2519,2764,5283
"37805","NYANDARUA","NYANDARUA CENTRA","35",646,605,1251
"37806","NYANDARUA","NYANDARUA CENTRA","36",417,507,924
"37807","NYANDARUA","NYANDARUA CENTRA","37",437,435,872
"37808","NYANDARUA","NYANDARUA CENTRA","38",411,394,805
"37809","NYANDARUA","NYANDARUA CENTRA","39",364,442,806
"37810","NYANDARUA","NYANDARUA CENTRA","35-39",2275,2383,4658
"37811","NYANDARUA","NYANDARUA CENTRA","40",502,526,1028
"37812","NYANDARUA","NYANDARUA CENTRA","41",442,430,872
"37813","NYANDARUA","NYANDARUA CENTRA","42",391,468,859
"37814","NYANDARUA","NYANDARUA CENTRA","43",337,389,726
"37815","NYANDARUA","NYANDARUA CENTRA","44",293,305,598
"37816","NYANDARUA","NYANDARUA CENTRA","40-44",1965,2118,4083
"37817","NYANDARUA","NYANDARUA CENTRA","45",457,464,921
"37818","NYANDARUA","NYANDARUA CENTRA","46",357,348,705
"37819","NYANDARUA","NYANDARUA CENTRA","47",379,374,753
"37820","NYANDARUA","NYANDARUA CENTRA","48",269,279,548
"37821","NYANDARUA","NYANDARUA CENTRA","49",327,348,675
"37822","NYANDARUA","NYANDARUA CENTRA","45-49",1789,1813,3602
"37823","NYANDARUA","NYANDARUA CENTRA","50",320,411,731
"37824","NYANDARUA","NYANDARUA CENTRA","51",292,313,605
"37825","NYANDARUA","NYANDARUA CENTRA","52",298,315,613
"37826","NYANDARUA","NYANDARUA CENTRA","53",222,251,473
"37827","NYANDARUA","NYANDARUA CENTRA","54",238,315,553
"37828","NYANDARUA","NYANDARUA CENTRA","50-54",1370,1605,2975
"37829","NYANDARUA","NYANDARUA CENTRA","55",292,255,547
"37830","NYANDARUA","NYANDARUA CENTRA","56",298,269,567
"37831","NYANDARUA","NYANDARUA CENTRA","57",245,264,509
"37832","NYANDARUA","NYANDARUA CENTRA","58",221,222,443
"37833","NYANDARUA","NYANDARUA CENTRA","59",229,237,466
"37834","NYANDARUA","NYANDARUA CENTRA","55-59",1285,1247,2532
"37835","NYANDARUA","NYANDARUA CENTRA","60",229,250,479
"37836","NYANDARUA","NYANDARUA CENTRA","61",167,177,344
"37837","NYANDARUA","NYANDARUA CENTRA","62",162,161,323
"37838","NYANDARUA","NYANDARUA CENTRA","63",141,135,276
"37839","NYANDARUA","NYANDARUA CENTRA","64",95,81,176
"37840","NYANDARUA","NYANDARUA CENTRA","60-64",794,804,1598
"37841","NYANDARUA","NYANDARUA CENTRA","65",165,148,313
"37842","NYANDARUA","NYANDARUA CENTRA","66",121,112,233
"37843","NYANDARUA","NYANDARUA CENTRA","67",162,178,340
"37844","NYANDARUA","NYANDARUA CENTRA","68",70,93,163
"37845","NYANDARUA","NYANDARUA CENTRA","69",111,138,249
"37846","NYANDARUA","NYANDARUA CENTRA","65-69",629,669,1298
"37847","NYANDARUA","NYANDARUA CENTRA","70",151,178,329
"37848","NYANDARUA","NYANDARUA CENTRA","71",82,108,190
"37849","NYANDARUA","NYANDARUA CENTRA","72",94,105,199
"37850","NYANDARUA","NYANDARUA CENTRA","73",62,80,142
"37851","NYANDARUA","NYANDARUA CENTRA","74",72,95,167
"37852","NYANDARUA","NYANDARUA CENTRA","70-74",461,566,1027
"37853","NYANDARUA","NYANDARUA CENTRA","75",51,112,163
"37854","NYANDARUA","NYANDARUA CENTRA","76",78,157,235
"37855","NYANDARUA","NYANDARUA CENTRA","77",46,74,120
"37856","NYANDARUA","NYANDARUA CENTRA","78",29,54,83
"37857","NYANDARUA","NYANDARUA CENTRA","79",39,64,103
"37858","NYANDARUA","NYANDARUA CENTRA","75-79",243,461,704
"37859","NYANDARUA","NYANDARUA CENTRA","80",66,85,151
"37860","NYANDARUA","NYANDARUA CENTRA","81",29,60,89
"37861","NYANDARUA","NYANDARUA CENTRA","82",32,37,69
"37862","NYANDARUA","NYANDARUA CENTRA","83",45,38,83
"37863","NYANDARUA","NYANDARUA CENTRA","84",37,70,107
"37864","NYANDARUA","NYANDARUA CENTRA","80-84",209,290,499
"37865","NYANDARUA","NYANDARUA CENTRA","85",29,43,72
"37866","NYANDARUA","NYANDARUA CENTRA","86",15,31,46
"37867","NYANDARUA","NYANDARUA CENTRA","87",26,23,49
"37868","NYANDARUA","NYANDARUA CENTRA","88",11,17,28
"37869","NYANDARUA","NYANDARUA CENTRA","89",21,48,69
"37870","NYANDARUA","NYANDARUA CENTRA","85-89",102,162,264
"37871","NYANDARUA","NYANDARUA CENTRA","90",16,34,50
"37872","NYANDARUA","NYANDARUA CENTRA","91",16,12,28
"37873","NYANDARUA","NYANDARUA CENTRA","92",5,8,13
"37874","NYANDARUA","NYANDARUA CENTRA","93",5,10,15
"37875","NYANDARUA","NYANDARUA CENTRA","94",5,17,22
"37876","NYANDARUA","NYANDARUA CENTRA","90-94",47,81,128
"37877","NYANDARUA","NYANDARUA CENTRA","95",7,13,20
"37878","NYANDARUA","NYANDARUA CENTRA","96",2,8,10
"37879","NYANDARUA","NYANDARUA CENTRA","97",6,7,13
"37880","NYANDARUA","NYANDARUA CENTRA","98",4,3,7
"37881","NYANDARUA","NYANDARUA CENTRA","99",5,9,14
"37882","NYANDARUA","NYANDARUA CENTRA","95-99",24,40,64
"37883","NYANDARUA","NYANDARUA CENTRA","100+",10,24,34
"37884","NYANDARUA","NYANDARUA CENTRA","Not Stated",NA,1,1
"37885","NYANDARUA","NYANDARUA WEST","Total",48752,49209,97961
"37886","NYANDARUA","NYANDARUA WEST","0",1091,1076,2167
"37887","NYANDARUA","NYANDARUA WEST","1",988,1044,2032
"37888","NYANDARUA","NYANDARUA WEST","2",1152,1025,2177
"37889","NYANDARUA","NYANDARUA WEST","3",1034,1084,2118
"37890","NYANDARUA","NYANDARUA WEST","4",1131,1073,2204
"37891","NYANDARUA","NYANDARUA WEST","0 - 4",5396,5302,10698
"37892","NYANDARUA","NYANDARUA WEST","5",1161,1025,2186
"37893","NYANDARUA","NYANDARUA WEST","6",1110,1104,2214
"37894","NYANDARUA","NYANDARUA WEST","7",1118,1128,2246
"37895","NYANDARUA","NYANDARUA WEST","8",1131,1046,2177
"37896","NYANDARUA","NYANDARUA WEST","9",1205,1206,2411
"37897","NYANDARUA","NYANDARUA WEST","5-9",5725,5509,11234
"37898","NYANDARUA","NYANDARUA WEST","10",1226,1099,2325
"37899","NYANDARUA","NYANDARUA WEST","11",1100,1071,2171
"37900","NYANDARUA","NYANDARUA WEST","12",1247,1128,2375
"37901","NYANDARUA","NYANDARUA WEST","13",1270,1154,2424
"37902","NYANDARUA","NYANDARUA WEST","14",1326,1111,2437
"37903","NYANDARUA","NYANDARUA WEST","10 -14",6169,5563,11732
"37904","NYANDARUA","NYANDARUA WEST","15",1246,1107,2353
"37905","NYANDARUA","NYANDARUA WEST","16",1167,1087,2254
"37906","NYANDARUA","NYANDARUA WEST","17",1278,1169,2447
"37907","NYANDARUA","NYANDARUA WEST","18",952,891,1843
"37908","NYANDARUA","NYANDARUA WEST","19",1009,898,1907
"37909","NYANDARUA","NYANDARUA WEST","15-19",5652,5152,10804
"37910","NYANDARUA","NYANDARUA WEST","20",844,857,1701
"37911","NYANDARUA","NYANDARUA WEST","21",828,771,1599
"37912","NYANDARUA","NYANDARUA WEST","22",844,776,1620
"37913","NYANDARUA","NYANDARUA WEST","23",778,834,1612
"37914","NYANDARUA","NYANDARUA WEST","24",698,693,1391
"37915","NYANDARUA","NYANDARUA WEST","20-24",3992,3931,7923
"37916","NYANDARUA","NYANDARUA WEST","25",785,777,1562
"37917","NYANDARUA","NYANDARUA WEST","26",599,696,1295
"37918","NYANDARUA","NYANDARUA WEST","27",637,699,1336
"37919","NYANDARUA","NYANDARUA WEST","28",593,663,1256
"37920","NYANDARUA","NYANDARUA WEST","29",655,625,1280
"37921","NYANDARUA","NYANDARUA WEST","25-29",3269,3460,6729
"37922","NYANDARUA","NYANDARUA WEST","30",789,860,1649
"37923","NYANDARUA","NYANDARUA WEST","31",596,539,1135
"37924","NYANDARUA","NYANDARUA WEST","32",660,782,1442
"37925","NYANDARUA","NYANDARUA WEST","33",593,670,1263
"37926","NYANDARUA","NYANDARUA WEST","34",564,625,1189
"37927","NYANDARUA","NYANDARUA WEST","30-34",3202,3476,6678
"37928","NYANDARUA","NYANDARUA WEST","35",846,911,1757
"37929","NYANDARUA","NYANDARUA WEST","36",582,598,1180
"37930","NYANDARUA","NYANDARUA WEST","37",593,636,1229
"37931","NYANDARUA","NYANDARUA WEST","38",499,562,1061
"37932","NYANDARUA","NYANDARUA WEST","39",579,621,1200
"37933","NYANDARUA","NYANDARUA WEST","35-39",3099,3328,6427
"37934","NYANDARUA","NYANDARUA WEST","40",654,669,1323
"37935","NYANDARUA","NYANDARUA WEST","41",621,625,1246
"37936","NYANDARUA","NYANDARUA WEST","42",535,561,1096
"37937","NYANDARUA","NYANDARUA WEST","43",479,516,995
"37938","NYANDARUA","NYANDARUA WEST","44",425,425,850
"37939","NYANDARUA","NYANDARUA WEST","40-44",2714,2796,5510
"37940","NYANDARUA","NYANDARUA WEST","45",599,649,1248
"37941","NYANDARUA","NYANDARUA WEST","46",466,517,983
"37942","NYANDARUA","NYANDARUA WEST","47",489,539,1028
"37943","NYANDARUA","NYANDARUA WEST","48",376,456,832
"37944","NYANDARUA","NYANDARUA WEST","49",447,483,930
"37945","NYANDARUA","NYANDARUA WEST","45-49",2377,2644,5021
"37946","NYANDARUA","NYANDARUA WEST","50",518,524,1042
"37947","NYANDARUA","NYANDARUA WEST","51",392,382,774
"37948","NYANDARUA","NYANDARUA WEST","52",425,461,886
"37949","NYANDARUA","NYANDARUA WEST","53",299,375,674
"37950","NYANDARUA","NYANDARUA WEST","54",362,379,741
"37951","NYANDARUA","NYANDARUA WEST","50-54",1996,2121,4117
"37952","NYANDARUA","NYANDARUA WEST","55",404,437,841
"37953","NYANDARUA","NYANDARUA WEST","56",414,431,845
"37954","NYANDARUA","NYANDARUA WEST","57",276,358,634
"37955","NYANDARUA","NYANDARUA WEST","58",331,358,689
"37956","NYANDARUA","NYANDARUA WEST","59",305,313,618
"37957","NYANDARUA","NYANDARUA WEST","55-59",1730,1897,3627
"37958","NYANDARUA","NYANDARUA WEST","60",342,374,716
"37959","NYANDARUA","NYANDARUA WEST","61",258,246,504
"37960","NYANDARUA","NYANDARUA WEST","62",227,210,437
"37961","NYANDARUA","NYANDARUA WEST","63",190,184,374
"37962","NYANDARUA","NYANDARUA WEST","64",120,148,268
"37963","NYANDARUA","NYANDARUA WEST","60-64",1137,1162,2299
"37964","NYANDARUA","NYANDARUA WEST","65",221,215,436
"37965","NYANDARUA","NYANDARUA WEST","66",128,135,263
"37966","NYANDARUA","NYANDARUA WEST","67",244,254,498
"37967","NYANDARUA","NYANDARUA WEST","68",80,104,184
"37968","NYANDARUA","NYANDARUA WEST","69",163,169,332
"37969","NYANDARUA","NYANDARUA WEST","65-69",836,877,1713
"37970","NYANDARUA","NYANDARUA WEST","70",183,267,450
"37971","NYANDARUA","NYANDARUA WEST","71",124,157,281
"37972","NYANDARUA","NYANDARUA WEST","72",135,108,243
"37973","NYANDARUA","NYANDARUA WEST","73",91,112,203
"37974","NYANDARUA","NYANDARUA WEST","74",107,105,212
"37975","NYANDARUA","NYANDARUA WEST","70-74",640,749,1389
"37976","NYANDARUA","NYANDARUA WEST","75",91,116,207
"37977","NYANDARUA","NYANDARUA WEST","76",128,205,333
"37978","NYANDARUA","NYANDARUA WEST","77",65,84,149
"37979","NYANDARUA","NYANDARUA WEST","78",44,58,102
"37980","NYANDARUA","NYANDARUA WEST","79",51,84,135
"37981","NYANDARUA","NYANDARUA WEST","75-79",379,547,926
"37982","NYANDARUA","NYANDARUA WEST","80",73,114,187
"37983","NYANDARUA","NYANDARUA WEST","81",38,51,89
"37984","NYANDARUA","NYANDARUA WEST","82",35,51,86
"37985","NYANDARUA","NYANDARUA WEST","83",38,41,79
"37986","NYANDARUA","NYANDARUA WEST","84",52,56,108
"37987","NYANDARUA","NYANDARUA WEST","80-84",236,313,549
"37988","NYANDARUA","NYANDARUA WEST","85",38,57,95
"37989","NYANDARUA","NYANDARUA WEST","86",18,45,63
"37990","NYANDARUA","NYANDARUA WEST","87",23,26,49
"37991","NYANDARUA","NYANDARUA WEST","88",14,18,32
"37992","NYANDARUA","NYANDARUA WEST","89",31,48,79
"37993","NYANDARUA","NYANDARUA WEST","85-89",124,194,318
"37994","NYANDARUA","NYANDARUA WEST","90",13,33,46
"37995","NYANDARUA","NYANDARUA WEST","91",21,31,52
"37996","NYANDARUA","NYANDARUA WEST","92",7,16,23
"37997","NYANDARUA","NYANDARUA WEST","93",9,12,21
"37998","NYANDARUA","NYANDARUA WEST","94",2,12,14
"37999","NYANDARUA","NYANDARUA WEST","90-94",52,104,156
"38000","NYANDARUA","NYANDARUA WEST","95",8,12,20
"38001","NYANDARUA","NYANDARUA WEST","96",1,8,9
"38002","NYANDARUA","NYANDARUA WEST","97",2,10,12
"38003","NYANDARUA","NYANDARUA WEST","98",3,7,10
"38004","NYANDARUA","NYANDARUA WEST","99",3,14,17
"38005","NYANDARUA","NYANDARUA WEST","95-99",17,51,68
"38006","NYANDARUA","NYANDARUA WEST","100+",10,33,43
"38007","NYANDARUA","NYANDARUA WEST","Not Stated",NA,NA,NA
"38008","NYANDARUA","NYANDARUA NORTH","Total",48486,50210,98696
"38009","NYANDARUA","NYANDARUA NORTH","0",996,998,1994
"38010","NYANDARUA","NYANDARUA NORTH","1",1084,977,2061
"38011","NYANDARUA","NYANDARUA NORTH","2",1102,1022,2124
"38012","NYANDARUA","NYANDARUA NORTH","3",1052,1082,2134
"38013","NYANDARUA","NYANDARUA NORTH","4",1152,1052,2204
"38014","NYANDARUA","NYANDARUA NORTH","0 - 4",5386,5131,10517
"38015","NYANDARUA","NYANDARUA NORTH","5",1126,1082,2208
"38016","NYANDARUA","NYANDARUA NORTH","6",1056,1127,2183
"38017","NYANDARUA","NYANDARUA NORTH","7",1229,1115,2344
"38018","NYANDARUA","NYANDARUA NORTH","8",1097,1131,2228
"38019","NYANDARUA","NYANDARUA NORTH","9",1252,1241,2493
"38020","NYANDARUA","NYANDARUA NORTH","5-9",5760,5696,11456
"38021","NYANDARUA","NYANDARUA NORTH","10",1295,1203,2498
"38022","NYANDARUA","NYANDARUA NORTH","11",1145,1177,2322
"38023","NYANDARUA","NYANDARUA NORTH","12",1321,1252,2573
"38024","NYANDARUA","NYANDARUA NORTH","13",1300,1234,2534
"38025","NYANDARUA","NYANDARUA NORTH","14",1431,1302,2733
"38026","NYANDARUA","NYANDARUA NORTH","10 -14",6492,6168,12660
"38027","NYANDARUA","NYANDARUA NORTH","15",1314,1232,2546
"38028","NYANDARUA","NYANDARUA NORTH","16",1303,1184,2487
"38029","NYANDARUA","NYANDARUA NORTH","17",1321,1178,2499
"38030","NYANDARUA","NYANDARUA NORTH","18",1002,901,1903
"38031","NYANDARUA","NYANDARUA NORTH","19",971,891,1862
"38032","NYANDARUA","NYANDARUA NORTH","15-19",5911,5386,11297
"38033","NYANDARUA","NYANDARUA NORTH","20",804,696,1500
"38034","NYANDARUA","NYANDARUA NORTH","21",717,664,1381
"38035","NYANDARUA","NYANDARUA NORTH","22",640,617,1257
"38036","NYANDARUA","NYANDARUA NORTH","23",557,601,1158
"38037","NYANDARUA","NYANDARUA NORTH","24",534,558,1092
"38038","NYANDARUA","NYANDARUA NORTH","20-24",3252,3136,6388
"38039","NYANDARUA","NYANDARUA NORTH","25",572,596,1168
"38040","NYANDARUA","NYANDARUA NORTH","26",450,516,966
"38041","NYANDARUA","NYANDARUA NORTH","27",439,574,1013
"38042","NYANDARUA","NYANDARUA NORTH","28",437,519,956
"38043","NYANDARUA","NYANDARUA NORTH","29",492,592,1084
"38044","NYANDARUA","NYANDARUA NORTH","25-29",2390,2797,5187
"38045","NYANDARUA","NYANDARUA NORTH","30",629,746,1375
"38046","NYANDARUA","NYANDARUA NORTH","31",491,547,1038
"38047","NYANDARUA","NYANDARUA NORTH","32",618,709,1327
"38048","NYANDARUA","NYANDARUA NORTH","33",535,656,1191
"38049","NYANDARUA","NYANDARUA NORTH","34",555,637,1192
"38050","NYANDARUA","NYANDARUA NORTH","30-34",2828,3295,6123
"38051","NYANDARUA","NYANDARUA NORTH","35",769,809,1578
"38052","NYANDARUA","NYANDARUA NORTH","36",547,633,1180
"38053","NYANDARUA","NYANDARUA NORTH","37",571,579,1150
"38054","NYANDARUA","NYANDARUA NORTH","38",454,542,996
"38055","NYANDARUA","NYANDARUA NORTH","39",598,606,1204
"38056","NYANDARUA","NYANDARUA NORTH","35-39",2939,3169,6108
"38057","NYANDARUA","NYANDARUA NORTH","40",688,743,1431
"38058","NYANDARUA","NYANDARUA NORTH","41",580,621,1201
"38059","NYANDARUA","NYANDARUA NORTH","42",517,621,1138
"38060","NYANDARUA","NYANDARUA NORTH","43",461,562,1023
"38061","NYANDARUA","NYANDARUA NORTH","44",407,435,842
"38062","NYANDARUA","NYANDARUA NORTH","40-44",2653,2982,5635
"38063","NYANDARUA","NYANDARUA NORTH","45",619,622,1241
"38064","NYANDARUA","NYANDARUA NORTH","46",466,477,943
"38065","NYANDARUA","NYANDARUA NORTH","47",538,557,1095
"38066","NYANDARUA","NYANDARUA NORTH","48",398,435,833
"38067","NYANDARUA","NYANDARUA NORTH","49",466,509,975
"38068","NYANDARUA","NYANDARUA NORTH","45-49",2487,2600,5087
"38069","NYANDARUA","NYANDARUA NORTH","50",540,567,1107
"38070","NYANDARUA","NYANDARUA NORTH","51",436,478,914
"38071","NYANDARUA","NYANDARUA NORTH","52",462,485,947
"38072","NYANDARUA","NYANDARUA NORTH","53",357,401,758
"38073","NYANDARUA","NYANDARUA NORTH","54",405,463,868
"38074","NYANDARUA","NYANDARUA NORTH","50-54",2200,2394,4594
"38075","NYANDARUA","NYANDARUA NORTH","55",427,496,923
"38076","NYANDARUA","NYANDARUA NORTH","56",422,477,899
"38077","NYANDARUA","NYANDARUA NORTH","57",356,460,816
"38078","NYANDARUA","NYANDARUA NORTH","58",325,320,645
"38079","NYANDARUA","NYANDARUA NORTH","59",322,383,705
"38080","NYANDARUA","NYANDARUA NORTH","55-59",1852,2136,3988
"38081","NYANDARUA","NYANDARUA NORTH","60",378,391,769
"38082","NYANDARUA","NYANDARUA NORTH","61",257,321,578
"38083","NYANDARUA","NYANDARUA NORTH","62",274,275,549
"38084","NYANDARUA","NYANDARUA NORTH","63",195,212,407
"38085","NYANDARUA","NYANDARUA NORTH","64",139,186,325
"38086","NYANDARUA","NYANDARUA NORTH","60-64",1243,1385,2628
"38087","NYANDARUA","NYANDARUA NORTH","65",236,269,505
"38088","NYANDARUA","NYANDARUA NORTH","66",172,186,358
"38089","NYANDARUA","NYANDARUA NORTH","67",303,338,641
"38090","NYANDARUA","NYANDARUA NORTH","68",118,140,258
"38091","NYANDARUA","NYANDARUA NORTH","69",203,217,420
"38092","NYANDARUA","NYANDARUA NORTH","65-69",1032,1150,2182
"38093","NYANDARUA","NYANDARUA NORTH","70",272,320,592
"38094","NYANDARUA","NYANDARUA NORTH","71",193,220,413
"38095","NYANDARUA","NYANDARUA NORTH","72",178,190,368
"38096","NYANDARUA","NYANDARUA NORTH","73",135,144,279
"38097","NYANDARUA","NYANDARUA NORTH","74",142,179,321
"38098","NYANDARUA","NYANDARUA NORTH","70-74",920,1053,1973
"38099","NYANDARUA","NYANDARUA NORTH","75",139,176,315
"38100","NYANDARUA","NYANDARUA NORTH","76",155,299,454
"38101","NYANDARUA","NYANDARUA NORTH","77",97,136,233
"38102","NYANDARUA","NYANDARUA NORTH","78",62,91,153
"38103","NYANDARUA","NYANDARUA NORTH","79",83,99,182
"38104","NYANDARUA","NYANDARUA NORTH","75-79",536,801,1337
"38105","NYANDARUA","NYANDARUA NORTH","80",103,169,272
"38106","NYANDARUA","NYANDARUA NORTH","81",57,88,145
"38107","NYANDARUA","NYANDARUA NORTH","82",54,51,105
"38108","NYANDARUA","NYANDARUA NORTH","83",67,60,127
"38109","NYANDARUA","NYANDARUA NORTH","84",49,68,117
"38110","NYANDARUA","NYANDARUA NORTH","80-84",330,436,766
"38111","NYANDARUA","NYANDARUA NORTH","85",43,66,109
"38112","NYANDARUA","NYANDARUA NORTH","86",34,49,83
"38113","NYANDARUA","NYANDARUA NORTH","87",27,57,84
"38114","NYANDARUA","NYANDARUA NORTH","88",14,25,39
"38115","NYANDARUA","NYANDARUA NORTH","89",30,68,98
"38116","NYANDARUA","NYANDARUA NORTH","85-89",148,265,413
"38117","NYANDARUA","NYANDARUA NORTH","90",24,35,59
"38118","NYANDARUA","NYANDARUA NORTH","91",26,45,71
"38119","NYANDARUA","NYANDARUA NORTH","92",11,17,28
"38120","NYANDARUA","NYANDARUA NORTH","93",8,9,17
"38121","NYANDARUA","NYANDARUA NORTH","94",4,14,18
"38122","NYANDARUA","NYANDARUA NORTH","90-94",73,120,193
"38123","NYANDARUA","NYANDARUA NORTH","95",11,23,34
"38124","NYANDARUA","NYANDARUA NORTH","96",6,10,16
"38125","NYANDARUA","NYANDARUA NORTH","97",9,20,29
"38126","NYANDARUA","NYANDARUA NORTH","98",3,6,9
"38127","NYANDARUA","NYANDARUA NORTH","99",11,16,27
"38128","NYANDARUA","NYANDARUA NORTH","95-99",40,75,115
"38129","NYANDARUA","NYANDARUA NORTH","100+",14,35,49
"38130","NYANDARUA","NYANDARUA NORTH","Not Stated",NA,NA,NA
"38131","NYANDARUA","ABERDARE NATIONA","Total",11,4,15
"38132","NYANDARUA","ABERDARE NATIONA","0",NA,NA,NA
"38133","NYANDARUA","ABERDARE NATIONA","1",NA,NA,NA
"38134","NYANDARUA","ABERDARE NATIONA","2",1,NA,1
"38135","NYANDARUA","ABERDARE NATIONA","3",NA,NA,NA
"38136","NYANDARUA","ABERDARE NATIONA","4",NA,NA,NA
"38137","NYANDARUA","ABERDARE NATIONA","0 - 4",1,NA,1
"38138","NYANDARUA","ABERDARE NATIONA","5",NA,NA,NA
"38139","NYANDARUA","ABERDARE NATIONA","6",NA,NA,NA
"38140","NYANDARUA","ABERDARE NATIONA","7",NA,NA,NA
"38141","NYANDARUA","ABERDARE NATIONA","8",NA,NA,NA
"38142","NYANDARUA","ABERDARE NATIONA","9",NA,NA,NA
"38143","NYANDARUA","ABERDARE NATIONA","5-9",NA,NA,NA
"38144","NYANDARUA","ABERDARE NATIONA","10",NA,NA,NA
"38145","NYANDARUA","ABERDARE NATIONA","11",NA,NA,NA
"38146","NYANDARUA","ABERDARE NATIONA","12",NA,NA,NA
"38147","NYANDARUA","ABERDARE NATIONA","13",NA,NA,NA
"38148","NYANDARUA","ABERDARE NATIONA","14",NA,NA,NA
"38149","NYANDARUA","ABERDARE NATIONA","10 -14",NA,NA,NA
"38150","NYANDARUA","ABERDARE NATIONA","15",NA,NA,NA
"38151","NYANDARUA","ABERDARE NATIONA","16",NA,NA,NA
"38152","NYANDARUA","ABERDARE NATIONA","17",NA,NA,NA
"38153","NYANDARUA","ABERDARE NATIONA","18",NA,NA,NA
"38154","NYANDARUA","ABERDARE NATIONA","19",NA,NA,NA
"38155","NYANDARUA","ABERDARE NATIONA","15-19",NA,NA,NA
"38156","NYANDARUA","ABERDARE NATIONA","20",NA,NA,NA
"38157","NYANDARUA","ABERDARE NATIONA","21",NA,NA,NA
"38158","NYANDARUA","ABERDARE NATIONA","22",NA,2,2
"38159","NYANDARUA","ABERDARE NATIONA","23",NA,NA,NA
"38160","NYANDARUA","ABERDARE NATIONA","24",NA,NA,NA
"38161","NYANDARUA","ABERDARE NATIONA","20-24",NA,2,2
"38162","NYANDARUA","ABERDARE NATIONA","25",NA,NA,NA
"38163","NYANDARUA","ABERDARE NATIONA","26",3,NA,3
"38164","NYANDARUA","ABERDARE NATIONA","27",NA,NA,NA
"38165","NYANDARUA","ABERDARE NATIONA","28",NA,NA,NA
"38166","NYANDARUA","ABERDARE NATIONA","29",1,NA,1
"38167","NYANDARUA","ABERDARE NATIONA","25-29",4,NA,4
"38168","NYANDARUA","ABERDARE NATIONA","30",3,NA,3
"38169","NYANDARUA","ABERDARE NATIONA","31",NA,NA,NA
"38170","NYANDARUA","ABERDARE NATIONA","32",NA,1,1
"38171","NYANDARUA","ABERDARE NATIONA","33",NA,NA,NA
"38172","NYANDARUA","ABERDARE NATIONA","34",NA,NA,NA
"38173","NYANDARUA","ABERDARE NATIONA","30-34",3,1,4
"38174","NYANDARUA","ABERDARE NATIONA","35",1,NA,1
"38175","NYANDARUA","ABERDARE NATIONA","36",NA,NA,NA
"38176","NYANDARUA","ABERDARE NATIONA","37",NA,NA,NA
"38177","NYANDARUA","ABERDARE NATIONA","38",NA,NA,NA
"38178","NYANDARUA","ABERDARE NATIONA","39",NA,NA,NA
"38179","NYANDARUA","ABERDARE NATIONA","35-39",1,NA,1
"38180","NYANDARUA","ABERDARE NATIONA","40",NA,NA,NA
"38181","NYANDARUA","ABERDARE NATIONA","41",NA,NA,NA
"38182","NYANDARUA","ABERDARE NATIONA","42",NA,NA,NA
"38183","NYANDARUA","ABERDARE NATIONA","43",NA,NA,NA
"38184","NYANDARUA","ABERDARE NATIONA","44",NA,NA,NA
"38185","NYANDARUA","ABERDARE NATIONA","40-44",NA,NA,NA
"38186","NYANDARUA","ABERDARE NATIONA","45",NA,NA,NA
"38187","NYANDARUA","ABERDARE NATIONA","46",1,NA,1
"38188","NYANDARUA","ABERDARE NATIONA","47",NA,1,1
"38189","NYANDARUA","ABERDARE NATIONA","48",NA,NA,NA
"38190","NYANDARUA","ABERDARE NATIONA","49",NA,NA,NA
"38191","NYANDARUA","ABERDARE NATIONA","45-49",1,1,2
"38192","NYANDARUA","ABERDARE NATIONA","50",1,NA,1
"38193","NYANDARUA","ABERDARE NATIONA","51",NA,NA,NA
"38194","NYANDARUA","ABERDARE NATIONA","52",NA,NA,NA
"38195","NYANDARUA","ABERDARE NATIONA","53",NA,NA,NA
"38196","NYANDARUA","ABERDARE NATIONA","54",NA,NA,NA
"38197","NYANDARUA","ABERDARE NATIONA","50-54",1,NA,1
"38198","NYANDARUA","ABERDARE NATIONA","55",NA,NA,NA
"38199","NYANDARUA","ABERDARE NATIONA","56",NA,NA,NA
"38200","NYANDARUA","ABERDARE NATIONA","57",NA,NA,NA
"38201","NYANDARUA","ABERDARE NATIONA","58",NA,NA,NA
"38202","NYANDARUA","ABERDARE NATIONA","59",NA,NA,NA
"38203","NYANDARUA","ABERDARE NATIONA","55-59",NA,NA,NA
"38204","NYANDARUA","ABERDARE NATIONA","60",NA,NA,NA
"38205","NYANDARUA","ABERDARE NATIONA","61",NA,NA,NA
"38206","NYANDARUA","ABERDARE NATIONA","62",NA,NA,NA
"38207","NYANDARUA","ABERDARE NATIONA","63",NA,NA,NA
"38208","NYANDARUA","ABERDARE NATIONA","64",NA,NA,NA
"38209","NYANDARUA","ABERDARE NATIONA","60-64",NA,NA,NA
"38210","NYANDARUA","ABERDARE NATIONA","65",NA,NA,NA
"38211","NYANDARUA","ABERDARE NATIONA","66",NA,NA,NA
"38212","NYANDARUA","ABERDARE NATIONA","67",NA,NA,NA
"38213","NYANDARUA","ABERDARE NATIONA","68",NA,NA,NA
"38214","NYANDARUA","ABERDARE NATIONA","69",NA,NA,NA
"38215","NYANDARUA","ABERDARE NATIONA","65-69",NA,NA,NA
"38216","NYANDARUA","ABERDARE NATIONA","70",NA,NA,NA
"38217","NYANDARUA","ABERDARE NATIONA","71",NA,NA,NA
"38218","NYANDARUA","ABERDARE NATIONA","72",NA,NA,NA
"38219","NYANDARUA","ABERDARE NATIONA","73",NA,NA,NA
"38220","NYANDARUA","ABERDARE NATIONA","74",NA,NA,NA
"38221","NYANDARUA","ABERDARE NATIONA","70-74",NA,NA,NA
"38222","NYANDARUA","ABERDARE NATIONA","75",NA,NA,NA
"38223","NYANDARUA","ABERDARE NATIONA","76",NA,NA,NA
"38224","NYANDARUA","ABERDARE NATIONA","77",NA,NA,NA
"38225","NYANDARUA","ABERDARE NATIONA","78",NA,NA,NA
"38226","NYANDARUA","ABERDARE NATIONA","79",NA,NA,NA
"38227","NYANDARUA","ABERDARE NATIONA","75-79",NA,NA,NA
"38228","NYANDARUA","ABERDARE NATIONA","80",NA,NA,NA
"38229","NYANDARUA","ABERDARE NATIONA","81",NA,NA,NA
"38230","NYANDARUA","ABERDARE NATIONA","82",NA,NA,NA
"38231","NYANDARUA","ABERDARE NATIONA","83",NA,NA,NA
"38232","NYANDARUA","ABERDARE NATIONA","84",NA,NA,NA
"38233","NYANDARUA","ABERDARE NATIONA","80-84",NA,NA,NA
"38234","NYANDARUA","ABERDARE NATIONA","85",NA,NA,NA
"38235","NYANDARUA","ABERDARE NATIONA","86",NA,NA,NA
"38236","NYANDARUA","ABERDARE NATIONA","87",NA,NA,NA
"38237","NYANDARUA","ABERDARE NATIONA","88",NA,NA,NA
"38238","NYANDARUA","ABERDARE NATIONA","89",NA,NA,NA
"38239","NYANDARUA","ABERDARE NATIONA","85-89",NA,NA,NA
"38240","NYANDARUA","ABERDARE NATIONA","90",NA,NA,NA
"38241","NYANDARUA","ABERDARE NATIONA","91",NA,NA,NA
"38242","NYANDARUA","ABERDARE NATIONA","92",NA,NA,NA
"38243","NYANDARUA","ABERDARE NATIONA","93",NA,NA,NA
"38244","NYANDARUA","ABERDARE NATIONA","94",NA,NA,NA
"38245","NYANDARUA","ABERDARE NATIONA","90-94",NA,NA,NA
"38246","NYANDARUA","ABERDARE NATIONA","95",NA,NA,NA
"38247","NYANDARUA","ABERDARE NATIONA","96",NA,NA,NA
"38248","NYANDARUA","ABERDARE NATIONA","97",NA,NA,NA
"38249","NYANDARUA","ABERDARE NATIONA","98",NA,NA,NA
"38250","NYANDARUA","ABERDARE NATIONA","99",NA,NA,NA
"38251","NYANDARUA","ABERDARE NATIONA","95-99",NA,NA,NA
"38252","NYANDARUA","ABERDARE NATIONA","100+",NA,NA,NA
"38253","NYANDARUA","ABERDARE NATIONA","Not Stated",NA,NA,NA
"38254","NYERI","ALL","Total",374288,384845,759133
"38255","NYERI","ALL","0",7398,7367,14765
"38256","NYERI","ALL","1",7302,7214,14516
"38257","NYERI","ALL","2",7302,7102,14404
"38258","NYERI","ALL","3",7556,7240,14796
"38259","NYERI","ALL","4",7458,7159,14617
"38260","NYERI","ALL","0 - 4",37016,36082,73098
"38261","NYERI","ALL","5",7342,7200,14542
"38262","NYERI","ALL","6",7415,7348,14763
"38263","NYERI","ALL","7",7633,7508,15141
"38264","NYERI","ALL","8",7454,7445,14899
"38265","NYERI","ALL","9",7922,7812,15734
"38266","NYERI","ALL","5-9",37766,37313,75079
"38267","NYERI","ALL","10",7751,7636,15387
"38268","NYERI","ALL","11",7187,7171,14358
"38269","NYERI","ALL","12",8042,7593,15635
"38270","NYERI","ALL","13",8197,7788,15985
"38271","NYERI","ALL","14",7866,7291,15157
"38272","NYERI","ALL","10 -14",39043,37479,76522
"38273","NYERI","ALL","15",7792,7559,15351
"38274","NYERI","ALL","16",7711,7393,15104
"38275","NYERI","ALL","17",8298,7577,15875
"38276","NYERI","ALL","18",7010,6449,13459
"38277","NYERI","ALL","19",7158,6580,13738
"38278","NYERI","ALL","15-19",37969,35558,73527
"38279","NYERI","ALL","20",6391,6182,12573
"38280","NYERI","ALL","21",6084,5901,11985
"38281","NYERI","ALL","22",5880,5898,11778
"38282","NYERI","ALL","23",6053,5996,12049
"38283","NYERI","ALL","24",5370,5414,10784
"38284","NYERI","ALL","20-24",29778,29391,59169
"38285","NYERI","ALL","25",5457,5374,10831
"38286","NYERI","ALL","26",4591,4981,9572
"38287","NYERI","ALL","27",4760,4930,9690
"38288","NYERI","ALL","28",4303,4795,9098
"38289","NYERI","ALL","29",4907,5199,10106
"38290","NYERI","ALL","25-29",24018,25279,49297
"38291","NYERI","ALL","30",5956,6375,12331
"38292","NYERI","ALL","31",4656,4789,9445
"38293","NYERI","ALL","32",5828,6250,12078
"38294","NYERI","ALL","33",5017,5505,10522
"38295","NYERI","ALL","34",4923,5286,10209
"38296","NYERI","ALL","30-34",26380,28205,54585
"38297","NYERI","ALL","35",6503,6649,13152
"38298","NYERI","ALL","36",4927,5218,10145
"38299","NYERI","ALL","37",5102,5157,10259
"38300","NYERI","ALL","38",4554,4867,9421
"38301","NYERI","ALL","39",4819,5338,10157
"38302","NYERI","ALL","35-39",25905,27229,53134
"38303","NYERI","ALL","40",5906,5821,11727
"38304","NYERI","ALL","41",4850,4806,9656
"38305","NYERI","ALL","42",4952,4766,9718
"38306","NYERI","ALL","43",4235,4727,8962
"38307","NYERI","ALL","44",3893,4082,7975
"38308","NYERI","ALL","40-44",23836,24202,48038
"38309","NYERI","ALL","45",5336,5295,10631
"38310","NYERI","ALL","46",4230,4275,8505
"38311","NYERI","ALL","47",4484,4481,8965
"38312","NYERI","ALL","48",3737,3601,7338
"38313","NYERI","ALL","49",3987,4142,8129
"38314","NYERI","ALL","45-49",21774,21794,43568
"38315","NYERI","ALL","50",4610,4881,9491
"38316","NYERI","ALL","51",3535,3725,7260
"38317","NYERI","ALL","52",3956,4325,8281
"38318","NYERI","ALL","53",2926,3422,6348
"38319","NYERI","ALL","54",3617,3671,7288
"38320","NYERI","ALL","50-54",18644,20024,38668
"38321","NYERI","ALL","55",3585,3724,7309
"38322","NYERI","ALL","56",3580,3557,7137
"38323","NYERI","ALL","57",3122,3477,6599
"38324","NYERI","ALL","58",2752,2819,5571
"38325","NYERI","ALL","59",2877,2985,5862
"38326","NYERI","ALL","55-59",15916,16562,32478
"38327","NYERI","ALL","60",3110,3470,6580
"38328","NYERI","ALL","61",2348,2544,4892
"38329","NYERI","ALL","62",2063,2093,4156
"38330","NYERI","ALL","63",1613,1792,3405
"38331","NYERI","ALL","64",1177,1308,2485
"38332","NYERI","ALL","60-64",10311,11207,21518
"38333","NYERI","ALL","65",1922,2213,4135
"38334","NYERI","ALL","66",1366,1487,2853
"38335","NYERI","ALL","67",2478,2677,5155
"38336","NYERI","ALL","68",1194,1253,2447
"38337","NYERI","ALL","69",1701,1877,3578
"38338","NYERI","ALL","65-69",8661,9507,18168
"38339","NYERI","ALL","70",2305,3015,5320
"38340","NYERI","ALL","71",1643,1871,3514
"38341","NYERI","ALL","72",1618,1542,3160
"38342","NYERI","ALL","73",1302,1332,2634
"38343","NYERI","ALL","74",1118,1448,2566
"38344","NYERI","ALL","70-74",7986,9208,17194
"38345","NYERI","ALL","75",968,1349,2317
"38346","NYERI","ALL","76",1064,2024,3088
"38347","NYERI","ALL","77",796,1229,2025
"38348","NYERI","ALL","78",566,742,1308
"38349","NYERI","ALL","79",597,1103,1700
"38350","NYERI","ALL","75-79",3991,6447,10438
"38351","NYERI","ALL","80",908,1526,2434
"38352","NYERI","ALL","81",506,750,1256
"38353","NYERI","ALL","82",490,567,1057
"38354","NYERI","ALL","83",536,740,1276
"38355","NYERI","ALL","84",415,671,1086
"38356","NYERI","ALL","80-84",2855,4254,7109
"38357","NYERI","ALL","85",362,609,971
"38358","NYERI","ALL","86",319,543,862
"38359","NYERI","ALL","87",297,456,753
"38360","NYERI","ALL","88",155,266,421
"38361","NYERI","ALL","89",253,622,875
"38362","NYERI","ALL","85-89",1386,2496,3882
"38363","NYERI","ALL","90",182,506,688
"38364","NYERI","ALL","91",208,410,618
"38365","NYERI","ALL","92",92,179,271
"38366","NYERI","ALL","93",87,175,262
"38367","NYERI","ALL","94",72,182,254
"38368","NYERI","ALL","90-94",641,1452,2093
"38369","NYERI","ALL","95",103,237,340
"38370","NYERI","ALL","96",53,127,180
"38371","NYERI","ALL","97",68,110,178
"38372","NYERI","ALL","98",51,102,153
"38373","NYERI","ALL","99",42,174,216
"38374","NYERI","ALL","95-99",317,750,1067
"38375","NYERI","ALL","100+",90,401,491
"38376","NYERI","ALL","Not Stated",5,5,10
"38377","NYERI","TETU","Total",39293,41155,80448
"38378","NYERI","TETU","0",675,721,1396
"38379","NYERI","TETU","1",701,774,1475
"38380","NYERI","TETU","2",754,728,1482
"38381","NYERI","TETU","3",793,780,1573
"38382","NYERI","TETU","4",756,719,1475
"38383","NYERI","TETU","0 - 4",3679,3722,7401
"38384","NYERI","TETU","5",783,775,1558
"38385","NYERI","TETU","6",835,770,1605
"38386","NYERI","TETU","7",815,781,1596
"38387","NYERI","TETU","8",824,768,1592
"38388","NYERI","TETU","9",872,838,1710
"38389","NYERI","TETU","5-9",4129,3932,8061
"38390","NYERI","TETU","10",880,808,1688
"38391","NYERI","TETU","11",728,781,1509
"38392","NYERI","TETU","12",839,792,1631
"38393","NYERI","TETU","13",851,819,1670
"38394","NYERI","TETU","14",860,785,1645
"38395","NYERI","TETU","10 -14",4158,3985,8143
"38396","NYERI","TETU","15",820,775,1595
"38397","NYERI","TETU","16",849,832,1681
"38398","NYERI","TETU","17",888,839,1727
"38399","NYERI","TETU","18",735,629,1364
"38400","NYERI","TETU","19",747,656,1403
"38401","NYERI","TETU","15-19",4039,3731,7770
"38402","NYERI","TETU","20",637,531,1168
"38403","NYERI","TETU","21",561,521,1082
"38404","NYERI","TETU","22",518,525,1043
"38405","NYERI","TETU","23",537,478,1015
"38406","NYERI","TETU","24",433,420,853
"38407","NYERI","TETU","20-24",2686,2475,5161
"38408","NYERI","TETU","25",489,469,958
"38409","NYERI","TETU","26",383,440,823
"38410","NYERI","TETU","27",381,434,815
"38411","NYERI","TETU","28",397,434,831
"38412","NYERI","TETU","29",425,461,886
"38413","NYERI","TETU","25-29",2075,2238,4313
"38414","NYERI","TETU","30",539,572,1111
"38415","NYERI","TETU","31",442,457,899
"38416","NYERI","TETU","32",532,581,1113
"38417","NYERI","TETU","33",476,522,998
"38418","NYERI","TETU","34",484,496,980
"38419","NYERI","TETU","30-34",2473,2628,5101
"38420","NYERI","TETU","35",621,633,1254
"38421","NYERI","TETU","36",493,541,1034
"38422","NYERI","TETU","37",470,535,1005
"38423","NYERI","TETU","38",415,528,943
"38424","NYERI","TETU","39",505,540,1045
"38425","NYERI","TETU","35-39",2504,2777,5281
"38426","NYERI","TETU","40",577,595,1172
"38427","NYERI","TETU","41",461,490,951
"38428","NYERI","TETU","42",488,496,984
"38429","NYERI","TETU","43",420,496,916
"38430","NYERI","TETU","44",402,480,882
"38431","NYERI","TETU","40-44",2348,2557,4905
"38432","NYERI","TETU","45",541,511,1052
"38433","NYERI","TETU","46",465,509,974
"38434","NYERI","TETU","47",479,525,1004
"38435","NYERI","TETU","48",403,405,808
"38436","NYERI","TETU","49",429,463,892
"38437","NYERI","TETU","45-49",2317,2413,4730
"38438","NYERI","TETU","50",441,548,989
"38439","NYERI","TETU","51",358,452,810
"38440","NYERI","TETU","52",439,489,928
"38441","NYERI","TETU","53",277,400,677
"38442","NYERI","TETU","54",416,421,837
"38443","NYERI","TETU","50-54",1931,2310,4241
"38444","NYERI","TETU","55",379,464,843
"38445","NYERI","TETU","56",391,421,812
"38446","NYERI","TETU","57",372,456,828
"38447","NYERI","TETU","58",345,359,704
"38448","NYERI","TETU","59",328,357,685
"38449","NYERI","TETU","55-59",1815,2057,3872
"38450","NYERI","TETU","60",378,437,815
"38451","NYERI","TETU","61",303,342,645
"38452","NYERI","TETU","62",278,277,555
"38453","NYERI","TETU","63",226,262,488
"38454","NYERI","TETU","64",163,174,337
"38455","NYERI","TETU","60-64",1348,1492,2840
"38456","NYERI","TETU","65",269,305,574
"38457","NYERI","TETU","66",167,204,371
"38458","NYERI","TETU","67",340,369,709
"38459","NYERI","TETU","68",168,153,321
"38460","NYERI","TETU","69",250,258,508
"38461","NYERI","TETU","65-69",1194,1289,2483
"38462","NYERI","TETU","70",353,421,774
"38463","NYERI","TETU","71",274,233,507
"38464","NYERI","TETU","72",245,208,453
"38465","NYERI","TETU","73",176,195,371
"38466","NYERI","TETU","74",192,188,380
"38467","NYERI","TETU","70-74",1240,1245,2485
"38468","NYERI","TETU","75",133,167,300
"38469","NYERI","TETU","76",173,365,538
"38470","NYERI","TETU","77",95,165,260
"38471","NYERI","TETU","78",84,112,196
"38472","NYERI","TETU","79",91,148,239
"38473","NYERI","TETU","75-79",576,957,1533
"38474","NYERI","TETU","80",142,180,322
"38475","NYERI","TETU","81",82,115,197
"38476","NYERI","TETU","82",42,88,130
"38477","NYERI","TETU","83",83,115,198
"38478","NYERI","TETU","84",47,87,134
"38479","NYERI","TETU","80-84",396,585,981
"38480","NYERI","TETU","85",59,89,148
"38481","NYERI","TETU","86",52,107,159
"38482","NYERI","TETU","87",42,77,119
"38483","NYERI","TETU","88",23,31,54
"38484","NYERI","TETU","89",35,106,141
"38485","NYERI","TETU","85-89",211,410,621
"38486","NYERI","TETU","90",30,64,94
"38487","NYERI","TETU","91",29,51,80
"38488","NYERI","TETU","92",13,27,40
"38489","NYERI","TETU","93",14,30,44
"38490","NYERI","TETU","94",18,19,37
"38491","NYERI","TETU","90-94",104,191,295
"38492","NYERI","TETU","95",19,42,61
"38493","NYERI","TETU","96",6,19,25
"38494","NYERI","TETU","97",11,7,18
"38495","NYERI","TETU","98",10,20,30
"38496","NYERI","TETU","99",9,18,27
"38497","NYERI","TETU","95-99",55,106,161
"38498","NYERI","TETU","100+",14,55,69
"38499","NYERI","TETU","Not Stated",1,NA,1
"38500","NYERI","KIENI EAST","Total",55360,55012,110372
"38501","NYERI","KIENI EAST","0",1210,1141,2351
"38502","NYERI","KIENI EAST","1",1177,1134,2311
"38503","NYERI","KIENI EAST","2",1110,1118,2228
"38504","NYERI","KIENI EAST","3",1190,1151,2341
"38505","NYERI","KIENI EAST","4",1164,1130,2294
"38506","NYERI","KIENI EAST","0 - 4",5851,5674,11525
"38507","NYERI","KIENI EAST","5",1082,1077,2159
"38508","NYERI","KIENI EAST","6",1157,1198,2355
"38509","NYERI","KIENI EAST","7",1164,1123,2287
"38510","NYERI","KIENI EAST","8",1166,1206,2372
"38511","NYERI","KIENI EAST","9",1209,1212,2421
"38512","NYERI","KIENI EAST","5-9",5778,5816,11594
"38513","NYERI","KIENI EAST","10",1112,1169,2281
"38514","NYERI","KIENI EAST","11",1043,1079,2122
"38515","NYERI","KIENI EAST","12",1264,1147,2411
"38516","NYERI","KIENI EAST","13",1267,1184,2451
"38517","NYERI","KIENI EAST","14",1179,1058,2237
"38518","NYERI","KIENI EAST","10 -14",5865,5637,11502
"38519","NYERI","KIENI EAST","15",1143,1160,2303
"38520","NYERI","KIENI EAST","16",1169,1138,2307
"38521","NYERI","KIENI EAST","17",1201,1104,2305
"38522","NYERI","KIENI EAST","18",1005,937,1942
"38523","NYERI","KIENI EAST","19",1009,885,1894
"38524","NYERI","KIENI EAST","15-19",5527,5224,10751
"38525","NYERI","KIENI EAST","20",887,839,1726
"38526","NYERI","KIENI EAST","21",923,837,1760
"38527","NYERI","KIENI EAST","22",877,846,1723
"38528","NYERI","KIENI EAST","23",944,854,1798
"38529","NYERI","KIENI EAST","24",809,797,1606
"38530","NYERI","KIENI EAST","20-24",4440,4173,8613
"38531","NYERI","KIENI EAST","25",832,831,1663
"38532","NYERI","KIENI EAST","26",680,782,1462
"38533","NYERI","KIENI EAST","27",744,731,1475
"38534","NYERI","KIENI EAST","28",658,689,1347
"38535","NYERI","KIENI EAST","29",766,810,1576
"38536","NYERI","KIENI EAST","25-29",3680,3843,7523
"38537","NYERI","KIENI EAST","30",905,1015,1920
"38538","NYERI","KIENI EAST","31",712,740,1452
"38539","NYERI","KIENI EAST","32",975,1015,1990
"38540","NYERI","KIENI EAST","33",758,833,1591
"38541","NYERI","KIENI EAST","34",780,810,1590
"38542","NYERI","KIENI EAST","30-34",4130,4413,8543
"38543","NYERI","KIENI EAST","35",1004,1066,2070
"38544","NYERI","KIENI EAST","36",749,805,1554
"38545","NYERI","KIENI EAST","37",804,762,1566
"38546","NYERI","KIENI EAST","38",686,704,1390
"38547","NYERI","KIENI EAST","39",735,785,1520
"38548","NYERI","KIENI EAST","35-39",3978,4122,8100
"38549","NYERI","KIENI EAST","40",925,803,1728
"38550","NYERI","KIENI EAST","41",793,763,1556
"38551","NYERI","KIENI EAST","42",756,709,1465
"38552","NYERI","KIENI EAST","43",656,703,1359
"38553","NYERI","KIENI EAST","44",575,600,1175
"38554","NYERI","KIENI EAST","40-44",3705,3578,7283
"38555","NYERI","KIENI EAST","45",831,818,1649
"38556","NYERI","KIENI EAST","46",644,649,1293
"38557","NYERI","KIENI EAST","47",695,626,1321
"38558","NYERI","KIENI EAST","48",583,498,1081
"38559","NYERI","KIENI EAST","49",608,591,1199
"38560","NYERI","KIENI EAST","45-49",3361,3182,6543
"38561","NYERI","KIENI EAST","50",707,648,1355
"38562","NYERI","KIENI EAST","51",547,518,1065
"38563","NYERI","KIENI EAST","52",566,575,1141
"38564","NYERI","KIENI EAST","53",396,456,852
"38565","NYERI","KIENI EAST","54",504,512,1016
"38566","NYERI","KIENI EAST","50-54",2720,2709,5429
"38567","NYERI","KIENI EAST","55",536,456,992
"38568","NYERI","KIENI EAST","56",514,435,949
"38569","NYERI","KIENI EAST","57",415,411,826
"38570","NYERI","KIENI EAST","58",389,353,742
"38571","NYERI","KIENI EAST","59",376,349,725
"38572","NYERI","KIENI EAST","55-59",2230,2004,4234
"38573","NYERI","KIENI EAST","60",361,372,733
"38574","NYERI","KIENI EAST","61",293,288,581
"38575","NYERI","KIENI EAST","62",277,244,521
"38576","NYERI","KIENI EAST","63",213,220,433
"38577","NYERI","KIENI EAST","64",152,154,306
"38578","NYERI","KIENI EAST","60-64",1296,1278,2574
"38579","NYERI","KIENI EAST","65",224,251,475
"38580","NYERI","KIENI EAST","66",181,171,352
"38581","NYERI","KIENI EAST","67",270,278,548
"38582","NYERI","KIENI EAST","68",131,117,248
"38583","NYERI","KIENI EAST","69",203,201,404
"38584","NYERI","KIENI EAST","65-69",1009,1018,2027
"38585","NYERI","KIENI EAST","70",221,297,518
"38586","NYERI","KIENI EAST","71",185,190,375
"38587","NYERI","KIENI EAST","72",179,141,320
"38588","NYERI","KIENI EAST","73",151,135,286
"38589","NYERI","KIENI EAST","74",116,142,258
"38590","NYERI","KIENI EAST","70-74",852,905,1757
"38591","NYERI","KIENI EAST","75",94,139,233
"38592","NYERI","KIENI EAST","76",83,178,261
"38593","NYERI","KIENI EAST","77",99,125,224
"38594","NYERI","KIENI EAST","78",50,81,131
"38595","NYERI","KIENI EAST","79",66,112,178
"38596","NYERI","KIENI EAST","75-79",392,635,1027
"38597","NYERI","KIENI EAST","80",103,150,253
"38598","NYERI","KIENI EAST","81",52,64,116
"38599","NYERI","KIENI EAST","82",59,58,117
"38600","NYERI","KIENI EAST","83",62,68,130
"38601","NYERI","KIENI EAST","84",44,52,96
"38602","NYERI","KIENI EAST","80-84",320,392,712
"38603","NYERI","KIENI EAST","85",28,36,64
"38604","NYERI","KIENI EAST","86",28,38,66
"38605","NYERI","KIENI EAST","87",31,40,71
"38606","NYERI","KIENI EAST","88",15,22,37
"38607","NYERI","KIENI EAST","89",21,59,80
"38608","NYERI","KIENI EAST","85-89",123,195,318
"38609","NYERI","KIENI EAST","90",16,45,61
"38610","NYERI","KIENI EAST","91",21,42,63
"38611","NYERI","KIENI EAST","92",6,14,20
"38612","NYERI","KIENI EAST","93",7,16,23
"38613","NYERI","KIENI EAST","94",6,14,20
"38614","NYERI","KIENI EAST","90-94",56,131,187
"38615","NYERI","KIENI EAST","95",9,18,27
"38616","NYERI","KIENI EAST","96",8,8,16
"38617","NYERI","KIENI EAST","97",9,12,21
"38618","NYERI","KIENI EAST","98",5,6,11
"38619","NYERI","KIENI EAST","99",2,8,10
"38620","NYERI","KIENI EAST","95-99",33,52,85
"38621","NYERI","KIENI EAST","100+",13,30,43
"38622","NYERI","KIENI EAST","Not Stated",1,1,2
"38623","NYERI","KIENI WEST","Total",43843,44677,88520
"38624","NYERI","KIENI WEST","0",867,903,1770
"38625","NYERI","KIENI WEST","1",818,870,1688
"38626","NYERI","KIENI WEST","2",892,842,1734
"38627","NYERI","KIENI WEST","3",859,877,1736
"38628","NYERI","KIENI WEST","4",964,876,1840
"38629","NYERI","KIENI WEST","0 - 4",4400,4368,8768
"38630","NYERI","KIENI WEST","5",940,891,1831
"38631","NYERI","KIENI WEST","6",968,927,1895
"38632","NYERI","KIENI WEST","7",953,966,1919
"38633","NYERI","KIENI WEST","8",934,957,1891
"38634","NYERI","KIENI WEST","9",1026,1005,2031
"38635","NYERI","KIENI WEST","5-9",4821,4746,9567
"38636","NYERI","KIENI WEST","10",1070,1004,2074
"38637","NYERI","KIENI WEST","11",974,964,1938
"38638","NYERI","KIENI WEST","12",1053,1007,2060
"38639","NYERI","KIENI WEST","13",1027,1037,2064
"38640","NYERI","KIENI WEST","14",1038,1002,2040
"38641","NYERI","KIENI WEST","10 -14",5162,5014,10176
"38642","NYERI","KIENI WEST","15",1066,955,2021
"38643","NYERI","KIENI WEST","16",1097,1008,2105
"38644","NYERI","KIENI WEST","17",1156,993,2149
"38645","NYERI","KIENI WEST","18",858,754,1612
"38646","NYERI","KIENI WEST","19",804,716,1520
"38647","NYERI","KIENI WEST","15-19",4981,4426,9407
"38648","NYERI","KIENI WEST","20",712,678,1390
"38649","NYERI","KIENI WEST","21",684,578,1262
"38650","NYERI","KIENI WEST","22",644,592,1236
"38651","NYERI","KIENI WEST","23",584,586,1170
"38652","NYERI","KIENI WEST","24",564,519,1083
"38653","NYERI","KIENI WEST","20-24",3188,2953,6141
"38654","NYERI","KIENI WEST","25",564,529,1093
"38655","NYERI","KIENI WEST","26",437,483,920
"38656","NYERI","KIENI WEST","27",532,497,1029
"38657","NYERI","KIENI WEST","28",413,454,867
"38658","NYERI","KIENI WEST","29",502,505,1007
"38659","NYERI","KIENI WEST","25-29",2448,2468,4916
"38660","NYERI","KIENI WEST","30",644,649,1293
"38661","NYERI","KIENI WEST","31",473,499,972
"38662","NYERI","KIENI WEST","32",605,688,1293
"38663","NYERI","KIENI WEST","33",572,602,1174
"38664","NYERI","KIENI WEST","34",506,627,1133
"38665","NYERI","KIENI WEST","30-34",2800,3065,5865
"38666","NYERI","KIENI WEST","35",735,777,1512
"38667","NYERI","KIENI WEST","36",508,603,1111
"38668","NYERI","KIENI WEST","37",587,586,1173
"38669","NYERI","KIENI WEST","38",509,561,1070
"38670","NYERI","KIENI WEST","39",530,644,1174
"38671","NYERI","KIENI WEST","35-39",2869,3171,6040
"38672","NYERI","KIENI WEST","40",693,698,1391
"38673","NYERI","KIENI WEST","41",550,553,1103
"38674","NYERI","KIENI WEST","42",598,557,1155
"38675","NYERI","KIENI WEST","43",474,589,1063
"38676","NYERI","KIENI WEST","44",453,492,945
"38677","NYERI","KIENI WEST","40-44",2768,2889,5657
"38678","NYERI","KIENI WEST","45",664,653,1317
"38679","NYERI","KIENI WEST","46",481,539,1020
"38680","NYERI","KIENI WEST","47",512,562,1074
"38681","NYERI","KIENI WEST","48",430,450,880
"38682","NYERI","KIENI WEST","49",481,478,959
"38683","NYERI","KIENI WEST","45-49",2568,2682,5250
"38684","NYERI","KIENI WEST","50",583,589,1172
"38685","NYERI","KIENI WEST","51",454,432,886
"38686","NYERI","KIENI WEST","52",470,534,1004
"38687","NYERI","KIENI WEST","53",367,411,778
"38688","NYERI","KIENI WEST","54",413,445,858
"38689","NYERI","KIENI WEST","50-54",2287,2411,4698
"38690","NYERI","KIENI WEST","55",445,408,853
"38691","NYERI","KIENI WEST","56",418,377,795
"38692","NYERI","KIENI WEST","57",375,392,767
"38693","NYERI","KIENI WEST","58",291,320,611
"38694","NYERI","KIENI WEST","59",304,370,674
"38695","NYERI","KIENI WEST","55-59",1833,1867,3700
"38696","NYERI","KIENI WEST","60",345,392,737
"38697","NYERI","KIENI WEST","61",255,273,528
"38698","NYERI","KIENI WEST","62",216,182,398
"38699","NYERI","KIENI WEST","63",180,198,378
"38700","NYERI","KIENI WEST","64",128,132,260
"38701","NYERI","KIENI WEST","60-64",1124,1177,2301
"38702","NYERI","KIENI WEST","65",229,251,480
"38703","NYERI","KIENI WEST","66",156,154,310
"38704","NYERI","KIENI WEST","67",253,281,534
"38705","NYERI","KIENI WEST","68",106,110,216
"38706","NYERI","KIENI WEST","69",164,163,327
"38707","NYERI","KIENI WEST","65-69",908,959,1867
"38708","NYERI","KIENI WEST","70",226,280,506
"38709","NYERI","KIENI WEST","71",152,188,340
"38710","NYERI","KIENI WEST","72",147,171,318
"38711","NYERI","KIENI WEST","73",120,142,262
"38712","NYERI","KIENI WEST","74",120,151,271
"38713","NYERI","KIENI WEST","70-74",765,932,1697
"38714","NYERI","KIENI WEST","75",91,136,227
"38715","NYERI","KIENI WEST","76",120,280,400
"38716","NYERI","KIENI WEST","77",68,127,195
"38717","NYERI","KIENI WEST","78",71,66,137
"38718","NYERI","KIENI WEST","79",56,110,166
"38719","NYERI","KIENI WEST","75-79",406,719,1125
"38720","NYERI","KIENI WEST","80",88,141,229
"38721","NYERI","KIENI WEST","81",41,68,109
"38722","NYERI","KIENI WEST","82",62,50,112
"38723","NYERI","KIENI WEST","83",58,65,123
"38724","NYERI","KIENI WEST","84",38,57,95
"38725","NYERI","KIENI WEST","80-84",287,381,668
"38726","NYERI","KIENI WEST","85",33,59,92
"38727","NYERI","KIENI WEST","86",32,72,104
"38728","NYERI","KIENI WEST","87",34,41,75
"38729","NYERI","KIENI WEST","88",17,20,37
"38730","NYERI","KIENI WEST","89",20,51,71
"38731","NYERI","KIENI WEST","85-89",136,243,379
"38732","NYERI","KIENI WEST","90",18,38,56
"38733","NYERI","KIENI WEST","91",16,37,53
"38734","NYERI","KIENI WEST","92",7,12,19
"38735","NYERI","KIENI WEST","93",7,15,22
"38736","NYERI","KIENI WEST","94",6,14,20
"38737","NYERI","KIENI WEST","90-94",54,116,170
"38738","NYERI","KIENI WEST","95",6,17,23
"38739","NYERI","KIENI WEST","96",5,12,17
"38740","NYERI","KIENI WEST","97",14,10,24
"38741","NYERI","KIENI WEST","98",4,5,9
"38742","NYERI","KIENI WEST","99",4,12,16
"38743","NYERI","KIENI WEST","95-99",33,56,89
"38744","NYERI","KIENI WEST","100+",5,34,39
"38745","NYERI","KIENI WEST","Not Stated",NA,NA,NA
"38746","NYERI","MATHIRA EAST","Total",48070,50992,99062
"38747","NYERI","MATHIRA EAST","0",924,968,1892
"38748","NYERI","MATHIRA EAST","1",940,887,1827
"38749","NYERI","MATHIRA EAST","2",888,843,1731
"38750","NYERI","MATHIRA EAST","3",904,866,1770
"38751","NYERI","MATHIRA EAST","4",901,901,1802
"38752","NYERI","MATHIRA EAST","0 - 4",4557,4465,9022
"38753","NYERI","MATHIRA EAST","5",898,907,1805
"38754","NYERI","MATHIRA EAST","6",895,923,1818
"38755","NYERI","MATHIRA EAST","7",873,974,1847
"38756","NYERI","MATHIRA EAST","8",868,871,1739
"38757","NYERI","MATHIRA EAST","9",929,982,1911
"38758","NYERI","MATHIRA EAST","5-9",4463,4657,9120
"38759","NYERI","MATHIRA EAST","10",917,980,1897
"38760","NYERI","MATHIRA EAST","11",913,833,1746
"38761","NYERI","MATHIRA EAST","12",982,892,1874
"38762","NYERI","MATHIRA EAST","13",981,924,1905
"38763","NYERI","MATHIRA EAST","14",993,924,1917
"38764","NYERI","MATHIRA EAST","10 -14",4786,4553,9339
"38765","NYERI","MATHIRA EAST","15",932,971,1903
"38766","NYERI","MATHIRA EAST","16",865,922,1787
"38767","NYERI","MATHIRA EAST","17",993,988,1981
"38768","NYERI","MATHIRA EAST","18",979,989,1968
"38769","NYERI","MATHIRA EAST","19",1106,1019,2125
"38770","NYERI","MATHIRA EAST","15-19",4875,4889,9764
"38771","NYERI","MATHIRA EAST","20",958,923,1881
"38772","NYERI","MATHIRA EAST","21",939,867,1806
"38773","NYERI","MATHIRA EAST","22",917,873,1790
"38774","NYERI","MATHIRA EAST","23",849,870,1719
"38775","NYERI","MATHIRA EAST","24",767,726,1493
"38776","NYERI","MATHIRA EAST","20-24",4430,4259,8689
"38777","NYERI","MATHIRA EAST","25",745,731,1476
"38778","NYERI","MATHIRA EAST","26",619,664,1283
"38779","NYERI","MATHIRA EAST","27",598,713,1311
"38780","NYERI","MATHIRA EAST","28",520,643,1163
"38781","NYERI","MATHIRA EAST","29",599,699,1298
"38782","NYERI","MATHIRA EAST","25-29",3081,3450,6531
"38783","NYERI","MATHIRA EAST","30",784,914,1698
"38784","NYERI","MATHIRA EAST","31",563,663,1226
"38785","NYERI","MATHIRA EAST","32",770,880,1650
"38786","NYERI","MATHIRA EAST","33",642,768,1410
"38787","NYERI","MATHIRA EAST","34",698,713,1411
"38788","NYERI","MATHIRA EAST","30-34",3457,3938,7395
"38789","NYERI","MATHIRA EAST","35",898,907,1805
"38790","NYERI","MATHIRA EAST","36",602,687,1289
"38791","NYERI","MATHIRA EAST","37",662,724,1386
"38792","NYERI","MATHIRA EAST","38",613,635,1248
"38793","NYERI","MATHIRA EAST","39",607,741,1348
"38794","NYERI","MATHIRA EAST","35-39",3382,3694,7076
"38795","NYERI","MATHIRA EAST","40",782,796,1578
"38796","NYERI","MATHIRA EAST","41",631,638,1269
"38797","NYERI","MATHIRA EAST","42",671,691,1362
"38798","NYERI","MATHIRA EAST","43",507,616,1123
"38799","NYERI","MATHIRA EAST","44",503,519,1022
"38800","NYERI","MATHIRA EAST","40-44",3094,3260,6354
"38801","NYERI","MATHIRA EAST","45",717,725,1442
"38802","NYERI","MATHIRA EAST","46",536,544,1080
"38803","NYERI","MATHIRA EAST","47",604,577,1181
"38804","NYERI","MATHIRA EAST","48",488,510,998
"38805","NYERI","MATHIRA EAST","49",531,558,1089
"38806","NYERI","MATHIRA EAST","45-49",2876,2914,5790
"38807","NYERI","MATHIRA EAST","50",611,686,1297
"38808","NYERI","MATHIRA EAST","51",462,489,951
"38809","NYERI","MATHIRA EAST","52",547,610,1157
"38810","NYERI","MATHIRA EAST","53",406,423,829
"38811","NYERI","MATHIRA EAST","54",502,455,957
"38812","NYERI","MATHIRA EAST","50-54",2528,2663,5191
"38813","NYERI","MATHIRA EAST","55",467,510,977
"38814","NYERI","MATHIRA EAST","56",427,494,921
"38815","NYERI","MATHIRA EAST","57",441,437,878
"38816","NYERI","MATHIRA EAST","58",352,411,763
"38817","NYERI","MATHIRA EAST","59",345,424,769
"38818","NYERI","MATHIRA EAST","55-59",2032,2276,4308
"38819","NYERI","MATHIRA EAST","60",387,458,845
"38820","NYERI","MATHIRA EAST","61",309,331,640
"38821","NYERI","MATHIRA EAST","62",244,285,529
"38822","NYERI","MATHIRA EAST","63",186,233,419
"38823","NYERI","MATHIRA EAST","64",169,170,339
"38824","NYERI","MATHIRA EAST","60-64",1295,1477,2772
"38825","NYERI","MATHIRA EAST","65",232,277,509
"38826","NYERI","MATHIRA EAST","66",176,169,345
"38827","NYERI","MATHIRA EAST","67",342,345,687
"38828","NYERI","MATHIRA EAST","68",152,188,340
"38829","NYERI","MATHIRA EAST","69",206,247,453
"38830","NYERI","MATHIRA EAST","65-69",1108,1226,2334
"38831","NYERI","MATHIRA EAST","70",302,408,710
"38832","NYERI","MATHIRA EAST","71",184,249,433
"38833","NYERI","MATHIRA EAST","72",177,212,389
"38834","NYERI","MATHIRA EAST","73",140,183,323
"38835","NYERI","MATHIRA EAST","74",135,186,321
"38836","NYERI","MATHIRA EAST","70-74",938,1238,2176
"38837","NYERI","MATHIRA EAST","75",129,173,302
"38838","NYERI","MATHIRA EAST","76",106,172,278
"38839","NYERI","MATHIRA EAST","77",123,189,312
"38840","NYERI","MATHIRA EAST","78",92,84,176
"38841","NYERI","MATHIRA EAST","79",83,166,249
"38842","NYERI","MATHIRA EAST","75-79",533,784,1317
"38843","NYERI","MATHIRA EAST","80",103,227,330
"38844","NYERI","MATHIRA EAST","81",66,102,168
"38845","NYERI","MATHIRA EAST","82",63,72,135
"38846","NYERI","MATHIRA EAST","83",59,89,148
"38847","NYERI","MATHIRA EAST","84",49,112,161
"38848","NYERI","MATHIRA EAST","80-84",340,602,942
"38849","NYERI","MATHIRA EAST","85",39,84,123
"38850","NYERI","MATHIRA EAST","86",37,57,94
"38851","NYERI","MATHIRA EAST","87",31,45,76
"38852","NYERI","MATHIRA EAST","88",19,32,51
"38853","NYERI","MATHIRA EAST","89",31,63,94
"38854","NYERI","MATHIRA EAST","85-89",157,281,438
"38855","NYERI","MATHIRA EAST","90",24,76,100
"38856","NYERI","MATHIRA EAST","91",34,56,90
"38857","NYERI","MATHIRA EAST","92",16,25,41
"38858","NYERI","MATHIRA EAST","93",7,30,37
"38859","NYERI","MATHIRA EAST","94",10,26,36
"38860","NYERI","MATHIRA EAST","90-94",91,213,304
"38861","NYERI","MATHIRA EAST","95",11,40,51
"38862","NYERI","MATHIRA EAST","96",8,7,15
"38863","NYERI","MATHIRA EAST","97",8,12,20
"38864","NYERI","MATHIRA EAST","98",5,17,22
"38865","NYERI","MATHIRA EAST","99",5,20,25
"38866","NYERI","MATHIRA EAST","95-99",37,96,133
"38867","NYERI","MATHIRA EAST","100+",9,57,66
"38868","NYERI","MATHIRA EAST","Not Stated",1,NA,1
"38869","NYERI","MATHIRA WEST","Total",29480,30412,59892
"38870","NYERI","MATHIRA WEST","0",489,472,961
"38871","NYERI","MATHIRA WEST","1",516,506,1022
"38872","NYERI","MATHIRA WEST","2",550,539,1089
"38873","NYERI","MATHIRA WEST","3",594,541,1135
"38874","NYERI","MATHIRA WEST","4",598,572,1170
"38875","NYERI","MATHIRA WEST","0 - 4",2747,2630,5377
"38876","NYERI","MATHIRA WEST","5",558,520,1078
"38877","NYERI","MATHIRA WEST","6",576,526,1102
"38878","NYERI","MATHIRA WEST","7",649,577,1226
"38879","NYERI","MATHIRA WEST","8",586,560,1146
"38880","NYERI","MATHIRA WEST","9",616,616,1232
"38881","NYERI","MATHIRA WEST","5-9",2985,2799,5784
"38882","NYERI","MATHIRA WEST","10",629,584,1213
"38883","NYERI","MATHIRA WEST","11",569,574,1143
"38884","NYERI","MATHIRA WEST","12",679,654,1333
"38885","NYERI","MATHIRA WEST","13",651,634,1285
"38886","NYERI","MATHIRA WEST","14",669,597,1266
"38887","NYERI","MATHIRA WEST","10 -14",3197,3043,6240
"38888","NYERI","MATHIRA WEST","15",657,608,1265
"38889","NYERI","MATHIRA WEST","16",657,569,1226
"38890","NYERI","MATHIRA WEST","17",650,613,1263
"38891","NYERI","MATHIRA WEST","18",585,472,1057
"38892","NYERI","MATHIRA WEST","19",553,482,1035
"38893","NYERI","MATHIRA WEST","15-19",3102,2744,5846
"38894","NYERI","MATHIRA WEST","20",475,430,905
"38895","NYERI","MATHIRA WEST","21",383,378,761
"38896","NYERI","MATHIRA WEST","22",396,388,784
"38897","NYERI","MATHIRA WEST","23",415,404,819
"38898","NYERI","MATHIRA WEST","24",295,339,634
"38899","NYERI","MATHIRA WEST","20-24",1964,1939,3903
"38900","NYERI","MATHIRA WEST","25",363,315,678
"38901","NYERI","MATHIRA WEST","26",320,301,621
"38902","NYERI","MATHIRA WEST","27",286,283,569
"38903","NYERI","MATHIRA WEST","28",275,311,586
"38904","NYERI","MATHIRA WEST","29",307,366,673
"38905","NYERI","MATHIRA WEST","25-29",1551,1576,3127
"38906","NYERI","MATHIRA WEST","30",370,419,789
"38907","NYERI","MATHIRA WEST","31",307,330,637
"38908","NYERI","MATHIRA WEST","32",406,401,807
"38909","NYERI","MATHIRA WEST","33",328,371,699
"38910","NYERI","MATHIRA WEST","34",321,340,661
"38911","NYERI","MATHIRA WEST","30-34",1732,1861,3593
"38912","NYERI","MATHIRA WEST","35",428,481,909
"38913","NYERI","MATHIRA WEST","36",365,368,733
"38914","NYERI","MATHIRA WEST","37",340,373,713
"38915","NYERI","MATHIRA WEST","38",336,349,685
"38916","NYERI","MATHIRA WEST","39",334,392,726
"38917","NYERI","MATHIRA WEST","35-39",1803,1963,3766
"38918","NYERI","MATHIRA WEST","40",424,428,852
"38919","NYERI","MATHIRA WEST","41",350,381,731
"38920","NYERI","MATHIRA WEST","42",367,360,727
"38921","NYERI","MATHIRA WEST","43",346,347,693
"38922","NYERI","MATHIRA WEST","44",340,308,648
"38923","NYERI","MATHIRA WEST","40-44",1827,1824,3651
"38924","NYERI","MATHIRA WEST","45",423,409,832
"38925","NYERI","MATHIRA WEST","46",360,373,733
"38926","NYERI","MATHIRA WEST","47",370,354,724
"38927","NYERI","MATHIRA WEST","48",319,293,612
"38928","NYERI","MATHIRA WEST","49",322,370,692
"38929","NYERI","MATHIRA WEST","45-49",1794,1799,3593
"38930","NYERI","MATHIRA WEST","50",352,386,738
"38931","NYERI","MATHIRA WEST","51",314,308,622
"38932","NYERI","MATHIRA WEST","52",323,335,658
"38933","NYERI","MATHIRA WEST","53",259,321,580
"38934","NYERI","MATHIRA WEST","54",309,309,618
"38935","NYERI","MATHIRA WEST","50-54",1557,1659,3216
"38936","NYERI","MATHIRA WEST","55",309,350,659
"38937","NYERI","MATHIRA WEST","56",299,328,627
"38938","NYERI","MATHIRA WEST","57",270,341,611
"38939","NYERI","MATHIRA WEST","58",235,233,468
"38940","NYERI","MATHIRA WEST","59",260,261,521
"38941","NYERI","MATHIRA WEST","55-59",1373,1513,2886
"38942","NYERI","MATHIRA WEST","60",293,354,647
"38943","NYERI","MATHIRA WEST","61",220,256,476
"38944","NYERI","MATHIRA WEST","62",197,229,426
"38945","NYERI","MATHIRA WEST","63",186,168,354
"38946","NYERI","MATHIRA WEST","64",117,139,256
"38947","NYERI","MATHIRA WEST","60-64",1013,1146,2159
"38948","NYERI","MATHIRA WEST","65",169,225,394
"38949","NYERI","MATHIRA WEST","66",141,154,295
"38950","NYERI","MATHIRA WEST","67",232,285,517
"38951","NYERI","MATHIRA WEST","68",113,142,255
"38952","NYERI","MATHIRA WEST","69",164,210,374
"38953","NYERI","MATHIRA WEST","65-69",819,1016,1835
"38954","NYERI","MATHIRA WEST","70",239,328,567
"38955","NYERI","MATHIRA WEST","71",186,209,395
"38956","NYERI","MATHIRA WEST","72",195,203,398
"38957","NYERI","MATHIRA WEST","73",134,160,294
"38958","NYERI","MATHIRA WEST","74",116,189,305
"38959","NYERI","MATHIRA WEST","70-74",870,1089,1959
"38960","NYERI","MATHIRA WEST","75",109,149,258
"38961","NYERI","MATHIRA WEST","76",129,204,333
"38962","NYERI","MATHIRA WEST","77",98,155,253
"38963","NYERI","MATHIRA WEST","78",71,77,148
"38964","NYERI","MATHIRA WEST","79",72,143,215
"38965","NYERI","MATHIRA WEST","75-79",479,728,1207
"38966","NYERI","MATHIRA WEST","80",117,172,289
"38967","NYERI","MATHIRA WEST","81",65,90,155
"38968","NYERI","MATHIRA WEST","82",59,68,127
"38969","NYERI","MATHIRA WEST","83",78,95,173
"38970","NYERI","MATHIRA WEST","84",60,75,135
"38971","NYERI","MATHIRA WEST","80-84",379,500,879
"38972","NYERI","MATHIRA WEST","85",43,65,108
"38973","NYERI","MATHIRA WEST","86",44,66,110
"38974","NYERI","MATHIRA WEST","87",35,53,88
"38975","NYERI","MATHIRA WEST","88",19,29,48
"38976","NYERI","MATHIRA WEST","89",32,53,85
"38977","NYERI","MATHIRA WEST","85-89",173,266,439
"38978","NYERI","MATHIRA WEST","90",17,62,79
"38979","NYERI","MATHIRA WEST","91",32,65,97
"38980","NYERI","MATHIRA WEST","92",11,23,34
"38981","NYERI","MATHIRA WEST","93",9,22,31
"38982","NYERI","MATHIRA WEST","94",9,16,25
"38983","NYERI","MATHIRA WEST","90-94",78,188,266
"38984","NYERI","MATHIRA WEST","95",13,26,39
"38985","NYERI","MATHIRA WEST","96",3,11,14
"38986","NYERI","MATHIRA WEST","97",3,17,20
"38987","NYERI","MATHIRA WEST","98",5,7,12
"38988","NYERI","MATHIRA WEST","99",4,28,32
"38989","NYERI","MATHIRA WEST","95-99",28,89,117
"38990","NYERI","MATHIRA WEST","100+",8,40,48
"38991","NYERI","MATHIRA WEST","Not Stated",1,NA,1
"38992","NYERI","NYERI SOUTH","Total",44115,46964,91079
"38993","NYERI","NYERI SOUTH","0",816,854,1670
"38994","NYERI","NYERI SOUTH","1",841,811,1652
"38995","NYERI","NYERI SOUTH","2",857,811,1668
"38996","NYERI","NYERI SOUTH","3",898,871,1769
"38997","NYERI","NYERI SOUTH","4",888,827,1715
"38998","NYERI","NYERI SOUTH","0 - 4",4300,4174,8474
"38999","NYERI","NYERI SOUTH","5",923,896,1819
"39000","NYERI","NYERI SOUTH","6",871,876,1747
"39001","NYERI","NYERI SOUTH","7",888,897,1785
"39002","NYERI","NYERI SOUTH","8",910,912,1822
"39003","NYERI","NYERI SOUTH","9",918,951,1869
"39004","NYERI","NYERI SOUTH","5-9",4510,4532,9042
"39005","NYERI","NYERI SOUTH","10",958,909,1867
"39006","NYERI","NYERI SOUTH","11",874,857,1731
"39007","NYERI","NYERI SOUTH","12",940,926,1866
"39008","NYERI","NYERI SOUTH","13",999,926,1925
"39009","NYERI","NYERI SOUTH","14",970,877,1847
"39010","NYERI","NYERI SOUTH","10 -14",4741,4495,9236
"39011","NYERI","NYERI SOUTH","15",966,980,1946
"39012","NYERI","NYERI SOUTH","16",950,892,1842
"39013","NYERI","NYERI SOUTH","17",1098,895,1993
"39014","NYERI","NYERI SOUTH","18",871,805,1676
"39015","NYERI","NYERI SOUTH","19",879,851,1730
"39016","NYERI","NYERI SOUTH","15-19",4764,4423,9187
"39017","NYERI","NYERI SOUTH","20",743,710,1453
"39018","NYERI","NYERI SOUTH","21",653,699,1352
"39019","NYERI","NYERI SOUTH","22",624,631,1255
"39020","NYERI","NYERI SOUTH","23",620,636,1256
"39021","NYERI","NYERI SOUTH","24",516,563,1079
"39022","NYERI","NYERI SOUTH","20-24",3156,3239,6395
"39023","NYERI","NYERI SOUTH","25",539,551,1090
"39024","NYERI","NYERI SOUTH","26",458,538,996
"39025","NYERI","NYERI SOUTH","27",504,520,1024
"39026","NYERI","NYERI SOUTH","28",448,523,971
"39027","NYERI","NYERI SOUTH","29",492,598,1090
"39028","NYERI","NYERI SOUTH","25-29",2441,2730,5171
"39029","NYERI","NYERI SOUTH","30",630,679,1309
"39030","NYERI","NYERI SOUTH","31",524,545,1069
"39031","NYERI","NYERI SOUTH","32",594,678,1272
"39032","NYERI","NYERI SOUTH","33",554,620,1174
"39033","NYERI","NYERI SOUTH","34",528,606,1134
"39034","NYERI","NYERI SOUTH","30-34",2830,3128,5958
"39035","NYERI","NYERI SOUTH","35",726,784,1510
"39036","NYERI","NYERI SOUTH","36",560,606,1166
"39037","NYERI","NYERI SOUTH","37",596,595,1191
"39038","NYERI","NYERI SOUTH","38",489,566,1055
"39039","NYERI","NYERI SOUTH","39",565,638,1203
"39040","NYERI","NYERI SOUTH","35-39",2936,3189,6125
"39041","NYERI","NYERI SOUTH","40",680,682,1362
"39042","NYERI","NYERI SOUTH","41",554,612,1166
"39043","NYERI","NYERI SOUTH","42",557,606,1163
"39044","NYERI","NYERI SOUTH","43",519,598,1117
"39045","NYERI","NYERI SOUTH","44",501,554,1055
"39046","NYERI","NYERI SOUTH","40-44",2811,3052,5863
"39047","NYERI","NYERI SOUTH","45",596,672,1268
"39048","NYERI","NYERI SOUTH","46",510,531,1041
"39049","NYERI","NYERI SOUTH","47",517,601,1118
"39050","NYERI","NYERI SOUTH","48",461,458,919
"39051","NYERI","NYERI SOUTH","49",450,493,943
"39052","NYERI","NYERI SOUTH","45-49",2534,2755,5289
"39053","NYERI","NYERI SOUTH","50",582,627,1209
"39054","NYERI","NYERI SOUTH","51",414,481,895
"39055","NYERI","NYERI SOUTH","52",493,546,1039
"39056","NYERI","NYERI SOUTH","53",352,475,827
"39057","NYERI","NYERI SOUTH","54",410,505,915
"39058","NYERI","NYERI SOUTH","50-54",2251,2634,4885
"39059","NYERI","NYERI SOUTH","55",450,472,922
"39060","NYERI","NYERI SOUTH","56",446,497,943
"39061","NYERI","NYERI SOUTH","57",364,461,825
"39062","NYERI","NYERI SOUTH","58",345,359,704
"39063","NYERI","NYERI SOUTH","59",420,430,850
"39064","NYERI","NYERI SOUTH","55-59",2025,2219,4244
"39065","NYERI","NYERI SOUTH","60",419,476,895
"39066","NYERI","NYERI SOUTH","61",303,366,669
"39067","NYERI","NYERI SOUTH","62",256,283,539
"39068","NYERI","NYERI SOUTH","63",186,216,402
"39069","NYERI","NYERI SOUTH","64",130,181,311
"39070","NYERI","NYERI SOUTH","60-64",1294,1522,2816
"39071","NYERI","NYERI SOUTH","65",232,274,506
"39072","NYERI","NYERI SOUTH","66",176,206,382
"39073","NYERI","NYERI SOUTH","67",317,379,696
"39074","NYERI","NYERI SOUTH","68",173,177,350
"39075","NYERI","NYERI SOUTH","69",242,273,515
"39076","NYERI","NYERI SOUTH","65-69",1140,1309,2449
"39077","NYERI","NYERI SOUTH","70",314,447,761
"39078","NYERI","NYERI SOUTH","71",213,301,514
"39079","NYERI","NYERI SOUTH","72",238,182,420
"39080","NYERI","NYERI SOUTH","73",181,178,359
"39081","NYERI","NYERI SOUTH","74",146,182,328
"39082","NYERI","NYERI SOUTH","70-74",1092,1290,2382
"39083","NYERI","NYERI SOUTH","75",130,178,308
"39084","NYERI","NYERI SOUTH","76",178,339,517
"39085","NYERI","NYERI SOUTH","77",107,145,252
"39086","NYERI","NYERI SOUTH","78",77,106,183
"39087","NYERI","NYERI SOUTH","79",82,163,245
"39088","NYERI","NYERI SOUTH","75-79",574,931,1505
"39089","NYERI","NYERI SOUTH","80",110,203,313
"39090","NYERI","NYERI SOUTH","81",61,115,176
"39091","NYERI","NYERI SOUTH","82",64,77,141
"39092","NYERI","NYERI SOUTH","83",64,93,157
"39093","NYERI","NYERI SOUTH","84",71,118,189
"39094","NYERI","NYERI SOUTH","80-84",370,606,976
"39095","NYERI","NYERI SOUTH","85",57,104,161
"39096","NYERI","NYERI SOUTH","86",36,53,89
"39097","NYERI","NYERI SOUTH","87",45,71,116
"39098","NYERI","NYERI SOUTH","88",19,42,61
"39099","NYERI","NYERI SOUTH","89",45,113,158
"39100","NYERI","NYERI SOUTH","85-89",202,383,585
"39101","NYERI","NYERI SOUTH","90",25,70,95
"39102","NYERI","NYERI SOUTH","91",30,47,77
"39103","NYERI","NYERI SOUTH","92",14,21,35
"39104","NYERI","NYERI SOUTH","93",14,20,34
"39105","NYERI","NYERI SOUTH","94",2,33,35
"39106","NYERI","NYERI SOUTH","90-94",85,191,276
"39107","NYERI","NYERI SOUTH","95",19,26,45
"39108","NYERI","NYERI SOUTH","96",6,16,22
"39109","NYERI","NYERI SOUTH","97",8,14,22
"39110","NYERI","NYERI SOUTH","98",9,9,18
"39111","NYERI","NYERI SOUTH","99",6,33,39
"39112","NYERI","NYERI SOUTH","95-99",48,98,146
"39113","NYERI","NYERI SOUTH","100+",11,64,75
"39114","NYERI","NYERI SOUTH","Not Stated",NA,NA,NA
"39115","NYERI","MUKURWEINI","Total",43975,45156,89131
"39116","NYERI","MUKURWEINI","0",790,765,1555
"39117","NYERI","MUKURWEINI","1",754,780,1534
"39118","NYERI","MUKURWEINI","2",827,841,1668
"39119","NYERI","MUKURWEINI","3",868,781,1649
"39120","NYERI","MUKURWEINI","4",819,827,1646
"39121","NYERI","MUKURWEINI","0 - 4",4058,3994,8052
"39122","NYERI","MUKURWEINI","5",848,839,1687
"39123","NYERI","MUKURWEINI","6",879,884,1763
"39124","NYERI","MUKURWEINI","7",972,889,1861
"39125","NYERI","MUKURWEINI","8",882,945,1827
"39126","NYERI","MUKURWEINI","9",1030,910,1940
"39127","NYERI","MUKURWEINI","5-9",NA,4467,9078
"39128","NYERI","MUKURWEINI","10",926,948,1874
"39129","NYERI","MUKURWEINI","11",930,899,1829
"39130","NYERI","MUKURWEINI","12",996,896,1892
"39131","NYERI","MUKURWEINI","13",1068,983,2051
"39132","NYERI","MUKURWEINI","14",1003,867,1870
"39133","NYERI","MUKURWEINI","10 -14",NA,4593,9516
"39134","NYERI","MUKURWEINI","15",1022,880,1902
"39135","NYERI","MUKURWEINI","16",968,832,1800
"39136","NYERI","MUKURWEINI","17",1068,867,1935
"39137","NYERI","MUKURWEINI","18",877,670,1547
"39138","NYERI","MUKURWEINI","19",789,662,1451
"39139","NYERI","MUKURWEINI","15-19",4724,3911,8635
"39140","NYERI","MUKURWEINI","20",693,637,1330
"39141","NYERI","MUKURWEINI","21",591,546,1137
"39142","NYERI","MUKURWEINI","22",505,504,1009
"39143","NYERI","MUKURWEINI","23",550,560,1110
"39144","NYERI","MUKURWEINI","24",494,465,959
"39145","NYERI","MUKURWEINI","20-24",2833,2712,5545
"39146","NYERI","MUKURWEINI","25",501,480,981
"39147","NYERI","MUKURWEINI","26",417,438,855
"39148","NYERI","MUKURWEINI","27",407,449,856
"39149","NYERI","MUKURWEINI","28",359,454,813
"39150","NYERI","MUKURWEINI","29",465,527,992
"39151","NYERI","MUKURWEINI","25-29",2149,2348,4497
"39152","NYERI","MUKURWEINI","30",578,645,1223
"39153","NYERI","MUKURWEINI","31",490,517,1007
"39154","NYERI","MUKURWEINI","32",598,618,1216
"39155","NYERI","MUKURWEINI","33",536,552,1088
"39156","NYERI","MUKURWEINI","34",486,540,1026
"39157","NYERI","MUKURWEINI","30-34",2688,2872,5560
"39158","NYERI","MUKURWEINI","35",702,632,1334
"39159","NYERI","MUKURWEINI","36",572,545,1117
"39160","NYERI","MUKURWEINI","37",558,559,1117
"39161","NYERI","MUKURWEINI","38",483,544,1027
"39162","NYERI","MUKURWEINI","39",529,614,1143
"39163","NYERI","MUKURWEINI","35-39",2844,2894,5738
"39164","NYERI","MUKURWEINI","40",679,681,1360
"39165","NYERI","MUKURWEINI","41",550,510,1060
"39166","NYERI","MUKURWEINI","42",541,490,1031
"39167","NYERI","MUKURWEINI","43",510,561,1071
"39168","NYERI","MUKURWEINI","44",451,456,907
"39169","NYERI","MUKURWEINI","40-44",2731,2698,5429
"39170","NYERI","MUKURWEINI","45",604,618,1222
"39171","NYERI","MUKURWEINI","46",521,460,981
"39172","NYERI","MUKURWEINI","47",528,545,1073
"39173","NYERI","MUKURWEINI","48",396,418,814
"39174","NYERI","MUKURWEINI","49",477,536,1013
"39175","NYERI","MUKURWEINI","45-49",2526,2577,5103
"39176","NYERI","MUKURWEINI","50",531,599,1130
"39177","NYERI","MUKURWEINI","51",452,450,902
"39178","NYERI","MUKURWEINI","52",501,537,1038
"39179","NYERI","MUKURWEINI","53",370,447,817
"39180","NYERI","MUKURWEINI","54",473,463,936
"39181","NYERI","MUKURWEINI","50-54",2327,2496,4823
"39182","NYERI","MUKURWEINI","55",449,524,973
"39183","NYERI","MUKURWEINI","56",497,502,999
"39184","NYERI","MUKURWEINI","57",380,463,843
"39185","NYERI","MUKURWEINI","58",327,376,703
"39186","NYERI","MUKURWEINI","59",404,423,827
"39187","NYERI","MUKURWEINI","55-59",2057,2288,4345
"39188","NYERI","MUKURWEINI","60",434,501,935
"39189","NYERI","MUKURWEINI","61",328,373,701
"39190","NYERI","MUKURWEINI","62",289,299,588
"39191","NYERI","MUKURWEINI","63",200,247,447
"39192","NYERI","MUKURWEINI","64",161,186,347
"39193","NYERI","MUKURWEINI","60-64",1412,1606,3018
"39194","NYERI","MUKURWEINI","65",307,354,661
"39195","NYERI","MUKURWEINI","66",209,221,430
"39196","NYERI","MUKURWEINI","67",409,424,833
"39197","NYERI","MUKURWEINI","68",195,198,393
"39198","NYERI","MUKURWEINI","69",272,302,574
"39199","NYERI","MUKURWEINI","65-69",1392,1499,2891
"39200","NYERI","MUKURWEINI","70",361,509,870
"39201","NYERI","MUKURWEINI","71",250,297,547
"39202","NYERI","MUKURWEINI","72",240,244,484
"39203","NYERI","MUKURWEINI","73",221,196,417
"39204","NYERI","MUKURWEINI","74",162,254,416
"39205","NYERI","MUKURWEINI","70-74",1234,1500,2734
"39206","NYERI","MUKURWEINI","75",154,256,410
"39207","NYERI","MUKURWEINI","76",142,264,406
"39208","NYERI","MUKURWEINI","77",120,197,317
"39209","NYERI","MUKURWEINI","78",59,134,193
"39210","NYERI","MUKURWEINI","79",83,157,240
"39211","NYERI","MUKURWEINI","75-79",558,1008,1566
"39212","NYERI","MUKURWEINI","80",146,288,434
"39213","NYERI","MUKURWEINI","81",82,124,206
"39214","NYERI","MUKURWEINI","82",80,91,171
"39215","NYERI","MUKURWEINI","83",84,122,206
"39216","NYERI","MUKURWEINI","84",75,109,184
"39217","NYERI","MUKURWEINI","80-84",467,734,1201
"39218","NYERI","MUKURWEINI","85",73,101,174
"39219","NYERI","MUKURWEINI","86",60,95,155
"39220","NYERI","MUKURWEINI","87",51,77,128
"39221","NYERI","MUKURWEINI","88",23,59,82
"39222","NYERI","MUKURWEINI","89",43,118,161
"39223","NYERI","MUKURWEINI","85-89",250,450,700
"39224","NYERI","MUKURWEINI","90",42,86,128
"39225","NYERI","MUKURWEINI","91",30,49,79
"39226","NYERI","MUKURWEINI","92",15,40,55
"39227","NYERI","MUKURWEINI","93",18,29,47
"39228","NYERI","MUKURWEINI","94",14,41,55
"39229","NYERI","MUKURWEINI","90-94",119,245,364
"39230","NYERI","MUKURWEINI","95",14,41,55
"39231","NYERI","MUKURWEINI","96",12,42,54
"39232","NYERI","MUKURWEINI","97",8,27,35
"39233","NYERI","MUKURWEINI","98",8,28,36
"39234","NYERI","MUKURWEINI","99",9,44,53
"39235","NYERI","MUKURWEINI","95-99",51,182,233
"39236","NYERI","MUKURWEINI","100+",21,81,102
"39237","NYERI","MUKURWEINI","Not Stated",NA,1,1
"39238","NYERI","NYERI CENTRAL","Total",69955,70380,140335
"39239","NYERI","NYERI CENTRAL","0",1625,1539,3164
"39240","NYERI","NYERI CENTRAL","1",1553,1450,3003
"39241","NYERI","NYERI CENTRAL","2",1419,1378,2797
"39242","NYERI","NYERI CENTRAL","3",1446,1373,2819
"39243","NYERI","NYERI CENTRAL","4",1366,1306,2672
"39244","NYERI","NYERI CENTRAL","0 - 4",7409,7046,14455
"39245","NYERI","NYERI CENTRAL","5",1306,1293,2599
"39246","NYERI","NYERI CENTRAL","6",1234,1243,2477
"39247","NYERI","NYERI CENTRAL","7",1317,1300,2617
"39248","NYERI","NYERI CENTRAL","8",1282,1223,2505
"39249","NYERI","NYERI CENTRAL","9",1320,1298,2618
"39250","NYERI","NYERI CENTRAL","5-9",6459,6357,12816
"39251","NYERI","NYERI CENTRAL","10",1258,1233,2491
"39252","NYERI","NYERI CENTRAL","11",1155,1183,2338
"39253","NYERI","NYERI CENTRAL","12",1287,1278,2565
"39254","NYERI","NYERI CENTRAL","13",1352,1281,2633
"39255","NYERI","NYERI CENTRAL","14",1153,1179,2332
"39256","NYERI","NYERI CENTRAL","10 -14",6205,6154,12359
"39257","NYERI","NYERI CENTRAL","15",1186,1228,2414
"39258","NYERI","NYERI CENTRAL","16",1155,1198,2353
"39259","NYERI","NYERI CENTRAL","17",1244,1277,2521
"39260","NYERI","NYERI CENTRAL","18",1098,1189,2287
"39261","NYERI","NYERI CENTRAL","19",1270,1306,2576
"39262","NYERI","NYERI CENTRAL","15-19",5953,6198,12151
"39263","NYERI","NYERI CENTRAL","20",1284,1431,2715
"39264","NYERI","NYERI CENTRAL","21",1348,1474,2822
"39265","NYERI","NYERI CENTRAL","22",1399,1539,2938
"39266","NYERI","NYERI CENTRAL","23",1552,1605,3157
"39267","NYERI","NYERI CENTRAL","24",1488,1580,3068
"39268","NYERI","NYERI CENTRAL","20-24",7071,7629,14700
"39269","NYERI","NYERI CENTRAL","25",1421,1461,2882
"39270","NYERI","NYERI CENTRAL","26",1274,1332,2606
"39271","NYERI","NYERI CENTRAL","27",1301,1300,2601
"39272","NYERI","NYERI CENTRAL","28",1225,1280,2505
"39273","NYERI","NYERI CENTRAL","29",1346,1230,2576
"39274","NYERI","NYERI CENTRAL","25-29",6567,6603,13170
"39275","NYERI","NYERI CENTRAL","30",1499,1480,2979
"39276","NYERI","NYERI CENTRAL","31",1139,1037,2176
"39277","NYERI","NYERI CENTRAL","32",1339,1388,2727
"39278","NYERI","NYERI CENTRAL","33",1148,1237,2385
"39279","NYERI","NYERI CENTRAL","34",1117,1153,2270
"39280","NYERI","NYERI CENTRAL","30-34",6242,6295,12537
"39281","NYERI","NYERI CENTRAL","35",1382,1365,2747
"39282","NYERI","NYERI CENTRAL","36",1071,1060,2131
"39283","NYERI","NYERI CENTRAL","37",1078,1022,2100
"39284","NYERI","NYERI CENTRAL","38",1012,978,1990
"39285","NYERI","NYERI CENTRAL","39",1007,984,1991
"39286","NYERI","NYERI CENTRAL","35-39",5550,5409,10959
"39287","NYERI","NYERI CENTRAL","40",1136,1138,2274
"39288","NYERI","NYERI CENTRAL","41",961,859,1820
"39289","NYERI","NYERI CENTRAL","42",970,856,1826
"39290","NYERI","NYERI CENTRAL","43",802,817,1619
"39291","NYERI","NYERI CENTRAL","44",666,672,1338
"39292","NYERI","NYERI CENTRAL","40-44",4535,4342,8877
"39293","NYERI","NYERI CENTRAL","45",958,889,1847
"39294","NYERI","NYERI CENTRAL","46",710,670,1380
"39295","NYERI","NYERI CENTRAL","47",775,689,1464
"39296","NYERI","NYERI CENTRAL","48",654,568,1222
"39297","NYERI","NYERI CENTRAL","49",687,653,1340
"39298","NYERI","NYERI CENTRAL","45-49",3784,3469,7253
"39299","NYERI","NYERI CENTRAL","50",800,796,1596
"39300","NYERI","NYERI CENTRAL","51",532,594,1126
"39301","NYERI","NYERI CENTRAL","52",615,699,1314
"39302","NYERI","NYERI CENTRAL","53",497,488,985
"39303","NYERI","NYERI CENTRAL","54",589,560,1149
"39304","NYERI","NYERI CENTRAL","50-54",3033,3137,6170
"39305","NYERI","NYERI CENTRAL","55",547,538,1085
"39306","NYERI","NYERI CENTRAL","56",586,503,1089
"39307","NYERI","NYERI CENTRAL","57",502,516,1018
"39308","NYERI","NYERI CENTRAL","58",467,407,874
"39309","NYERI","NYERI CENTRAL","59",439,371,810
"39310","NYERI","NYERI CENTRAL","55-59",2541,2335,4876
"39311","NYERI","NYERI CENTRAL","60",492,479,971
"39312","NYERI","NYERI CENTRAL","61",336,315,651
"39313","NYERI","NYERI CENTRAL","62",306,294,600
"39314","NYERI","NYERI CENTRAL","63",234,248,482
"39315","NYERI","NYERI CENTRAL","64",157,172,329
"39316","NYERI","NYERI CENTRAL","60-64",1525,1508,3033
"39317","NYERI","NYERI CENTRAL","65",260,276,536
"39318","NYERI","NYERI CENTRAL","66",159,208,367
"39319","NYERI","NYERI CENTRAL","67",313,316,629
"39320","NYERI","NYERI CENTRAL","68",156,168,324
"39321","NYERI","NYERI CENTRAL","69",200,223,423
"39322","NYERI","NYERI CENTRAL","65-69",1088,1191,2279
"39323","NYERI","NYERI CENTRAL","70",289,325,614
"39324","NYERI","NYERI CENTRAL","71",199,204,403
"39325","NYERI","NYERI CENTRAL","72",197,181,378
"39326","NYERI","NYERI CENTRAL","73",179,143,322
"39327","NYERI","NYERI CENTRAL","74",131,156,287
"39328","NYERI","NYERI CENTRAL","70-74",995,1009,2004
"39329","NYERI","NYERI CENTRAL","75",128,151,279
"39330","NYERI","NYERI CENTRAL","76",133,222,355
"39331","NYERI","NYERI CENTRAL","77",86,126,212
"39332","NYERI","NYERI CENTRAL","78",62,82,144
"39333","NYERI","NYERI CENTRAL","79",64,104,168
"39334","NYERI","NYERI CENTRAL","75-79",473,685,1158
"39335","NYERI","NYERI CENTRAL","80",99,165,264
"39336","NYERI","NYERI CENTRAL","81",57,72,129
"39337","NYERI","NYERI CENTRAL","82",61,63,124
"39338","NYERI","NYERI CENTRAL","83",48,93,141
"39339","NYERI","NYERI CENTRAL","84",31,61,92
"39340","NYERI","NYERI CENTRAL","80-84",296,454,750
"39341","NYERI","NYERI CENTRAL","85",29,71,100
"39342","NYERI","NYERI CENTRAL","86",30,55,85
"39343","NYERI","NYERI CENTRAL","87",28,52,80
"39344","NYERI","NYERI CENTRAL","88",20,31,51
"39345","NYERI","NYERI CENTRAL","89",26,59,85
"39346","NYERI","NYERI CENTRAL","85-89",133,268,401
"39347","NYERI","NYERI CENTRAL","90",10,65,75
"39348","NYERI","NYERI CENTRAL","91",16,63,79
"39349","NYERI","NYERI CENTRAL","92",10,17,27
"39350","NYERI","NYERI CENTRAL","93",11,13,24
"39351","NYERI","NYERI CENTRAL","94",7,19,26
"39352","NYERI","NYERI CENTRAL","90-94",54,177,231
"39353","NYERI","NYERI CENTRAL","95",12,27,39
"39354","NYERI","NYERI CENTRAL","96",5,12,17
"39355","NYERI","NYERI CENTRAL","97",7,11,18
"39356","NYERI","NYERI CENTRAL","98",5,10,15
"39357","NYERI","NYERI CENTRAL","99",3,11,14
"39358","NYERI","NYERI CENTRAL","95-99",32,71,103
"39359","NYERI","NYERI CENTRAL","100+",9,40,49
"39360","NYERI","NYERI CENTRAL","Not Stated",1,3,4
"39361","NYERI","MT. KENYA FOREST","Total",123,65,188
"39362","NYERI","MT. KENYA FOREST","0",1,2,3
"39363","NYERI","MT. KENYA FOREST","1",1,2,3
"39364","NYERI","MT. KENYA FOREST","2",3,1,4
"39365","NYERI","MT. KENYA FOREST","3",1,NA,1
"39366","NYERI","MT. KENYA FOREST","4",2,1,3
"39367","NYERI","MT. KENYA FOREST","0 - 4",8,6,14
"39368","NYERI","MT. KENYA FOREST","5",3,2,5
"39369","NYERI","MT. KENYA FOREST","6",NA,1,1
"39370","NYERI","MT. KENYA FOREST","7",2,1,3
"39371","NYERI","MT. KENYA FOREST","8",1,3,4
"39372","NYERI","MT. KENYA FOREST","9",2,NA,2
"39373","NYERI","MT. KENYA FOREST","5-9",8,7,15
"39374","NYERI","MT. KENYA FOREST","10",NA,1,2
"39375","NYERI","MT. KENYA FOREST","11",NA,1,1
"39376","NYERI","MT. KENYA FOREST","12",2,1,3
"39377","NYERI","MT. KENYA FOREST","13",1,NA,1
"39378","NYERI","MT. KENYA FOREST","14",1,1,2
"39379","NYERI","MT. KENYA FOREST","10 -14",5,4,9
"39380","NYERI","MT. KENYA FOREST","15",NA,2,2
"39381","NYERI","MT. KENYA FOREST","16",1,2,3
"39382","NYERI","MT. KENYA FOREST","17",NA,1,1
"39383","NYERI","MT. KENYA FOREST","18",2,2,4
"39384","NYERI","MT. KENYA FOREST","19",1,2,3
"39385","NYERI","MT. KENYA FOREST","15-19",4,9,13
"39386","NYERI","MT. KENYA FOREST","20",2,1,3
"39387","NYERI","MT. KENYA FOREST","21",2,1,3
"39388","NYERI","MT. KENYA FOREST","22",NA,NA,NA
"39389","NYERI","MT. KENYA FOREST","23",2,1,3
"39390","NYERI","MT. KENYA FOREST","24",2,3,5
"39391","NYERI","MT. KENYA FOREST","20-24",8,6,14
"39392","NYERI","MT. KENYA FOREST","25",3,2,5
"39393","NYERI","MT. KENYA FOREST","26",1,NA,1
"39394","NYERI","MT. KENYA FOREST","27",1,1,2
"39395","NYERI","MT. KENYA FOREST","28",1,3,4
"39396","NYERI","MT. KENYA FOREST","29",2,1,3
"39397","NYERI","MT. KENYA FOREST","25-29",8,7,15
"39398","NYERI","MT. KENYA FOREST","30",4,1,5
"39399","NYERI","MT. KENYA FOREST","31",4,1,5
"39400","NYERI","MT. KENYA FOREST","32",4,1,5
"39401","NYERI","MT. KENYA FOREST","33",2,NA,2
"39402","NYERI","MT. KENYA FOREST","34",3,1,4
"39403","NYERI","MT. KENYA FOREST","30-34",17,4,21
"39404","NYERI","MT. KENYA FOREST","35",1,3,4
"39405","NYERI","MT. KENYA FOREST","36",5,2,7
"39406","NYERI","MT. KENYA FOREST","37",4,1,5
"39407","NYERI","MT. KENYA FOREST","38",4,2,6
"39408","NYERI","MT. KENYA FOREST","39",7,NA,7
"39409","NYERI","MT. KENYA FOREST","35-39",21,8,29
"39410","NYERI","MT. KENYA FOREST","40",4,NA,4
"39411","NYERI","MT. KENYA FOREST","41",NA,NA,NA
"39412","NYERI","MT. KENYA FOREST","42",2,1,3
"39413","NYERI","MT. KENYA FOREST","43",NA,NA,NA
"39414","NYERI","MT. KENYA FOREST","44",1,1,2
"39415","NYERI","MT. KENYA FOREST","40-44",7,2,9
"39416","NYERI","MT. KENYA FOREST","45",2,NA,2
"39417","NYERI","MT. KENYA FOREST","46",3,NA,3
"39418","NYERI","MT. KENYA FOREST","47",3,2,5
"39419","NYERI","MT. KENYA FOREST","48",3,1,4
"39420","NYERI","MT. KENYA FOREST","49",NA,NA,NA
"39421","NYERI","MT. KENYA FOREST","45-49",11,3,14
"39422","NYERI","MT. KENYA FOREST","50",3,2,5
"39423","NYERI","MT. KENYA FOREST","51",2,1,3
"39424","NYERI","MT. KENYA FOREST","52",1,NA,1
"39425","NYERI","MT. KENYA FOREST","53",2,1,3
"39426","NYERI","MT. KENYA FOREST","54",1,1,2
"39427","NYERI","MT. KENYA FOREST","50-54",9,5,14
"39428","NYERI","MT. KENYA FOREST","55",3,2,5
"39429","NYERI","MT. KENYA FOREST","56",2,NA,2
"39430","NYERI","MT. KENYA FOREST","57",2,NA,2
"39431","NYERI","MT. KENYA FOREST","58",1,1,2
"39432","NYERI","MT. KENYA FOREST","59",1,NA,1
"39433","NYERI","MT. KENYA FOREST","55-59",9,3,12
"39434","NYERI","MT. KENYA FOREST","60",1,1,2
"39435","NYERI","MT. KENYA FOREST","61",1,NA,1
"39436","NYERI","MT. KENYA FOREST","62",NA,NA,NA
"39437","NYERI","MT. KENYA FOREST","63",2,NA,2
"39438","NYERI","MT. KENYA FOREST","64",NA,NA,NA
"39439","NYERI","MT. KENYA FOREST","60-64",4,1,5
"39440","NYERI","MT. KENYA FOREST","65",NA,NA,NA
"39441","NYERI","MT. KENYA FOREST","66",1,NA,1
"39442","NYERI","MT. KENYA FOREST","67",2,NA,2
"39443","NYERI","MT. KENYA FOREST","68",NA,NA,NA
"39444","NYERI","MT. KENYA FOREST","69",NA,NA,NA
"39445","NYERI","MT. KENYA FOREST","65-69",3,NA,3
"39446","NYERI","MT. KENYA FOREST","70",NA,NA,NA
"39447","NYERI","MT. KENYA FOREST","71",NA,NA,NA
"39448","NYERI","MT. KENYA FOREST","72",NA,NA,NA
"39449","NYERI","MT. KENYA FOREST","73",NA,NA,NA
"39450","NYERI","MT. KENYA FOREST","74",NA,NA,NA
"39451","NYERI","MT. KENYA FOREST","70-74",NA,NA,NA
"39452","NYERI","MT. KENYA FOREST","75",NA,NA,NA
"39453","NYERI","MT. KENYA FOREST","76",NA,NA,NA
"39454","NYERI","MT. KENYA FOREST","77",NA,NA,NA
"39455","NYERI","MT. KENYA FOREST","78",NA,NA,NA
"39456","NYERI","MT. KENYA FOREST","79",NA,NA,NA
"39457","NYERI","MT. KENYA FOREST","75-79",NA,NA,NA
"39458","NYERI","MT. KENYA FOREST","80",NA,NA,NA
"39459","NYERI","MT. KENYA FOREST","81",NA,NA,NA
"39460","NYERI","MT. KENYA FOREST","82",NA,NA,NA
"39461","NYERI","MT. KENYA FOREST","83",NA,NA,NA
"39462","NYERI","MT. KENYA FOREST","84",NA,NA,NA
"39463","NYERI","MT. KENYA FOREST","80-84",NA,NA,NA
"39464","NYERI","MT. KENYA FOREST","85",1,NA,1
"39465","NYERI","MT. KENYA FOREST","86",NA,NA,NA
"39466","NYERI","MT. KENYA FOREST","87",NA,NA,NA
"39467","NYERI","MT. KENYA FOREST","88",NA,NA,NA
"39468","NYERI","MT. KENYA FOREST","89",NA,NA,NA
"39469","NYERI","MT. KENYA FOREST","85-89",1,NA,1
"39470","NYERI","MT. KENYA FOREST","90",NA,NA,NA
"39471","NYERI","MT. KENYA FOREST","91",NA,NA,NA
"39472","NYERI","MT. KENYA FOREST","92",NA,NA,NA
"39473","NYERI","MT. KENYA FOREST","93",NA,NA,NA
"39474","NYERI","MT. KENYA FOREST","94",NA,NA,NA
"39475","NYERI","MT. KENYA FOREST","90-94",NA,NA,NA
"39476","NYERI","MT. KENYA FOREST","95",NA,NA,NA
"39477","NYERI","MT. KENYA FOREST","96",NA,NA,NA
"39478","NYERI","MT. KENYA FOREST","97",NA,NA,NA
"39479","NYERI","MT. KENYA FOREST","98",NA,NA,NA
"39480","NYERI","MT. KENYA FOREST","99",NA,NA,NA
"39481","NYERI","MT. KENYA FOREST","95-99",NA,NA,NA
"39482","NYERI","MT. KENYA FOREST","100+",NA,NA,NA
"39483","NYERI","MT. KENYA FOREST","Not Stated",NA,NA,NA
"39484","NYERI","ABERDARE FOREST","Total",74,32,106
"39485","NYERI","ABERDARE FOREST","0",1,2,3
"39486","NYERI","ABERDARE FOREST","1",1,NA,1
"39487","NYERI","ABERDARE FOREST","2",2,1,3
"39488","NYERI","ABERDARE FOREST","3",3,NA,3
"39489","NYERI","ABERDARE FOREST","4",NA,NA,NA
"39490","NYERI","ABERDARE FOREST","0 - 4",7,3,10
"39491","NYERI","ABERDARE FOREST","5",1,NA,1
"39492","NYERI","ABERDARE FOREST","6",NA,NA,NA
"39493","NYERI","ABERDARE FOREST","7",NA,NA,NA
"39494","NYERI","ABERDARE FOREST","8",1,NA,1
"39495","NYERI","ABERDARE FOREST","9",NA,NA,NA
"39496","NYERI","ABERDARE FOREST","5-9",2,NA,2
"39497","NYERI","ABERDARE FOREST","10",NA,NA,NA
"39498","NYERI","ABERDARE FOREST","11",1,NA,1
"39499","NYERI","ABERDARE FOREST","12",NA,NA,NA
"39500","NYERI","ABERDARE FOREST","13",NA,NA,NA
"39501","NYERI","ABERDARE FOREST","14",NA,1,1
"39502","NYERI","ABERDARE FOREST","10 -14",1,1,2
"39503","NYERI","ABERDARE FOREST","15",NA,NA,NA
"39504","NYERI","ABERDARE FOREST","16",NA,NA,NA
"39505","NYERI","ABERDARE FOREST","17",NA,NA,NA
"39506","NYERI","ABERDARE FOREST","18",NA,2,2
"39507","NYERI","ABERDARE FOREST","19",NA,1,1
"39508","NYERI","ABERDARE FOREST","15-19",NA,3,3
"39509","NYERI","ABERDARE FOREST","20",NA,2,2
"39510","NYERI","ABERDARE FOREST","21",NA,NA,NA
"39511","NYERI","ABERDARE FOREST","22",NA,NA,NA
"39512","NYERI","ABERDARE FOREST","23",NA,2,2
"39513","NYERI","ABERDARE FOREST","24",2,2,4
"39514","NYERI","ABERDARE FOREST","20-24",2,6,8
"39515","NYERI","ABERDARE FOREST","25",NA,5,5
"39516","NYERI","ABERDARE FOREST","26",2,3,5
"39517","NYERI","ABERDARE FOREST","27",6,2,8
"39518","NYERI","ABERDARE FOREST","28",7,4,11
"39519","NYERI","ABERDARE FOREST","29",3,2,5
"39520","NYERI","ABERDARE FOREST","25-29",18,16,34
"39521","NYERI","ABERDARE FOREST","30",3,1,4
"39522","NYERI","ABERDARE FOREST","31",2,NA,2
"39523","NYERI","ABERDARE FOREST","32",5,NA,5
"39524","NYERI","ABERDARE FOREST","33",1,NA,1
"39525","NYERI","ABERDARE FOREST","34",NA,NA,NA
"39526","NYERI","ABERDARE FOREST","30-34",11,1,12
"39527","NYERI","ABERDARE FOREST","35",6,1,7
"39528","NYERI","ABERDARE FOREST","36",2,1,3
"39529","NYERI","ABERDARE FOREST","37",3,NA,3
"39530","NYERI","ABERDARE FOREST","38",7,NA,7
"39531","NYERI","ABERDARE FOREST","39",NA,NA,NA
"39532","NYERI","ABERDARE FOREST","35-39",18,2,20
"39533","NYERI","ABERDARE FOREST","40",6,NA,6
"39534","NYERI","ABERDARE FOREST","41",NA,NA,NA
"39535","NYERI","ABERDARE FOREST","42",2,NA,2
"39536","NYERI","ABERDARE FOREST","43",1,NA,1
"39537","NYERI","ABERDARE FOREST","44",1,NA,1
"39538","NYERI","ABERDARE FOREST","40-44",10,NA,10
"39539","NYERI","ABERDARE FOREST","45",NA,NA,NA
"39540","NYERI","ABERDARE FOREST","46",NA,NA,NA
"39541","NYERI","ABERDARE FOREST","47",1,NA,1
"39542","NYERI","ABERDARE FOREST","48",NA,NA,NA
"39543","NYERI","ABERDARE FOREST","49",2,NA,2
"39544","NYERI","ABERDARE FOREST","45-49",3,NA,3
"39545","NYERI","ABERDARE FOREST","50",NA,NA,NA
"39546","NYERI","ABERDARE FOREST","51",NA,NA,NA
"39547","NYERI","ABERDARE FOREST","52",1,NA,1
"39548","NYERI","ABERDARE FOREST","53",NA,NA,NA
"39549","NYERI","ABERDARE FOREST","54",NA,NA,NA
"39550","NYERI","ABERDARE FOREST","50-54",1,NA,1
"39551","NYERI","ABERDARE FOREST","55",NA,NA,NA
"39552","NYERI","ABERDARE FOREST","56",NA,NA,NA
"39553","NYERI","ABERDARE FOREST","57",1,NA,1
"39554","NYERI","ABERDARE FOREST","58",NA,NA,NA
"39555","NYERI","ABERDARE FOREST","59",NA,NA,NA
"39556","NYERI","ABERDARE FOREST","55-59",1,NA,1
"39557","NYERI","ABERDARE FOREST","60",NA,NA,NA
"39558","NYERI","ABERDARE FOREST","61",NA,NA,NA
"39559","NYERI","ABERDARE FOREST","62",NA,NA,NA
"39560","NYERI","ABERDARE FOREST","63",NA,NA,NA
"39561","NYERI","ABERDARE FOREST","64",NA,NA,NA
"39562","NYERI","ABERDARE FOREST","60-64",NA,NA,NA
"39563","NYERI","ABERDARE FOREST","65",NA,NA,NA
"39564","NYERI","ABERDARE FOREST","66",NA,NA,NA
"39565","NYERI","ABERDARE FOREST","67",NA,NA,NA
"39566","NYERI","ABERDARE FOREST","68",NA,NA,NA
"39567","NYERI","ABERDARE FOREST","69",NA,NA,NA
"39568","NYERI","ABERDARE FOREST","65-69",NA,NA,NA
"39569","NYERI","ABERDARE FOREST","70",NA,NA,NA
"39570","NYERI","ABERDARE FOREST","71",NA,NA,NA
"39571","NYERI","ABERDARE FOREST","72",NA,NA,NA
"39572","NYERI","ABERDARE FOREST","73",NA,NA,NA
"39573","NYERI","ABERDARE FOREST","74",NA,NA,NA
"39574","NYERI","ABERDARE FOREST","70-74",NA,NA,NA
"39575","NYERI","ABERDARE FOREST","75",NA,NA,NA
"39576","NYERI","ABERDARE FOREST","76",NA,NA,NA
"39577","NYERI","ABERDARE FOREST","77",NA,NA,NA
"39578","NYERI","ABERDARE FOREST","78",NA,NA,NA
"39579","NYERI","ABERDARE FOREST","79",NA,NA,NA
"39580","NYERI","ABERDARE FOREST","75-79",NA,NA,NA
"39581","NYERI","ABERDARE FOREST","80",NA,NA,NA
"39582","NYERI","ABERDARE FOREST","81",NA,NA,NA
"39583","NYERI","ABERDARE FOREST","82",NA,NA,NA
"39584","NYERI","ABERDARE FOREST","83",NA,NA,NA
"39585","NYERI","ABERDARE FOREST","84",NA,NA,NA
"39586","NYERI","ABERDARE FOREST","80-84",NA,NA,NA
"39587","NYERI","ABERDARE FOREST","85",NA,NA,NA
"39588","NYERI","ABERDARE FOREST","86",NA,NA,NA
"39589","NYERI","ABERDARE FOREST","87",NA,NA,NA
"39590","NYERI","ABERDARE FOREST","88",NA,NA,NA
"39591","NYERI","ABERDARE FOREST","89",NA,NA,NA
"39592","NYERI","ABERDARE FOREST","85-89",NA,NA,NA
"39593","NYERI","ABERDARE FOREST","90",NA,NA,NA
"39594","NYERI","ABERDARE FOREST","91",NA,NA,NA
"39595","NYERI","ABERDARE FOREST","92",NA,NA,NA
"39596","NYERI","ABERDARE FOREST","93",NA,NA,NA
"39597","NYERI","ABERDARE FOREST","94",NA,NA,NA
"39598","NYERI","ABERDARE FOREST","90-94",NA,NA,NA
"39599","NYERI","ABERDARE FOREST","95",NA,NA,NA
"39600","NYERI","ABERDARE FOREST","96",NA,NA,NA
"39601","NYERI","ABERDARE FOREST","97",NA,NA,NA
"39602","NYERI","ABERDARE FOREST","98",NA,NA,NA
"39603","NYERI","ABERDARE FOREST","99",NA,NA,NA
"39604","NYERI","ABERDARE FOREST","95-99",NA,NA,NA
"39605","NYERI","ABERDARE FOREST","100+",NA,NA,NA
"39606","NYERI","ABERDARE FOREST","Not Stated",NA,NA,NA
"39607","SAMBURU","ALL","Total",156774,153546,310320
"39608","SAMBURU","ALL","0",4527,4386,8913
"39609","SAMBURU","ALL","1",4234,4239,8473
"39610","SAMBURU","ALL","2",5315,5436,10751
"39611","SAMBURU","ALL","3",5591,5581,11172
"39612","SAMBURU","ALL","4",5794,5578,11372
"39613","SAMBURU","ALL","0 - 4",25461,25220,50681
"39614","SAMBURU","ALL","5",5981,5814,11795
"39615","SAMBURU","ALL","6",5781,5653,11434
"39616","SAMBURU","ALL","7",4965,4788,9753
"39617","SAMBURU","ALL","8",5713,5641,11354
"39618","SAMBURU","ALL","9",4356,4271,8627
"39619","SAMBURU","ALL","5-9",26796,26167,52963
"39620","SAMBURU","ALL","10",7223,6917,14140
"39621","SAMBURU","ALL","11",3312,3664,6976
"39622","SAMBURU","ALL","12",5778,4993,10771
"39623","SAMBURU","ALL","13",4234,3816,8050
"39624","SAMBURU","ALL","14",4516,3890,8406
"39625","SAMBURU","ALL","10 -14",25063,23280,48343
"39626","SAMBURU","ALL","15",5215,4376,9591
"39627","SAMBURU","ALL","16",3827,3181,7008
"39628","SAMBURU","ALL","17",3827,2825,6652
"39629","SAMBURU","ALL","18",3921,3243,7164
"39630","SAMBURU","ALL","19",3075,2688,5763
"39631","SAMBURU","ALL","15-19",19865,16313,36178
"39632","SAMBURU","ALL","20",4485,4327,8812
"39633","SAMBURU","ALL","21",2413,2688,5101
"39634","SAMBURU","ALL","22",2538,2733,5271
"39635","SAMBURU","ALL","23",2571,2916,5487
"39636","SAMBURU","ALL","24",2301,2276,4577
"39637","SAMBURU","ALL","20-24",14308,14940,29248
"39638","SAMBURU","ALL","25",3414,3384,6798
"39639","SAMBURU","ALL","26",1905,2246,4151
"39640","SAMBURU","ALL","27",1877,2098,3975
"39641","SAMBURU","ALL","28",1848,1830,3678
"39642","SAMBURU","ALL","29",1945,1947,3892
"39643","SAMBURU","ALL","25-29",10989,11505,22494
"39644","SAMBURU","ALL","30",3370,3180,6550
"39645","SAMBURU","ALL","31",1261,1536,2797
"39646","SAMBURU","ALL","32",1632,1934,3566
"39647","SAMBURU","ALL","33",1186,1603,2789
"39648","SAMBURU","ALL","34",935,1060,1995
"39649","SAMBURU","ALL","30-34",8384,9313,17697
"39650","SAMBURU","ALL","35",2271,2393,4664
"39651","SAMBURU","ALL","36",871,1097,1968
"39652","SAMBURU","ALL","37",772,683,1455
"39653","SAMBURU","ALL","38",635,598,1233
"39654","SAMBURU","ALL","39",753,695,1448
"39655","SAMBURU","ALL","35-39",5302,5466,10768
"39656","SAMBURU","ALL","40",2007,1547,3554
"39657","SAMBURU","ALL","41",1087,1016,2103
"39658","SAMBURU","ALL","42",990,953,1943
"39659","SAMBURU","ALL","43",732,766,1498
"39660","SAMBURU","ALL","44",506,428,934
"39661","SAMBURU","ALL","40-44",5322,4710,10032
"39662","SAMBURU","ALL","45",1451,1309,2760
"39663","SAMBURU","ALL","46",784,937,1721
"39664","SAMBURU","ALL","47",790,810,1600
"39665","SAMBURU","ALL","48",501,574,1075
"39666","SAMBURU","ALL","49",584,584,1168
"39667","SAMBURU","ALL","45-49",4110,4214,8324
"39668","SAMBURU","ALL","50",1156,1171,2327
"39669","SAMBURU","ALL","51",401,501,902
"39670","SAMBURU","ALL","52",396,445,841
"39671","SAMBURU","ALL","53",274,295,569
"39672","SAMBURU","ALL","54",440,418,858
"39673","SAMBURU","ALL","50-54",2667,2830,5497
"39674","SAMBURU","ALL","55",538,499,1037
"39675","SAMBURU","ALL","56",433,362,795
"39676","SAMBURU","ALL","57",299,346,645
"39677","SAMBURU","ALL","58",338,289,627
"39678","SAMBURU","ALL","59",481,612,1093
"39679","SAMBURU","ALL","55-59",2089,2108,4197
"39680","SAMBURU","ALL","60",996,989,1985
"39681","SAMBURU","ALL","61",385,404,789
"39682","SAMBURU","ALL","62",310,363,673
"39683","SAMBURU","ALL","63",308,398,706
"39684","SAMBURU","ALL","64",195,271,466
"39685","SAMBURU","ALL","60-64",2194,2425,4619
"39686","SAMBURU","ALL","65",435,514,949
"39687","SAMBURU","ALL","66",141,146,287
"39688","SAMBURU","ALL","67",223,290,513
"39689","SAMBURU","ALL","68",188,202,390
"39690","SAMBURU","ALL","69",259,395,654
"39691","SAMBURU","ALL","65-69",1246,1547,2793
"39692","SAMBURU","ALL","70",624,730,1354
"39693","SAMBURU","ALL","71",274,360,634
"39694","SAMBURU","ALL","72",162,156,318
"39695","SAMBURU","ALL","73",142,158,300
"39696","SAMBURU","ALL","74",148,156,304
"39697","SAMBURU","ALL","70-74",1350,1560,2910
"39698","SAMBURU","ALL","75",273,234,507
"39699","SAMBURU","ALL","76",71,92,163
"39700","SAMBURU","ALL","77",86,99,185
"39701","SAMBURU","ALL","78",74,83,157
"39702","SAMBURU","ALL","79",184,240,424
"39703","SAMBURU","ALL","75-79",688,748,1436
"39704","SAMBURU","ALL","80",238,338,576
"39705","SAMBURU","ALL","81",101,100,201
"39706","SAMBURU","ALL","82",54,63,117
"39707","SAMBURU","ALL","83",54,93,147
"39708","SAMBURU","ALL","84",60,68,128
"39709","SAMBURU","ALL","80-84",507,662,1169
"39710","SAMBURU","ALL","85",47,73,120
"39711","SAMBURU","ALL","86",23,34,57
"39712","SAMBURU","ALL","87",36,51,87
"39713","SAMBURU","ALL","88",27,26,53
"39714","SAMBURU","ALL","89",96,119,215
"39715","SAMBURU","ALL","85-89",229,303,532
"39716","SAMBURU","ALL","90",61,84,145
"39717","SAMBURU","ALL","91",16,20,36
"39718","SAMBURU","ALL","92",8,5,13
"39719","SAMBURU","ALL","93",13,14,27
"39720","SAMBURU","ALL","94",12,11,23
"39721","SAMBURU","ALL","90-94",110,134,244
"39722","SAMBURU","ALL","95",24,32,56
"39723","SAMBURU","ALL","96",10,9,19
"39724","SAMBURU","ALL","97",7,6,13
"39725","SAMBURU","ALL","98",9,5,14
"39726","SAMBURU","ALL","99",14,23,37
"39727","SAMBURU","ALL","95-99",64,75,139
"39728","SAMBURU","ALL","100+",29,25,54
"39729","SAMBURU","ALL","Not Stated",1,1,2
"39730","SAMBURU","SAMBURU CENTRAL","Total",83633,81307,164940
"39731","SAMBURU","SAMBURU CENTRAL","0",2365,2289,4654
"39732","SAMBURU","SAMBURU CENTRAL","1",2233,2235,4468
"39733","SAMBURU","SAMBURU CENTRAL","2",2688,2833,5521
"39734","SAMBURU","SAMBURU CENTRAL","3",2828,2815,5643
"39735","SAMBURU","SAMBURU CENTRAL","4",2978,2899,5877
"39736","SAMBURU","SAMBURU CENTRAL","0 - 4",13092,13071,26163
"39737","SAMBURU","SAMBURU CENTRAL","5",3059,3039,6098
"39738","SAMBURU","SAMBURU CENTRAL","6",3032,2951,5983
"39739","SAMBURU","SAMBURU CENTRAL","7",2627,2539,5166
"39740","SAMBURU","SAMBURU CENTRAL","8",2933,2911,5844
"39741","SAMBURU","SAMBURU CENTRAL","9",2418,2306,4724
"39742","SAMBURU","SAMBURU CENTRAL","5-9",14069,13746,27815
"39743","SAMBURU","SAMBURU CENTRAL","10",3709,3434,7143
"39744","SAMBURU","SAMBURU CENTRAL","11",1926,1967,3893
"39745","SAMBURU","SAMBURU CENTRAL","12",2967,2689,5656
"39746","SAMBURU","SAMBURU CENTRAL","13",2339,2159,4498
"39747","SAMBURU","SAMBURU CENTRAL","14",2488,2194,4682
"39748","SAMBURU","SAMBURU CENTRAL","10 -14",13429,12443,25872
"39749","SAMBURU","SAMBURU CENTRAL","15",2903,2421,5324
"39750","SAMBURU","SAMBURU CENTRAL","16",2069,1785,3854
"39751","SAMBURU","SAMBURU CENTRAL","17",2172,1709,3881
"39752","SAMBURU","SAMBURU CENTRAL","18",2132,1725,3857
"39753","SAMBURU","SAMBURU CENTRAL","19",1731,1545,3276
"39754","SAMBURU","SAMBURU CENTRAL","15-19",11007,9185,20192
"39755","SAMBURU","SAMBURU CENTRAL","20",2267,2340,4607
"39756","SAMBURU","SAMBURU CENTRAL","21",1339,1443,2782
"39757","SAMBURU","SAMBURU CENTRAL","22",1401,1564,2965
"39758","SAMBURU","SAMBURU CENTRAL","23",1348,1463,2811
"39759","SAMBURU","SAMBURU CENTRAL","24",1236,1147,2383
"39760","SAMBURU","SAMBURU CENTRAL","20-24",7591,7957,15548
"39761","SAMBURU","SAMBURU CENTRAL","25",1794,1742,3536
"39762","SAMBURU","SAMBURU CENTRAL","26",1061,1087,2148
"39763","SAMBURU","SAMBURU CENTRAL","27",1007,1096,2103
"39764","SAMBURU","SAMBURU CENTRAL","28",1031,980,2011
"39765","SAMBURU","SAMBURU CENTRAL","29",1040,954,1994
"39766","SAMBURU","SAMBURU CENTRAL","25-29",5933,5859,11792
"39767","SAMBURU","SAMBURU CENTRAL","30",1722,1695,3417
"39768","SAMBURU","SAMBURU CENTRAL","31",705,888,1593
"39769","SAMBURU","SAMBURU CENTRAL","32",890,958,1848
"39770","SAMBURU","SAMBURU CENTRAL","33",644,858,1502
"39771","SAMBURU","SAMBURU CENTRAL","34",532,579,1111
"39772","SAMBURU","SAMBURU CENTRAL","30-34",4493,4978,9471
"39773","SAMBURU","SAMBURU CENTRAL","35",1190,1311,2501
"39774","SAMBURU","SAMBURU CENTRAL","36",513,648,1161
"39775","SAMBURU","SAMBURU CENTRAL","37",443,423,866
"39776","SAMBURU","SAMBURU CENTRAL","38",407,375,782
"39777","SAMBURU","SAMBURU CENTRAL","39",442,387,829
"39778","SAMBURU","SAMBURU CENTRAL","35-39",2995,3144,6139
"39779","SAMBURU","SAMBURU CENTRAL","40",1091,816,1907
"39780","SAMBURU","SAMBURU CENTRAL","41",615,505,1120
"39781","SAMBURU","SAMBURU CENTRAL","42",502,467,969
"39782","SAMBURU","SAMBURU CENTRAL","43",337,379,716
"39783","SAMBURU","SAMBURU CENTRAL","44",316,228,544
"39784","SAMBURU","SAMBURU CENTRAL","40-44",2861,2395,5256
"39785","SAMBURU","SAMBURU CENTRAL","45",737,665,1402
"39786","SAMBURU","SAMBURU CENTRAL","46",405,533,938
"39787","SAMBURU","SAMBURU CENTRAL","47",462,475,937
"39788","SAMBURU","SAMBURU CENTRAL","48",295,319,614
"39789","SAMBURU","SAMBURU CENTRAL","49",320,271,591
"39790","SAMBURU","SAMBURU CENTRAL","45-49",2219,2263,4482
"39791","SAMBURU","SAMBURU CENTRAL","50",593,601,1194
"39792","SAMBURU","SAMBURU CENTRAL","51",232,239,471
"39793","SAMBURU","SAMBURU CENTRAL","52",214,227,441
"39794","SAMBURU","SAMBURU CENTRAL","53",160,144,304
"39795","SAMBURU","SAMBURU CENTRAL","54",246,220,466
"39796","SAMBURU","SAMBURU CENTRAL","50-54",1445,1431,2876
"39797","SAMBURU","SAMBURU CENTRAL","55",291,270,561
"39798","SAMBURU","SAMBURU CENTRAL","56",240,188,428
"39799","SAMBURU","SAMBURU CENTRAL","57",181,206,387
"39800","SAMBURU","SAMBURU CENTRAL","58",215,151,366
"39801","SAMBURU","SAMBURU CENTRAL","59",243,327,570
"39802","SAMBURU","SAMBURU CENTRAL","55-59",1170,1142,2312
"39803","SAMBURU","SAMBURU CENTRAL","60",500,513,1013
"39804","SAMBURU","SAMBURU CENTRAL","61",221,215,436
"39805","SAMBURU","SAMBURU CENTRAL","62",168,194,362
"39806","SAMBURU","SAMBURU CENTRAL","63",166,201,367
"39807","SAMBURU","SAMBURU CENTRAL","64",107,124,231
"39808","SAMBURU","SAMBURU CENTRAL","60-64",1162,1247,2409
"39809","SAMBURU","SAMBURU CENTRAL","65",219,279,498
"39810","SAMBURU","SAMBURU CENTRAL","66",74,69,143
"39811","SAMBURU","SAMBURU CENTRAL","67",127,164,291
"39812","SAMBURU","SAMBURU CENTRAL","68",108,78,186
"39813","SAMBURU","SAMBURU CENTRAL","69",126,195,321
"39814","SAMBURU","SAMBURU CENTRAL","65-69",654,785,1439
"39815","SAMBURU","SAMBURU CENTRAL","70",319,357,676
"39816","SAMBURU","SAMBURU CENTRAL","71",135,163,298
"39817","SAMBURU","SAMBURU CENTRAL","72",86,67,153
"39818","SAMBURU","SAMBURU CENTRAL","73",73,60,133
"39819","SAMBURU","SAMBURU CENTRAL","74",75,70,145
"39820","SAMBURU","SAMBURU CENTRAL","70-74",688,717,1405
"39821","SAMBURU","SAMBURU CENTRAL","75",140,116,256
"39822","SAMBURU","SAMBURU CENTRAL","76",38,34,72
"39823","SAMBURU","SAMBURU CENTRAL","77",45,37,82
"39824","SAMBURU","SAMBURU CENTRAL","78",45,41,86
"39825","SAMBURU","SAMBURU CENTRAL","79",82,111,193
"39826","SAMBURU","SAMBURU CENTRAL","75-79",350,339,689
"39827","SAMBURU","SAMBURU CENTRAL","80",132,185,317
"39828","SAMBURU","SAMBURU CENTRAL","81",39,48,87
"39829","SAMBURU","SAMBURU CENTRAL","82",28,23,51
"39830","SAMBURU","SAMBURU CENTRAL","83",30,51,81
"39831","SAMBURU","SAMBURU CENTRAL","84",33,28,61
"39832","SAMBURU","SAMBURU CENTRAL","80-84",262,335,597
"39833","SAMBURU","SAMBURU CENTRAL","85",21,38,59
"39834","SAMBURU","SAMBURU CENTRAL","86",13,15,28
"39835","SAMBURU","SAMBURU CENTRAL","87",22,31,53
"39836","SAMBURU","SAMBURU CENTRAL","88",17,7,24
"39837","SAMBURU","SAMBURU CENTRAL","89",44,55,99
"39838","SAMBURU","SAMBURU CENTRAL","85-89",117,146,263
"39839","SAMBURU","SAMBURU CENTRAL","90",30,43,73
"39840","SAMBURU","SAMBURU CENTRAL","91",6,13,19
"39841","SAMBURU","SAMBURU CENTRAL","92",4,4,8
"39842","SAMBURU","SAMBURU CENTRAL","93",10,7,17
"39843","SAMBURU","SAMBURU CENTRAL","94",6,6,12
"39844","SAMBURU","SAMBURU CENTRAL","90-94",56,73,129
"39845","SAMBURU","SAMBURU CENTRAL","95",5,15,20
"39846","SAMBURU","SAMBURU CENTRAL","96",4,3,7
"39847","SAMBURU","SAMBURU CENTRAL","97",3,3,6
"39848","SAMBURU","SAMBURU CENTRAL","98",5,2,7
"39849","SAMBURU","SAMBURU CENTRAL","99",3,13,16
"39850","SAMBURU","SAMBURU CENTRAL","95-99",20,36,56
"39851","SAMBURU","SAMBURU CENTRAL","100+",19,15,34
"39852","SAMBURU","SAMBURU CENTRAL","Not Stated",1,NA,1
"39853","SAMBURU","SAMBURU EAST","Total",38211,39782,77993
"39854","SAMBURU","SAMBURU EAST","0",1116,1080,2196
"39855","SAMBURU","SAMBURU EAST","1",1125,1127,2252
"39856","SAMBURU","SAMBURU EAST","2",1356,1391,2747
"39857","SAMBURU","SAMBURU EAST","3",1499,1510,3009
"39858","SAMBURU","SAMBURU EAST","4",1482,1387,2869
"39859","SAMBURU","SAMBURU EAST","0 - 4",6578,6495,13073
"39860","SAMBURU","SAMBURU EAST","5",1498,1449,2947
"39861","SAMBURU","SAMBURU EAST","6",1408,1447,2855
"39862","SAMBURU","SAMBURU EAST","7",1154,1132,2286
"39863","SAMBURU","SAMBURU EAST","8",1410,1407,2817
"39864","SAMBURU","SAMBURU EAST","9",1025,1024,2049
"39865","SAMBURU","SAMBURU EAST","5-9",6495,6459,12954
"39866","SAMBURU","SAMBURU EAST","10",1806,1872,3678
"39867","SAMBURU","SAMBURU EAST","11",737,834,1571
"39868","SAMBURU","SAMBURU EAST","12",1377,1238,2615
"39869","SAMBURU","SAMBURU EAST","13",1028,954,1982
"39870","SAMBURU","SAMBURU EAST","14",950,903,1853
"39871","SAMBURU","SAMBURU EAST","10 -14",5898,5801,11699
"39872","SAMBURU","SAMBURU EAST","15",1031,1028,2059
"39873","SAMBURU","SAMBURU EAST","16",874,777,1651
"39874","SAMBURU","SAMBURU EAST","17",758,609,1367
"39875","SAMBURU","SAMBURU EAST","18",859,875,1734
"39876","SAMBURU","SAMBURU EAST","19",719,709,1428
"39877","SAMBURU","SAMBURU EAST","15-19",4241,3998,8239
"39878","SAMBURU","SAMBURU EAST","20",1039,1071,2110
"39879","SAMBURU","SAMBURU EAST","21",575,697,1272
"39880","SAMBURU","SAMBURU EAST","22",604,701,1305
"39881","SAMBURU","SAMBURU EAST","23",681,852,1533
"39882","SAMBURU","SAMBURU EAST","24",582,632,1214
"39883","SAMBURU","SAMBURU EAST","20-24",3481,3953,7434
"39884","SAMBURU","SAMBURU EAST","25",842,993,1835
"39885","SAMBURU","SAMBURU EAST","26",430,603,1033
"39886","SAMBURU","SAMBURU EAST","27",401,505,906
"39887","SAMBURU","SAMBURU EAST","28",457,509,966
"39888","SAMBURU","SAMBURU EAST","29",516,648,1164
"39889","SAMBURU","SAMBURU EAST","25-29",2646,3258,5904
"39890","SAMBURU","SAMBURU EAST","30",922,979,1901
"39891","SAMBURU","SAMBURU EAST","31",310,396,706
"39892","SAMBURU","SAMBURU EAST","32",411,561,972
"39893","SAMBURU","SAMBURU EAST","33",257,340,597
"39894","SAMBURU","SAMBURU EAST","34",242,253,495
"39895","SAMBURU","SAMBURU EAST","30-34",2142,2529,4671
"39896","SAMBURU","SAMBURU EAST","35",626,634,1260
"39897","SAMBURU","SAMBURU EAST","36",220,294,514
"39898","SAMBURU","SAMBURU EAST","37",209,165,374
"39899","SAMBURU","SAMBURU EAST","38",134,134,268
"39900","SAMBURU","SAMBURU EAST","39",180,178,358
"39901","SAMBURU","SAMBURU EAST","35-39",1369,1405,2774
"39902","SAMBURU","SAMBURU EAST","40",535,428,963
"39903","SAMBURU","SAMBURU EAST","41",275,301,576
"39904","SAMBURU","SAMBURU EAST","42",253,238,491
"39905","SAMBURU","SAMBURU EAST","43",238,209,447
"39906","SAMBURU","SAMBURU EAST","44",126,121,247
"39907","SAMBURU","SAMBURU EAST","40-44",1427,1297,2724
"39908","SAMBURU","SAMBURU EAST","45",418,377,795
"39909","SAMBURU","SAMBURU EAST","46",202,239,441
"39910","SAMBURU","SAMBURU EAST","47",207,169,376
"39911","SAMBURU","SAMBURU EAST","48",143,161,304
"39912","SAMBURU","SAMBURU EAST","49",160,204,364
"39913","SAMBURU","SAMBURU EAST","45-49",1130,1150,2280
"39914","SAMBURU","SAMBURU EAST","50",322,305,627
"39915","SAMBURU","SAMBURU EAST","51",84,131,215
"39916","SAMBURU","SAMBURU EAST","52",93,100,193
"39917","SAMBURU","SAMBURU EAST","53",68,72,140
"39918","SAMBURU","SAMBURU EAST","54",107,114,221
"39919","SAMBURU","SAMBURU EAST","50-54",674,722,1396
"39920","SAMBURU","SAMBURU EAST","55",143,151,294
"39921","SAMBURU","SAMBURU EAST","56",113,94,207
"39922","SAMBURU","SAMBURU EAST","57",63,69,132
"39923","SAMBURU","SAMBURU EAST","58",72,78,150
"39924","SAMBURU","SAMBURU EAST","59",134,156,290
"39925","SAMBURU","SAMBURU EAST","55-59",525,548,1073
"39926","SAMBURU","SAMBURU EAST","60",262,284,546
"39927","SAMBURU","SAMBURU EAST","61",107,112,219
"39928","SAMBURU","SAMBURU EAST","62",80,97,177
"39929","SAMBURU","SAMBURU EAST","63",84,116,200
"39930","SAMBURU","SAMBURU EAST","64",44,85,129
"39931","SAMBURU","SAMBURU EAST","60-64",577,694,1271
"39932","SAMBURU","SAMBURU EAST","65",123,147,270
"39933","SAMBURU","SAMBURU EAST","66",31,40,71
"39934","SAMBURU","SAMBURU EAST","67",48,68,116
"39935","SAMBURU","SAMBURU EAST","68",45,74,119
"39936","SAMBURU","SAMBURU EAST","69",63,104,167
"39937","SAMBURU","SAMBURU EAST","65-69",310,433,743
"39938","SAMBURU","SAMBURU EAST","70",146,190,336
"39939","SAMBURU","SAMBURU EAST","71",79,118,197
"39940","SAMBURU","SAMBURU EAST","72",43,46,89
"39941","SAMBURU","SAMBURU EAST","73",33,64,97
"39942","SAMBURU","SAMBURU EAST","74",35,47,82
"39943","SAMBURU","SAMBURU EAST","70-74",336,465,801
"39944","SAMBURU","SAMBURU EAST","75",53,58,111
"39945","SAMBURU","SAMBURU EAST","76",17,37,54
"39946","SAMBURU","SAMBURU EAST","77",23,37,60
"39947","SAMBURU","SAMBURU EAST","78",14,25,39
"39948","SAMBURU","SAMBURU EAST","79",45,57,102
"39949","SAMBURU","SAMBURU EAST","75-79",152,214,366
"39950","SAMBURU","SAMBURU EAST","80",58,98,156
"39951","SAMBURU","SAMBURU EAST","81",38,29,67
"39952","SAMBURU","SAMBURU EAST","82",6,27,33
"39953","SAMBURU","SAMBURU EAST","83",11,26,37
"39954","SAMBURU","SAMBURU EAST","84",13,30,43
"39955","SAMBURU","SAMBURU EAST","80-84",126,210,336
"39956","SAMBURU","SAMBURU EAST","85",13,18,31
"39957","SAMBURU","SAMBURU EAST","86",3,12,15
"39958","SAMBURU","SAMBURU EAST","87",6,8,14
"39959","SAMBURU","SAMBURU EAST","88",5,11,16
"39960","SAMBURU","SAMBURU EAST","89",25,36,61
"39961","SAMBURU","SAMBURU EAST","85-89",52,85,137
"39962","SAMBURU","SAMBURU EAST","90",12,21,33
"39963","SAMBURU","SAMBURU EAST","91",5,5,10
"39964","SAMBURU","SAMBURU EAST","92",2,1,3
"39965","SAMBURU","SAMBURU EAST","93",1,4,5
"39966","SAMBURU","SAMBURU EAST","94",2,4,6
"39967","SAMBURU","SAMBURU EAST","90-94",22,35,57
"39968","SAMBURU","SAMBURU EAST","95",5,6,11
"39969","SAMBURU","SAMBURU EAST","96",3,4,7
"39970","SAMBURU","SAMBURU EAST","97",3,2,5
"39971","SAMBURU","SAMBURU EAST","98",3,3,6
"39972","SAMBURU","SAMBURU EAST","99",7,8,15
"39973","SAMBURU","SAMBURU EAST","95-99",21,23,44
"39974","SAMBURU","SAMBURU EAST","100+",9,8,17
"39975","SAMBURU","SAMBURU EAST","Not Stated",NA,NA,NA
"39976","SAMBURU","SAMBURU NORTH","Total",34930,32457,67387
"39977","SAMBURU","SAMBURU NORTH","0",1046,1017,2063
"39978","SAMBURU","SAMBURU NORTH","1",876,877,1753
"39979","SAMBURU","SAMBURU NORTH","2",1271,1212,2483
"39980","SAMBURU","SAMBURU NORTH","3",1264,1256,2520
"39981","SAMBURU","SAMBURU NORTH","4",1334,1292,2626
"39982","SAMBURU","SAMBURU NORTH","0 - 4",5791,5654,11445
"39983","SAMBURU","SAMBURU NORTH","5",1424,1326,2750
"39984","SAMBURU","SAMBURU NORTH","6",1341,1255,2596
"39985","SAMBURU","SAMBURU NORTH","7",1184,1117,2301
"39986","SAMBURU","SAMBURU NORTH","8",1370,1323,2693
"39987","SAMBURU","SAMBURU NORTH","9",913,941,1854
"39988","SAMBURU","SAMBURU NORTH","5-9",6232,5962,12194
"39989","SAMBURU","SAMBURU NORTH","10",1708,1611,3319
"39990","SAMBURU","SAMBURU NORTH","11",649,863,1512
"39991","SAMBURU","SAMBURU NORTH","12",1434,1066,2500
"39992","SAMBURU","SAMBURU NORTH","13",867,703,1570
"39993","SAMBURU","SAMBURU NORTH","14",1078,793,1871
"39994","SAMBURU","SAMBURU NORTH","10 -14",5736,5036,10772
"39995","SAMBURU","SAMBURU NORTH","15",1281,927,2208
"39996","SAMBURU","SAMBURU NORTH","16",884,619,1503
"39997","SAMBURU","SAMBURU NORTH","17",897,507,1404
"39998","SAMBURU","SAMBURU NORTH","18",930,643,1573
"39999","SAMBURU","SAMBURU NORTH","19",625,434,1059
"40000","SAMBURU","SAMBURU NORTH","15-19",4617,3130,7747
"40001","SAMBURU","SAMBURU NORTH","20",1179,916,2095
"40002","SAMBURU","SAMBURU NORTH","21",499,548,1047
"40003","SAMBURU","SAMBURU NORTH","22",533,468,1001
"40004","SAMBURU","SAMBURU NORTH","23",542,601,1143
"40005","SAMBURU","SAMBURU NORTH","24",483,497,980
"40006","SAMBURU","SAMBURU NORTH","20-24",3236,3030,6266
"40007","SAMBURU","SAMBURU NORTH","25",778,649,1427
"40008","SAMBURU","SAMBURU NORTH","26",414,556,970
"40009","SAMBURU","SAMBURU NORTH","27",469,497,966
"40010","SAMBURU","SAMBURU NORTH","28",360,341,701
"40011","SAMBURU","SAMBURU NORTH","29",389,345,734
"40012","SAMBURU","SAMBURU NORTH","25-29",2410,2388,4798
"40013","SAMBURU","SAMBURU NORTH","30",726,506,1232
"40014","SAMBURU","SAMBURU NORTH","31",246,252,498
"40015","SAMBURU","SAMBURU NORTH","32",331,415,746
"40016","SAMBURU","SAMBURU NORTH","33",285,405,690
"40017","SAMBURU","SAMBURU NORTH","34",161,228,389
"40018","SAMBURU","SAMBURU NORTH","30-34",1749,1806,3555
"40019","SAMBURU","SAMBURU NORTH","35",455,448,903
"40020","SAMBURU","SAMBURU NORTH","36",138,155,293
"40021","SAMBURU","SAMBURU NORTH","37",120,95,215
"40022","SAMBURU","SAMBURU NORTH","38",94,89,183
"40023","SAMBURU","SAMBURU NORTH","39",131,130,261
"40024","SAMBURU","SAMBURU NORTH","35-39",938,917,1855
"40025","SAMBURU","SAMBURU NORTH","40",381,303,684
"40026","SAMBURU","SAMBURU NORTH","41",197,210,407
"40027","SAMBURU","SAMBURU NORTH","42",235,248,483
"40028","SAMBURU","SAMBURU NORTH","43",157,178,335
"40029","SAMBURU","SAMBURU NORTH","44",64,79,143
"40030","SAMBURU","SAMBURU NORTH","40-44",1034,1018,2052
"40031","SAMBURU","SAMBURU NORTH","45",296,267,563
"40032","SAMBURU","SAMBURU NORTH","46",177,165,342
"40033","SAMBURU","SAMBURU NORTH","47",121,166,287
"40034","SAMBURU","SAMBURU NORTH","48",63,94,157
"40035","SAMBURU","SAMBURU NORTH","49",104,109,213
"40036","SAMBURU","SAMBURU NORTH","45-49",761,801,1562
"40037","SAMBURU","SAMBURU NORTH","50",241,265,506
"40038","SAMBURU","SAMBURU NORTH","51",85,131,216
"40039","SAMBURU","SAMBURU NORTH","52",89,118,207
"40040","SAMBURU","SAMBURU NORTH","53",46,79,125
"40041","SAMBURU","SAMBURU NORTH","54",87,84,171
"40042","SAMBURU","SAMBURU NORTH","50-54",548,677,1225
"40043","SAMBURU","SAMBURU NORTH","55",104,78,182
"40044","SAMBURU","SAMBURU NORTH","56",80,80,160
"40045","SAMBURU","SAMBURU NORTH","57",55,71,126
"40046","SAMBURU","SAMBURU NORTH","58",51,60,111
"40047","SAMBURU","SAMBURU NORTH","59",104,129,233
"40048","SAMBURU","SAMBURU NORTH","55-59",394,418,812
"40049","SAMBURU","SAMBURU NORTH","60",234,192,426
"40050","SAMBURU","SAMBURU NORTH","61",57,77,134
"40051","SAMBURU","SAMBURU NORTH","62",62,72,134
"40052","SAMBURU","SAMBURU NORTH","63",58,81,139
"40053","SAMBURU","SAMBURU NORTH","64",44,62,106
"40054","SAMBURU","SAMBURU NORTH","60-64",455,484,939
"40055","SAMBURU","SAMBURU NORTH","65",93,88,181
"40056","SAMBURU","SAMBURU NORTH","66",36,37,73
"40057","SAMBURU","SAMBURU NORTH","67",48,58,106
"40058","SAMBURU","SAMBURU NORTH","68",35,50,85
"40059","SAMBURU","SAMBURU NORTH","69",70,96,166
"40060","SAMBURU","SAMBURU NORTH","65-69",282,329,611
"40061","SAMBURU","SAMBURU NORTH","70",159,183,342
"40062","SAMBURU","SAMBURU NORTH","71",60,79,139
"40063","SAMBURU","SAMBURU NORTH","72",33,43,76
"40064","SAMBURU","SAMBURU NORTH","73",36,34,70
"40065","SAMBURU","SAMBURU NORTH","74",38,39,77
"40066","SAMBURU","SAMBURU NORTH","70-74",326,378,704
"40067","SAMBURU","SAMBURU NORTH","75",80,60,140
"40068","SAMBURU","SAMBURU NORTH","76",16,21,37
"40069","SAMBURU","SAMBURU NORTH","77",18,25,43
"40070","SAMBURU","SAMBURU NORTH","78",15,17,32
"40071","SAMBURU","SAMBURU NORTH","79",57,72,129
"40072","SAMBURU","SAMBURU NORTH","75-79",186,195,381
"40073","SAMBURU","SAMBURU NORTH","80",48,55,103
"40074","SAMBURU","SAMBURU NORTH","81",24,23,47
"40075","SAMBURU","SAMBURU NORTH","82",20,13,33
"40076","SAMBURU","SAMBURU NORTH","83",13,16,29
"40077","SAMBURU","SAMBURU NORTH","84",14,10,24
"40078","SAMBURU","SAMBURU NORTH","80-84",119,117,236
"40079","SAMBURU","SAMBURU NORTH","85",13,17,30
"40080","SAMBURU","SAMBURU NORTH","86",7,7,14
"40081","SAMBURU","SAMBURU NORTH","87",8,12,20
"40082","SAMBURU","SAMBURU NORTH","88",5,8,13
"40083","SAMBURU","SAMBURU NORTH","89",27,28,55
"40084","SAMBURU","SAMBURU NORTH","85-89",60,72,132
"40085","SAMBURU","SAMBURU NORTH","90",19,20,39
"40086","SAMBURU","SAMBURU NORTH","91",5,2,7
"40087","SAMBURU","SAMBURU NORTH","92",2,NA,2
"40088","SAMBURU","SAMBURU NORTH","93",2,3,5
"40089","SAMBURU","SAMBURU NORTH","94",4,1,5
"40090","SAMBURU","SAMBURU NORTH","90-94",32,26,58
"40091","SAMBURU","SAMBURU NORTH","95",14,11,25
"40092","SAMBURU","SAMBURU NORTH","96",3,2,5
"40093","SAMBURU","SAMBURU NORTH","97",1,1,2
"40094","SAMBURU","SAMBURU NORTH","98",1,NA,1
"40095","SAMBURU","SAMBURU NORTH","99",4,2,6
"40096","SAMBURU","SAMBURU NORTH","95-99",23,16,39
"40097","SAMBURU","SAMBURU NORTH","100+",1,2,3
"40098","SAMBURU","SAMBURU NORTH","Not Stated",NA,1,1
"40099","SIAYA","ALL","Total",471669,521496,993165
"40100","SIAYA","ALL","0",11662,11781,23443
"40101","SIAYA","ALL","1",11681,11557,23238
"40102","SIAYA","ALL","2",11737,11991,23728
"40103","SIAYA","ALL","3",12819,12728,25547
"40104","SIAYA","ALL","4",12968,12734,25702
"40105","SIAYA","ALL","0 - 4",60867,60791,121658
"40106","SIAYA","ALL","5",13550,13046,26596
"40107","SIAYA","ALL","6",14046,14050,28096
"40108","SIAYA","ALL","7",13619,13886,27505
"40109","SIAYA","ALL","8",12870,13462,26332
"40110","SIAYA","ALL","9",14658,14649,29307
"40111","SIAYA","ALL","5-9",68743,69093,137836
"40112","SIAYA","ALL","10",15661,15172,30833
"40113","SIAYA","ALL","11",14304,14500,28804
"40114","SIAYA","ALL","12",16218,15898,32116
"40115","SIAYA","ALL","13",15736,15653,31389
"40116","SIAYA","ALL","14",14130,13876,28006
"40117","SIAYA","ALL","10 -14",76049,75099,151148
"40118","SIAYA","ALL","15",13959,13480,27439
"40119","SIAYA","ALL","16",12378,12366,24744
"40120","SIAYA","ALL","17",12639,12041,24680
"40121","SIAYA","ALL","18",9970,9733,19703
"40122","SIAYA","ALL","19",10360,10456,20816
"40123","SIAYA","ALL","15-19",59306,58076,117382
"40124","SIAYA","ALL","20",8912,9781,18693
"40125","SIAYA","ALL","21",7632,8463,16095
"40126","SIAYA","ALL","22",6862,8409,15271
"40127","SIAYA","ALL","23",6787,8713,15500
"40128","SIAYA","ALL","24",6219,7871,14090
"40129","SIAYA","ALL","20-24",36412,43237,79649
"40130","SIAYA","ALL","25",6897,8665,15562
"40131","SIAYA","ALL","26",5830,7805,13635
"40132","SIAYA","ALL","27",6361,7801,14162
"40133","SIAYA","ALL","28",4780,5843,10623
"40134","SIAYA","ALL","29",4942,6382,11324
"40135","SIAYA","ALL","25-29",28810,36496,65306
"40136","SIAYA","ALL","30",6995,9251,16246
"40137","SIAYA","ALL","31",4989,5813,10802
"40138","SIAYA","ALL","32",6307,7990,14297
"40139","SIAYA","ALL","33",5549,6873,12422
"40140","SIAYA","ALL","34",5392,6162,11554
"40141","SIAYA","ALL","30-34",29232,36089,65321
"40142","SIAYA","ALL","35",6430,6847,13277
"40143","SIAYA","ALL","36",4705,4755,9460
"40144","SIAYA","ALL","37",5089,4753,9842
"40145","SIAYA","ALL","38",3483,3189,6672
"40146","SIAYA","ALL","39",4209,4109,8318
"40147","SIAYA","ALL","35-39",23916,23653,47569
"40148","SIAYA","ALL","40",4958,5392,10350
"40149","SIAYA","ALL","41",4294,4278,8572
"40150","SIAYA","ALL","42",4051,3975,8026
"40151","SIAYA","ALL","43",3753,3964,7717
"40152","SIAYA","ALL","44",3087,3405,6492
"40153","SIAYA","ALL","40-44",20143,21014,41157
"40154","SIAYA","ALL","45",4020,4467,8487
"40155","SIAYA","ALL","46",2902,3347,6249
"40156","SIAYA","ALL","47",3104,3471,6575
"40157","SIAYA","ALL","48",1965,2304,4269
"40158","SIAYA","ALL","49",2263,2716,4979
"40159","SIAYA","ALL","45-49",14254,16305,30559
"40160","SIAYA","ALL","50",3054,4395,7449
"40161","SIAYA","ALL","51",2562,3536,6098
"40162","SIAYA","ALL","52",2012,2701,4713
"40163","SIAYA","ALL","53",1730,2331,4061
"40164","SIAYA","ALL","54",2042,2539,4581
"40165","SIAYA","ALL","50-54",11400,15502,26902
"40166","SIAYA","ALL","55",2303,2906,5209
"40167","SIAYA","ALL","56",2202,3292,5494
"40168","SIAYA","ALL","57",2254,3938,6192
"40169","SIAYA","ALL","58",1561,2214,3775
"40170","SIAYA","ALL","59",1915,2861,4776
"40171","SIAYA","ALL","55-59",10235,15211,25446
"40172","SIAYA","ALL","60",2597,4213,6810
"40173","SIAYA","ALL","61",1900,2895,4795
"40174","SIAYA","ALL","62",1780,2457,4237
"40175","SIAYA","ALL","63",1708,2588,4296
"40176","SIAYA","ALL","64",1465,2166,3631
"40177","SIAYA","ALL","60-64",9450,14319,23769
"40178","SIAYA","ALL","65",1982,2949,4931
"40179","SIAYA","ALL","66",1566,2469,4035
"40180","SIAYA","ALL","67",2123,3451,5574
"40181","SIAYA","ALL","68",928,1288,2216
"40182","SIAYA","ALL","69",1502,2084,3586
"40183","SIAYA","ALL","65-69",8101,12241,20342
"40184","SIAYA","ALL","70",2019,3585,5604
"40185","SIAYA","ALL","71",1410,1961,3371
"40186","SIAYA","ALL","72",1265,1530,2795
"40187","SIAYA","ALL","73",1004,1368,2372
"40188","SIAYA","ALL","74",971,1453,2424
"40189","SIAYA","ALL","70-74",6669,9897,16566
"40190","SIAYA","ALL","75",760,1338,2098
"40191","SIAYA","ALL","76",704,1108,1812
"40192","SIAYA","ALL","77",897,1621,2518
"40193","SIAYA","ALL","78",426,676,1102
"40194","SIAYA","ALL","79",596,1315,1911
"40195","SIAYA","ALL","75-79",3383,6058,9441
"40196","SIAYA","ALL","80",755,1520,2275
"40197","SIAYA","ALL","81",475,907,1382
"40198","SIAYA","ALL","82",503,718,1221
"40199","SIAYA","ALL","83",468,711,1179
"40200","SIAYA","ALL","84",396,636,1032
"40201","SIAYA","ALL","80-84",2597,4492,7089
"40202","SIAYA","ALL","85",332,664,996
"40203","SIAYA","ALL","86",262,408,670
"40204","SIAYA","ALL","87",381,624,1005
"40205","SIAYA","ALL","88",162,301,463
"40206","SIAYA","ALL","89",261,644,905
"40207","SIAYA","ALL","85-89",1398,2641,4039
"40208","SIAYA","ALL","90",163,319,482
"40209","SIAYA","ALL","91",127,218,345
"40210","SIAYA","ALL","92",77,117,194
"40211","SIAYA","ALL","93",62,102,164
"40212","SIAYA","ALL","94",57,94,151
"40213","SIAYA","ALL","90-94",486,850,1336
"40214","SIAYA","ALL","95",65,97,162
"40215","SIAYA","ALL","96",27,51,78
"40216","SIAYA","ALL","97",28,54,82
"40217","SIAYA","ALL","98",15,44,59
"40218","SIAYA","ALL","99",26,61,87
"40219","SIAYA","ALL","95-99",161,307,468
"40220","SIAYA","ALL","100+",43,115,158
"40221","SIAYA","ALL","Not Stated",14,10,24
"40222","SIAYA","SIAYA","Total",105906,118433,224339
"40223","SIAYA","SIAYA","0",2746,2620,5366
"40224","SIAYA","SIAYA","1",2635,2608,5243
"40225","SIAYA","SIAYA","2",2714,2686,5400
"40226","SIAYA","SIAYA","3",2842,2785,5627
"40227","SIAYA","SIAYA","4",2955,2853,5808
"40228","SIAYA","SIAYA","0 - 4",13892,13552,27444
"40229","SIAYA","SIAYA","5",3126,2964,6090
"40230","SIAYA","SIAYA","6",3109,3123,6232
"40231","SIAYA","SIAYA","7",3088,3160,6248
"40232","SIAYA","SIAYA","8",2972,3090,6062
"40233","SIAYA","SIAYA","9",3335,3459,6794
"40234","SIAYA","SIAYA","5-9",15630,15796,31426
"40235","SIAYA","SIAYA","10",3496,3431,6927
"40236","SIAYA","SIAYA","11",3075,3214,6289
"40237","SIAYA","SIAYA","12",3626,3504,7130
"40238","SIAYA","SIAYA","13",3547,3510,7057
"40239","SIAYA","SIAYA","14",3011,3048,6059
"40240","SIAYA","SIAYA","10 -14",16755,16707,33462
"40241","SIAYA","SIAYA","15",3063,2931,5994
"40242","SIAYA","SIAYA","16",2683,2734,5417
"40243","SIAYA","SIAYA","17",2771,2754,5525
"40244","SIAYA","SIAYA","18",2197,2148,4345
"40245","SIAYA","SIAYA","19",2228,2247,4475
"40246","SIAYA","SIAYA","15-19",12942,12814,25756
"40247","SIAYA","SIAYA","20",1983,2135,4118
"40248","SIAYA","SIAYA","21",1672,1908,3580
"40249","SIAYA","SIAYA","22",1540,1907,3447
"40250","SIAYA","SIAYA","23",1532,1985,3517
"40251","SIAYA","SIAYA","24",1392,1702,3094
"40252","SIAYA","SIAYA","20-24",8119,9637,17756
"40253","SIAYA","SIAYA","25",1491,1986,3477
"40254","SIAYA","SIAYA","26",1265,1820,3085
"40255","SIAYA","SIAYA","27",1414,1710,3124
"40256","SIAYA","SIAYA","28",1160,1384,2544
"40257","SIAYA","SIAYA","29",1133,1451,2584
"40258","SIAYA","SIAYA","25-29",6463,8351,14814
"40259","SIAYA","SIAYA","30",1602,2067,3669
"40260","SIAYA","SIAYA","31",1081,1254,2335
"40261","SIAYA","SIAYA","32",1373,1790,3163
"40262","SIAYA","SIAYA","33",1188,1467,2655
"40263","SIAYA","SIAYA","34",1198,1308,2506
"40264","SIAYA","SIAYA","30-34",6442,7886,14328
"40265","SIAYA","SIAYA","35",1406,1550,2956
"40266","SIAYA","SIAYA","36",1074,1109,2183
"40267","SIAYA","SIAYA","37",1120,1047,2167
"40268","SIAYA","SIAYA","38",804,744,1548
"40269","SIAYA","SIAYA","39",948,981,1929
"40270","SIAYA","SIAYA","35-39",5352,5431,10783
"40271","SIAYA","SIAYA","40",1072,1164,2236
"40272","SIAYA","SIAYA","41",975,954,1929
"40273","SIAYA","SIAYA","42",914,920,1834
"40274","SIAYA","SIAYA","43",791,892,1683
"40275","SIAYA","SIAYA","44",679,735,1414
"40276","SIAYA","SIAYA","40-44",4431,4665,9096
"40277","SIAYA","SIAYA","45",910,978,1888
"40278","SIAYA","SIAYA","46",624,773,1397
"40279","SIAYA","SIAYA","47",683,762,1445
"40280","SIAYA","SIAYA","48",444,550,994
"40281","SIAYA","SIAYA","49",510,632,1142
"40282","SIAYA","SIAYA","45-49",3171,3695,6866
"40283","SIAYA","SIAYA","50",739,1050,1789
"40284","SIAYA","SIAYA","51",624,805,1429
"40285","SIAYA","SIAYA","52",470,629,1099
"40286","SIAYA","SIAYA","53",404,537,941
"40287","SIAYA","SIAYA","54",465,620,1085
"40288","SIAYA","SIAYA","50-54",2702,3641,6343
"40289","SIAYA","SIAYA","55",575,752,1327
"40290","SIAYA","SIAYA","56",507,762,1269
"40291","SIAYA","SIAYA","57",483,944,1427
"40292","SIAYA","SIAYA","58",347,575,922
"40293","SIAYA","SIAYA","59",437,631,1068
"40294","SIAYA","SIAYA","55-59",2349,3664,6013
"40295","SIAYA","SIAYA","60",587,1061,1648
"40296","SIAYA","SIAYA","61",403,724,1127
"40297","SIAYA","SIAYA","62",416,598,1014
"40298","SIAYA","SIAYA","63",402,593,995
"40299","SIAYA","SIAYA","64",344,515,859
"40300","SIAYA","SIAYA","60-64",2152,3491,5643
"40301","SIAYA","SIAYA","65",519,747,1266
"40302","SIAYA","SIAYA","66",362,605,967
"40303","SIAYA","SIAYA","67",491,848,1339
"40304","SIAYA","SIAYA","68",214,334,548
"40305","SIAYA","SIAYA","69",340,534,874
"40306","SIAYA","SIAYA","65-69",1926,3068,4994
"40307","SIAYA","SIAYA","70",530,904,1434
"40308","SIAYA","SIAYA","71",309,506,815
"40309","SIAYA","SIAYA","72",290,346,636
"40310","SIAYA","SIAYA","73",247,340,587
"40311","SIAYA","SIAYA","74",234,362,596
"40312","SIAYA","SIAYA","70-74",1610,2458,4068
"40313","SIAYA","SIAYA","75",193,346,539
"40314","SIAYA","SIAYA","76",169,250,419
"40315","SIAYA","SIAYA","77",221,397,618
"40316","SIAYA","SIAYA","78",103,142,245
"40317","SIAYA","SIAYA","79",162,354,516
"40318","SIAYA","SIAYA","75-79",848,1489,2337
"40319","SIAYA","SIAYA","80",192,387,579
"40320","SIAYA","SIAYA","81",108,220,328
"40321","SIAYA","SIAYA","82",128,164,292
"40322","SIAYA","SIAYA","83",116,168,284
"40323","SIAYA","SIAYA","84",96,156,252
"40324","SIAYA","SIAYA","80-84",640,1095,1735
"40325","SIAYA","SIAYA","85",82,146,228
"40326","SIAYA","SIAYA","86",70,98,168
"40327","SIAYA","SIAYA","87",74,158,232
"40328","SIAYA","SIAYA","88",30,76,106
"40329","SIAYA","SIAYA","89",68,181,249
"40330","SIAYA","SIAYA","85-89",324,659,983
"40331","SIAYA","SIAYA","90",36,91,127
"40332","SIAYA","SIAYA","91",34,68,102
"40333","SIAYA","SIAYA","92",19,29,48
"40334","SIAYA","SIAYA","93",12,28,40
"40335","SIAYA","SIAYA","94",13,20,33
"40336","SIAYA","SIAYA","90-94",114,236,350
"40337","SIAYA","SIAYA","95",7,19,26
"40338","SIAYA","SIAYA","96",6,12,18
"40339","SIAYA","SIAYA","97",11,15,26
"40340","SIAYA","SIAYA","98",5,10,15
"40341","SIAYA","SIAYA","99",3,11,14
"40342","SIAYA","SIAYA","95-99",32,67,99
"40343","SIAYA","SIAYA","100+",7,27,34
"40344","SIAYA","SIAYA","Not Stated",5,4,9
"40345","SIAYA","GEM","Total",85696,94092,179788
"40346","SIAYA","GEM","0",2156,2125,4281
"40347","SIAYA","GEM","1",2132,2166,4298
"40348","SIAYA","GEM","2",2055,2183,4238
"40349","SIAYA","GEM","3",2303,2200,4503
"40350","SIAYA","GEM","4",2293,2302,4595
"40351","SIAYA","GEM","0 - 4",10939,10976,21915
"40352","SIAYA","GEM","5",2409,2309,4718
"40353","SIAYA","GEM","6",2567,2524,5091
"40354","SIAYA","GEM","7",2433,2413,4846
"40355","SIAYA","GEM","8",2405,2424,4829
"40356","SIAYA","GEM","9",2642,2634,5276
"40357","SIAYA","GEM","5-9",12456,12304,24760
"40358","SIAYA","GEM","10",2925,2698,5623
"40359","SIAYA","GEM","11",2729,2743,5472
"40360","SIAYA","GEM","12",2944,2877,5821
"40361","SIAYA","GEM","13",2961,2877,5838
"40362","SIAYA","GEM","14",2669,2522,5191
"40363","SIAYA","GEM","10 -14",14228,13717,27945
"40364","SIAYA","GEM","15",2580,2491,5071
"40365","SIAYA","GEM","16",2323,2226,4549
"40366","SIAYA","GEM","17",2247,2195,4442
"40367","SIAYA","GEM","18",1846,1789,3635
"40368","SIAYA","GEM","19",1890,1964,3854
"40369","SIAYA","GEM","15-19",10886,10665,21551
"40370","SIAYA","GEM","20",1563,1695,3258
"40371","SIAYA","GEM","21",1288,1463,2751
"40372","SIAYA","GEM","22",1117,1336,2453
"40373","SIAYA","GEM","23",1142,1429,2571
"40374","SIAYA","GEM","24",965,1319,2284
"40375","SIAYA","GEM","20-24",6075,7242,13317
"40376","SIAYA","GEM","25",1076,1402,2478
"40377","SIAYA","GEM","26",924,1295,2219
"40378","SIAYA","GEM","27",1032,1335,2367
"40379","SIAYA","GEM","28",774,982,1756
"40380","SIAYA","GEM","29",833,1078,1911
"40381","SIAYA","GEM","25-29",4639,6092,10731
"40382","SIAYA","GEM","30",1117,1571,2688
"40383","SIAYA","GEM","31",856,964,1820
"40384","SIAYA","GEM","32",1029,1293,2322
"40385","SIAYA","GEM","33",926,1085,2011
"40386","SIAYA","GEM","34",853,1112,1965
"40387","SIAYA","GEM","30-34",4781,6025,10806
"40388","SIAYA","GEM","35",1076,1195,2271
"40389","SIAYA","GEM","36",828,864,1692
"40390","SIAYA","GEM","37",905,870,1775
"40391","SIAYA","GEM","38",603,585,1188
"40392","SIAYA","GEM","39",736,729,1465
"40393","SIAYA","GEM","35-39",4148,4243,8391
"40394","SIAYA","GEM","40",895,1025,1920
"40395","SIAYA","GEM","41",696,797,1493
"40396","SIAYA","GEM","42",756,721,1477
"40397","SIAYA","GEM","43",693,737,1430
"40398","SIAYA","GEM","44",614,667,1281
"40399","SIAYA","GEM","40-44",3654,3947,7601
"40400","SIAYA","GEM","45",740,881,1621
"40401","SIAYA","GEM","46",567,662,1229
"40402","SIAYA","GEM","47",575,702,1277
"40403","SIAYA","GEM","48",379,431,810
"40404","SIAYA","GEM","49",461,537,998
"40405","SIAYA","GEM","45-49",2722,3213,5935
"40406","SIAYA","GEM","50",600,831,1431
"40407","SIAYA","GEM","51",524,676,1200
"40408","SIAYA","GEM","52",405,580,985
"40409","SIAYA","GEM","53",364,478,842
"40410","SIAYA","GEM","54",400,452,852
"40411","SIAYA","GEM","50-54",2293,3017,5310
"40412","SIAYA","GEM","55",450,538,988
"40413","SIAYA","GEM","56",475,638,1113
"40414","SIAYA","GEM","57",490,762,1252
"40415","SIAYA","GEM","58",312,450,762
"40416","SIAYA","GEM","59",389,547,936
"40417","SIAYA","GEM","55-59",2116,2935,5051
"40418","SIAYA","GEM","60",553,798,1351
"40419","SIAYA","GEM","61",377,555,932
"40420","SIAYA","GEM","62",402,484,886
"40421","SIAYA","GEM","63",367,495,862
"40422","SIAYA","GEM","64",328,399,727
"40423","SIAYA","GEM","60-64",2027,2731,4758
"40424","SIAYA","GEM","65",377,567,944
"40425","SIAYA","GEM","66",334,484,818
"40426","SIAYA","GEM","67",452,644,1096
"40427","SIAYA","GEM","68",218,252,470
"40428","SIAYA","GEM","69",319,412,731
"40429","SIAYA","GEM","65-69",1700,2359,4059
"40430","SIAYA","GEM","70",406,695,1101
"40431","SIAYA","GEM","71",298,360,658
"40432","SIAYA","GEM","72",273,284,557
"40433","SIAYA","GEM","73",195,282,477
"40434","SIAYA","GEM","74",199,270,469
"40435","SIAYA","GEM","70-74",1371,1891,3262
"40436","SIAYA","GEM","75",169,260,429
"40437","SIAYA","GEM","76",154,240,394
"40438","SIAYA","GEM","77",180,314,494
"40439","SIAYA","GEM","78",86,139,225
"40440","SIAYA","GEM","79",126,229,355
"40441","SIAYA","GEM","75-79",715,1182,1897
"40442","SIAYA","GEM","80",150,304,454
"40443","SIAYA","GEM","81",96,169,265
"40444","SIAYA","GEM","82",95,136,231
"40445","SIAYA","GEM","83",88,129,217
"40446","SIAYA","GEM","84",87,128,215
"40447","SIAYA","GEM","80-84",516,866,1382
"40448","SIAYA","GEM","85",71,123,194
"40449","SIAYA","GEM","86",58,74,132
"40450","SIAYA","GEM","87",82,111,193
"40451","SIAYA","GEM","88",33,49,82
"40452","SIAYA","GEM","89",57,116,173
"40453","SIAYA","GEM","85-89",301,473,774
"40454","SIAYA","GEM","90",30,61,91
"40455","SIAYA","GEM","91",19,28,47
"40456","SIAYA","GEM","92",17,17,34
"40457","SIAYA","GEM","93",10,15,25
"40458","SIAYA","GEM","94",8,20,28
"40459","SIAYA","GEM","90-94",84,141,225
"40460","SIAYA","GEM","95",13,13,26
"40461","SIAYA","GEM","96",4,11,15
"40462","SIAYA","GEM","97",7,14,21
"40463","SIAYA","GEM","98",2,9,11
"40464","SIAYA","GEM","99",8,12,20
"40465","SIAYA","GEM","95-99",34,59,93
"40466","SIAYA","GEM","100+",9,13,22
"40467","SIAYA","GEM","Not Stated",2,1,3
"40468","SIAYA","UGENYA","Total",62624,71726,134350
"40469","SIAYA","UGENYA","0",1459,1507,2966
"40470","SIAYA","UGENYA","1",1448,1458,2906
"40471","SIAYA","UGENYA","2",1495,1534,3029
"40472","SIAYA","UGENYA","3",1718,1728,3446
"40473","SIAYA","UGENYA","4",1745,1700,3445
"40474","SIAYA","UGENYA","0 - 4",7865,7927,15792
"40475","SIAYA","UGENYA","5",1835,1767,3602
"40476","SIAYA","UGENYA","6",2032,1967,3999
"40477","SIAYA","UGENYA","7",1921,1877,3798
"40478","SIAYA","UGENYA","8",1805,1796,3601
"40479","SIAYA","UGENYA","9",2065,2071,4136
"40480","SIAYA","UGENYA","5-9",9658,9478,19136
"40481","SIAYA","UGENYA","10",2109,2112,4221
"40482","SIAYA","UGENYA","11",2009,1984,3993
"40483","SIAYA","UGENYA","12",2351,2211,4562
"40484","SIAYA","UGENYA","13",2169,2124,4293
"40485","SIAYA","UGENYA","14",2030,2008,4038
"40486","SIAYA","UGENYA","10 -14",10668,10439,21107
"40487","SIAYA","UGENYA","15",2019,1914,3933
"40488","SIAYA","UGENYA","16",1882,1782,3664
"40489","SIAYA","UGENYA","17",1904,1691,3595
"40490","SIAYA","UGENYA","18",1438,1335,2773
"40491","SIAYA","UGENYA","19",1439,1458,2897
"40492","SIAYA","UGENYA","15-19",8682,8180,16862
"40493","SIAYA","UGENYA","20",1172,1293,2465
"40494","SIAYA","UGENYA","21",961,1040,2001
"40495","SIAYA","UGENYA","22",827,1032,1859
"40496","SIAYA","UGENYA","23",736,1037,1773
"40497","SIAYA","UGENYA","24",680,900,1580
"40498","SIAYA","UGENYA","20-24",4376,5302,9678
"40499","SIAYA","UGENYA","25",766,1036,1802
"40500","SIAYA","UGENYA","26",667,916,1583
"40501","SIAYA","UGENYA","27",689,962,1651
"40502","SIAYA","UGENYA","28",522,707,1229
"40503","SIAYA","UGENYA","29",551,712,1263
"40504","SIAYA","UGENYA","25-29",3195,4333,7528
"40505","SIAYA","UGENYA","30",798,1087,1885
"40506","SIAYA","UGENYA","31",569,772,1341
"40507","SIAYA","UGENYA","32",722,1012,1734
"40508","SIAYA","UGENYA","33",611,812,1423
"40509","SIAYA","UGENYA","34",668,794,1462
"40510","SIAYA","UGENYA","30-34",3368,4477,7845
"40511","SIAYA","UGENYA","35",674,930,1604
"40512","SIAYA","UGENYA","36",485,647,1132
"40513","SIAYA","UGENYA","37",611,664,1275
"40514","SIAYA","UGENYA","38",377,436,813
"40515","SIAYA","UGENYA","39",481,584,1065
"40516","SIAYA","UGENYA","35-39",2628,3261,5889
"40517","SIAYA","UGENYA","40",601,790,1391
"40518","SIAYA","UGENYA","41",542,648,1190
"40519","SIAYA","UGENYA","42",539,608,1147
"40520","SIAYA","UGENYA","43",427,547,974
"40521","SIAYA","UGENYA","44",389,453,842
"40522","SIAYA","UGENYA","40-44",2498,3046,5544
"40523","SIAYA","UGENYA","45",533,623,1156
"40524","SIAYA","UGENYA","46",399,473,872
"40525","SIAYA","UGENYA","47",432,530,962
"40526","SIAYA","UGENYA","48",277,399,676
"40527","SIAYA","UGENYA","49",295,391,686
"40528","SIAYA","UGENYA","45-49",1936,2416,4352
"40529","SIAYA","UGENYA","50",451,730,1181
"40530","SIAYA","UGENYA","51",326,563,889
"40531","SIAYA","UGENYA","52",275,422,697
"40532","SIAYA","UGENYA","53",247,354,601
"40533","SIAYA","UGENYA","54",304,355,659
"40534","SIAYA","UGENYA","50-54",1603,2424,4027
"40535","SIAYA","UGENYA","55",323,404,727
"40536","SIAYA","UGENYA","56",310,503,813
"40537","SIAYA","UGENYA","57",333,640,973
"40538","SIAYA","UGENYA","58",232,332,564
"40539","SIAYA","UGENYA","59",258,484,742
"40540","SIAYA","UGENYA","55-59",1456,2363,3819
"40541","SIAYA","UGENYA","60",342,641,983
"40542","SIAYA","UGENYA","61",284,454,738
"40543","SIAYA","UGENYA","62",248,370,618
"40544","SIAYA","UGENYA","63",224,399,623
"40545","SIAYA","UGENYA","64",188,362,550
"40546","SIAYA","UGENYA","60-64",1286,2226,3512
"40547","SIAYA","UGENYA","65",269,473,742
"40548","SIAYA","UGENYA","66",225,351,576
"40549","SIAYA","UGENYA","67",346,533,879
"40550","SIAYA","UGENYA","68",109,189,298
"40551","SIAYA","UGENYA","69",211,338,549
"40552","SIAYA","UGENYA","65-69",1160,1884,3044
"40553","SIAYA","UGENYA","70",287,611,898
"40554","SIAYA","UGENYA","71",191,315,506
"40555","SIAYA","UGENYA","72",200,244,444
"40556","SIAYA","UGENYA","73",135,205,340
"40557","SIAYA","UGENYA","74",139,235,374
"40558","SIAYA","UGENYA","70-74",952,1610,2562
"40559","SIAYA","UGENYA","75",102,219,321
"40560","SIAYA","UGENYA","76",103,170,273
"40561","SIAYA","UGENYA","77",129,274,403
"40562","SIAYA","UGENYA","78",75,131,206
"40563","SIAYA","UGENYA","79",83,218,301
"40564","SIAYA","UGENYA","75-79",492,1012,1504
"40565","SIAYA","UGENYA","80",125,264,389
"40566","SIAYA","UGENYA","81",93,152,245
"40567","SIAYA","UGENYA","82",80,105,185
"40568","SIAYA","UGENYA","83",72,108,180
"40569","SIAYA","UGENYA","84",68,105,173
"40570","SIAYA","UGENYA","80-84",438,734,1172
"40571","SIAYA","UGENYA","85",69,119,188
"40572","SIAYA","UGENYA","86",46,49,95
"40573","SIAYA","UGENYA","87",65,92,157
"40574","SIAYA","UGENYA","88",28,48,76
"40575","SIAYA","UGENYA","89",41,112,153
"40576","SIAYA","UGENYA","85-89",249,420,669
"40577","SIAYA","UGENYA","90",23,38,61
"40578","SIAYA","UGENYA","91",23,38,61
"40579","SIAYA","UGENYA","92",10,20,30
"40580","SIAYA","UGENYA","93",8,19,27
"40581","SIAYA","UGENYA","94",10,13,23
"40582","SIAYA","UGENYA","90-94",74,128,202
"40583","SIAYA","UGENYA","95",16,16,32
"40584","SIAYA","UGENYA","96",7,7,14
"40585","SIAYA","UGENYA","97",2,4,6
"40586","SIAYA","UGENYA","98",2,9,11
"40587","SIAYA","UGENYA","99",3,10,13
"40588","SIAYA","UGENYA","95-99",30,46,76
"40589","SIAYA","UGENYA","100+",9,19,28
"40590","SIAYA","UGENYA","Not Stated",1,1,2
"40591","SIAYA","UGUNJA","Total",48912,55329,104241
"40592","SIAYA","UGUNJA","0",1160,1128,2288
"40593","SIAYA","UGUNJA","1",1229,1170,2399
"40594","SIAYA","UGUNJA","2",1124,1215,2339
"40595","SIAYA","UGUNJA","3",1249,1252,2501
"40596","SIAYA","UGUNJA","4",1341,1342,2683
"40597","SIAYA","UGUNJA","0 - 4",6103,6107,12210
"40598","SIAYA","UGUNJA","5",1433,1387,2820
"40599","SIAYA","UGUNJA","6",1380,1485,2865
"40600","SIAYA","UGUNJA","7",1373,1479,2852
"40601","SIAYA","UGUNJA","8",1323,1509,2832
"40602","SIAYA","UGUNJA","9",1574,1572,3146
"40603","SIAYA","UGUNJA","5-9",7083,7432,14515
"40604","SIAYA","UGUNJA","10",1647,1629,3276
"40605","SIAYA","UGUNJA","11",1512,1562,3074
"40606","SIAYA","UGUNJA","12",1732,1692,3424
"40607","SIAYA","UGUNJA","13",1676,1692,3368
"40608","SIAYA","UGUNJA","14",1593,1489,3082
"40609","SIAYA","UGUNJA","10 -14",8160,8064,16224
"40610","SIAYA","UGUNJA","15",1546,1488,3034
"40611","SIAYA","UGUNJA","16",1322,1345,2667
"40612","SIAYA","UGUNJA","17",1395,1299,2694
"40613","SIAYA","UGUNJA","18",1085,1054,2139
"40614","SIAYA","UGUNJA","19",1103,994,2097
"40615","SIAYA","UGUNJA","15-19",6451,6180,12631
"40616","SIAYA","UGUNJA","20",901,955,1856
"40617","SIAYA","UGUNJA","21",769,786,1555
"40618","SIAYA","UGUNJA","22",697,829,1526
"40619","SIAYA","UGUNJA","23",655,847,1502
"40620","SIAYA","UGUNJA","24",602,805,1407
"40621","SIAYA","UGUNJA","20-24",3624,4222,7846
"40622","SIAYA","UGUNJA","25",658,842,1500
"40623","SIAYA","UGUNJA","26",552,792,1344
"40624","SIAYA","UGUNJA","27",623,777,1400
"40625","SIAYA","UGUNJA","28",473,598,1071
"40626","SIAYA","UGUNJA","29",478,699,1177
"40627","SIAYA","UGUNJA","25-29",2784,3708,6492
"40628","SIAYA","UGUNJA","30",644,970,1614
"40629","SIAYA","UGUNJA","31",517,602,1119
"40630","SIAYA","UGUNJA","32",639,795,1434
"40631","SIAYA","UGUNJA","33",523,694,1217
"40632","SIAYA","UGUNJA","34",505,656,1161
"40633","SIAYA","UGUNJA","30-34",2828,3717,6545
"40634","SIAYA","UGUNJA","35",636,728,1364
"40635","SIAYA","UGUNJA","36",470,504,974
"40636","SIAYA","UGUNJA","37",476,537,1013
"40637","SIAYA","UGUNJA","38",355,385,740
"40638","SIAYA","UGUNJA","39",387,475,862
"40639","SIAYA","UGUNJA","35-39",2324,2629,4953
"40640","SIAYA","UGUNJA","40",519,569,1088
"40641","SIAYA","UGUNJA","41",471,464,935
"40642","SIAYA","UGUNJA","42",415,430,845
"40643","SIAYA","UGUNJA","43",395,439,834
"40644","SIAYA","UGUNJA","44",316,361,677
"40645","SIAYA","UGUNJA","40-44",2116,2263,4379
"40646","SIAYA","UGUNJA","45",425,454,879
"40647","SIAYA","UGUNJA","46",321,361,682
"40648","SIAYA","UGUNJA","47",330,368,698
"40649","SIAYA","UGUNJA","48",224,288,512
"40650","SIAYA","UGUNJA","49",254,310,564
"40651","SIAYA","UGUNJA","45-49",1554,1781,3335
"40652","SIAYA","UGUNJA","50",316,491,807
"40653","SIAYA","UGUNJA","51",266,390,656
"40654","SIAYA","UGUNJA","52",208,269,477
"40655","SIAYA","UGUNJA","53",188,260,448
"40656","SIAYA","UGUNJA","54",222,287,509
"40657","SIAYA","UGUNJA","50-54",1200,1697,2897
"40658","SIAYA","UGUNJA","55",241,332,573
"40659","SIAYA","UGUNJA","56",263,434,697
"40660","SIAYA","UGUNJA","57",244,437,681
"40661","SIAYA","UGUNJA","58",165,243,408
"40662","SIAYA","UGUNJA","59",211,331,542
"40663","SIAYA","UGUNJA","55-59",1124,1777,2901
"40664","SIAYA","UGUNJA","60",269,424,693
"40665","SIAYA","UGUNJA","61",208,309,517
"40666","SIAYA","UGUNJA","62",201,261,462
"40667","SIAYA","UGUNJA","63",177,306,483
"40668","SIAYA","UGUNJA","64",152,252,404
"40669","SIAYA","UGUNJA","60-64",1007,1552,2559
"40670","SIAYA","UGUNJA","65",212,351,563
"40671","SIAYA","UGUNJA","66",156,260,416
"40672","SIAYA","UGUNJA","67",216,394,610
"40673","SIAYA","UGUNJA","68",98,133,231
"40674","SIAYA","UGUNJA","69",171,242,413
"40675","SIAYA","UGUNJA","65-69",853,1380,2233
"40676","SIAYA","UGUNJA","70",204,396,600
"40677","SIAYA","UGUNJA","71",161,234,395
"40678","SIAYA","UGUNJA","72",128,195,323
"40679","SIAYA","UGUNJA","73",110,148,258
"40680","SIAYA","UGUNJA","74",126,170,296
"40681","SIAYA","UGUNJA","70-74",729,1143,1872
"40682","SIAYA","UGUNJA","75",82,162,244
"40683","SIAYA","UGUNJA","76",82,148,230
"40684","SIAYA","UGUNJA","77",127,196,323
"40685","SIAYA","UGUNJA","78",47,61,108
"40686","SIAYA","UGUNJA","79",65,158,223
"40687","SIAYA","UGUNJA","75-79",403,725,1128
"40688","SIAYA","UGUNJA","80",101,169,270
"40689","SIAYA","UGUNJA","81",56,106,162
"40690","SIAYA","UGUNJA","82",59,103,162
"40691","SIAYA","UGUNJA","83",44,83,127
"40692","SIAYA","UGUNJA","84",55,63,118
"40693","SIAYA","UGUNJA","80-84",315,524,839
"40694","SIAYA","UGUNJA","85",37,86,123
"40695","SIAYA","UGUNJA","86",30,57,87
"40696","SIAYA","UGUNJA","87",47,62,109
"40697","SIAYA","UGUNJA","88",23,36,59
"40698","SIAYA","UGUNJA","89",31,69,100
"40699","SIAYA","UGUNJA","85-89",168,310,478
"40700","SIAYA","UGUNJA","90",21,34,55
"40701","SIAYA","UGUNJA","91",13,16,29
"40702","SIAYA","UGUNJA","92",13,11,24
"40703","SIAYA","UGUNJA","93",11,7,18
"40704","SIAYA","UGUNJA","94",6,7,13
"40705","SIAYA","UGUNJA","90-94",64,75,139
"40706","SIAYA","UGUNJA","95",9,12,21
"40707","SIAYA","UGUNJA","96",1,2,3
"40708","SIAYA","UGUNJA","97",2,6,8
"40709","SIAYA","UGUNJA","98",1,5,6
"40710","SIAYA","UGUNJA","99",3,9,12
"40711","SIAYA","UGUNJA","95-99",16,34,50
"40712","SIAYA","UGUNJA","100+",5,9,14
"40713","SIAYA","UGUNJA","Not Stated",1,NA,1
"40714","SIAYA","BONDO","Total",95962,101917,197879
"40715","SIAYA","BONDO","0",2500,2634,5134
"40716","SIAYA","BONDO","1",2477,2388,4865
"40717","SIAYA","BONDO","2",2511,2549,5060
"40718","SIAYA","BONDO","3",2747,2647,5394
"40719","SIAYA","BONDO","4",2542,2630,5172
"40720","SIAYA","BONDO","0 - 4",12777,12848,25625
"40721","SIAYA","BONDO","5",2689,2670,5359
"40722","SIAYA","BONDO","6",2805,2751,5556
"40723","SIAYA","BONDO","7",2725,2740,5465
"40724","SIAYA","BONDO","8",2443,2635,5078
"40725","SIAYA","BONDO","9",2753,2675,5428
"40726","SIAYA","BONDO","5-9",13415,13471,26886
"40727","SIAYA","BONDO","10",3019,2931,5950
"40728","SIAYA","BONDO","11",2788,2741,5529
"40729","SIAYA","BONDO","12",3003,3145,6148
"40730","SIAYA","BONDO","13",2897,3055,5952
"40731","SIAYA","BONDO","14",2618,2647,5265
"40732","SIAYA","BONDO","10 -14",14325,14519,28844
"40733","SIAYA","BONDO","15",2490,2560,5050
"40734","SIAYA","BONDO","16",2282,2304,4586
"40735","SIAYA","BONDO","17",2323,2286,4609
"40736","SIAYA","BONDO","18",1869,1891,3760
"40737","SIAYA","BONDO","19",2121,2196,4317
"40738","SIAYA","BONDO","15-19",11085,11237,22322
"40739","SIAYA","BONDO","20",1920,2193,4113
"40740","SIAYA","BONDO","21",1769,2019,3788
"40741","SIAYA","BONDO","22",1628,2005,3633
"40742","SIAYA","BONDO","23",1722,2069,3791
"40743","SIAYA","BONDO","24",1694,1908,3602
"40744","SIAYA","BONDO","20-24",8733,10194,18927
"40745","SIAYA","BONDO","25",1848,2087,3935
"40746","SIAYA","BONDO","26",1532,1834,3366
"40747","SIAYA","BONDO","27",1655,1787,3442
"40748","SIAYA","BONDO","28",1172,1349,2521
"40749","SIAYA","BONDO","29",1238,1463,2701
"40750","SIAYA","BONDO","25-29",7445,8520,15965
"40751","SIAYA","BONDO","30",1782,2087,3869
"40752","SIAYA","BONDO","31",1212,1314,2526
"40753","SIAYA","BONDO","32",1568,1876,3444
"40754","SIAYA","BONDO","33",1377,1611,2988
"40755","SIAYA","BONDO","34",1314,1316,2630
"40756","SIAYA","BONDO","30-34",7253,8204,15457
"40757","SIAYA","BONDO","35",1573,1361,2934
"40758","SIAYA","BONDO","36",1116,897,2013
"40759","SIAYA","BONDO","37",1137,960,2097
"40760","SIAYA","BONDO","38",813,615,1428
"40761","SIAYA","BONDO","39",1013,772,1785
"40762","SIAYA","BONDO","35-39",5652,4605,10257
"40763","SIAYA","BONDO","40",1102,1092,2194
"40764","SIAYA","BONDO","41",953,782,1735
"40765","SIAYA","BONDO","42",822,732,1554
"40766","SIAYA","BONDO","43",818,683,1501
"40767","SIAYA","BONDO","44",619,617,1236
"40768","SIAYA","BONDO","40-44",4314,3906,8220
"40769","SIAYA","BONDO","45",805,803,1608
"40770","SIAYA","BONDO","46",550,561,1111
"40771","SIAYA","BONDO","47",603,597,1200
"40772","SIAYA","BONDO","48",362,342,704
"40773","SIAYA","BONDO","49",434,467,901
"40774","SIAYA","BONDO","45-49",2754,2770,5524
"40775","SIAYA","BONDO","50",533,688,1221
"40776","SIAYA","BONDO","51",410,541,951
"40777","SIAYA","BONDO","52",384,441,825
"40778","SIAYA","BONDO","53",282,347,629
"40779","SIAYA","BONDO","54",356,405,761
"40780","SIAYA","BONDO","50-54",1965,2422,4387
"40781","SIAYA","BONDO","55",356,451,807
"40782","SIAYA","BONDO","56",349,468,817
"40783","SIAYA","BONDO","57",371,569,940
"40784","SIAYA","BONDO","58",263,328,591
"40785","SIAYA","BONDO","59",301,452,753
"40786","SIAYA","BONDO","55-59",1640,2268,3908
"40787","SIAYA","BONDO","60",415,605,1020
"40788","SIAYA","BONDO","61",294,410,704
"40789","SIAYA","BONDO","62",254,374,628
"40790","SIAYA","BONDO","63",284,377,661
"40791","SIAYA","BONDO","64",225,296,521
"40792","SIAYA","BONDO","60-64",1472,2062,3534
"40793","SIAYA","BONDO","65",319,398,717
"40794","SIAYA","BONDO","66",237,356,593
"40795","SIAYA","BONDO","67",277,487,764
"40796","SIAYA","BONDO","68",154,187,341
"40797","SIAYA","BONDO","69",220,277,497
"40798","SIAYA","BONDO","65-69",1207,1705,2912
"40799","SIAYA","BONDO","70",283,446,729
"40800","SIAYA","BONDO","71",195,269,464
"40801","SIAYA","BONDO","72",175,224,399
"40802","SIAYA","BONDO","73",134,193,327
"40803","SIAYA","BONDO","74",117,210,327
"40804","SIAYA","BONDO","70-74",904,1342,2246
"40805","SIAYA","BONDO","75",105,154,259
"40806","SIAYA","BONDO","76",85,141,226
"40807","SIAYA","BONDO","77",127,188,315
"40808","SIAYA","BONDO","78",44,96,140
"40809","SIAYA","BONDO","79",74,150,224
"40810","SIAYA","BONDO","75-79",435,729,1164
"40811","SIAYA","BONDO","80",91,193,284
"40812","SIAYA","BONDO","81",57,119,176
"40813","SIAYA","BONDO","82",65,90,155
"40814","SIAYA","BONDO","83",68,105,173
"40815","SIAYA","BONDO","84",34,75,109
"40816","SIAYA","BONDO","80-84",315,582,897
"40817","SIAYA","BONDO","85",30,69,99
"40818","SIAYA","BONDO","86",22,63,85
"40819","SIAYA","BONDO","87",54,91,145
"40820","SIAYA","BONDO","88",27,40,67
"40821","SIAYA","BONDO","89",29,82,111
"40822","SIAYA","BONDO","85-89",162,345,507
"40823","SIAYA","BONDO","90",26,34,60
"40824","SIAYA","BONDO","91",22,34,56
"40825","SIAYA","BONDO","92",9,17,26
"40826","SIAYA","BONDO","93",11,13,24
"40827","SIAYA","BONDO","94",8,17,25
"40828","SIAYA","BONDO","90-94",76,115,191
"40829","SIAYA","BONDO","95",11,14,25
"40830","SIAYA","BONDO","96",5,7,12
"40831","SIAYA","BONDO","97",4,9,13
"40832","SIAYA","BONDO","98",2,6,8
"40833","SIAYA","BONDO","99",1,10,11
"40834","SIAYA","BONDO","95-99",23,46,69
"40835","SIAYA","BONDO","100+",6,25,31
"40836","SIAYA","BONDO","Not Stated",4,2,6
"40837","SIAYA","RARIEDA","Total",72569,79999,152568
"40838","SIAYA","RARIEDA","0",1641,1767,3408
"40839","SIAYA","RARIEDA","1",1760,1767,3527
"40840","SIAYA","RARIEDA","2",1838,1824,3662
"40841","SIAYA","RARIEDA","3",1960,2116,4076
"40842","SIAYA","RARIEDA","4",2092,1907,3999
"40843","SIAYA","RARIEDA","0 - 4",9291,9381,18672
"40844","SIAYA","RARIEDA","5",2058,1949,4007
"40845","SIAYA","RARIEDA","6",2153,2200,4353
"40846","SIAYA","RARIEDA","7",2079,2217,4296
"40847","SIAYA","RARIEDA","8",1922,2008,3930
"40848","SIAYA","RARIEDA","9",2289,2238,4527
"40849","SIAYA","RARIEDA","5-9",10501,10612,21113
"40850","SIAYA","RARIEDA","10",2465,2371,4836
"40851","SIAYA","RARIEDA","11",2191,2256,4447
"40852","SIAYA","RARIEDA","12",2562,2469,5031
"40853","SIAYA","RARIEDA","13",2486,2395,4881
"40854","SIAYA","RARIEDA","14",2209,2162,4371
"40855","SIAYA","RARIEDA","10 -14",11913,11653,23566
"40856","SIAYA","RARIEDA","15",2261,2096,4357
"40857","SIAYA","RARIEDA","16",1886,1975,3861
"40858","SIAYA","RARIEDA","17",1999,1816,3815
"40859","SIAYA","RARIEDA","18",1535,1516,3051
"40860","SIAYA","RARIEDA","19",1579,1597,3176
"40861","SIAYA","RARIEDA","15-19",9260,9000,18260
"40862","SIAYA","RARIEDA","20",1373,1510,2883
"40863","SIAYA","RARIEDA","21",1173,1247,2420
"40864","SIAYA","RARIEDA","22",1053,1300,2353
"40865","SIAYA","RARIEDA","23",1000,1346,2346
"40866","SIAYA","RARIEDA","24",886,1237,2123
"40867","SIAYA","RARIEDA","20-24",5485,6640,12125
"40868","SIAYA","RARIEDA","25",1058,1312,2370
"40869","SIAYA","RARIEDA","26",890,1148,2038
"40870","SIAYA","RARIEDA","27",948,1230,2178
"40871","SIAYA","RARIEDA","28",679,823,1502
"40872","SIAYA","RARIEDA","29",709,979,1688
"40873","SIAYA","RARIEDA","25-29",4284,5492,9776
"40874","SIAYA","RARIEDA","30",1052,1469,2521
"40875","SIAYA","RARIEDA","31",754,907,1661
"40876","SIAYA","RARIEDA","32",976,1224,2200
"40877","SIAYA","RARIEDA","33",924,1204,2128
"40878","SIAYA","RARIEDA","34",854,976,1830
"40879","SIAYA","RARIEDA","30-34",4560,5780,10340
"40880","SIAYA","RARIEDA","35",1065,1083,2148
"40881","SIAYA","RARIEDA","36",732,734,1466
"40882","SIAYA","RARIEDA","37",840,675,1515
"40883","SIAYA","RARIEDA","38",531,424,955
"40884","SIAYA","RARIEDA","39",644,568,1212
"40885","SIAYA","RARIEDA","35-39",3812,3484,7296
"40886","SIAYA","RARIEDA","40",769,752,1521
"40887","SIAYA","RARIEDA","41",657,633,1290
"40888","SIAYA","RARIEDA","42",605,564,1169
"40889","SIAYA","RARIEDA","43",629,666,1295
"40890","SIAYA","RARIEDA","44",470,572,1042
"40891","SIAYA","RARIEDA","40-44",3130,3187,6317
"40892","SIAYA","RARIEDA","45",607,728,1335
"40893","SIAYA","RARIEDA","46",441,517,958
"40894","SIAYA","RARIEDA","47",481,512,993
"40895","SIAYA","RARIEDA","48",279,294,573
"40896","SIAYA","RARIEDA","49",309,379,688
"40897","SIAYA","RARIEDA","45-49",2117,2430,4547
"40898","SIAYA","RARIEDA","50",415,605,1020
"40899","SIAYA","RARIEDA","51",412,561,973
"40900","SIAYA","RARIEDA","52",270,360,630
"40901","SIAYA","RARIEDA","53",245,355,600
"40902","SIAYA","RARIEDA","54",295,420,715
"40903","SIAYA","RARIEDA","50-54",1637,2301,3938
"40904","SIAYA","RARIEDA","55",358,429,787
"40905","SIAYA","RARIEDA","56",298,487,785
"40906","SIAYA","RARIEDA","57",333,586,919
"40907","SIAYA","RARIEDA","58",242,286,528
"40908","SIAYA","RARIEDA","59",319,416,735
"40909","SIAYA","RARIEDA","55-59",1550,2204,3754
"40910","SIAYA","RARIEDA","60",431,684,1115
"40911","SIAYA","RARIEDA","61",334,443,777
"40912","SIAYA","RARIEDA","62",259,370,629
"40913","SIAYA","RARIEDA","63",254,418,672
"40914","SIAYA","RARIEDA","64",228,342,570
"40915","SIAYA","RARIEDA","60-64",1506,2257,3763
"40916","SIAYA","RARIEDA","65",286,413,699
"40917","SIAYA","RARIEDA","66",252,413,665
"40918","SIAYA","RARIEDA","67",341,545,886
"40919","SIAYA","RARIEDA","68",135,193,328
"40920","SIAYA","RARIEDA","69",241,281,522
"40921","SIAYA","RARIEDA","65-69",1255,1845,3100
"40922","SIAYA","RARIEDA","70",309,533,842
"40923","SIAYA","RARIEDA","71",256,277,533
"40924","SIAYA","RARIEDA","72",199,237,436
"40925","SIAYA","RARIEDA","73",183,200,383
"40926","SIAYA","RARIEDA","74",156,206,362
"40927","SIAYA","RARIEDA","70-74",1103,1453,2556
"40928","SIAYA","RARIEDA","75",109,197,306
"40929","SIAYA","RARIEDA","76",111,159,270
"40930","SIAYA","RARIEDA","77",113,252,365
"40931","SIAYA","RARIEDA","78",71,107,178
"40932","SIAYA","RARIEDA","79",86,206,292
"40933","SIAYA","RARIEDA","75-79",490,921,1411
"40934","SIAYA","RARIEDA","80",96,203,299
"40935","SIAYA","RARIEDA","81",65,141,206
"40936","SIAYA","RARIEDA","82",76,120,196
"40937","SIAYA","RARIEDA","83",80,118,198
"40938","SIAYA","RARIEDA","84",56,109,165
"40939","SIAYA","RARIEDA","80-84",373,691,1064
"40940","SIAYA","RARIEDA","85",43,121,164
"40941","SIAYA","RARIEDA","86",36,67,103
"40942","SIAYA","RARIEDA","87",59,110,169
"40943","SIAYA","RARIEDA","88",21,52,73
"40944","SIAYA","RARIEDA","89",35,84,119
"40945","SIAYA","RARIEDA","85-89",194,434,628
"40946","SIAYA","RARIEDA","90",27,61,88
"40947","SIAYA","RARIEDA","91",16,34,50
"40948","SIAYA","RARIEDA","92",9,23,32
"40949","SIAYA","RARIEDA","93",10,20,30
"40950","SIAYA","RARIEDA","94",12,17,29
"40951","SIAYA","RARIEDA","90-94",74,155,229
"40952","SIAYA","RARIEDA","95",9,23,32
"40953","SIAYA","RARIEDA","96",4,12,16
"40954","SIAYA","RARIEDA","97",2,6,8
"40955","SIAYA","RARIEDA","98",3,5,8
"40956","SIAYA","RARIEDA","99",8,9,17
"40957","SIAYA","RARIEDA","95-99",26,55,81
"40958","SIAYA","RARIEDA","100+",7,22,29
"40959","SIAYA","RARIEDA","Not Stated",1,2,3
"40960","TAITA/ TAVETA","ALL","Total",173337,167327,340664
"40961","TAITA/ TAVETA","ALL","0",3853,3895,7748
"40962","TAITA/ TAVETA","ALL","1",3918,3958,7876
"40963","TAITA/ TAVETA","ALL","2",3823,3804,7627
"40964","TAITA/ TAVETA","ALL","3",3939,3850,7789
"40965","TAITA/ TAVETA","ALL","4",3856,3793,7649
"40966","TAITA/ TAVETA","ALL","0 - 4",19389,19300,38689
"40967","TAITA/ TAVETA","ALL","5",3797,3689,7486
"40968","TAITA/ TAVETA","ALL","6",3627,3637,7264
"40969","TAITA/ TAVETA","ALL","7",3661,3640,7301
"40970","TAITA/ TAVETA","ALL","8",3744,3660,7404
"40971","TAITA/ TAVETA","ALL","9",3913,3995,7908
"40972","TAITA/ TAVETA","ALL","5-9",18742,18621,37363
"40973","TAITA/ TAVETA","ALL","10",3932,3894,7826
"40974","TAITA/ TAVETA","ALL","11",3952,3956,7908
"40975","TAITA/ TAVETA","ALL","12",4186,3942,8128
"40976","TAITA/ TAVETA","ALL","13",4108,4131,8239
"40977","TAITA/ TAVETA","ALL","14",3981,3748,7729
"40978","TAITA/ TAVETA","ALL","10 -14",20159,19671,39830
"40979","TAITA/ TAVETA","ALL","15",3707,3642,7349
"40980","TAITA/ TAVETA","ALL","16",3623,3564,7187
"40981","TAITA/ TAVETA","ALL","17",3946,3562,7508
"40982","TAITA/ TAVETA","ALL","18",3325,2984,6309
"40983","TAITA/ TAVETA","ALL","19",3278,3195,6473
"40984","TAITA/ TAVETA","ALL","15-19",17879,16947,34826
"40985","TAITA/ TAVETA","ALL","20",3277,3206,6483
"40986","TAITA/ TAVETA","ALL","21",2823,2668,5491
"40987","TAITA/ TAVETA","ALL","22",2888,2847,5735
"40988","TAITA/ TAVETA","ALL","23",3009,2943,5952
"40989","TAITA/ TAVETA","ALL","24",2762,2792,5554
"40990","TAITA/ TAVETA","ALL","20-24",14759,14456,29215
"40991","TAITA/ TAVETA","ALL","25",3035,2774,5809
"40992","TAITA/ TAVETA","ALL","26",2532,2495,5027
"40993","TAITA/ TAVETA","ALL","27",2673,2625,5298
"40994","TAITA/ TAVETA","ALL","28",2433,2355,4788
"40995","TAITA/ TAVETA","ALL","29",2674,2561,5235
"40996","TAITA/ TAVETA","ALL","25-29",13347,12810,26157
"40997","TAITA/ TAVETA","ALL","30",3085,2840,5925
"40998","TAITA/ TAVETA","ALL","31",2373,2228,4601
"40999","TAITA/ TAVETA","ALL","32",2879,2597,5476
"41000","TAITA/ TAVETA","ALL","33",2299,2277,4576
"41001","TAITA/ TAVETA","ALL","34",2287,2018,4305
"41002","TAITA/ TAVETA","ALL","30-34",12923,11960,24883
"41003","TAITA/ TAVETA","ALL","35",2875,2487,5362
"41004","TAITA/ TAVETA","ALL","36",2353,2060,4413
"41005","TAITA/ TAVETA","ALL","37",2324,2003,4327
"41006","TAITA/ TAVETA","ALL","38",1919,1679,3598
"41007","TAITA/ TAVETA","ALL","39",2183,1932,4115
"41008","TAITA/ TAVETA","ALL","35-39",11654,10161,21815
"41009","TAITA/ TAVETA","ALL","40",2429,2063,4492
"41010","TAITA/ TAVETA","ALL","41",2136,1798,3934
"41011","TAITA/ TAVETA","ALL","42",2057,1728,3785
"41012","TAITA/ TAVETA","ALL","43",1827,1565,3392
"41013","TAITA/ TAVETA","ALL","44",1678,1460,3138
"41014","TAITA/ TAVETA","ALL","40-44",10127,8614,18741
"41015","TAITA/ TAVETA","ALL","45",2253,1878,4131
"41016","TAITA/ TAVETA","ALL","46",1714,1533,3247
"41017","TAITA/ TAVETA","ALL","47",1833,1657,3490
"41018","TAITA/ TAVETA","ALL","48",1382,1239,2621
"41019","TAITA/ TAVETA","ALL","49",1544,1422,2966
"41020","TAITA/ TAVETA","ALL","45-49",8726,7729,16455
"41021","TAITA/ TAVETA","ALL","50",1870,1560,3430
"41022","TAITA/ TAVETA","ALL","51",1361,1154,2515
"41023","TAITA/ TAVETA","ALL","52",1249,1080,2329
"41024","TAITA/ TAVETA","ALL","53",1064,926,1990
"41025","TAITA/ TAVETA","ALL","54",1228,1142,2370
"41026","TAITA/ TAVETA","ALL","50-54",6772,5862,12634
"41027","TAITA/ TAVETA","ALL","55",1222,1083,2305
"41028","TAITA/ TAVETA","ALL","56",1326,1172,2498
"41029","TAITA/ TAVETA","ALL","57",1135,1448,2583
"41030","TAITA/ TAVETA","ALL","58",838,966,1804
"41031","TAITA/ TAVETA","ALL","59",1011,1046,2057
"41032","TAITA/ TAVETA","ALL","55-59",5532,5715,11247
"41033","TAITA/ TAVETA","ALL","60",1148,1298,2446
"41034","TAITA/ TAVETA","ALL","61",904,935,1839
"41035","TAITA/ TAVETA","ALL","62",909,883,1792
"41036","TAITA/ TAVETA","ALL","63",844,823,1667
"41037","TAITA/ TAVETA","ALL","64",688,645,1333
"41038","TAITA/ TAVETA","ALL","60-64",4493,4584,9077
"41039","TAITA/ TAVETA","ALL","65",883,1028,1911
"41040","TAITA/ TAVETA","ALL","66",706,676,1382
"41041","TAITA/ TAVETA","ALL","67",858,785,1643
"41042","TAITA/ TAVETA","ALL","68",513,404,917
"41043","TAITA/ TAVETA","ALL","69",632,742,1374
"41044","TAITA/ TAVETA","ALL","65-69",3592,3635,7227
"41045","TAITA/ TAVETA","ALL","70",669,1062,1731
"41046","TAITA/ TAVETA","ALL","71",495,549,1044
"41047","TAITA/ TAVETA","ALL","72",449,392,841
"41048","TAITA/ TAVETA","ALL","73",376,370,746
"41049","TAITA/ TAVETA","ALL","74",364,494,858
"41050","TAITA/ TAVETA","ALL","70-74",2353,2867,5220
"41051","TAITA/ TAVETA","ALL","75",317,394,711
"41052","TAITA/ TAVETA","ALL","76",239,283,522
"41053","TAITA/ TAVETA","ALL","77",323,340,663
"41054","TAITA/ TAVETA","ALL","78",191,212,403
"41055","TAITA/ TAVETA","ALL","79",255,406,661
"41056","TAITA/ TAVETA","ALL","75-79",1325,1635,2960
"41057","TAITA/ TAVETA","ALL","80",283,446,729
"41058","TAITA/ TAVETA","ALL","81",168,253,421
"41059","TAITA/ TAVETA","ALL","82",134,169,303
"41060","TAITA/ TAVETA","ALL","83",156,224,380
"41061","TAITA/ TAVETA","ALL","84",119,217,336
"41062","TAITA/ TAVETA","ALL","80-84",860,1309,2169
"41063","TAITA/ TAVETA","ALL","85",115,193,308
"41064","TAITA/ TAVETA","ALL","86",81,97,178
"41065","TAITA/ TAVETA","ALL","87",80,183,263
"41066","TAITA/ TAVETA","ALL","88",60,85,145
"41067","TAITA/ TAVETA","ALL","89",85,279,364
"41068","TAITA/ TAVETA","ALL","85-89",421,837,1258
"41069","TAITA/ TAVETA","ALL","90",53,135,188
"41070","TAITA/ TAVETA","ALL","91",36,78,114
"41071","TAITA/ TAVETA","ALL","92",30,33,63
"41072","TAITA/ TAVETA","ALL","93",26,43,69
"41073","TAITA/ TAVETA","ALL","94",17,48,65
"41074","TAITA/ TAVETA","ALL","90-94",162,337,499
"41075","TAITA/ TAVETA","ALL","95",23,45,68
"41076","TAITA/ TAVETA","ALL","96",10,27,37
"41077","TAITA/ TAVETA","ALL","97",19,26,45
"41078","TAITA/ TAVETA","ALL","98",8,29,37
"41079","TAITA/ TAVETA","ALL","99",19,63,82
"41080","TAITA/ TAVETA","ALL","95-99",79,190,269
"41081","TAITA/ TAVETA","ALL","100+",41,86,127
"41082","TAITA/ TAVETA","ALL","Not Stated",2,1,3
"41083","TAITA/ TAVETA","MWATATE","Total",41426,40231,81657
"41084","TAITA/ TAVETA","MWATATE","0",842,976,1818
"41085","TAITA/ TAVETA","MWATATE","1",897,898,1795
"41086","TAITA/ TAVETA","MWATATE","2",873,831,1704
"41087","TAITA/ TAVETA","MWATATE","3",917,888,1805
"41088","TAITA/ TAVETA","MWATATE","4",902,884,1786
"41089","TAITA/ TAVETA","MWATATE","0 - 4",4431,4477,8908
"41090","TAITA/ TAVETA","MWATATE","5",884,889,1773
"41091","TAITA/ TAVETA","MWATATE","6",851,856,1707
"41092","TAITA/ TAVETA","MWATATE","7",915,874,1789
"41093","TAITA/ TAVETA","MWATATE","8",900,874,1774
"41094","TAITA/ TAVETA","MWATATE","9",902,931,1833
"41095","TAITA/ TAVETA","MWATATE","5-9",4452,4424,8876
"41096","TAITA/ TAVETA","MWATATE","10",980,969,1949
"41097","TAITA/ TAVETA","MWATATE","11",972,949,1921
"41098","TAITA/ TAVETA","MWATATE","12",1001,999,2000
"41099","TAITA/ TAVETA","MWATATE","13",1045,1010,2055
"41100","TAITA/ TAVETA","MWATATE","14",979,920,1899
"41101","TAITA/ TAVETA","MWATATE","10 -14",4977,4847,9824
"41102","TAITA/ TAVETA","MWATATE","15",895,876,1771
"41103","TAITA/ TAVETA","MWATATE","16",908,870,1778
"41104","TAITA/ TAVETA","MWATATE","17",1007,893,1900
"41105","TAITA/ TAVETA","MWATATE","18",848,723,1571
"41106","TAITA/ TAVETA","MWATATE","19",764,740,1504
"41107","TAITA/ TAVETA","MWATATE","15-19",4422,4102,8524
"41108","TAITA/ TAVETA","MWATATE","20",814,688,1502
"41109","TAITA/ TAVETA","MWATATE","21",696,577,1273
"41110","TAITA/ TAVETA","MWATATE","22",738,602,1340
"41111","TAITA/ TAVETA","MWATATE","23",723,600,1323
"41112","TAITA/ TAVETA","MWATATE","24",628,558,1186
"41113","TAITA/ TAVETA","MWATATE","20-24",3599,3025,6624
"41114","TAITA/ TAVETA","MWATATE","25",578,546,1124
"41115","TAITA/ TAVETA","MWATATE","26",504,520,1024
"41116","TAITA/ TAVETA","MWATATE","27",550,524,1074
"41117","TAITA/ TAVETA","MWATATE","28",484,547,1031
"41118","TAITA/ TAVETA","MWATATE","29",561,517,1078
"41119","TAITA/ TAVETA","MWATATE","25-29",2677,2654,5331
"41120","TAITA/ TAVETA","MWATATE","30",599,580,1179
"41121","TAITA/ TAVETA","MWATATE","31",511,468,979
"41122","TAITA/ TAVETA","MWATATE","32",636,545,1181
"41123","TAITA/ TAVETA","MWATATE","33",510,510,1020
"41124","TAITA/ TAVETA","MWATATE","34",559,452,1011
"41125","TAITA/ TAVETA","MWATATE","30-34",2815,2555,5370
"41126","TAITA/ TAVETA","MWATATE","35",607,579,1186
"41127","TAITA/ TAVETA","MWATATE","36",535,490,1025
"41128","TAITA/ TAVETA","MWATATE","37",480,494,974
"41129","TAITA/ TAVETA","MWATATE","38",437,407,844
"41130","TAITA/ TAVETA","MWATATE","39",505,431,936
"41131","TAITA/ TAVETA","MWATATE","35-39",2564,2401,4965
"41132","TAITA/ TAVETA","MWATATE","40",575,502,1077
"41133","TAITA/ TAVETA","MWATATE","41",475,455,930
"41134","TAITA/ TAVETA","MWATATE","42",494,429,923
"41135","TAITA/ TAVETA","MWATATE","43",436,374,810
"41136","TAITA/ TAVETA","MWATATE","44",408,352,760
"41137","TAITA/ TAVETA","MWATATE","40-44",2388,2112,4500
"41138","TAITA/ TAVETA","MWATATE","45",544,422,966
"41139","TAITA/ TAVETA","MWATATE","46",448,365,813
"41140","TAITA/ TAVETA","MWATATE","47",443,409,852
"41141","TAITA/ TAVETA","MWATATE","48",339,352,691
"41142","TAITA/ TAVETA","MWATATE","49",376,363,739
"41143","TAITA/ TAVETA","MWATATE","45-49",2150,1911,4061
"41144","TAITA/ TAVETA","MWATATE","50",505,406,911
"41145","TAITA/ TAVETA","MWATATE","51",325,287,612
"41146","TAITA/ TAVETA","MWATATE","52",304,291,595
"41147","TAITA/ TAVETA","MWATATE","53",280,280,560
"41148","TAITA/ TAVETA","MWATATE","54",350,311,661
"41149","TAITA/ TAVETA","MWATATE","50-54",1764,1575,3339
"41150","TAITA/ TAVETA","MWATATE","55",291,292,583
"41151","TAITA/ TAVETA","MWATATE","56",348,320,668
"41152","TAITA/ TAVETA","MWATATE","57",294,408,702
"41153","TAITA/ TAVETA","MWATATE","58",221,273,494
"41154","TAITA/ TAVETA","MWATATE","59",271,292,563
"41155","TAITA/ TAVETA","MWATATE","55-59",1425,1585,3010
"41156","TAITA/ TAVETA","MWATATE","60",326,363,689
"41157","TAITA/ TAVETA","MWATATE","61",249,254,503
"41158","TAITA/ TAVETA","MWATATE","62",279,260,539
"41159","TAITA/ TAVETA","MWATATE","63",250,237,487
"41160","TAITA/ TAVETA","MWATATE","64",179,199,378
"41161","TAITA/ TAVETA","MWATATE","60-64",1283,1313,2596
"41162","TAITA/ TAVETA","MWATATE","65",253,304,557
"41163","TAITA/ TAVETA","MWATATE","66",206,207,413
"41164","TAITA/ TAVETA","MWATATE","67",232,239,471
"41165","TAITA/ TAVETA","MWATATE","68",145,107,252
"41166","TAITA/ TAVETA","MWATATE","69",174,206,380
"41167","TAITA/ TAVETA","MWATATE","65-69",1010,1063,2073
"41168","TAITA/ TAVETA","MWATATE","70",181,327,508
"41169","TAITA/ TAVETA","MWATATE","71",129,162,291
"41170","TAITA/ TAVETA","MWATATE","72",128,124,252
"41171","TAITA/ TAVETA","MWATATE","73",120,94,214
"41172","TAITA/ TAVETA","MWATATE","74",99,163,262
"41173","TAITA/ TAVETA","MWATATE","70-74",657,870,1527
"41174","TAITA/ TAVETA","MWATATE","75",89,119,208
"41175","TAITA/ TAVETA","MWATATE","76",66,85,151
"41176","TAITA/ TAVETA","MWATATE","77",93,103,196
"41177","TAITA/ TAVETA","MWATATE","78",67,67,134
"41178","TAITA/ TAVETA","MWATATE","79",61,123,184
"41179","TAITA/ TAVETA","MWATATE","75-79",376,497,873
"41180","TAITA/ TAVETA","MWATATE","80",86,133,219
"41181","TAITA/ TAVETA","MWATATE","81",51,89,140
"41182","TAITA/ TAVETA","MWATATE","82",33,59,92
"41183","TAITA/ TAVETA","MWATATE","83",44,66,110
"41184","TAITA/ TAVETA","MWATATE","84",36,68,104
"41185","TAITA/ TAVETA","MWATATE","80-84",250,415,665
"41186","TAITA/ TAVETA","MWATATE","85",31,67,98
"41187","TAITA/ TAVETA","MWATATE","86",19,28,47
"41188","TAITA/ TAVETA","MWATATE","87",25,56,81
"41189","TAITA/ TAVETA","MWATATE","88",17,24,41
"41190","TAITA/ TAVETA","MWATATE","89",30,79,109
"41191","TAITA/ TAVETA","MWATATE","85-89",122,254,376
"41192","TAITA/ TAVETA","MWATATE","90",9,36,45
"41193","TAITA/ TAVETA","MWATATE","91",8,11,19
"41194","TAITA/ TAVETA","MWATATE","92",7,11,18
"41195","TAITA/ TAVETA","MWATATE","93",8,11,19
"41196","TAITA/ TAVETA","MWATATE","94",4,13,17
"41197","TAITA/ TAVETA","MWATATE","90-94",36,82,118
"41198","TAITA/ TAVETA","MWATATE","95",5,10,15
"41199","TAITA/ TAVETA","MWATATE","96",4,12,16
"41200","TAITA/ TAVETA","MWATATE","97",7,8,15
"41201","TAITA/ TAVETA","MWATATE","98",2,5,7
"41202","TAITA/ TAVETA","MWATATE","99",3,14,17
"41203","TAITA/ TAVETA","MWATATE","95-99",21,49,70
"41204","TAITA/ TAVETA","MWATATE","100+",6,20,26
"41205","TAITA/ TAVETA","MWATATE","Not Stated",1,NA,1
"41206","TAITA/ TAVETA","TAITA","Total",28386,27573,55959
"41207","TAITA/ TAVETA","TAITA","0",541,551,1092
"41208","TAITA/ TAVETA","TAITA","1",564,548,1112
"41209","TAITA/ TAVETA","TAITA","2",564,534,1098
"41210","TAITA/ TAVETA","TAITA","3",564,559,1123
"41211","TAITA/ TAVETA","TAITA","4",620,604,1224
"41212","TAITA/ TAVETA","TAITA","0 - 4",2853,2796,5649
"41213","TAITA/ TAVETA","TAITA","5",598,582,1180
"41214","TAITA/ TAVETA","TAITA","6",543,559,1102
"41215","TAITA/ TAVETA","TAITA","7",582,571,1153
"41216","TAITA/ TAVETA","TAITA","8",634,627,1261
"41217","TAITA/ TAVETA","TAITA","9",670,641,1311
"41218","TAITA/ TAVETA","TAITA","5-9",3027,2980,6007
"41219","TAITA/ TAVETA","TAITA","10",626,622,1248
"41220","TAITA/ TAVETA","TAITA","11",664,668,1332
"41221","TAITA/ TAVETA","TAITA","12",743,670,1413
"41222","TAITA/ TAVETA","TAITA","13",707,702,1409
"41223","TAITA/ TAVETA","TAITA","14",688,622,1310
"41224","TAITA/ TAVETA","TAITA","10 -14",3428,3284,6712
"41225","TAITA/ TAVETA","TAITA","15",596,627,1223
"41226","TAITA/ TAVETA","TAITA","16",588,579,1167
"41227","TAITA/ TAVETA","TAITA","17",663,651,1314
"41228","TAITA/ TAVETA","TAITA","18",568,463,1031
"41229","TAITA/ TAVETA","TAITA","19",582,458,1040
"41230","TAITA/ TAVETA","TAITA","15-19",2997,2778,5775
"41231","TAITA/ TAVETA","TAITA","20",496,423,919
"41232","TAITA/ TAVETA","TAITA","21",441,345,786
"41233","TAITA/ TAVETA","TAITA","22",417,358,775
"41234","TAITA/ TAVETA","TAITA","23",435,358,793
"41235","TAITA/ TAVETA","TAITA","24",368,360,728
"41236","TAITA/ TAVETA","TAITA","20-24",2157,1844,4001
"41237","TAITA/ TAVETA","TAITA","25",356,338,694
"41238","TAITA/ TAVETA","TAITA","26",371,288,659
"41239","TAITA/ TAVETA","TAITA","27",347,319,666
"41240","TAITA/ TAVETA","TAITA","28",296,278,574
"41241","TAITA/ TAVETA","TAITA","29",361,311,672
"41242","TAITA/ TAVETA","TAITA","25-29",1731,1534,3265
"41243","TAITA/ TAVETA","TAITA","30",400,340,740
"41244","TAITA/ TAVETA","TAITA","31",291,284,575
"41245","TAITA/ TAVETA","TAITA","32",405,342,747
"41246","TAITA/ TAVETA","TAITA","33",329,328,657
"41247","TAITA/ TAVETA","TAITA","34",345,314,659
"41248","TAITA/ TAVETA","TAITA","30-34",1770,1608,3378
"41249","TAITA/ TAVETA","TAITA","35",467,406,873
"41250","TAITA/ TAVETA","TAITA","36",355,324,679
"41251","TAITA/ TAVETA","TAITA","37",371,306,677
"41252","TAITA/ TAVETA","TAITA","38",331,253,584
"41253","TAITA/ TAVETA","TAITA","39",359,312,671
"41254","TAITA/ TAVETA","TAITA","35-39",1883,1601,3484
"41255","TAITA/ TAVETA","TAITA","40",387,332,719
"41256","TAITA/ TAVETA","TAITA","41",366,279,645
"41257","TAITA/ TAVETA","TAITA","42",323,296,619
"41258","TAITA/ TAVETA","TAITA","43",278,276,554
"41259","TAITA/ TAVETA","TAITA","44",273,278,551
"41260","TAITA/ TAVETA","TAITA","40-44",1627,1461,3088
"41261","TAITA/ TAVETA","TAITA","45",358,324,682
"41262","TAITA/ TAVETA","TAITA","46",297,274,571
"41263","TAITA/ TAVETA","TAITA","47",289,316,605
"41264","TAITA/ TAVETA","TAITA","48",235,243,478
"41265","TAITA/ TAVETA","TAITA","49",282,270,552
"41266","TAITA/ TAVETA","TAITA","45-49",1461,1427,2888
"41267","TAITA/ TAVETA","TAITA","50",320,320,640
"41268","TAITA/ TAVETA","TAITA","51",245,222,467
"41269","TAITA/ TAVETA","TAITA","52",256,229,485
"41270","TAITA/ TAVETA","TAITA","53",207,211,418
"41271","TAITA/ TAVETA","TAITA","54",223,251,474
"41272","TAITA/ TAVETA","TAITA","50-54",1251,1233,2484
"41273","TAITA/ TAVETA","TAITA","55",228,223,451
"41274","TAITA/ TAVETA","TAITA","56",254,253,507
"41275","TAITA/ TAVETA","TAITA","57",259,375,634
"41276","TAITA/ TAVETA","TAITA","58",175,221,396
"41277","TAITA/ TAVETA","TAITA","59",213,232,445
"41278","TAITA/ TAVETA","TAITA","55-59",1129,1304,2433
"41279","TAITA/ TAVETA","TAITA","60",237,309,546
"41280","TAITA/ TAVETA","TAITA","61",180,205,385
"41281","TAITA/ TAVETA","TAITA","62",178,201,379
"41282","TAITA/ TAVETA","TAITA","63",178,197,375
"41283","TAITA/ TAVETA","TAITA","64",151,155,306
"41284","TAITA/ TAVETA","TAITA","60-64",924,1067,1991
"41285","TAITA/ TAVETA","TAITA","65",206,227,433
"41286","TAITA/ TAVETA","TAITA","66",174,173,347
"41287","TAITA/ TAVETA","TAITA","67",195,178,373
"41288","TAITA/ TAVETA","TAITA","68",127,94,221
"41289","TAITA/ TAVETA","TAITA","69",145,178,323
"41290","TAITA/ TAVETA","TAITA","65-69",847,850,1697
"41291","TAITA/ TAVETA","TAITA","70",151,230,381
"41292","TAITA/ TAVETA","TAITA","71",122,155,277
"41293","TAITA/ TAVETA","TAITA","72",119,90,209
"41294","TAITA/ TAVETA","TAITA","73",101,95,196
"41295","TAITA/ TAVETA","TAITA","74",93,143,236
"41296","TAITA/ TAVETA","TAITA","70-74",586,713,1299
"41297","TAITA/ TAVETA","TAITA","75",82,96,178
"41298","TAITA/ TAVETA","TAITA","76",62,79,141
"41299","TAITA/ TAVETA","TAITA","77",83,79,162
"41300","TAITA/ TAVETA","TAITA","78",42,58,100
"41301","TAITA/ TAVETA","TAITA","79",57,97,154
"41302","TAITA/ TAVETA","TAITA","75-79",326,409,735
"41303","TAITA/ TAVETA","TAITA","80",76,108,184
"41304","TAITA/ TAVETA","TAITA","81",56,77,133
"41305","TAITA/ TAVETA","TAITA","82",23,45,68
"41306","TAITA/ TAVETA","TAITA","83",35,52,87
"41307","TAITA/ TAVETA","TAITA","84",29,46,75
"41308","TAITA/ TAVETA","TAITA","80-84",219,328,547
"41309","TAITA/ TAVETA","TAITA","85",32,39,71
"41310","TAITA/ TAVETA","TAITA","86",27,26,53
"41311","TAITA/ TAVETA","TAITA","87",25,59,84
"41312","TAITA/ TAVETA","TAITA","88",12,24,36
"41313","TAITA/ TAVETA","TAITA","89",17,65,82
"41314","TAITA/ TAVETA","TAITA","85-89",113,213,326
"41315","TAITA/ TAVETA","TAITA","90",13,34,47
"41316","TAITA/ TAVETA","TAITA","91",8,31,39
"41317","TAITA/ TAVETA","TAITA","92",5,6,11
"41318","TAITA/ TAVETA","TAITA","93",3,7,10
"41319","TAITA/ TAVETA","TAITA","94",3,10,13
"41320","TAITA/ TAVETA","TAITA","90-94",32,88,120
"41321","TAITA/ TAVETA","TAITA","95",6,12,18
"41322","TAITA/ TAVETA","TAITA","96",NA,3,3
"41323","TAITA/ TAVETA","TAITA","97",2,5,7
"41324","TAITA/ TAVETA","TAITA","98",1,7,8
"41325","TAITA/ TAVETA","TAITA","99",7,15,22
"41326","TAITA/ TAVETA","TAITA","95-99",16,42,58
"41327","TAITA/ TAVETA","TAITA","100+",9,12,21
"41328","TAITA/ TAVETA","TAITA","Not Stated",NA,1,1
"41329","TAITA/ TAVETA","TAVETA","Total",47410,43812,91222
"41330","TAITA/ TAVETA","TAVETA","0",1058,1000,2058
"41331","TAITA/ TAVETA","TAVETA","1",1099,1219,2318
"41332","TAITA/ TAVETA","TAVETA","2",1101,1079,2180
"41333","TAITA/ TAVETA","TAVETA","3",1192,1093,2285
"41334","TAITA/ TAVETA","TAVETA","4",1041,1093,2134
"41335","TAITA/ TAVETA","TAVETA","0 - 4",5491,5484,10975
"41336","TAITA/ TAVETA","TAVETA","5",1065,1019,2084
"41337","TAITA/ TAVETA","TAVETA","6",1023,1037,2060
"41338","TAITA/ TAVETA","TAVETA","7",1015,986,2001
"41339","TAITA/ TAVETA","TAVETA","8",1053,1014,2067
"41340","TAITA/ TAVETA","TAVETA","9",1144,1183,2327
"41341","TAITA/ TAVETA","TAVETA","5-9",5300,5239,10539
"41342","TAITA/ TAVETA","TAVETA","10",1117,1087,2204
"41343","TAITA/ TAVETA","TAVETA","11",1118,1091,2209
"41344","TAITA/ TAVETA","TAVETA","12",1188,1047,2235
"41345","TAITA/ TAVETA","TAVETA","13",1156,1146,2302
"41346","TAITA/ TAVETA","TAVETA","14",1105,1051,2156
"41347","TAITA/ TAVETA","TAVETA","10 -14",5684,5422,11106
"41348","TAITA/ TAVETA","TAVETA","15",1067,1040,2107
"41349","TAITA/ TAVETA","TAVETA","16",998,951,1949
"41350","TAITA/ TAVETA","TAVETA","17",1090,928,2018
"41351","TAITA/ TAVETA","TAVETA","18",928,867,1795
"41352","TAITA/ TAVETA","TAVETA","19",889,889,1778
"41353","TAITA/ TAVETA","TAVETA","15-19",4972,4675,9647
"41354","TAITA/ TAVETA","TAVETA","20",909,939,1848
"41355","TAITA/ TAVETA","TAVETA","21",704,720,1424
"41356","TAITA/ TAVETA","TAVETA","22",771,804,1575
"41357","TAITA/ TAVETA","TAVETA","23",820,830,1650
"41358","TAITA/ TAVETA","TAVETA","24",744,790,1534
"41359","TAITA/ TAVETA","TAVETA","20-24",3948,4083,8031
"41360","TAITA/ TAVETA","TAVETA","25",953,825,1778
"41361","TAITA/ TAVETA","TAVETA","26",711,710,1421
"41362","TAITA/ TAVETA","TAVETA","27",819,757,1576
"41363","TAITA/ TAVETA","TAVETA","28",726,621,1347
"41364","TAITA/ TAVETA","TAVETA","29",784,744,1528
"41365","TAITA/ TAVETA","TAVETA","25-29",3993,3657,7650
"41366","TAITA/ TAVETA","TAVETA","30",962,860,1822
"41367","TAITA/ TAVETA","TAVETA","31",687,654,1341
"41368","TAITA/ TAVETA","TAVETA","32",855,720,1575
"41369","TAITA/ TAVETA","TAVETA","33",659,605,1264
"41370","TAITA/ TAVETA","TAVETA","34",619,512,1131
"41371","TAITA/ TAVETA","TAVETA","30-34",3782,3351,7133
"41372","TAITA/ TAVETA","TAVETA","35",829,657,1486
"41373","TAITA/ TAVETA","TAVETA","36",628,562,1190
"41374","TAITA/ TAVETA","TAVETA","37",661,554,1215
"41375","TAITA/ TAVETA","TAVETA","38",518,402,920
"41376","TAITA/ TAVETA","TAVETA","39",625,543,1168
"41377","TAITA/ TAVETA","TAVETA","35-39",3261,2718,5979
"41378","TAITA/ TAVETA","TAVETA","40",695,570,1265
"41379","TAITA/ TAVETA","TAVETA","41",597,483,1080
"41380","TAITA/ TAVETA","TAVETA","42",592,408,1000
"41381","TAITA/ TAVETA","TAVETA","43",490,356,846
"41382","TAITA/ TAVETA","TAVETA","44",449,344,793
"41383","TAITA/ TAVETA","TAVETA","40-44",2823,2161,4984
"41384","TAITA/ TAVETA","TAVETA","45",638,472,1110
"41385","TAITA/ TAVETA","TAVETA","46",432,389,821
"41386","TAITA/ TAVETA","TAVETA","47",525,402,927
"41387","TAITA/ TAVETA","TAVETA","48",362,260,622
"41388","TAITA/ TAVETA","TAVETA","49",412,338,750
"41389","TAITA/ TAVETA","TAVETA","45-49",2369,1861,4230
"41390","TAITA/ TAVETA","TAVETA","50",465,353,818
"41391","TAITA/ TAVETA","TAVETA","51",384,282,666
"41392","TAITA/ TAVETA","TAVETA","52",311,216,527
"41393","TAITA/ TAVETA","TAVETA","53",235,171,406
"41394","TAITA/ TAVETA","TAVETA","54",309,247,556
"41395","TAITA/ TAVETA","TAVETA","50-54",1704,1269,2973
"41396","TAITA/ TAVETA","TAVETA","55",329,255,584
"41397","TAITA/ TAVETA","TAVETA","56",331,241,572
"41398","TAITA/ TAVETA","TAVETA","57",215,249,464
"41399","TAITA/ TAVETA","TAVETA","58",192,183,375
"41400","TAITA/ TAVETA","TAVETA","59",244,213,457
"41401","TAITA/ TAVETA","TAVETA","55-59",1311,1141,2452
"41402","TAITA/ TAVETA","TAVETA","60",280,245,525
"41403","TAITA/ TAVETA","TAVETA","61",208,186,394
"41404","TAITA/ TAVETA","TAVETA","62",190,159,349
"41405","TAITA/ TAVETA","TAVETA","63",188,161,349
"41406","TAITA/ TAVETA","TAVETA","64",138,108,246
"41407","TAITA/ TAVETA","TAVETA","60-64",1004,859,1863
"41408","TAITA/ TAVETA","TAVETA","65",176,212,388
"41409","TAITA/ TAVETA","TAVETA","66",121,113,234
"41410","TAITA/ TAVETA","TAVETA","67",189,152,341
"41411","TAITA/ TAVETA","TAVETA","68",91,87,178
"41412","TAITA/ TAVETA","TAVETA","69",127,135,262
"41413","TAITA/ TAVETA","TAVETA","65-69",704,699,1403
"41414","TAITA/ TAVETA","TAVETA","70",137,182,319
"41415","TAITA/ TAVETA","TAVETA","71",109,95,204
"41416","TAITA/ TAVETA","TAVETA","72",93,62,155
"41417","TAITA/ TAVETA","TAVETA","73",61,65,126
"41418","TAITA/ TAVETA","TAVETA","74",66,57,123
"41419","TAITA/ TAVETA","TAVETA","70-74",466,461,927
"41420","TAITA/ TAVETA","TAVETA","75",73,68,141
"41421","TAITA/ TAVETA","TAVETA","76",47,35,82
"41422","TAITA/ TAVETA","TAVETA","77",66,57,123
"41423","TAITA/ TAVETA","TAVETA","78",29,26,55
"41424","TAITA/ TAVETA","TAVETA","79",53,63,116
"41425","TAITA/ TAVETA","TAVETA","75-79",268,249,517
"41426","TAITA/ TAVETA","TAVETA","80",51,77,128
"41427","TAITA/ TAVETA","TAVETA","81",26,30,56
"41428","TAITA/ TAVETA","TAVETA","82",33,26,59
"41429","TAITA/ TAVETA","TAVETA","83",30,34,64
"41430","TAITA/ TAVETA","TAVETA","84",21,28,49
"41431","TAITA/ TAVETA","TAVETA","80-84",161,195,356
"41432","TAITA/ TAVETA","TAVETA","85",22,38,60
"41433","TAITA/ TAVETA","TAVETA","86",17,12,29
"41434","TAITA/ TAVETA","TAVETA","87",14,30,44
"41435","TAITA/ TAVETA","TAVETA","88",13,17,30
"41436","TAITA/ TAVETA","TAVETA","89",25,59,84
"41437","TAITA/ TAVETA","TAVETA","85-89",91,156,247
"41438","TAITA/ TAVETA","TAVETA","90",19,33,52
"41439","TAITA/ TAVETA","TAVETA","91",8,18,26
"41440","TAITA/ TAVETA","TAVETA","92",10,6,16
"41441","TAITA/ TAVETA","TAVETA","93",5,5,10
"41442","TAITA/ TAVETA","TAVETA","94",4,7,11
"41443","TAITA/ TAVETA","TAVETA","90-94",46,69,115
"41444","TAITA/ TAVETA","TAVETA","95",2,12,14
"41445","TAITA/ TAVETA","TAVETA","96",2,5,7
"41446","TAITA/ TAVETA","TAVETA","97",7,5,12
"41447","TAITA/ TAVETA","TAVETA","98",2,4,6
"41448","TAITA/ TAVETA","TAVETA","99",6,10,16
"41449","TAITA/ TAVETA","TAVETA","95-99",19,36,55
"41450","TAITA/ TAVETA","TAVETA","100+",12,27,39
"41451","TAITA/ TAVETA","TAVETA","Not Stated",1,NA,1
"41452","TAITA/ TAVETA","VOI","Total",56115,55711,111826
"41453","TAITA/ TAVETA","VOI","0",1412,1368,2780
"41454","TAITA/ TAVETA","VOI","1",1358,1293,2651
"41455","TAITA/ TAVETA","VOI","2",1285,1360,2645
"41456","TAITA/ TAVETA","VOI","3",1266,1310,2576
"41457","TAITA/ TAVETA","VOI","4",1293,1212,2505
"41458","TAITA/ TAVETA","VOI","0 - 4",6614,6543,13157
"41459","TAITA/ TAVETA","VOI","5",1250,1199,2449
"41460","TAITA/ TAVETA","VOI","6",1210,1185,2395
"41461","TAITA/ TAVETA","VOI","7",1149,1209,2358
"41462","TAITA/ TAVETA","VOI","8",1157,1145,2302
"41463","TAITA/ TAVETA","VOI","9",1197,1240,2437
"41464","TAITA/ TAVETA","VOI","5-9",5963,5978,11941
"41465","TAITA/ TAVETA","VOI","10",1209,1216,2425
"41466","TAITA/ TAVETA","VOI","11",1198,1248,2446
"41467","TAITA/ TAVETA","VOI","12",1254,1226,2480
"41468","TAITA/ TAVETA","VOI","13",1200,1273,2473
"41469","TAITA/ TAVETA","VOI","14",1209,1155,2364
"41470","TAITA/ TAVETA","VOI","10 -14",6070,6118,12188
"41471","TAITA/ TAVETA","VOI","15",1149,1099,2248
"41472","TAITA/ TAVETA","VOI","16",1129,1164,2293
"41473","TAITA/ TAVETA","VOI","17",1186,1090,2276
"41474","TAITA/ TAVETA","VOI","18",981,931,1912
"41475","TAITA/ TAVETA","VOI","19",1043,1108,2151
"41476","TAITA/ TAVETA","VOI","15-19",5488,5392,10880
"41477","TAITA/ TAVETA","VOI","20",1058,1156,2214
"41478","TAITA/ TAVETA","VOI","21",982,1026,2008
"41479","TAITA/ TAVETA","VOI","22",962,1083,2045
"41480","TAITA/ TAVETA","VOI","23",1031,1155,2186
"41481","TAITA/ TAVETA","VOI","24",1022,1084,2106
"41482","TAITA/ TAVETA","VOI","20-24",5055,5504,10559
"41483","TAITA/ TAVETA","VOI","25",1148,1065,2213
"41484","TAITA/ TAVETA","VOI","26",946,977,1923
"41485","TAITA/ TAVETA","VOI","27",957,1025,1982
"41486","TAITA/ TAVETA","VOI","28",927,909,1836
"41487","TAITA/ TAVETA","VOI","29",968,989,1957
"41488","TAITA/ TAVETA","VOI","25-29",4946,4965,9911
"41489","TAITA/ TAVETA","VOI","30",1124,1060,2184
"41490","TAITA/ TAVETA","VOI","31",884,822,1706
"41491","TAITA/ TAVETA","VOI","32",983,990,1973
"41492","TAITA/ TAVETA","VOI","33",801,834,1635
"41493","TAITA/ TAVETA","VOI","34",764,740,1504
"41494","TAITA/ TAVETA","VOI","30-34",4556,4446,9002
"41495","TAITA/ TAVETA","VOI","35",972,845,1817
"41496","TAITA/ TAVETA","VOI","36",835,684,1519
"41497","TAITA/ TAVETA","VOI","37",812,649,1461
"41498","TAITA/ TAVETA","VOI","38",633,617,1250
"41499","TAITA/ TAVETA","VOI","39",694,646,1340
"41500","TAITA/ TAVETA","VOI","35-39",3946,3441,7387
"41501","TAITA/ TAVETA","VOI","40",772,659,1431
"41502","TAITA/ TAVETA","VOI","41",698,581,1279
"41503","TAITA/ TAVETA","VOI","42",648,595,1243
"41504","TAITA/ TAVETA","VOI","43",623,559,1182
"41505","TAITA/ TAVETA","VOI","44",548,486,1034
"41506","TAITA/ TAVETA","VOI","40-44",3289,2880,6169
"41507","TAITA/ TAVETA","VOI","45",713,660,1373
"41508","TAITA/ TAVETA","VOI","46",537,505,1042
"41509","TAITA/ TAVETA","VOI","47",576,530,1106
"41510","TAITA/ TAVETA","VOI","48",446,384,830
"41511","TAITA/ TAVETA","VOI","49",474,451,925
"41512","TAITA/ TAVETA","VOI","45-49",2746,2530,5276
"41513","TAITA/ TAVETA","VOI","50",580,481,1061
"41514","TAITA/ TAVETA","VOI","51",407,363,770
"41515","TAITA/ TAVETA","VOI","52",378,344,722
"41516","TAITA/ TAVETA","VOI","53",342,264,606
"41517","TAITA/ TAVETA","VOI","54",346,333,679
"41518","TAITA/ TAVETA","VOI","50-54",2053,1785,3838
"41519","TAITA/ TAVETA","VOI","55",374,313,687
"41520","TAITA/ TAVETA","VOI","56",393,358,751
"41521","TAITA/ TAVETA","VOI","57",367,416,783
"41522","TAITA/ TAVETA","VOI","58",250,289,539
"41523","TAITA/ TAVETA","VOI","59",283,309,592
"41524","TAITA/ TAVETA","VOI","55-59",1667,1685,3352
"41525","TAITA/ TAVETA","VOI","60",305,381,686
"41526","TAITA/ TAVETA","VOI","61",267,290,557
"41527","TAITA/ TAVETA","VOI","62",262,263,525
"41528","TAITA/ TAVETA","VOI","63",228,228,456
"41529","TAITA/ TAVETA","VOI","64",220,183,403
"41530","TAITA/ TAVETA","VOI","60-64",1282,1345,2627
"41531","TAITA/ TAVETA","VOI","65",248,285,533
"41532","TAITA/ TAVETA","VOI","66",205,183,388
"41533","TAITA/ TAVETA","VOI","67",242,216,458
"41534","TAITA/ TAVETA","VOI","68",150,116,266
"41535","TAITA/ TAVETA","VOI","69",186,223,409
"41536","TAITA/ TAVETA","VOI","65-69",1031,1023,2054
"41537","TAITA/ TAVETA","VOI","70",200,323,523
"41538","TAITA/ TAVETA","VOI","71",135,137,272
"41539","TAITA/ TAVETA","VOI","72",109,116,225
"41540","TAITA/ TAVETA","VOI","73",94,116,210
"41541","TAITA/ TAVETA","VOI","74",106,131,237
"41542","TAITA/ TAVETA","VOI","70-74",644,823,1467
"41543","TAITA/ TAVETA","VOI","75",73,111,184
"41544","TAITA/ TAVETA","VOI","76",64,84,148
"41545","TAITA/ TAVETA","VOI","77",81,101,182
"41546","TAITA/ TAVETA","VOI","78",53,61,114
"41547","TAITA/ TAVETA","VOI","79",84,123,207
"41548","TAITA/ TAVETA","VOI","75-79",355,480,835
"41549","TAITA/ TAVETA","VOI","80",70,128,198
"41550","TAITA/ TAVETA","VOI","81",35,57,92
"41551","TAITA/ TAVETA","VOI","82",45,39,84
"41552","TAITA/ TAVETA","VOI","83",47,72,119
"41553","TAITA/ TAVETA","VOI","84",33,75,108
"41554","TAITA/ TAVETA","VOI","80-84",230,371,601
"41555","TAITA/ TAVETA","VOI","85",30,49,79
"41556","TAITA/ TAVETA","VOI","86",18,31,49
"41557","TAITA/ TAVETA","VOI","87",16,38,54
"41558","TAITA/ TAVETA","VOI","88",18,20,38
"41559","TAITA/ TAVETA","VOI","89",13,76,89
"41560","TAITA/ TAVETA","VOI","85-89",95,214,309
"41561","TAITA/ TAVETA","VOI","90",12,32,44
"41562","TAITA/ TAVETA","VOI","91",12,18,30
"41563","TAITA/ TAVETA","VOI","92",8,10,18
"41564","TAITA/ TAVETA","VOI","93",10,20,30
"41565","TAITA/ TAVETA","VOI","94",6,18,24
"41566","TAITA/ TAVETA","VOI","90-94",48,98,146
"41567","TAITA/ TAVETA","VOI","95",10,11,21
"41568","TAITA/ TAVETA","VOI","96",4,7,11
"41569","TAITA/ TAVETA","VOI","97",3,8,11
"41570","TAITA/ TAVETA","VOI","98",3,13,16
"41571","TAITA/ TAVETA","VOI","99",3,24,27
"41572","TAITA/ TAVETA","VOI","95-99",23,63,86
"41573","TAITA/ TAVETA","VOI","100+",14,27,41
"41574","TAITA/ TAVETA","VOI","Not Stated",NA,NA,NA
"41575","TANA RIVER","ALL","Total",158550,157391,315941
"41576","TANA RIVER","ALL","0",4867,4775,9642
"41577","TANA RIVER","ALL","1",4934,4600,9534
"41578","TANA RIVER","ALL","2",5639,5317,10956
"41579","TANA RIVER","ALL","3",5663,5573,11236
"41580","TANA RIVER","ALL","4",6069,5741,11810
"41581","TANA RIVER","ALL","0 - 4",27172,26006,53178
"41582","TANA RIVER","ALL","5",5797,5524,11321
"41583","TANA RIVER","ALL","6",5768,5646,11414
"41584","TANA RIVER","ALL","7",5531,5026,10557
"41585","TANA RIVER","ALL","8",5508,5261,10769
"41586","TANA RIVER","ALL","9",4487,4421,8908
"41587","TANA RIVER","ALL","5-9",27091,25878,52969
"41588","TANA RIVER","ALL","10",5919,5787,11706
"41589","TANA RIVER","ALL","11",3965,3890,7855
"41590","TANA RIVER","ALL","12",5339,4949,10288
"41591","TANA RIVER","ALL","13",4358,4357,8715
"41592","TANA RIVER","ALL","14",4138,3988,8126
"41593","TANA RIVER","ALL","10 -14",23719,22971,46690
"41594","TANA RIVER","ALL","15",4265,4049,8314
"41595","TANA RIVER","ALL","16",3350,3136,6486
"41596","TANA RIVER","ALL","17",3352,2935,6287
"41597","TANA RIVER","ALL","18",3307,3163,6470
"41598","TANA RIVER","ALL","19",2598,2777,5375
"41599","TANA RIVER","ALL","15-19",16872,16060,32932
"41600","TANA RIVER","ALL","20",3315,3742,7057
"41601","TANA RIVER","ALL","21",2192,2515,4707
"41602","TANA RIVER","ALL","22",2639,2900,5539
"41603","TANA RIVER","ALL","23",2558,2601,5159
"41604","TANA RIVER","ALL","24",2254,2460,4714
"41605","TANA RIVER","ALL","20-24",12958,14218,27176
"41606","TANA RIVER","ALL","25",3229,3564,6793
"41607","TANA RIVER","ALL","26",2022,2160,4182
"41608","TANA RIVER","ALL","27",1879,2269,4148
"41609","TANA RIVER","ALL","28",1736,2098,3834
"41610","TANA RIVER","ALL","29",1554,1649,3203
"41611","TANA RIVER","ALL","25-29",10420,11740,22160
"41612","TANA RIVER","ALL","30",2976,3463,6439
"41613","TANA RIVER","ALL","31",1396,1597,2993
"41614","TANA RIVER","ALL","32",1706,1905,3611
"41615","TANA RIVER","ALL","33",1174,1402,2576
"41616","TANA RIVER","ALL","34",1176,1124,2300
"41617","TANA RIVER","ALL","30-34",8428,9491,17919
"41618","TANA RIVER","ALL","35",2486,2510,4996
"41619","TANA RIVER","ALL","36",1278,1284,2562
"41620","TANA RIVER","ALL","37",1296,1200,2496
"41621","TANA RIVER","ALL","38",939,902,1841
"41622","TANA RIVER","ALL","39",877,728,1605
"41623","TANA RIVER","ALL","35-39",6876,6624,13500
"41624","TANA RIVER","ALL","40",2197,2112,4309
"41625","TANA RIVER","ALL","41",1249,1276,2525
"41626","TANA RIVER","ALL","42",1026,884,1910
"41627","TANA RIVER","ALL","43",696,648,1344
"41628","TANA RIVER","ALL","44",605,467,1072
"41629","TANA RIVER","ALL","40-44",5773,5387,11160
"41630","TANA RIVER","ALL","45",1801,1855,3656
"41631","TANA RIVER","ALL","46",952,1040,1992
"41632","TANA RIVER","ALL","47",835,781,1616
"41633","TANA RIVER","ALL","48",663,576,1239
"41634","TANA RIVER","ALL","49",656,543,1199
"41635","TANA RIVER","ALL","45-49",4907,4795,9702
"41636","TANA RIVER","ALL","50",1426,1371,2797
"41637","TANA RIVER","ALL","51",538,547,1085
"41638","TANA RIVER","ALL","52",626,588,1214
"41639","TANA RIVER","ALL","53",483,396,879
"41640","TANA RIVER","ALL","54",570,548,1118
"41641","TANA RIVER","ALL","50-54",3643,3450,7093
"41642","TANA RIVER","ALL","55",681,548,1229
"41643","TANA RIVER","ALL","56",689,541,1230
"41644","TANA RIVER","ALL","57",606,617,1223
"41645","TANA RIVER","ALL","58",566,630,1196
"41646","TANA RIVER","ALL","59",581,591,1172
"41647","TANA RIVER","ALL","55-59",3123,2927,6050
"41648","TANA RIVER","ALL","60",1056,1151,2207
"41649","TANA RIVER","ALL","61",522,450,972
"41650","TANA RIVER","ALL","62",472,422,894
"41651","TANA RIVER","ALL","63",466,449,915
"41652","TANA RIVER","ALL","64",327,287,614
"41653","TANA RIVER","ALL","60-64",2843,2759,5602
"41654","TANA RIVER","ALL","65",545,631,1176
"41655","TANA RIVER","ALL","66",272,314,586
"41656","TANA RIVER","ALL","67",347,310,657
"41657","TANA RIVER","ALL","68",268,226,494
"41658","TANA RIVER","ALL","69",319,384,703
"41659","TANA RIVER","ALL","65-69",1751,1865,3616
"41660","TANA RIVER","ALL","70",611,815,1426
"41661","TANA RIVER","ALL","71",229,274,503
"41662","TANA RIVER","ALL","72",188,158,346
"41663","TANA RIVER","ALL","73",189,156,345
"41664","TANA RIVER","ALL","74",145,139,284
"41665","TANA RIVER","ALL","70-74",1362,1542,2904
"41666","TANA RIVER","ALL","75",205,232,437
"41667","TANA RIVER","ALL","76",135,139,274
"41668","TANA RIVER","ALL","77",113,86,199
"41669","TANA RIVER","ALL","78",115,82,197
"41670","TANA RIVER","ALL","79",140,115,255
"41671","TANA RIVER","ALL","75-79",708,654,1362
"41672","TANA RIVER","ALL","80",243,307,550
"41673","TANA RIVER","ALL","81",62,72,134
"41674","TANA RIVER","ALL","82",70,42,112
"41675","TANA RIVER","ALL","83",54,56,110
"41676","TANA RIVER","ALL","84",52,45,97
"41677","TANA RIVER","ALL","80-84",481,522,1003
"41678","TANA RIVER","ALL","85",82,64,146
"41679","TANA RIVER","ALL","86",38,33,71
"41680","TANA RIVER","ALL","87",53,46,99
"41681","TANA RIVER","ALL","88",36,14,50
"41682","TANA RIVER","ALL","89",46,72,118
"41683","TANA RIVER","ALL","85-89",255,229,484
"41684","TANA RIVER","ALL","90",53,95,148
"41685","TANA RIVER","ALL","91",11,29,40
"41686","TANA RIVER","ALL","92",9,14,23
"41687","TANA RIVER","ALL","93",9,13,22
"41688","TANA RIVER","ALL","94",7,4,11
"41689","TANA RIVER","ALL","90-94",89,155,244
"41690","TANA RIVER","ALL","95",11,22,33
"41691","TANA RIVER","ALL","96",8,11,19
"41692","TANA RIVER","ALL","97",3,10,13
"41693","TANA RIVER","ALL","98",6,10,16
"41694","TANA RIVER","ALL","99",9,14,23
"41695","TANA RIVER","ALL","95-99",37,67,104
"41696","TANA RIVER","ALL","100+",37,50,87
"41697","TANA RIVER","ALL","Not Stated",5,1,6
"41698","TANA RIVER","TANA DELTA","Total",55716,54924,110640
"41699","TANA RIVER","TANA DELTA","0",1725,1731,3456
"41700","TANA RIVER","TANA DELTA","1",1711,1603,3314
"41701","TANA RIVER","TANA DELTA","2",1932,1812,3744
"41702","TANA RIVER","TANA DELTA","3",1949,1858,3807
"41703","TANA RIVER","TANA DELTA","4",2168,1914,4082
"41704","TANA RIVER","TANA DELTA","0 - 4",9485,8918,18403
"41705","TANA RIVER","TANA DELTA","5",1985,1937,3922
"41706","TANA RIVER","TANA DELTA","6",1973,1956,3929
"41707","TANA RIVER","TANA DELTA","7",1952,1802,3754
"41708","TANA RIVER","TANA DELTA","8",1890,1751,3641
"41709","TANA RIVER","TANA DELTA","9",1709,1662,3371
"41710","TANA RIVER","TANA DELTA","5-9",9509,9108,18617
"41711","TANA RIVER","TANA DELTA","10",1990,1910,3900
"41712","TANA RIVER","TANA DELTA","11",1524,1482,3006
"41713","TANA RIVER","TANA DELTA","12",1870,1651,3521
"41714","TANA RIVER","TANA DELTA","13",1592,1610,3202
"41715","TANA RIVER","TANA DELTA","14",1480,1421,2901
"41716","TANA RIVER","TANA DELTA","10 -14",8456,8074,16530
"41717","TANA RIVER","TANA DELTA","15",1549,1430,2979
"41718","TANA RIVER","TANA DELTA","16",1234,1134,2368
"41719","TANA RIVER","TANA DELTA","17",1321,1118,2439
"41720","TANA RIVER","TANA DELTA","18",1236,1062,2298
"41721","TANA RIVER","TANA DELTA","19",1018,953,1971
"41722","TANA RIVER","TANA DELTA","15-19",6358,5697,12055
"41723","TANA RIVER","TANA DELTA","20",1096,1081,2177
"41724","TANA RIVER","TANA DELTA","21",770,902,1672
"41725","TANA RIVER","TANA DELTA","22",841,956,1797
"41726","TANA RIVER","TANA DELTA","23",826,794,1620
"41727","TANA RIVER","TANA DELTA","24",655,807,1462
"41728","TANA RIVER","TANA DELTA","20-24",4188,4540,8728
"41729","TANA RIVER","TANA DELTA","25",932,1054,1986
"41730","TANA RIVER","TANA DELTA","26",689,745,1434
"41731","TANA RIVER","TANA DELTA","27",596,701,1297
"41732","TANA RIVER","TANA DELTA","28",514,623,1137
"41733","TANA RIVER","TANA DELTA","29",563,560,1123
"41734","TANA RIVER","TANA DELTA","25-29",3294,3683,6977
"41735","TANA RIVER","TANA DELTA","30",807,954,1761
"41736","TANA RIVER","TANA DELTA","31",487,620,1107
"41737","TANA RIVER","TANA DELTA","32",577,703,1280
"41738","TANA RIVER","TANA DELTA","33",421,538,959
"41739","TANA RIVER","TANA DELTA","34",404,390,794
"41740","TANA RIVER","TANA DELTA","30-34",2696,3205,5901
"41741","TANA RIVER","TANA DELTA","35",730,807,1537
"41742","TANA RIVER","TANA DELTA","36",465,475,940
"41743","TANA RIVER","TANA DELTA","37",470,445,915
"41744","TANA RIVER","TANA DELTA","38",289,258,547
"41745","TANA RIVER","TANA DELTA","39",295,251,546
"41746","TANA RIVER","TANA DELTA","35-39",2249,2236,4485
"41747","TANA RIVER","TANA DELTA","40",605,612,1217
"41748","TANA RIVER","TANA DELTA","41",471,592,1063
"41749","TANA RIVER","TANA DELTA","42",359,328,687
"41750","TANA RIVER","TANA DELTA","43",251,258,509
"41751","TANA RIVER","TANA DELTA","44",219,185,404
"41752","TANA RIVER","TANA DELTA","40-44",1905,1975,3880
"41753","TANA RIVER","TANA DELTA","45",656,740,1396
"41754","TANA RIVER","TANA DELTA","46",383,448,831
"41755","TANA RIVER","TANA DELTA","47",365,362,727
"41756","TANA RIVER","TANA DELTA","48",255,236,491
"41757","TANA RIVER","TANA DELTA","49",277,225,502
"41758","TANA RIVER","TANA DELTA","45-49",1936,2011,3947
"41759","TANA RIVER","TANA DELTA","50",462,455,917
"41760","TANA RIVER","TANA DELTA","51",252,258,510
"41761","TANA RIVER","TANA DELTA","52",264,223,487
"41762","TANA RIVER","TANA DELTA","53",226,178,404
"41763","TANA RIVER","TANA DELTA","54",258,246,504
"41764","TANA RIVER","TANA DELTA","50-54",1462,1360,2822
"41765","TANA RIVER","TANA DELTA","55",198,185,383
"41766","TANA RIVER","TANA DELTA","56",307,241,548
"41767","TANA RIVER","TANA DELTA","57",227,230,457
"41768","TANA RIVER","TANA DELTA","58",213,239,452
"41769","TANA RIVER","TANA DELTA","59",248,246,494
"41770","TANA RIVER","TANA DELTA","55-59",1193,1141,2334
"41771","TANA RIVER","TANA DELTA","60",375,360,735
"41772","TANA RIVER","TANA DELTA","61",225,176,401
"41773","TANA RIVER","TANA DELTA","62",198,169,367
"41774","TANA RIVER","TANA DELTA","63",214,196,410
"41775","TANA RIVER","TANA DELTA","64",129,111,240
"41776","TANA RIVER","TANA DELTA","60-64",1141,1012,2153
"41777","TANA RIVER","TANA DELTA","65",196,259,455
"41778","TANA RIVER","TANA DELTA","66",114,113,227
"41779","TANA RIVER","TANA DELTA","67",130,133,263
"41780","TANA RIVER","TANA DELTA","68",116,91,207
"41781","TANA RIVER","TANA DELTA","69",141,176,317
"41782","TANA RIVER","TANA DELTA","65-69",697,772,1469
"41783","TANA RIVER","TANA DELTA","70",190,269,459
"41784","TANA RIVER","TANA DELTA","71",97,110,207
"41785","TANA RIVER","TANA DELTA","72",90,69,159
"41786","TANA RIVER","TANA DELTA","73",93,83,176
"41787","TANA RIVER","TANA DELTA","74",53,46,99
"41788","TANA RIVER","TANA DELTA","70-74",523,577,1100
"41789","TANA RIVER","TANA DELTA","75",73,74,147
"41790","TANA RIVER","TANA DELTA","76",59,49,108
"41791","TANA RIVER","TANA DELTA","77",48,41,89
"41792","TANA RIVER","TANA DELTA","78",39,31,70
"41793","TANA RIVER","TANA DELTA","79",68,63,131
"41794","TANA RIVER","TANA DELTA","75-79",287,258,545
"41795","TANA RIVER","TANA DELTA","80",83,86,169
"41796","TANA RIVER","TANA DELTA","81",23,29,52
"41797","TANA RIVER","TANA DELTA","82",29,11,40
"41798","TANA RIVER","TANA DELTA","83",23,25,48
"41799","TANA RIVER","TANA DELTA","84",22,19,41
"41800","TANA RIVER","TANA DELTA","80-84",180,170,350
"41801","TANA RIVER","TANA DELTA","85",26,21,47
"41802","TANA RIVER","TANA DELTA","86",17,15,32
"41803","TANA RIVER","TANA DELTA","87",24,19,43
"41804","TANA RIVER","TANA DELTA","88",16,7,23
"41805","TANA RIVER","TANA DELTA","89",15,29,44
"41806","TANA RIVER","TANA DELTA","85-89",98,91,189
"41807","TANA RIVER","TANA DELTA","90",16,29,45
"41808","TANA RIVER","TANA DELTA","91",3,12,15
"41809","TANA RIVER","TANA DELTA","92",2,7,9
"41810","TANA RIVER","TANA DELTA","93",4,9,13
"41811","TANA RIVER","TANA DELTA","94",2,2,4
"41812","TANA RIVER","TANA DELTA","90-94",27,59,86
"41813","TANA RIVER","TANA DELTA","95",7,6,13
"41814","TANA RIVER","TANA DELTA","96",3,6,9
"41815","TANA RIVER","TANA DELTA","97",1,4,5
"41816","TANA RIVER","TANA DELTA","98",2,3,5
"41817","TANA RIVER","TANA DELTA","99",5,7,12
"41818","TANA RIVER","TANA DELTA","95-99",18,26,44
"41819","TANA RIVER","TANA DELTA","100+",11,11,22
"41820","TANA RIVER","TANA DELTA","Not Stated",3,NA,3
"41821","TANA RIVER","TANA NORTH","Total",59123,57632,116755
"41822","TANA RIVER","TANA NORTH","0",1724,1658,3382
"41823","TANA RIVER","TANA NORTH","1",1769,1650,3419
"41824","TANA RIVER","TANA NORTH","2",2172,1996,4168
"41825","TANA RIVER","TANA NORTH","3",2096,2135,4231
"41826","TANA RIVER","TANA NORTH","4",2220,2182,4402
"41827","TANA RIVER","TANA NORTH","0 - 4",9981,9621,19602
"41828","TANA RIVER","TANA NORTH","5",2137,2011,4148
"41829","TANA RIVER","TANA NORTH","6",2158,2137,4295
"41830","TANA RIVER","TANA NORTH","7",1956,1746,3702
"41831","TANA RIVER","TANA NORTH","8",2169,2013,4182
"41832","TANA RIVER","TANA NORTH","9",1514,1518,3032
"41833","TANA RIVER","TANA NORTH","5-9",9934,9425,19359
"41834","TANA RIVER","TANA NORTH","10",2320,2188,4508
"41835","TANA RIVER","TANA NORTH","11",1310,1257,2567
"41836","TANA RIVER","TANA NORTH","12",1951,1848,3799
"41837","TANA RIVER","TANA NORTH","13",1577,1498,3075
"41838","TANA RIVER","TANA NORTH","14",1452,1461,2913
"41839","TANA RIVER","TANA NORTH","10 -14",8610,8252,16862
"41840","TANA RIVER","TANA NORTH","15",1499,1463,2962
"41841","TANA RIVER","TANA NORTH","16",1240,1174,2414
"41842","TANA RIVER","TANA NORTH","17",1128,1014,2142
"41843","TANA RIVER","TANA NORTH","18",1272,1234,2506
"41844","TANA RIVER","TANA NORTH","19",856,1000,1856
"41845","TANA RIVER","TANA NORTH","15-19",5995,5885,11880
"41846","TANA RIVER","TANA NORTH","20",1399,1653,3052
"41847","TANA RIVER","TANA NORTH","21",869,852,1721
"41848","TANA RIVER","TANA NORTH","22",1085,1145,2230
"41849","TANA RIVER","TANA NORTH","23",1021,951,1972
"41850","TANA RIVER","TANA NORTH","24",938,925,1863
"41851","TANA RIVER","TANA NORTH","20-24",5312,5526,10838
"41852","TANA RIVER","TANA NORTH","25",1402,1453,2855
"41853","TANA RIVER","TANA NORTH","26",748,795,1543
"41854","TANA RIVER","TANA NORTH","27",732,856,1588
"41855","TANA RIVER","TANA NORTH","28",749,851,1600
"41856","TANA RIVER","TANA NORTH","29",539,604,1143
"41857","TANA RIVER","TANA NORTH","25-29",4170,4559,8729
"41858","TANA RIVER","TANA NORTH","30",1413,1632,3045
"41859","TANA RIVER","TANA NORTH","31",565,557,1122
"41860","TANA RIVER","TANA NORTH","32",709,768,1477
"41861","TANA RIVER","TANA NORTH","33",437,497,934
"41862","TANA RIVER","TANA NORTH","34",454,402,856
"41863","TANA RIVER","TANA NORTH","30-34",3578,3856,7434
"41864","TANA RIVER","TANA NORTH","35",1100,994,2094
"41865","TANA RIVER","TANA NORTH","36",443,425,868
"41866","TANA RIVER","TANA NORTH","37",495,394,889
"41867","TANA RIVER","TANA NORTH","38",386,374,760
"41868","TANA RIVER","TANA NORTH","39",324,252,576
"41869","TANA RIVER","TANA NORTH","35-39",2748,2439,5187
"41870","TANA RIVER","TANA NORTH","40",1052,986,2038
"41871","TANA RIVER","TANA NORTH","41",434,345,779
"41872","TANA RIVER","TANA NORTH","42",381,319,700
"41873","TANA RIVER","TANA NORTH","43",257,217,474
"41874","TANA RIVER","TANA NORTH","44",230,150,380
"41875","TANA RIVER","TANA NORTH","40-44",2354,2017,4371
"41876","TANA RIVER","TANA NORTH","45",667,578,1245
"41877","TANA RIVER","TANA NORTH","46",310,262,572
"41878","TANA RIVER","TANA NORTH","47",209,221,430
"41879","TANA RIVER","TANA NORTH","48",230,175,405
"41880","TANA RIVER","TANA NORTH","49",205,165,370
"41881","TANA RIVER","TANA NORTH","45-49",1621,1401,3022
"41882","TANA RIVER","TANA NORTH","50",614,588,1202
"41883","TANA RIVER","TANA NORTH","51",145,149,294
"41884","TANA RIVER","TANA NORTH","52",214,189,403
"41885","TANA RIVER","TANA NORTH","53",131,110,241
"41886","TANA RIVER","TANA NORTH","54",171,134,305
"41887","TANA RIVER","TANA NORTH","50-54",1275,1170,2445
"41888","TANA RIVER","TANA NORTH","55",266,210,476
"41889","TANA RIVER","TANA NORTH","56",203,149,352
"41890","TANA RIVER","TANA NORTH","57",205,157,362
"41891","TANA RIVER","TANA NORTH","58",172,173,345
"41892","TANA RIVER","TANA NORTH","59",154,156,310
"41893","TANA RIVER","TANA NORTH","55-59",1000,845,1845
"41894","TANA RIVER","TANA NORTH","60",434,481,915
"41895","TANA RIVER","TANA NORTH","61",144,113,257
"41896","TANA RIVER","TANA NORTH","62",151,133,284
"41897","TANA RIVER","TANA NORTH","63",130,107,237
"41898","TANA RIVER","TANA NORTH","64",118,88,206
"41899","TANA RIVER","TANA NORTH","60-64",977,922,1899
"41900","TANA RIVER","TANA NORTH","65",197,212,409
"41901","TANA RIVER","TANA NORTH","66",88,99,187
"41902","TANA RIVER","TANA NORTH","67",109,86,195
"41903","TANA RIVER","TANA NORTH","68",76,72,148
"41904","TANA RIVER","TANA NORTH","69",84,104,188
"41905","TANA RIVER","TANA NORTH","65-69",554,573,1127
"41906","TANA RIVER","TANA NORTH","70",266,351,617
"41907","TANA RIVER","TANA NORTH","71",56,65,121
"41908","TANA RIVER","TANA NORTH","72",51,39,90
"41909","TANA RIVER","TANA NORTH","73",52,27,79
"41910","TANA RIVER","TANA NORTH","74",44,48,92
"41911","TANA RIVER","TANA NORTH","70-74",469,530,999
"41912","TANA RIVER","TANA NORTH","75",75,95,170
"41913","TANA RIVER","TANA NORTH","76",33,37,70
"41914","TANA RIVER","TANA NORTH","77",37,17,54
"41915","TANA RIVER","TANA NORTH","78",40,25,65
"41916","TANA RIVER","TANA NORTH","79",29,20,49
"41917","TANA RIVER","TANA NORTH","75-79",214,194,408
"41918","TANA RIVER","TANA NORTH","80",105,153,258
"41919","TANA RIVER","TANA NORTH","81",14,14,28
"41920","TANA RIVER","TANA NORTH","82",26,15,41
"41921","TANA RIVER","TANA NORTH","83",16,20,36
"41922","TANA RIVER","TANA NORTH","84",19,12,31
"41923","TANA RIVER","TANA NORTH","80-84",180,214,394
"41924","TANA RIVER","TANA NORTH","85",33,26,59
"41925","TANA RIVER","TANA NORTH","86",8,11,19
"41926","TANA RIVER","TANA NORTH","87",17,13,30
"41927","TANA RIVER","TANA NORTH","88",7,4,11
"41928","TANA RIVER","TANA NORTH","89",17,25,42
"41929","TANA RIVER","TANA NORTH","85-89",82,79,161
"41930","TANA RIVER","TANA NORTH","90",28,51,79
"41931","TANA RIVER","TANA NORTH","91",5,11,16
"41932","TANA RIVER","TANA NORTH","92",5,6,11
"41933","TANA RIVER","TANA NORTH","93",3,2,5
"41934","TANA RIVER","TANA NORTH","94",1,2,3
"41935","TANA RIVER","TANA NORTH","90-94",42,72,114
"41936","TANA RIVER","TANA NORTH","95",NA,10,10
"41937","TANA RIVER","TANA NORTH","96",3,5,8
"41938","TANA RIVER","TANA NORTH","97",2,4,6
"41939","TANA RIVER","TANA NORTH","98",3,4,7
"41940","TANA RIVER","TANA NORTH","99",1,2,3
"41941","TANA RIVER","TANA NORTH","95-99",9,25,34
"41942","TANA RIVER","TANA NORTH","100+",17,27,44
"41943","TANA RIVER","TANA NORTH","Not Stated",1,NA,1
"41944","TANA RIVER","TANA RIVER","Total",43711,44835,88546
"41945","TANA RIVER","TANA RIVER","0",1418,1386,2804
"41946","TANA RIVER","TANA RIVER","1",1454,1347,2801
"41947","TANA RIVER","TANA RIVER","2",1535,1509,3044
"41948","TANA RIVER","TANA RIVER","3",1618,1580,3198
"41949","TANA RIVER","TANA RIVER","4",1681,1645,3326
"41950","TANA RIVER","TANA RIVER","0 - 4",7706,7467,15173
"41951","TANA RIVER","TANA RIVER","5",1675,1576,3251
"41952","TANA RIVER","TANA RIVER","6",1637,1553,3190
"41953","TANA RIVER","TANA RIVER","7",1623,1478,3101
"41954","TANA RIVER","TANA RIVER","8",1449,1497,2946
"41955","TANA RIVER","TANA RIVER","9",1264,1241,2505
"41956","TANA RIVER","TANA RIVER","5-9",7648,7345,14993
"41957","TANA RIVER","TANA RIVER","10",1609,1689,3298
"41958","TANA RIVER","TANA RIVER","11",1131,1151,2282
"41959","TANA RIVER","TANA RIVER","12",1518,1450,2968
"41960","TANA RIVER","TANA RIVER","13",1189,1249,2438
"41961","TANA RIVER","TANA RIVER","14",1206,1106,2312
"41962","TANA RIVER","TANA RIVER","10 -14",6653,6645,13298
"41963","TANA RIVER","TANA RIVER","15",1217,1156,2373
"41964","TANA RIVER","TANA RIVER","16",876,828,1704
"41965","TANA RIVER","TANA RIVER","17",903,803,1706
"41966","TANA RIVER","TANA RIVER","18",799,867,1666
"41967","TANA RIVER","TANA RIVER","19",724,824,1548
"41968","TANA RIVER","TANA RIVER","15-19",4519,4478,8997
"41969","TANA RIVER","TANA RIVER","20",820,1008,1828
"41970","TANA RIVER","TANA RIVER","21",553,761,1314
"41971","TANA RIVER","TANA RIVER","22",713,799,1512
"41972","TANA RIVER","TANA RIVER","23",711,856,1567
"41973","TANA RIVER","TANA RIVER","24",661,728,1389
"41974","TANA RIVER","TANA RIVER","20-24",3458,4152,7610
"41975","TANA RIVER","TANA RIVER","25",895,1057,1952
"41976","TANA RIVER","TANA RIVER","26",585,620,1205
"41977","TANA RIVER","TANA RIVER","27",551,712,1263
"41978","TANA RIVER","TANA RIVER","28",473,624,1097
"41979","TANA RIVER","TANA RIVER","29",452,485,937
"41980","TANA RIVER","TANA RIVER","25-29",2956,3498,6454
"41981","TANA RIVER","TANA RIVER","30",756,877,1633
"41982","TANA RIVER","TANA RIVER","31",344,420,764
"41983","TANA RIVER","TANA RIVER","32",420,434,854
"41984","TANA RIVER","TANA RIVER","33",316,367,683
"41985","TANA RIVER","TANA RIVER","34",318,332,650
"41986","TANA RIVER","TANA RIVER","30-34",2154,2430,4584
"41987","TANA RIVER","TANA RIVER","35",656,709,1365
"41988","TANA RIVER","TANA RIVER","36",370,384,754
"41989","TANA RIVER","TANA RIVER","37",331,361,692
"41990","TANA RIVER","TANA RIVER","38",264,270,534
"41991","TANA RIVER","TANA RIVER","39",258,225,483
"41992","TANA RIVER","TANA RIVER","35-39",1879,1949,3828
"41993","TANA RIVER","TANA RIVER","40",540,514,1054
"41994","TANA RIVER","TANA RIVER","41",344,339,683
"41995","TANA RIVER","TANA RIVER","42",286,237,523
"41996","TANA RIVER","TANA RIVER","43",188,173,361
"41997","TANA RIVER","TANA RIVER","44",156,132,288
"41998","TANA RIVER","TANA RIVER","40-44",1514,1395,2909
"41999","TANA RIVER","TANA RIVER","45",478,537,1015
"42000","TANA RIVER","TANA RIVER","46",259,330,589
"42001","TANA RIVER","TANA RIVER","47",261,198,459
"42002","TANA RIVER","TANA RIVER","48",178,165,343
"42003","TANA RIVER","TANA RIVER","49",174,153,327
"42004","TANA RIVER","TANA RIVER","45-49",1350,1383,2733
"42005","TANA RIVER","TANA RIVER","50",350,328,678
"42006","TANA RIVER","TANA RIVER","51",141,140,281
"42007","TANA RIVER","TANA RIVER","52",148,176,324
"42008","TANA RIVER","TANA RIVER","53",126,108,234
"42009","TANA RIVER","TANA RIVER","54",141,168,309
"42010","TANA RIVER","TANA RIVER","50-54",906,920,1826
"42011","TANA RIVER","TANA RIVER","55",217,153,370
"42012","TANA RIVER","TANA RIVER","56",179,151,330
"42013","TANA RIVER","TANA RIVER","57",174,230,404
"42014","TANA RIVER","TANA RIVER","58",181,218,399
"42015","TANA RIVER","TANA RIVER","59",179,189,368
"42016","TANA RIVER","TANA RIVER","55-59",930,941,1871
"42017","TANA RIVER","TANA RIVER","60",247,310,557
"42018","TANA RIVER","TANA RIVER","61",153,161,314
"42019","TANA RIVER","TANA RIVER","62",123,120,243
"42020","TANA RIVER","TANA RIVER","63",122,146,268
"42021","TANA RIVER","TANA RIVER","64",80,88,168
"42022","TANA RIVER","TANA RIVER","60-64",725,825,1550
"42023","TANA RIVER","TANA RIVER","65",152,160,312
"42024","TANA RIVER","TANA RIVER","66",70,102,172
"42025","TANA RIVER","TANA RIVER","67",108,91,199
"42026","TANA RIVER","TANA RIVER","68",76,63,139
"42027","TANA RIVER","TANA RIVER","69",94,104,198
"42028","TANA RIVER","TANA RIVER","65-69",500,520,1020
"42029","TANA RIVER","TANA RIVER","70",155,195,350
"42030","TANA RIVER","TANA RIVER","71",76,99,175
"42031","TANA RIVER","TANA RIVER","72",47,50,97
"42032","TANA RIVER","TANA RIVER","73",44,46,90
"42033","TANA RIVER","TANA RIVER","74",48,45,93
"42034","TANA RIVER","TANA RIVER","70-74",370,435,805
"42035","TANA RIVER","TANA RIVER","75",57,63,120
"42036","TANA RIVER","TANA RIVER","76",43,53,96
"42037","TANA RIVER","TANA RIVER","77",28,28,56
"42038","TANA RIVER","TANA RIVER","78",36,26,62
"42039","TANA RIVER","TANA RIVER","79",43,32,75
"42040","TANA RIVER","TANA RIVER","75-79",207,202,409
"42041","TANA RIVER","TANA RIVER","80",55,68,123
"42042","TANA RIVER","TANA RIVER","81",25,29,54
"42043","TANA RIVER","TANA RIVER","82",15,16,31
"42044","TANA RIVER","TANA RIVER","83",15,11,26
"42045","TANA RIVER","TANA RIVER","84",11,14,25
"42046","TANA RIVER","TANA RIVER","80-84",121,138,259
"42047","TANA RIVER","TANA RIVER","85",23,17,40
"42048","TANA RIVER","TANA RIVER","86",13,7,20
"42049","TANA RIVER","TANA RIVER","87",12,14,26
"42050","TANA RIVER","TANA RIVER","88",13,3,16
"42051","TANA RIVER","TANA RIVER","89",14,18,32
"42052","TANA RIVER","TANA RIVER","85-89",75,59,134
"42053","TANA RIVER","TANA RIVER","90",9,15,24
"42054","TANA RIVER","TANA RIVER","91",3,6,9
"42055","TANA RIVER","TANA RIVER","92",2,1,3
"42056","TANA RIVER","TANA RIVER","93",2,2,4
"42057","TANA RIVER","TANA RIVER","94",4,NA,4
"42058","TANA RIVER","TANA RIVER","90-94",20,24,44
"42059","TANA RIVER","TANA RIVER","95",4,6,10
"42060","TANA RIVER","TANA RIVER","96",2,NA,2
"42061","TANA RIVER","TANA RIVER","97",NA,2,2
"42062","TANA RIVER","TANA RIVER","98",1,3,4
"42063","TANA RIVER","TANA RIVER","99",3,5,8
"42064","TANA RIVER","TANA RIVER","95-99",10,16,26
"42065","TANA RIVER","TANA RIVER","100+",9,12,21
"42066","TANA RIVER","TANA RIVER","Not Stated",1,1,2
"42067","THARAKA-NITHI","ALL","Total",193764,199406,393170
"42068","THARAKA-NITHI","ALL","0",3902,3889,7791
"42069","THARAKA-NITHI","ALL","1",3951,3974,7925
"42070","THARAKA-NITHI","ALL","2",4091,4017,8108
"42071","THARAKA-NITHI","ALL","3",4143,4257,8400
"42072","THARAKA-NITHI","ALL","4",4082,4078,8160
"42073","THARAKA-NITHI","ALL","0 - 4",20169,20215,40384
"42074","THARAKA-NITHI","ALL","5",4272,4140,8412
"42075","THARAKA-NITHI","ALL","6",4175,4220,8395
"42076","THARAKA-NITHI","ALL","7",4382,4269,8651
"42077","THARAKA-NITHI","ALL","8",4302,4311,8613
"42078","THARAKA-NITHI","ALL","9",4583,4548,9131
"42079","THARAKA-NITHI","ALL","5-9",21714,21488,43202
"42080","THARAKA-NITHI","ALL","10",4811,4628,9439
"42081","THARAKA-NITHI","ALL","11",4447,4544,8991
"42082","THARAKA-NITHI","ALL","12",5048,4960,10008
"42083","THARAKA-NITHI","ALL","13",5045,4998,10043
"42084","THARAKA-NITHI","ALL","14",4889,4754,9643
"42085","THARAKA-NITHI","ALL","10 -14",24240,23884,48124
"42086","THARAKA-NITHI","ALL","15",4656,4716,9372
"42087","THARAKA-NITHI","ALL","16",4489,4589,9078
"42088","THARAKA-NITHI","ALL","17",4662,4333,8995
"42089","THARAKA-NITHI","ALL","18",3811,3667,7478
"42090","THARAKA-NITHI","ALL","19",3930,3848,7778
"42091","THARAKA-NITHI","ALL","15-19",21548,21153,42701
"42092","THARAKA-NITHI","ALL","20",3395,3590,6985
"42093","THARAKA-NITHI","ALL","21",3074,3132,6206
"42094","THARAKA-NITHI","ALL","22",2978,3144,6122
"42095","THARAKA-NITHI","ALL","23",3100,3394,6494
"42096","THARAKA-NITHI","ALL","24",2839,2996,5835
"42097","THARAKA-NITHI","ALL","20-24",15386,16256,31642
"42098","THARAKA-NITHI","ALL","25",3054,3045,6099
"42099","THARAKA-NITHI","ALL","26",2490,2655,5145
"42100","THARAKA-NITHI","ALL","27",2691,2835,5526
"42101","THARAKA-NITHI","ALL","28",2243,2463,4706
"42102","THARAKA-NITHI","ALL","29",2582,2791,5373
"42103","THARAKA-NITHI","ALL","25-29",13060,13789,26849
"42104","THARAKA-NITHI","ALL","30",3136,3556,6692
"42105","THARAKA-NITHI","ALL","31",2481,2441,4922
"42106","THARAKA-NITHI","ALL","32",2846,3195,6041
"42107","THARAKA-NITHI","ALL","33",2656,2958,5614
"42108","THARAKA-NITHI","ALL","34",2175,2468,4643
"42109","THARAKA-NITHI","ALL","30-34",13294,14618,27912
"42110","THARAKA-NITHI","ALL","35",3218,3356,6574
"42111","THARAKA-NITHI","ALL","36",2226,2256,4482
"42112","THARAKA-NITHI","ALL","37",2376,2261,4637
"42113","THARAKA-NITHI","ALL","38",1941,1968,3909
"42114","THARAKA-NITHI","ALL","39",2379,2442,4821
"42115","THARAKA-NITHI","ALL","35-39",12140,12283,24423
"42116","THARAKA-NITHI","ALL","40",2712,2641,5353
"42117","THARAKA-NITHI","ALL","41",2336,2146,4482
"42118","THARAKA-NITHI","ALL","42",2130,2029,4159
"42119","THARAKA-NITHI","ALL","43",1857,1934,3791
"42120","THARAKA-NITHI","ALL","44",1714,1749,3463
"42121","THARAKA-NITHI","ALL","40-44",10749,10499,21248
"42122","THARAKA-NITHI","ALL","45",2447,2589,5036
"42123","THARAKA-NITHI","ALL","46",2102,2143,4245
"42124","THARAKA-NITHI","ALL","47",1953,1950,3903
"42125","THARAKA-NITHI","ALL","48",1535,1516,3051
"42126","THARAKA-NITHI","ALL","49",1858,1897,3755
"42127","THARAKA-NITHI","ALL","45-49",9895,10095,19990
"42128","THARAKA-NITHI","ALL","50",1956,2111,4067
"42129","THARAKA-NITHI","ALL","51",1583,1470,3053
"42130","THARAKA-NITHI","ALL","52",1211,1069,2280
"42131","THARAKA-NITHI","ALL","53",960,933,1893
"42132","THARAKA-NITHI","ALL","54",1302,1154,2456
"42133","THARAKA-NITHI","ALL","50-54",7012,6737,13749
"42134","THARAKA-NITHI","ALL","55",1449,1319,2768
"42135","THARAKA-NITHI","ALL","56",1599,1522,3121
"42136","THARAKA-NITHI","ALL","57",1215,1468,2683
"42137","THARAKA-NITHI","ALL","58",1195,1261,2456
"42138","THARAKA-NITHI","ALL","59",1406,1480,2886
"42139","THARAKA-NITHI","ALL","55-59",6864,7050,13914
"42140","THARAKA-NITHI","ALL","60",1676,1705,3381
"42141","THARAKA-NITHI","ALL","61",1197,1226,2423
"42142","THARAKA-NITHI","ALL","62",1042,975,2017
"42143","THARAKA-NITHI","ALL","63",937,999,1936
"42144","THARAKA-NITHI","ALL","64",679,671,1350
"42145","THARAKA-NITHI","ALL","60-64",5531,5576,11107
"42146","THARAKA-NITHI","ALL","65",1014,1168,2182
"42147","THARAKA-NITHI","ALL","66",707,728,1435
"42148","THARAKA-NITHI","ALL","67",1191,1234,2425
"42149","THARAKA-NITHI","ALL","68",578,619,1197
"42150","THARAKA-NITHI","ALL","69",855,1099,1954
"42151","THARAKA-NITHI","ALL","65-69",4345,4848,9193
"42152","THARAKA-NITHI","ALL","70",1107,1539,2646
"42153","THARAKA-NITHI","ALL","71",807,900,1707
"42154","THARAKA-NITHI","ALL","72",574,667,1241
"42155","THARAKA-NITHI","ALL","73",415,545,960
"42156","THARAKA-NITHI","ALL","74",462,644,1106
"42157","THARAKA-NITHI","ALL","70-74",3365,4295,7660
"42158","THARAKA-NITHI","ALL","75",435,517,952
"42159","THARAKA-NITHI","ALL","76",289,352,641
"42160","THARAKA-NITHI","ALL","77",431,539,970
"42161","THARAKA-NITHI","ALL","78",278,277,555
"42162","THARAKA-NITHI","ALL","79",347,618,965
"42163","THARAKA-NITHI","ALL","75-79",1780,2303,4083
"42164","THARAKA-NITHI","ALL","80",474,714,1188
"42165","THARAKA-NITHI","ALL","81",205,373,578
"42166","THARAKA-NITHI","ALL","82",180,196,376
"42167","THARAKA-NITHI","ALL","83",232,286,518
"42168","THARAKA-NITHI","ALL","84",180,305,485
"42169","THARAKA-NITHI","ALL","80-84",1271,1874,3145
"42170","THARAKA-NITHI","ALL","85",173,257,430
"42171","THARAKA-NITHI","ALL","86",125,152,277
"42172","THARAKA-NITHI","ALL","87",174,247,421
"42173","THARAKA-NITHI","ALL","88",96,115,211
"42174","THARAKA-NITHI","ALL","89",209,437,646
"42175","THARAKA-NITHI","ALL","85-89",777,1208,1985
"42176","THARAKA-NITHI","ALL","90",96,206,302
"42177","THARAKA-NITHI","ALL","91",83,155,238
"42178","THARAKA-NITHI","ALL","92",39,64,103
"42179","THARAKA-NITHI","ALL","93",42,69,111
"42180","THARAKA-NITHI","ALL","94",51,76,127
"42181","THARAKA-NITHI","ALL","90-94",311,570,881
"42182","THARAKA-NITHI","ALL","95",46,87,133
"42183","THARAKA-NITHI","ALL","96",20,51,71
"42184","THARAKA-NITHI","ALL","97",70,83,153
"42185","THARAKA-NITHI","ALL","98",26,45,71
"42186","THARAKA-NITHI","ALL","99",59,151,210
"42187","THARAKA-NITHI","ALL","95-99",221,417,638
"42188","THARAKA-NITHI","ALL","100+",87,243,330
"42189","THARAKA-NITHI","ALL","Not Stated",5,5,10
"42190","THARAKA-NITHI","IGAMBANG'OMBE","Total",26464,26745,53209
"42191","THARAKA-NITHI","IGAMBANG'OMBE","0",571,575,1146
"42192","THARAKA-NITHI","IGAMBANG'OMBE","1",552,565,1117
"42193","THARAKA-NITHI","IGAMBANG'OMBE","2",620,559,1179
"42194","THARAKA-NITHI","IGAMBANG'OMBE","3",583,610,1193
"42195","THARAKA-NITHI","IGAMBANG'OMBE","4",602,594,1196
"42196","THARAKA-NITHI","IGAMBANG'OMBE","0 - 4",2928,2903,5831
"42197","THARAKA-NITHI","IGAMBANG'OMBE","5",642,608,1250
"42198","THARAKA-NITHI","IGAMBANG'OMBE","6",631,609,1240
"42199","THARAKA-NITHI","IGAMBANG'OMBE","7",596,631,1227
"42200","THARAKA-NITHI","IGAMBANG'OMBE","8",627,630,1257
"42201","THARAKA-NITHI","IGAMBANG'OMBE","9",635,604,1239
"42202","THARAKA-NITHI","IGAMBANG'OMBE","5-9",3131,3082,6213
"42203","THARAKA-NITHI","IGAMBANG'OMBE","10",753,692,1445
"42204","THARAKA-NITHI","IGAMBANG'OMBE","11",692,651,1343
"42205","THARAKA-NITHI","IGAMBANG'OMBE","12",714,706,1420
"42206","THARAKA-NITHI","IGAMBANG'OMBE","13",749,772,1521
"42207","THARAKA-NITHI","IGAMBANG'OMBE","14",723,647,1370
"42208","THARAKA-NITHI","IGAMBANG'OMBE","10 -14",3631,3468,7099
"42209","THARAKA-NITHI","IGAMBANG'OMBE","15",741,682,1423
"42210","THARAKA-NITHI","IGAMBANG'OMBE","16",650,670,1320
"42211","THARAKA-NITHI","IGAMBANG'OMBE","17",657,598,1255
"42212","THARAKA-NITHI","IGAMBANG'OMBE","18",471,503,974
"42213","THARAKA-NITHI","IGAMBANG'OMBE","19",526,526,1052
"42214","THARAKA-NITHI","IGAMBANG'OMBE","15-19",3045,2979,6024
"42215","THARAKA-NITHI","IGAMBANG'OMBE","20",438,496,934
"42216","THARAKA-NITHI","IGAMBANG'OMBE","21",400,387,787
"42217","THARAKA-NITHI","IGAMBANG'OMBE","22",380,393,773
"42218","THARAKA-NITHI","IGAMBANG'OMBE","23",385,423,808
"42219","THARAKA-NITHI","IGAMBANG'OMBE","24",354,389,743
"42220","THARAKA-NITHI","IGAMBANG'OMBE","20-24",1957,2088,4045
"42221","THARAKA-NITHI","IGAMBANG'OMBE","25",436,414,850
"42222","THARAKA-NITHI","IGAMBANG'OMBE","26",301,326,627
"42223","THARAKA-NITHI","IGAMBANG'OMBE","27",366,373,739
"42224","THARAKA-NITHI","IGAMBANG'OMBE","28",307,305,612
"42225","THARAKA-NITHI","IGAMBANG'OMBE","29",351,375,726
"42226","THARAKA-NITHI","IGAMBANG'OMBE","25-29",1761,1793,3554
"42227","THARAKA-NITHI","IGAMBANG'OMBE","30",436,479,915
"42228","THARAKA-NITHI","IGAMBANG'OMBE","31",326,318,644
"42229","THARAKA-NITHI","IGAMBANG'OMBE","32",424,440,864
"42230","THARAKA-NITHI","IGAMBANG'OMBE","33",356,406,762
"42231","THARAKA-NITHI","IGAMBANG'OMBE","34",294,333,627
"42232","THARAKA-NITHI","IGAMBANG'OMBE","30-34",1836,1976,3812
"42233","THARAKA-NITHI","IGAMBANG'OMBE","35",380,436,816
"42234","THARAKA-NITHI","IGAMBANG'OMBE","36",260,272,532
"42235","THARAKA-NITHI","IGAMBANG'OMBE","37",330,253,583
"42236","THARAKA-NITHI","IGAMBANG'OMBE","38",247,244,491
"42237","THARAKA-NITHI","IGAMBANG'OMBE","39",292,301,593
"42238","THARAKA-NITHI","IGAMBANG'OMBE","35-39",1509,1506,3015
"42239","THARAKA-NITHI","IGAMBANG'OMBE","40",338,319,657
"42240","THARAKA-NITHI","IGAMBANG'OMBE","41",311,230,541
"42241","THARAKA-NITHI","IGAMBANG'OMBE","42",271,247,518
"42242","THARAKA-NITHI","IGAMBANG'OMBE","43",230,195,425
"42243","THARAKA-NITHI","IGAMBANG'OMBE","44",208,186,394
"42244","THARAKA-NITHI","IGAMBANG'OMBE","40-44",1358,1177,2535
"42245","THARAKA-NITHI","IGAMBANG'OMBE","45",293,355,648
"42246","THARAKA-NITHI","IGAMBANG'OMBE","46",258,249,507
"42247","THARAKA-NITHI","IGAMBANG'OMBE","47",225,245,470
"42248","THARAKA-NITHI","IGAMBANG'OMBE","48",196,191,387
"42249","THARAKA-NITHI","IGAMBANG'OMBE","49",250,215,465
"42250","THARAKA-NITHI","IGAMBANG'OMBE","45-49",1222,1255,2477
"42251","THARAKA-NITHI","IGAMBANG'OMBE","50",267,263,530
"42252","THARAKA-NITHI","IGAMBANG'OMBE","51",183,189,372
"42253","THARAKA-NITHI","IGAMBANG'OMBE","52",139,133,272
"42254","THARAKA-NITHI","IGAMBANG'OMBE","53",136,123,259
"42255","THARAKA-NITHI","IGAMBANG'OMBE","54",132,136,268
"42256","THARAKA-NITHI","IGAMBANG'OMBE","50-54",857,844,1701
"42257","THARAKA-NITHI","IGAMBANG'OMBE","55",189,152,341
"42258","THARAKA-NITHI","IGAMBANG'OMBE","56",213,210,423
"42259","THARAKA-NITHI","IGAMBANG'OMBE","57",146,187,333
"42260","THARAKA-NITHI","IGAMBANG'OMBE","58",143,147,290
"42261","THARAKA-NITHI","IGAMBANG'OMBE","59",139,173,312
"42262","THARAKA-NITHI","IGAMBANG'OMBE","55-59",830,869,1699
"42263","THARAKA-NITHI","IGAMBANG'OMBE","60",189,209,398
"42264","THARAKA-NITHI","IGAMBANG'OMBE","61",139,121,260
"42265","THARAKA-NITHI","IGAMBANG'OMBE","62",163,124,287
"42266","THARAKA-NITHI","IGAMBANG'OMBE","63",120,135,255
"42267","THARAKA-NITHI","IGAMBANG'OMBE","64",92,70,162
"42268","THARAKA-NITHI","IGAMBANG'OMBE","60-64",703,659,1362
"42269","THARAKA-NITHI","IGAMBANG'OMBE","65",135,172,307
"42270","THARAKA-NITHI","IGAMBANG'OMBE","66",90,83,173
"42271","THARAKA-NITHI","IGAMBANG'OMBE","67",192,194,386
"42272","THARAKA-NITHI","IGAMBANG'OMBE","68",100,93,193
"42273","THARAKA-NITHI","IGAMBANG'OMBE","69",97,146,243
"42274","THARAKA-NITHI","IGAMBANG'OMBE","65-69",614,688,1302
"42275","THARAKA-NITHI","IGAMBANG'OMBE","70",134,223,357
"42276","THARAKA-NITHI","IGAMBANG'OMBE","71",128,103,231
"42277","THARAKA-NITHI","IGAMBANG'OMBE","72",87,83,170
"42278","THARAKA-NITHI","IGAMBANG'OMBE","73",59,70,129
"42279","THARAKA-NITHI","IGAMBANG'OMBE","74",69,88,157
"42280","THARAKA-NITHI","IGAMBANG'OMBE","70-74",477,567,1044
"42281","THARAKA-NITHI","IGAMBANG'OMBE","75",63,75,138
"42282","THARAKA-NITHI","IGAMBANG'OMBE","76",24,43,67
"42283","THARAKA-NITHI","IGAMBANG'OMBE","77",61,56,117
"42284","THARAKA-NITHI","IGAMBANG'OMBE","78",39,40,79
"42285","THARAKA-NITHI","IGAMBANG'OMBE","79",48,84,132
"42286","THARAKA-NITHI","IGAMBANG'OMBE","75-79",235,298,533
"42287","THARAKA-NITHI","IGAMBANG'OMBE","80",76,104,180
"42288","THARAKA-NITHI","IGAMBANG'OMBE","81",28,52,80
"42289","THARAKA-NITHI","IGAMBANG'OMBE","82",26,24,50
"42290","THARAKA-NITHI","IGAMBANG'OMBE","83",32,36,68
"42291","THARAKA-NITHI","IGAMBANG'OMBE","84",25,41,66
"42292","THARAKA-NITHI","IGAMBANG'OMBE","80-84",187,257,444
"42293","THARAKA-NITHI","IGAMBANG'OMBE","85",18,36,54
"42294","THARAKA-NITHI","IGAMBANG'OMBE","86",10,22,32
"42295","THARAKA-NITHI","IGAMBANG'OMBE","87",25,37,62
"42296","THARAKA-NITHI","IGAMBANG'OMBE","88",16,20,36
"42297","THARAKA-NITHI","IGAMBANG'OMBE","89",26,55,81
"42298","THARAKA-NITHI","IGAMBANG'OMBE","85-89",95,170,265
"42299","THARAKA-NITHI","IGAMBANG'OMBE","90",20,37,57
"42300","THARAKA-NITHI","IGAMBANG'OMBE","91",12,18,30
"42301","THARAKA-NITHI","IGAMBANG'OMBE","92",7,14,21
"42302","THARAKA-NITHI","IGAMBANG'OMBE","93",3,12,15
"42303","THARAKA-NITHI","IGAMBANG'OMBE","94",7,11,18
"42304","THARAKA-NITHI","IGAMBANG'OMBE","90-94",49,92,141
"42305","THARAKA-NITHI","IGAMBANG'OMBE","95",8,11,19
"42306","THARAKA-NITHI","IGAMBANG'OMBE","96",NA,5,5
"42307","THARAKA-NITHI","IGAMBANG'OMBE","97",7,5,12
"42308","THARAKA-NITHI","IGAMBANG'OMBE","98",3,7,10
"42309","THARAKA-NITHI","IGAMBANG'OMBE","99",8,14,22
"42310","THARAKA-NITHI","IGAMBANG'OMBE","95-99",26,42,68
"42311","THARAKA-NITHI","IGAMBANG'OMBE","100+",11,31,42
"42312","THARAKA-NITHI","IGAMBANG'OMBE","Not Stated",2,1,3
"42313","THARAKA-NITHI","MAARA","Total",57689,57205,114894
"42314","THARAKA-NITHI","MAARA","0",982,976,1958
"42315","THARAKA-NITHI","MAARA","1",1035,1109,2144
"42316","THARAKA-NITHI","MAARA","2",1076,1048,2124
"42317","THARAKA-NITHI","MAARA","3",1108,1108,2216
"42318","THARAKA-NITHI","MAARA","4",1125,1060,2185
"42319","THARAKA-NITHI","MAARA","0 - 4",5326,5301,10627
"42320","THARAKA-NITHI","MAARA","5",1126,1022,2148
"42321","THARAKA-NITHI","MAARA","6",1045,1135,2180
"42322","THARAKA-NITHI","MAARA","7",1136,1121,2257
"42323","THARAKA-NITHI","MAARA","8",1117,1144,2261
"42324","THARAKA-NITHI","MAARA","9",1255,1193,2448
"42325","THARAKA-NITHI","MAARA","5-9",5679,5615,11294
"42326","THARAKA-NITHI","MAARA","10",1215,1176,2391
"42327","THARAKA-NITHI","MAARA","11",1143,1195,2338
"42328","THARAKA-NITHI","MAARA","12",1325,1290,2615
"42329","THARAKA-NITHI","MAARA","13",1339,1305,2644
"42330","THARAKA-NITHI","MAARA","14",1243,1229,2472
"42331","THARAKA-NITHI","MAARA","10 -14",6265,6195,12460
"42332","THARAKA-NITHI","MAARA","15",1165,1239,2404
"42333","THARAKA-NITHI","MAARA","16",1204,1172,2376
"42334","THARAKA-NITHI","MAARA","17",1316,1109,2425
"42335","THARAKA-NITHI","MAARA","18",1052,961,2013
"42336","THARAKA-NITHI","MAARA","19",1042,953,1995
"42337","THARAKA-NITHI","MAARA","15-19",5779,5434,11213
"42338","THARAKA-NITHI","MAARA","20",904,854,1758
"42339","THARAKA-NITHI","MAARA","21",865,773,1638
"42340","THARAKA-NITHI","MAARA","22",867,787,1654
"42341","THARAKA-NITHI","MAARA","23",880,885,1765
"42342","THARAKA-NITHI","MAARA","24",794,782,1576
"42343","THARAKA-NITHI","MAARA","20-24",4310,4081,8391
"42344","THARAKA-NITHI","MAARA","25",805,724,1529
"42345","THARAKA-NITHI","MAARA","26",734,720,1454
"42346","THARAKA-NITHI","MAARA","27",753,751,1504
"42347","THARAKA-NITHI","MAARA","28",656,691,1347
"42348","THARAKA-NITHI","MAARA","29",785,773,1558
"42349","THARAKA-NITHI","MAARA","25-29",3733,3659,7392
"42350","THARAKA-NITHI","MAARA","30",892,1067,1959
"42351","THARAKA-NITHI","MAARA","31",732,686,1418
"42352","THARAKA-NITHI","MAARA","32",886,936,1822
"42353","THARAKA-NITHI","MAARA","33",852,849,1701
"42354","THARAKA-NITHI","MAARA","34",736,713,1449
"42355","THARAKA-NITHI","MAARA","30-34",4098,4251,8349
"42356","THARAKA-NITHI","MAARA","35",992,928,1920
"42357","THARAKA-NITHI","MAARA","36",710,648,1358
"42358","THARAKA-NITHI","MAARA","37",753,635,1388
"42359","THARAKA-NITHI","MAARA","38",638,609,1247
"42360","THARAKA-NITHI","MAARA","39",784,711,1495
"42361","THARAKA-NITHI","MAARA","35-39",3877,3531,7408
"42362","THARAKA-NITHI","MAARA","40",935,847,1782
"42363","THARAKA-NITHI","MAARA","41",765,696,1461
"42364","THARAKA-NITHI","MAARA","42",696,652,1348
"42365","THARAKA-NITHI","MAARA","43",619,625,1244
"42366","THARAKA-NITHI","MAARA","44",660,578,1238
"42367","THARAKA-NITHI","MAARA","40-44",3675,3398,7073
"42368","THARAKA-NITHI","MAARA","45",816,791,1607
"42369","THARAKA-NITHI","MAARA","46",731,683,1414
"42370","THARAKA-NITHI","MAARA","47",633,658,1291
"42371","THARAKA-NITHI","MAARA","48",563,546,1109
"42372","THARAKA-NITHI","MAARA","49",656,683,1339
"42373","THARAKA-NITHI","MAARA","45-49",3399,3361,6760
"42374","THARAKA-NITHI","MAARA","50",659,746,1405
"42375","THARAKA-NITHI","MAARA","51",544,494,1038
"42376","THARAKA-NITHI","MAARA","52",456,358,814
"42377","THARAKA-NITHI","MAARA","53",379,339,718
"42378","THARAKA-NITHI","MAARA","54",473,403,876
"42379","THARAKA-NITHI","MAARA","50-54",2511,2340,4851
"42380","THARAKA-NITHI","MAARA","55",544,459,1003
"42381","THARAKA-NITHI","MAARA","56",537,488,1025
"42382","THARAKA-NITHI","MAARA","57",448,542,990
"42383","THARAKA-NITHI","MAARA","58",451,437,888
"42384","THARAKA-NITHI","MAARA","59",556,519,1075
"42385","THARAKA-NITHI","MAARA","55-59",2536,2445,4981
"42386","THARAKA-NITHI","MAARA","60",602,611,1213
"42387","THARAKA-NITHI","MAARA","61",444,478,922
"42388","THARAKA-NITHI","MAARA","62",379,392,771
"42389","THARAKA-NITHI","MAARA","63",373,350,723
"42390","THARAKA-NITHI","MAARA","64",274,261,535
"42391","THARAKA-NITHI","MAARA","60-64",2072,2092,4164
"42392","THARAKA-NITHI","MAARA","65",409,421,830
"42393","THARAKA-NITHI","MAARA","66",305,301,606
"42394","THARAKA-NITHI","MAARA","67",416,423,839
"42395","THARAKA-NITHI","MAARA","68",230,217,447
"42396","THARAKA-NITHI","MAARA","69",356,378,734
"42397","THARAKA-NITHI","MAARA","65-69",1716,1740,3456
"42398","THARAKA-NITHI","MAARA","70",404,536,940
"42399","THARAKA-NITHI","MAARA","71",269,273,542
"42400","THARAKA-NITHI","MAARA","72",195,224,419
"42401","THARAKA-NITHI","MAARA","73",145,185,330
"42402","THARAKA-NITHI","MAARA","74",173,236,409
"42403","THARAKA-NITHI","MAARA","70-74",1186,1454,2640
"42404","THARAKA-NITHI","MAARA","75",157,161,318
"42405","THARAKA-NITHI","MAARA","76",101,136,237
"42406","THARAKA-NITHI","MAARA","77",151,209,360
"42407","THARAKA-NITHI","MAARA","78",70,91,161
"42408","THARAKA-NITHI","MAARA","79",110,166,276
"42409","THARAKA-NITHI","MAARA","75-79",589,763,1352
"42410","THARAKA-NITHI","MAARA","80",156,263,419
"42411","THARAKA-NITHI","MAARA","81",79,131,210
"42412","THARAKA-NITHI","MAARA","82",69,79,148
"42413","THARAKA-NITHI","MAARA","83",84,119,203
"42414","THARAKA-NITHI","MAARA","84",61,110,171
"42415","THARAKA-NITHI","MAARA","80-84",449,702,1151
"42416","THARAKA-NITHI","MAARA","85",67,77,144
"42417","THARAKA-NITHI","MAARA","86",41,69,110
"42418","THARAKA-NITHI","MAARA","87",65,79,144
"42419","THARAKA-NITHI","MAARA","88",26,36,62
"42420","THARAKA-NITHI","MAARA","89",68,140,208
"42421","THARAKA-NITHI","MAARA","85-89",267,401,668
"42422","THARAKA-NITHI","MAARA","90",23,75,98
"42423","THARAKA-NITHI","MAARA","91",29,47,76
"42424","THARAKA-NITHI","MAARA","92",20,19,39
"42425","THARAKA-NITHI","MAARA","93",13,23,36
"42426","THARAKA-NITHI","MAARA","94",18,30,48
"42427","THARAKA-NITHI","MAARA","90-94",103,194,297
"42428","THARAKA-NITHI","MAARA","95",14,35,49
"42429","THARAKA-NITHI","MAARA","96",8,20,28
"42430","THARAKA-NITHI","MAARA","97",39,34,73
"42431","THARAKA-NITHI","MAARA","98",10,17,27
"42432","THARAKA-NITHI","MAARA","99",19,52,71
"42433","THARAKA-NITHI","MAARA","95-99",90,158,248
"42434","THARAKA-NITHI","MAARA","100+",29,88,117
"42435","THARAKA-NITHI","MAARA","Not Stated",NA,2,2
"42436","THARAKA-NITHI","MERU SOUTH","Total",44923,46155,91078
"42437","THARAKA-NITHI","MERU SOUTH","0",961,923,1884
"42438","THARAKA-NITHI","MERU SOUTH","1",897,861,1758
"42439","THARAKA-NITHI","MERU SOUTH","2",858,834,1692
"42440","THARAKA-NITHI","MERU SOUTH","3",889,912,1801
"42441","THARAKA-NITHI","MERU SOUTH","4",848,920,1768
"42442","THARAKA-NITHI","MERU SOUTH","0 - 4",4453,4450,8903
"42443","THARAKA-NITHI","MERU SOUTH","5",801,815,1616
"42444","THARAKA-NITHI","MERU SOUTH","6",836,795,1631
"42445","THARAKA-NITHI","MERU SOUTH","7",907,851,1758
"42446","THARAKA-NITHI","MERU SOUTH","8",846,778,1624
"42447","THARAKA-NITHI","MERU SOUTH","9",884,963,1847
"42448","THARAKA-NITHI","MERU SOUTH","5-9",4274,4202,8476
"42449","THARAKA-NITHI","MERU SOUTH","10",985,883,1868
"42450","THARAKA-NITHI","MERU SOUTH","11",826,918,1744
"42451","THARAKA-NITHI","MERU SOUTH","12",1029,1032,2061
"42452","THARAKA-NITHI","MERU SOUTH","13",1068,1003,2071
"42453","THARAKA-NITHI","MERU SOUTH","14",1006,951,1957
"42454","THARAKA-NITHI","MERU SOUTH","10 -14",4914,4787,9701
"42455","THARAKA-NITHI","MERU SOUTH","15",932,944,1876
"42456","THARAKA-NITHI","MERU SOUTH","16",901,914,1815
"42457","THARAKA-NITHI","MERU SOUTH","17",905,916,1821
"42458","THARAKA-NITHI","MERU SOUTH","18",806,792,1598
"42459","THARAKA-NITHI","MERU SOUTH","19",858,857,1715
"42460","THARAKA-NITHI","MERU SOUTH","15-19",4402,4423,8825
"42461","THARAKA-NITHI","MERU SOUTH","20",806,814,1620
"42462","THARAKA-NITHI","MERU SOUTH","21",741,773,1514
"42463","THARAKA-NITHI","MERU SOUTH","22",764,799,1563
"42464","THARAKA-NITHI","MERU SOUTH","23",889,887,1776
"42465","THARAKA-NITHI","MERU SOUTH","24",814,763,1577
"42466","THARAKA-NITHI","MERU SOUTH","20-24",4014,4036,8050
"42467","THARAKA-NITHI","MERU SOUTH","25",807,745,1552
"42468","THARAKA-NITHI","MERU SOUTH","26",673,662,1335
"42469","THARAKA-NITHI","MERU SOUTH","27",710,688,1398
"42470","THARAKA-NITHI","MERU SOUTH","28",599,645,1244
"42471","THARAKA-NITHI","MERU SOUTH","29",626,716,1342
"42472","THARAKA-NITHI","MERU SOUTH","25-29",3415,3456,6871
"42473","THARAKA-NITHI","MERU SOUTH","30",790,830,1620
"42474","THARAKA-NITHI","MERU SOUTH","31",654,605,1259
"42475","THARAKA-NITHI","MERU SOUTH","32",727,841,1568
"42476","THARAKA-NITHI","MERU SOUTH","33",659,685,1344
"42477","THARAKA-NITHI","MERU SOUTH","34",506,608,1114
"42478","THARAKA-NITHI","MERU SOUTH","30-34",3336,3569,6905
"42479","THARAKA-NITHI","MERU SOUTH","35",771,797,1568
"42480","THARAKA-NITHI","MERU SOUTH","36",593,584,1177
"42481","THARAKA-NITHI","MERU SOUTH","37",581,556,1137
"42482","THARAKA-NITHI","MERU SOUTH","38",558,524,1082
"42483","THARAKA-NITHI","MERU SOUTH","39",633,615,1248
"42484","THARAKA-NITHI","MERU SOUTH","35-39",3136,3076,6212
"42485","THARAKA-NITHI","MERU SOUTH","40",695,722,1417
"42486","THARAKA-NITHI","MERU SOUTH","41",609,560,1169
"42487","THARAKA-NITHI","MERU SOUTH","42",539,529,1068
"42488","THARAKA-NITHI","MERU SOUTH","43",466,481,947
"42489","THARAKA-NITHI","MERU SOUTH","44",390,438,828
"42490","THARAKA-NITHI","MERU SOUTH","40-44",2699,2730,5429
"42491","THARAKA-NITHI","MERU SOUTH","45",599,629,1228
"42492","THARAKA-NITHI","MERU SOUTH","46",499,529,1028
"42493","THARAKA-NITHI","MERU SOUTH","47",486,486,972
"42494","THARAKA-NITHI","MERU SOUTH","48",375,381,756
"42495","THARAKA-NITHI","MERU SOUTH","49",445,435,880
"42496","THARAKA-NITHI","MERU SOUTH","45-49",2404,2460,4864
"42497","THARAKA-NITHI","MERU SOUTH","50",483,564,1047
"42498","THARAKA-NITHI","MERU SOUTH","51",430,370,800
"42499","THARAKA-NITHI","MERU SOUTH","52",328,341,669
"42500","THARAKA-NITHI","MERU SOUTH","53",237,272,509
"42501","THARAKA-NITHI","MERU SOUTH","54",359,322,681
"42502","THARAKA-NITHI","MERU SOUTH","50-54",1837,1869,3706
"42503","THARAKA-NITHI","MERU SOUTH","55",355,382,737
"42504","THARAKA-NITHI","MERU SOUTH","56",449,416,865
"42505","THARAKA-NITHI","MERU SOUTH","57",343,439,782
"42506","THARAKA-NITHI","MERU SOUTH","58",291,309,600
"42507","THARAKA-NITHI","MERU SOUTH","59",391,383,774
"42508","THARAKA-NITHI","MERU SOUTH","55-59",1829,1929,3758
"42509","THARAKA-NITHI","MERU SOUTH","60",421,414,835
"42510","THARAKA-NITHI","MERU SOUTH","61",290,297,587
"42511","THARAKA-NITHI","MERU SOUTH","62",278,261,539
"42512","THARAKA-NITHI","MERU SOUTH","63",227,249,476
"42513","THARAKA-NITHI","MERU SOUTH","64",147,165,312
"42514","THARAKA-NITHI","MERU SOUTH","60-64",1363,1386,2749
"42515","THARAKA-NITHI","MERU SOUTH","65",254,285,539
"42516","THARAKA-NITHI","MERU SOUTH","66",178,210,388
"42517","THARAKA-NITHI","MERU SOUTH","67",279,313,592
"42518","THARAKA-NITHI","MERU SOUTH","68",128,155,283
"42519","THARAKA-NITHI","MERU SOUTH","69",191,227,418
"42520","THARAKA-NITHI","MERU SOUTH","65-69",1030,1190,2220
"42521","THARAKA-NITHI","MERU SOUTH","70",264,367,631
"42522","THARAKA-NITHI","MERU SOUTH","71",152,205,357
"42523","THARAKA-NITHI","MERU SOUTH","72",127,176,303
"42524","THARAKA-NITHI","MERU SOUTH","73",101,124,225
"42525","THARAKA-NITHI","MERU SOUTH","74",105,158,263
"42526","THARAKA-NITHI","MERU SOUTH","70-74",749,1030,1779
"42527","THARAKA-NITHI","MERU SOUTH","75",100,134,234
"42528","THARAKA-NITHI","MERU SOUTH","76",75,78,153
"42529","THARAKA-NITHI","MERU SOUTH","77",102,160,262
"42530","THARAKA-NITHI","MERU SOUTH","78",80,71,151
"42531","THARAKA-NITHI","MERU SOUTH","79",67,132,199
"42532","THARAKA-NITHI","MERU SOUTH","75-79",424,575,999
"42533","THARAKA-NITHI","MERU SOUTH","80",116,142,258
"42534","THARAKA-NITHI","MERU SOUTH","81",55,84,139
"42535","THARAKA-NITHI","MERU SOUTH","82",40,41,81
"42536","THARAKA-NITHI","MERU SOUTH","83",64,62,126
"42537","THARAKA-NITHI","MERU SOUTH","84",52,91,143
"42538","THARAKA-NITHI","MERU SOUTH","80-84",327,420,747
"42539","THARAKA-NITHI","MERU SOUTH","85",32,71,103
"42540","THARAKA-NITHI","MERU SOUTH","86",35,29,64
"42541","THARAKA-NITHI","MERU SOUTH","87",35,52,87
"42542","THARAKA-NITHI","MERU SOUTH","88",27,21,48
"42543","THARAKA-NITHI","MERU SOUTH","89",39,94,133
"42544","THARAKA-NITHI","MERU SOUTH","85-89",168,267,435
"42545","THARAKA-NITHI","MERU SOUTH","90",24,52,76
"42546","THARAKA-NITHI","MERU SOUTH","91",21,44,65
"42547","THARAKA-NITHI","MERU SOUTH","92",7,12,19
"42548","THARAKA-NITHI","MERU SOUTH","93",16,17,33
"42549","THARAKA-NITHI","MERU SOUTH","94",12,27,39
"42550","THARAKA-NITHI","MERU SOUTH","90-94",80,152,232
"42551","THARAKA-NITHI","MERU SOUTH","95",9,23,32
"42552","THARAKA-NITHI","MERU SOUTH","96",6,12,18
"42553","THARAKA-NITHI","MERU SOUTH","97",14,20,34
"42554","THARAKA-NITHI","MERU SOUTH","98",6,11,17
"42555","THARAKA-NITHI","MERU SOUTH","99",13,34,47
"42556","THARAKA-NITHI","MERU SOUTH","95-99",48,100,148
"42557","THARAKA-NITHI","MERU SOUTH","100+",19,46,65
"42558","THARAKA-NITHI","MERU SOUTH","Not Stated",2,2,4
"42559","THARAKA-NITHI","THARAKA NORTH","Total",28290,30053,58343
"42560","THARAKA-NITHI","THARAKA NORTH","0",583,616,1199
"42561","THARAKA-NITHI","THARAKA NORTH","1",667,657,1324
"42562","THARAKA-NITHI","THARAKA NORTH","2",700,711,1411
"42563","THARAKA-NITHI","THARAKA NORTH","3",709,747,1456
"42564","THARAKA-NITHI","THARAKA NORTH","4",705,699,1404
"42565","THARAKA-NITHI","THARAKA NORTH","0 - 4",3364,3430,6794
"42566","THARAKA-NITHI","THARAKA NORTH","5",786,830,1616
"42567","THARAKA-NITHI","THARAKA NORTH","6",756,837,1593
"42568","THARAKA-NITHI","THARAKA NORTH","7",813,806,1619
"42569","THARAKA-NITHI","THARAKA NORTH","8",814,783,1597
"42570","THARAKA-NITHI","THARAKA NORTH","9",823,822,1645
"42571","THARAKA-NITHI","THARAKA NORTH","5-9",3992,4078,8070
"42572","THARAKA-NITHI","THARAKA NORTH","10",909,897,1806
"42573","THARAKA-NITHI","THARAKA NORTH","11",808,823,1631
"42574","THARAKA-NITHI","THARAKA NORTH","12",876,883,1759
"42575","THARAKA-NITHI","THARAKA NORTH","13",825,827,1652
"42576","THARAKA-NITHI","THARAKA NORTH","14",870,866,1736
"42577","THARAKA-NITHI","THARAKA NORTH","10 -14",4288,4296,8584
"42578","THARAKA-NITHI","THARAKA NORTH","15",851,787,1638
"42579","THARAKA-NITHI","THARAKA NORTH","16",749,801,1550
"42580","THARAKA-NITHI","THARAKA NORTH","17",750,734,1484
"42581","THARAKA-NITHI","THARAKA NORTH","18",618,622,1240
"42582","THARAKA-NITHI","THARAKA NORTH","19",634,643,1277
"42583","THARAKA-NITHI","THARAKA NORTH","15-19",3602,3587,7189
"42584","THARAKA-NITHI","THARAKA NORTH","20",539,632,1171
"42585","THARAKA-NITHI","THARAKA NORTH","21",412,504,916
"42586","THARAKA-NITHI","THARAKA NORTH","22",405,521,926
"42587","THARAKA-NITHI","THARAKA NORTH","23",376,491,867
"42588","THARAKA-NITHI","THARAKA NORTH","24",381,481,862
"42589","THARAKA-NITHI","THARAKA NORTH","20-24",2113,2629,4742
"42590","THARAKA-NITHI","THARAKA NORTH","25",443,481,924
"42591","THARAKA-NITHI","THARAKA NORTH","26",333,361,694
"42592","THARAKA-NITHI","THARAKA NORTH","27",350,441,791
"42593","THARAKA-NITHI","THARAKA NORTH","28",272,334,606
"42594","THARAKA-NITHI","THARAKA NORTH","29",349,393,742
"42595","THARAKA-NITHI","THARAKA NORTH","25-29",1747,2010,3757
"42596","THARAKA-NITHI","THARAKA NORTH","30",463,521,984
"42597","THARAKA-NITHI","THARAKA NORTH","31",311,338,649
"42598","THARAKA-NITHI","THARAKA NORTH","32",328,385,713
"42599","THARAKA-NITHI","THARAKA NORTH","33",343,408,751
"42600","THARAKA-NITHI","THARAKA NORTH","34",258,298,556
"42601","THARAKA-NITHI","THARAKA NORTH","30-34",1703,1950,3653
"42602","THARAKA-NITHI","THARAKA NORTH","35",486,555,1041
"42603","THARAKA-NITHI","THARAKA NORTH","36",267,298,565
"42604","THARAKA-NITHI","THARAKA NORTH","37",267,363,630
"42605","THARAKA-NITHI","THARAKA NORTH","38",208,247,455
"42606","THARAKA-NITHI","THARAKA NORTH","39",277,389,666
"42607","THARAKA-NITHI","THARAKA NORTH","35-39",1505,1852,3357
"42608","THARAKA-NITHI","THARAKA NORTH","40",385,364,749
"42609","THARAKA-NITHI","THARAKA NORTH","41",280,272,552
"42610","THARAKA-NITHI","THARAKA NORTH","42",265,238,503
"42611","THARAKA-NITHI","THARAKA NORTH","43",236,274,510
"42612","THARAKA-NITHI","THARAKA NORTH","44",173,235,408
"42613","THARAKA-NITHI","THARAKA NORTH","40-44",1339,1383,2722
"42614","THARAKA-NITHI","THARAKA NORTH","45",367,354,721
"42615","THARAKA-NITHI","THARAKA NORTH","46",263,274,537
"42616","THARAKA-NITHI","THARAKA NORTH","47",245,210,455
"42617","THARAKA-NITHI","THARAKA NORTH","48",156,159,315
"42618","THARAKA-NITHI","THARAKA NORTH","49",237,218,455
"42619","THARAKA-NITHI","THARAKA NORTH","45-49",1268,1215,2483
"42620","THARAKA-NITHI","THARAKA NORTH","50",261,221,482
"42621","THARAKA-NITHI","THARAKA NORTH","51",176,155,331
"42622","THARAKA-NITHI","THARAKA NORTH","52",104,81,185
"42623","THARAKA-NITHI","THARAKA NORTH","53",88,85,173
"42624","THARAKA-NITHI","THARAKA NORTH","54",131,110,241
"42625","THARAKA-NITHI","THARAKA NORTH","50-54",760,652,1412
"42626","THARAKA-NITHI","THARAKA NORTH","55",153,136,289
"42627","THARAKA-NITHI","THARAKA NORTH","56",177,156,333
"42628","THARAKA-NITHI","THARAKA NORTH","57",119,108,227
"42629","THARAKA-NITHI","THARAKA NORTH","58",123,146,269
"42630","THARAKA-NITHI","THARAKA NORTH","59",136,174,310
"42631","THARAKA-NITHI","THARAKA NORTH","55-59",708,720,1428
"42632","THARAKA-NITHI","THARAKA NORTH","60",231,209,440
"42633","THARAKA-NITHI","THARAKA NORTH","61",139,143,282
"42634","THARAKA-NITHI","THARAKA NORTH","62",86,83,169
"42635","THARAKA-NITHI","THARAKA NORTH","63",82,111,193
"42636","THARAKA-NITHI","THARAKA NORTH","64",73,65,138
"42637","THARAKA-NITHI","THARAKA NORTH","60-64",611,611,1222
"42638","THARAKA-NITHI","THARAKA NORTH","65",90,120,210
"42639","THARAKA-NITHI","THARAKA NORTH","66",54,45,99
"42640","THARAKA-NITHI","THARAKA NORTH","67",128,124,252
"42641","THARAKA-NITHI","THARAKA NORTH","68",43,62,105
"42642","THARAKA-NITHI","THARAKA NORTH","69",90,154,244
"42643","THARAKA-NITHI","THARAKA NORTH","65-69",405,505,910
"42644","THARAKA-NITHI","THARAKA NORTH","70",132,178,310
"42645","THARAKA-NITHI","THARAKA NORTH","71",132,106,238
"42646","THARAKA-NITHI","THARAKA NORTH","72",73,80,153
"42647","THARAKA-NITHI","THARAKA NORTH","73",41,66,107
"42648","THARAKA-NITHI","THARAKA NORTH","74",47,69,116
"42649","THARAKA-NITHI","THARAKA NORTH","70-74",425,499,924
"42650","THARAKA-NITHI","THARAKA NORTH","75",49,44,93
"42651","THARAKA-NITHI","THARAKA NORTH","76",32,29,61
"42652","THARAKA-NITHI","THARAKA NORTH","77",35,30,65
"42653","THARAKA-NITHI","THARAKA NORTH","78",34,26,60
"42654","THARAKA-NITHI","THARAKA NORTH","79",53,98,151
"42655","THARAKA-NITHI","THARAKA NORTH","75-79",203,227,430
"42656","THARAKA-NITHI","THARAKA NORTH","80",53,83,136
"42657","THARAKA-NITHI","THARAKA NORTH","81",14,32,46
"42658","THARAKA-NITHI","THARAKA NORTH","82",16,6,22
"42659","THARAKA-NITHI","THARAKA NORTH","83",21,13,34
"42660","THARAKA-NITHI","THARAKA NORTH","84",15,29,44
"42661","THARAKA-NITHI","THARAKA NORTH","80-84",119,163,282
"42662","THARAKA-NITHI","THARAKA NORTH","85",19,17,36
"42663","THARAKA-NITHI","THARAKA NORTH","86",12,9,21
"42664","THARAKA-NITHI","THARAKA NORTH","87",11,14,25
"42665","THARAKA-NITHI","THARAKA NORTH","88",8,15,23
"42666","THARAKA-NITHI","THARAKA NORTH","89",27,58,85
"42667","THARAKA-NITHI","THARAKA NORTH","85-89",77,113,190
"42668","THARAKA-NITHI","THARAKA NORTH","90",15,17,32
"42669","THARAKA-NITHI","THARAKA NORTH","91",6,14,20
"42670","THARAKA-NITHI","THARAKA NORTH","92",1,2,3
"42671","THARAKA-NITHI","THARAKA NORTH","93",2,2,4
"42672","THARAKA-NITHI","THARAKA NORTH","94",1,2,3
"42673","THARAKA-NITHI","THARAKA NORTH","90-94",25,37,62
"42674","THARAKA-NITHI","THARAKA NORTH","95",4,6,10
"42675","THARAKA-NITHI","THARAKA NORTH","96",NA,4,4
"42676","THARAKA-NITHI","THARAKA NORTH","97",7,13,20
"42677","THARAKA-NITHI","THARAKA NORTH","98",4,4,8
"42678","THARAKA-NITHI","THARAKA NORTH","99",8,29,37
"42679","THARAKA-NITHI","THARAKA NORTH","95-99",23,56,79
"42680","THARAKA-NITHI","THARAKA NORTH","100+",12,40,52
"42681","THARAKA-NITHI","THARAKA NORTH","Not Stated",1,NA,1
"42682","THARAKA-NITHI","THARAKA SOUTH","Total",36190,39058,75248
"42683","THARAKA-NITHI","THARAKA SOUTH","0",795,790,1585
"42684","THARAKA-NITHI","THARAKA SOUTH","1",797,778,1575
"42685","THARAKA-NITHI","THARAKA SOUTH","2",837,863,1700
"42686","THARAKA-NITHI","THARAKA SOUTH","3",850,877,1727
"42687","THARAKA-NITHI","THARAKA SOUTH","4",800,803,1603
"42688","THARAKA-NITHI","THARAKA SOUTH","0 - 4",4079,4111,8190
"42689","THARAKA-NITHI","THARAKA SOUTH","5",917,863,1780
"42690","THARAKA-NITHI","THARAKA SOUTH","6",902,843,1745
"42691","THARAKA-NITHI","THARAKA SOUTH","7",927,858,1785
"42692","THARAKA-NITHI","THARAKA SOUTH","8",897,974,1871
"42693","THARAKA-NITHI","THARAKA SOUTH","9",983,964,1947
"42694","THARAKA-NITHI","THARAKA SOUTH","5-9",4626,4502,9128
"42695","THARAKA-NITHI","THARAKA SOUTH","10",948,979,1927
"42696","THARAKA-NITHI","THARAKA SOUTH","11",978,955,1933
"42697","THARAKA-NITHI","THARAKA SOUTH","12",1103,1048,2151
"42698","THARAKA-NITHI","THARAKA SOUTH","13",1064,1090,2154
"42699","THARAKA-NITHI","THARAKA SOUTH","14",1045,1061,2106
"42700","THARAKA-NITHI","THARAKA SOUTH","10 -14",5138,5133,10271
"42701","THARAKA-NITHI","THARAKA SOUTH","15",965,1064,2029
"42702","THARAKA-NITHI","THARAKA SOUTH","16",985,1031,2016
"42703","THARAKA-NITHI","THARAKA SOUTH","17",1033,975,2008
"42704","THARAKA-NITHI","THARAKA SOUTH","18",862,788,1650
"42705","THARAKA-NITHI","THARAKA SOUTH","19",868,867,1735
"42706","THARAKA-NITHI","THARAKA SOUTH","15-19",4713,4725,9438
"42707","THARAKA-NITHI","THARAKA SOUTH","20",706,791,1497
"42708","THARAKA-NITHI","THARAKA SOUTH","21",655,684,1339
"42709","THARAKA-NITHI","THARAKA SOUTH","22",562,631,1193
"42710","THARAKA-NITHI","THARAKA SOUTH","23",570,695,1265
"42711","THARAKA-NITHI","THARAKA SOUTH","24",495,572,1067
"42712","THARAKA-NITHI","THARAKA SOUTH","20-24",2988,3373,6361
"42713","THARAKA-NITHI","THARAKA SOUTH","25",560,677,1237
"42714","THARAKA-NITHI","THARAKA SOUTH","26",446,578,1024
"42715","THARAKA-NITHI","THARAKA SOUTH","27",503,577,1080
"42716","THARAKA-NITHI","THARAKA SOUTH","28",397,483,880
"42717","THARAKA-NITHI","THARAKA SOUTH","29",463,531,994
"42718","THARAKA-NITHI","THARAKA SOUTH","25-29",2369,2846,5215
"42719","THARAKA-NITHI","THARAKA SOUTH","30",552,655,1207
"42720","THARAKA-NITHI","THARAKA SOUTH","31",456,490,946
"42721","THARAKA-NITHI","THARAKA SOUTH","32",476,587,1063
"42722","THARAKA-NITHI","THARAKA SOUTH","33",441,608,1049
"42723","THARAKA-NITHI","THARAKA SOUTH","34",374,511,885
"42724","THARAKA-NITHI","THARAKA SOUTH","30-34",2299,2851,5150
"42725","THARAKA-NITHI","THARAKA SOUTH","35",582,633,1215
"42726","THARAKA-NITHI","THARAKA SOUTH","36",389,452,841
"42727","THARAKA-NITHI","THARAKA SOUTH","37",443,450,893
"42728","THARAKA-NITHI","THARAKA SOUTH","38",282,344,626
"42729","THARAKA-NITHI","THARAKA SOUTH","39",388,422,810
"42730","THARAKA-NITHI","THARAKA SOUTH","35-39",2084,2301,4385
"42731","THARAKA-NITHI","THARAKA SOUTH","40",354,388,742
"42732","THARAKA-NITHI","THARAKA SOUTH","41",369,387,756
"42733","THARAKA-NITHI","THARAKA SOUTH","42",355,362,717
"42734","THARAKA-NITHI","THARAKA SOUTH","43",304,357,661
"42735","THARAKA-NITHI","THARAKA SOUTH","44",282,311,593
"42736","THARAKA-NITHI","THARAKA SOUTH","40-44",1664,1805,3469
"42737","THARAKA-NITHI","THARAKA SOUTH","45",369,460,829
"42738","THARAKA-NITHI","THARAKA SOUTH","46",349,407,756
"42739","THARAKA-NITHI","THARAKA SOUTH","47",361,351,712
"42740","THARAKA-NITHI","THARAKA SOUTH","48",241,237,478
"42741","THARAKA-NITHI","THARAKA SOUTH","49",267,344,611
"42742","THARAKA-NITHI","THARAKA SOUTH","45-49",1587,1799,3386
"42743","THARAKA-NITHI","THARAKA SOUTH","50",283,315,598
"42744","THARAKA-NITHI","THARAKA SOUTH","51",249,260,509
"42745","THARAKA-NITHI","THARAKA SOUTH","52",183,156,339
"42746","THARAKA-NITHI","THARAKA SOUTH","53",118,114,232
"42747","THARAKA-NITHI","THARAKA SOUTH","54",205,183,388
"42748","THARAKA-NITHI","THARAKA SOUTH","50-54",1038,1028,2066
"42749","THARAKA-NITHI","THARAKA SOUTH","55",207,189,396
"42750","THARAKA-NITHI","THARAKA SOUTH","56",223,251,474
"42751","THARAKA-NITHI","THARAKA SOUTH","57",157,191,348
"42752","THARAKA-NITHI","THARAKA SOUTH","58",184,222,406
"42753","THARAKA-NITHI","THARAKA SOUTH","59",182,231,413
"42754","THARAKA-NITHI","THARAKA SOUTH","55-59",953,1084,2037
"42755","THARAKA-NITHI","THARAKA SOUTH","60",232,259,491
"42756","THARAKA-NITHI","THARAKA SOUTH","61",184,186,370
"42757","THARAKA-NITHI","THARAKA SOUTH","62",136,114,250
"42758","THARAKA-NITHI","THARAKA SOUTH","63",131,154,285
"42759","THARAKA-NITHI","THARAKA SOUTH","64",93,110,203
"42760","THARAKA-NITHI","THARAKA SOUTH","60-64",776,823,1599
"42761","THARAKA-NITHI","THARAKA SOUTH","65",126,168,294
"42762","THARAKA-NITHI","THARAKA SOUTH","66",80,89,169
"42763","THARAKA-NITHI","THARAKA SOUTH","67",174,179,353
"42764","THARAKA-NITHI","THARAKA SOUTH","68",74,92,166
"42765","THARAKA-NITHI","THARAKA SOUTH","69",120,194,314
"42766","THARAKA-NITHI","THARAKA SOUTH","65-69",574,722,1296
"42767","THARAKA-NITHI","THARAKA SOUTH","70",169,235,404
"42768","THARAKA-NITHI","THARAKA SOUTH","71",125,213,338
"42769","THARAKA-NITHI","THARAKA SOUTH","72",92,102,194
"42770","THARAKA-NITHI","THARAKA SOUTH","73",68,100,168
"42771","THARAKA-NITHI","THARAKA SOUTH","74",66,92,158
"42772","THARAKA-NITHI","THARAKA SOUTH","70-74",520,742,1262
"42773","THARAKA-NITHI","THARAKA SOUTH","75",66,103,169
"42774","THARAKA-NITHI","THARAKA SOUTH","76",57,65,122
"42775","THARAKA-NITHI","THARAKA SOUTH","77",81,84,165
"42776","THARAKA-NITHI","THARAKA SOUTH","78",55,49,104
"42777","THARAKA-NITHI","THARAKA SOUTH","79",68,137,205
"42778","THARAKA-NITHI","THARAKA SOUTH","75-79",327,438,765
"42779","THARAKA-NITHI","THARAKA SOUTH","80",72,120,192
"42780","THARAKA-NITHI","THARAKA SOUTH","81",28,73,101
"42781","THARAKA-NITHI","THARAKA SOUTH","82",29,46,75
"42782","THARAKA-NITHI","THARAKA SOUTH","83",31,56,87
"42783","THARAKA-NITHI","THARAKA SOUTH","84",27,34,61
"42784","THARAKA-NITHI","THARAKA SOUTH","80-84",187,329,516
"42785","THARAKA-NITHI","THARAKA SOUTH","85",36,55,91
"42786","THARAKA-NITHI","THARAKA SOUTH","86",27,22,49
"42787","THARAKA-NITHI","THARAKA SOUTH","87",38,64,102
"42788","THARAKA-NITHI","THARAKA SOUTH","88",18,22,40
"42789","THARAKA-NITHI","THARAKA SOUTH","89",48,89,137
"42790","THARAKA-NITHI","THARAKA SOUTH","85-89",167,252,419
"42791","THARAKA-NITHI","THARAKA SOUTH","90",14,25,39
"42792","THARAKA-NITHI","THARAKA SOUTH","91",15,32,47
"42793","THARAKA-NITHI","THARAKA SOUTH","92",4,17,21
"42794","THARAKA-NITHI","THARAKA SOUTH","93",8,15,23
"42795","THARAKA-NITHI","THARAKA SOUTH","94",12,6,18
"42796","THARAKA-NITHI","THARAKA SOUTH","90-94",53,95,148
"42797","THARAKA-NITHI","THARAKA SOUTH","95",11,12,23
"42798","THARAKA-NITHI","THARAKA SOUTH","96",4,10,14
"42799","THARAKA-NITHI","THARAKA SOUTH","97",3,11,14
"42800","THARAKA-NITHI","THARAKA SOUTH","98",3,6,9
"42801","THARAKA-NITHI","THARAKA SOUTH","99",11,22,33
"42802","THARAKA-NITHI","THARAKA SOUTH","95-99",32,61,93
"42803","THARAKA-NITHI","THARAKA SOUTH","100+",16,38,54
"42804","THARAKA-NITHI","THARAKA SOUTH","Not Stated",NA,NA,NA
"42805","THARAKA-NITHI","MT. KENYA FOREST","Total",208,190,398
"42806","THARAKA-NITHI","MT. KENYA FOREST","0",10,9,19
"42807","THARAKA-NITHI","MT. KENYA FOREST","1",3,4,7
"42808","THARAKA-NITHI","MT. KENYA FOREST","2",NA,2,2
"42809","THARAKA-NITHI","MT. KENYA FOREST","3",4,3,7
"42810","THARAKA-NITHI","MT. KENYA FOREST","4",2,2,4
"42811","THARAKA-NITHI","MT. KENYA FOREST","0 - 4",19,20,39
"42812","THARAKA-NITHI","MT. KENYA FOREST","5",NA,2,2
"42813","THARAKA-NITHI","MT. KENYA FOREST","6",5,1,6
"42814","THARAKA-NITHI","MT. KENYA FOREST","7",3,2,5
"42815","THARAKA-NITHI","MT. KENYA FOREST","8",1,2,3
"42816","THARAKA-NITHI","MT. KENYA FOREST","9",3,2,5
"42817","THARAKA-NITHI","MT. KENYA FOREST","5-9",12,9,21
"42818","THARAKA-NITHI","MT. KENYA FOREST","10",1,1,2
"42819","THARAKA-NITHI","MT. KENYA FOREST","11",NA,2,2
"42820","THARAKA-NITHI","MT. KENYA FOREST","12",1,1,2
"42821","THARAKA-NITHI","MT. KENYA FOREST","13",NA,1,1
"42822","THARAKA-NITHI","MT. KENYA FOREST","14",2,NA,2
"42823","THARAKA-NITHI","MT. KENYA FOREST","10 -14",4,5,9
"42824","THARAKA-NITHI","MT. KENYA FOREST","15",2,NA,2
"42825","THARAKA-NITHI","MT. KENYA FOREST","16",NA,1,1
"42826","THARAKA-NITHI","MT. KENYA FOREST","17",1,1,2
"42827","THARAKA-NITHI","MT. KENYA FOREST","18",2,1,3
"42828","THARAKA-NITHI","MT. KENYA FOREST","19",2,2,4
"42829","THARAKA-NITHI","MT. KENYA FOREST","15-19",7,5,12
"42830","THARAKA-NITHI","MT. KENYA FOREST","20",2,3,5
"42831","THARAKA-NITHI","MT. KENYA FOREST","21",1,11,12
"42832","THARAKA-NITHI","MT. KENYA FOREST","22",NA,13,13
"42833","THARAKA-NITHI","MT. KENYA FOREST","23",NA,13,13
"42834","THARAKA-NITHI","MT. KENYA FOREST","24",1,9,10
"42835","THARAKA-NITHI","MT. KENYA FOREST","20-24",4,49,53
"42836","THARAKA-NITHI","MT. KENYA FOREST","25",3,4,7
"42837","THARAKA-NITHI","MT. KENYA FOREST","26",3,8,11
"42838","THARAKA-NITHI","MT. KENYA FOREST","27",9,5,14
"42839","THARAKA-NITHI","MT. KENYA FOREST","28",12,5,17
"42840","THARAKA-NITHI","MT. KENYA FOREST","29",8,3,11
"42841","THARAKA-NITHI","MT. KENYA FOREST","25-29",35,25,60
"42842","THARAKA-NITHI","MT. KENYA FOREST","30",3,4,7
"42843","THARAKA-NITHI","MT. KENYA FOREST","31",2,4,6
"42844","THARAKA-NITHI","MT. KENYA FOREST","32",5,6,11
"42845","THARAKA-NITHI","MT. KENYA FOREST","33",5,2,7
"42846","THARAKA-NITHI","MT. KENYA FOREST","34",7,5,12
"42847","THARAKA-NITHI","MT. KENYA FOREST","30-34",22,21,43
"42848","THARAKA-NITHI","MT. KENYA FOREST","35",7,7,14
"42849","THARAKA-NITHI","MT. KENYA FOREST","36",7,2,9
"42850","THARAKA-NITHI","MT. KENYA FOREST","37",2,4,6
"42851","THARAKA-NITHI","MT. KENYA FOREST","38",8,NA,8
"42852","THARAKA-NITHI","MT. KENYA FOREST","39",5,4,9
"42853","THARAKA-NITHI","MT. KENYA FOREST","35-39",29,17,46
"42854","THARAKA-NITHI","MT. KENYA FOREST","40",5,1,6
"42855","THARAKA-NITHI","MT. KENYA FOREST","41",2,1,3
"42856","THARAKA-NITHI","MT. KENYA FOREST","42",4,1,5
"42857","THARAKA-NITHI","MT. KENYA FOREST","43",2,2,4
"42858","THARAKA-NITHI","MT. KENYA FOREST","44",1,1,2
"42859","THARAKA-NITHI","MT. KENYA FOREST","40-44",14,6,20
"42860","THARAKA-NITHI","MT. KENYA FOREST","45",3,NA,3
"42861","THARAKA-NITHI","MT. KENYA FOREST","46",2,1,3
"42862","THARAKA-NITHI","MT. KENYA FOREST","47",3,NA,3
"42863","THARAKA-NITHI","MT. KENYA FOREST","48",4,2,6
"42864","THARAKA-NITHI","MT. KENYA FOREST","49",3,2,5
"42865","THARAKA-NITHI","MT. KENYA FOREST","45-49",15,5,20
"42866","THARAKA-NITHI","MT. KENYA FOREST","50",3,2,5
"42867","THARAKA-NITHI","MT. KENYA FOREST","51",1,2,3
"42868","THARAKA-NITHI","MT. KENYA FOREST","52",1,NA,1
"42869","THARAKA-NITHI","MT. KENYA FOREST","53",2,NA,2
"42870","THARAKA-NITHI","MT. KENYA FOREST","54",2,NA,2
"42871","THARAKA-NITHI","MT. KENYA FOREST","50-54",9,4,13
"42872","THARAKA-NITHI","MT. KENYA FOREST","55",1,1,2
"42873","THARAKA-NITHI","MT. KENYA FOREST","56",NA,1,1
"42874","THARAKA-NITHI","MT. KENYA FOREST","57",2,1,3
"42875","THARAKA-NITHI","MT. KENYA FOREST","58",3,NA,3
"42876","THARAKA-NITHI","MT. KENYA FOREST","59",2,NA,2
"42877","THARAKA-NITHI","MT. KENYA FOREST","55-59",8,3,11
"42878","THARAKA-NITHI","MT. KENYA FOREST","60",1,3,4
"42879","THARAKA-NITHI","MT. KENYA FOREST","61",1,1,2
"42880","THARAKA-NITHI","MT. KENYA FOREST","62",NA,1,1
"42881","THARAKA-NITHI","MT. KENYA FOREST","63",4,NA,4
"42882","THARAKA-NITHI","MT. KENYA FOREST","64",NA,NA,NA
"42883","THARAKA-NITHI","MT. KENYA FOREST","60-64",6,5,11
"42884","THARAKA-NITHI","MT. KENYA FOREST","65",NA,2,2
"42885","THARAKA-NITHI","MT. KENYA FOREST","66",NA,NA,0
"42886","THARAKA-NITHI","MT. KENYA FOREST","67",2,1,3
"42887","THARAKA-NITHI","MT. KENYA FOREST","68",3,NA,3
"42888","THARAKA-NITHI","MT. KENYA FOREST","69",1,NA,1
"42889","THARAKA-NITHI","MT. KENYA FOREST","65-69",6,3,9
"42890","THARAKA-NITHI","MT. KENYA FOREST","70",4,NA,4
"42891","THARAKA-NITHI","MT. KENYA FOREST","71",1,NA,1
"42892","THARAKA-NITHI","MT. KENYA FOREST","72",NA,2,2
"42893","THARAKA-NITHI","MT. KENYA FOREST","73",1,NA,1
"42894","THARAKA-NITHI","MT. KENYA FOREST","74",2,1,3
"42895","THARAKA-NITHI","MT. KENYA FOREST","70-74",8,3,11
"42896","THARAKA-NITHI","MT. KENYA FOREST","75",NA,NA,NA
"42897","THARAKA-NITHI","MT. KENYA FOREST","76",NA,1,1
"42898","THARAKA-NITHI","MT. KENYA FOREST","77",1,NA,1
"42899","THARAKA-NITHI","MT. KENYA FOREST","78",NA,NA,NA
"42900","THARAKA-NITHI","MT. KENYA FOREST","79",1,1,2
"42901","THARAKA-NITHI","MT. KENYA FOREST","75-79",2,2,4
"42902","THARAKA-NITHI","MT. KENYA FOREST","80",1,2,3
"42903","THARAKA-NITHI","MT. KENYA FOREST","81",1,1,2
"42904","THARAKA-NITHI","MT. KENYA FOREST","82",NA,NA,NA
"42905","THARAKA-NITHI","MT. KENYA FOREST","83",NA,NA,NA
"42906","THARAKA-NITHI","MT. KENYA FOREST","84",NA,NA,NA
"42907","THARAKA-NITHI","MT. KENYA FOREST","80-84",2,3,5
"42908","THARAKA-NITHI","MT. KENYA FOREST","85",1,1,2
"42909","THARAKA-NITHI","MT. KENYA FOREST","86",NA,1,1
"42910","THARAKA-NITHI","MT. KENYA FOREST","87",NA,1,1
"42911","THARAKA-NITHI","MT. KENYA FOREST","88",1,1,2
"42912","THARAKA-NITHI","MT. KENYA FOREST","89",1,1,2
"42913","THARAKA-NITHI","MT. KENYA FOREST","85-89",3,5,8
"42914","THARAKA-NITHI","MT. KENYA FOREST","90",NA,NA,NA
"42915","THARAKA-NITHI","MT. KENYA FOREST","91",NA,NA,NA
"42916","THARAKA-NITHI","MT. KENYA FOREST","92",NA,NA,NA
"42917","THARAKA-NITHI","MT. KENYA FOREST","93",NA,NA,NA
"42918","THARAKA-NITHI","MT. KENYA FOREST","94",1,NA,1
"42919","THARAKA-NITHI","MT. KENYA FOREST","90-94",1,NA,1
"42920","THARAKA-NITHI","MT. KENYA FOREST","95",NA,NA,NA
"42921","THARAKA-NITHI","MT. KENYA FOREST","96",2,NA,2
"42922","THARAKA-NITHI","MT. KENYA FOREST","97",NA,NA,NA
"42923","THARAKA-NITHI","MT. KENYA FOREST","98",NA,NA,NA
"42924","THARAKA-NITHI","MT. KENYA FOREST","99",NA,NA,NA
"42925","THARAKA-NITHI","MT. KENYA FOREST","95-99",2,NA,2
"42926","THARAKA-NITHI","MT. KENYA FOREST","100+",NA,NA,NA
"42927","THARAKA-NITHI","MT. KENYA FOREST","Not Stated",NA,NA,NA
"42928","TRANS NZOIA","ALL","Total",489107,501206,990313
"42929","TRANS NZOIA","ALL","0",11952,11755,23707
"42930","TRANS NZOIA","ALL","1",12652,12595,25247
"42931","TRANS NZOIA","ALL","2",12779,12530,25309
"42932","TRANS NZOIA","ALL","3",13852,13781,27633
"42933","TRANS NZOIA","ALL","4",14091,13571,27662
"42934","TRANS NZOIA","ALL","0 - 4",65326,64232,129558
"42935","TRANS NZOIA","ALL","5",14281,13811,28092
"42936","TRANS NZOIA","ALL","6",14377,14325,28702
"42937","TRANS NZOIA","ALL","7",14186,14298,28484
"42938","TRANS NZOIA","ALL","8",13427,13642,27069
"42939","TRANS NZOIA","ALL","9",15364,15211,30575
"42940","TRANS NZOIA","ALL","5-9",71635,71287,142922
"42941","TRANS NZOIA","ALL","10",15532,14796,30328
"42942","TRANS NZOIA","ALL","11",13934,14535,28469
"42943","TRANS NZOIA","ALL","12",15568,15057,30625
"42944","TRANS NZOIA","ALL","13",15319,15296,30615
"42945","TRANS NZOIA","ALL","14",14803,14508,29311
"42946","TRANS NZOIA","ALL","10 -14",75156,74192,149348
"42947","TRANS NZOIA","ALL","15",14321,13981,28302
"42948","TRANS NZOIA","ALL","16",13191,13001,26192
"42949","TRANS NZOIA","ALL","17",13947,13013,26960
"42950","TRANS NZOIA","ALL","18",10561,9909,20470
"42951","TRANS NZOIA","ALL","19",11609,11011,22620
"42952","TRANS NZOIA","ALL","15-19",63629,60915,124544
"42953","TRANS NZOIA","ALL","20",9718,10000,19718
"42954","TRANS NZOIA","ALL","21",8222,8662,16884
"42955","TRANS NZOIA","ALL","22",7874,8675,16549
"42956","TRANS NZOIA","ALL","23",7892,8990,16882
"42957","TRANS NZOIA","ALL","24",7051,8024,15075
"42958","TRANS NZOIA","ALL","20-24",40757,44351,85108
"42959","TRANS NZOIA","ALL","25",7691,8648,16339
"42960","TRANS NZOIA","ALL","26",6134,7340,13474
"42961","TRANS NZOIA","ALL","27",6768,7506,14274
"42962","TRANS NZOIA","ALL","28",5195,6051,11246
"42963","TRANS NZOIA","ALL","29",5937,6679,12616
"42964","TRANS NZOIA","ALL","25-29",31725,36224,67949
"42965","TRANS NZOIA","ALL","30",7110,8123,15233
"42966","TRANS NZOIA","ALL","31",5327,6067,11394
"42967","TRANS NZOIA","ALL","32",6924,7811,14735
"42968","TRANS NZOIA","ALL","33",5557,6669,12226
"42969","TRANS NZOIA","ALL","34",5197,5755,10952
"42970","TRANS NZOIA","ALL","30-34",30115,34425,64540
"42971","TRANS NZOIA","ALL","35",6596,6582,13178
"42972","TRANS NZOIA","ALL","36",4668,4713,9381
"42973","TRANS NZOIA","ALL","37",4868,4491,9359
"42974","TRANS NZOIA","ALL","38",3769,3575,7344
"42975","TRANS NZOIA","ALL","39",4154,3892,8046
"42976","TRANS NZOIA","ALL","35-39",24055,23253,47308
"42977","TRANS NZOIA","ALL","40",4910,4809,9719
"42978","TRANS NZOIA","ALL","41",4599,4866,9465
"42979","TRANS NZOIA","ALL","42",4821,4851,9672
"42980","TRANS NZOIA","ALL","43",4270,4524,8794
"42981","TRANS NZOIA","ALL","44",3186,3234,6420
"42982","TRANS NZOIA","ALL","40-44",21786,22284,44070
"42983","TRANS NZOIA","ALL","45",4688,4650,9338
"42984","TRANS NZOIA","ALL","46",3380,3312,6692
"42985","TRANS NZOIA","ALL","47",3478,3547,7025
"42986","TRANS NZOIA","ALL","48",2449,2451,4900
"42987","TRANS NZOIA","ALL","49",2872,2849,5721
"42988","TRANS NZOIA","ALL","45-49",16867,16809,33676
"42989","TRANS NZOIA","ALL","50",3124,3271,6395
"42990","TRANS NZOIA","ALL","51",2656,2881,5537
"42991","TRANS NZOIA","ALL","52",2367,2589,4956
"42992","TRANS NZOIA","ALL","53",2156,2294,4450
"42993","TRANS NZOIA","ALL","54",2216,2382,4598
"42994","TRANS NZOIA","ALL","50-54",12519,13417,25936
"42995","TRANS NZOIA","ALL","55",2273,2267,4540
"42996","TRANS NZOIA","ALL","56",2115,2434,4549
"42997","TRANS NZOIA","ALL","57",2206,2951,5157
"42998","TRANS NZOIA","ALL","58",1893,2146,4039
"42999","TRANS NZOIA","ALL","59",2401,2409,4810
"43000","TRANS NZOIA","ALL","55-59",10888,12207,23095
"43001","TRANS NZOIA","ALL","60",2329,2314,4643
"43002","TRANS NZOIA","ALL","61",1960,2023,3983
"43003","TRANS NZOIA","ALL","62",1573,1603,3176
"43004","TRANS NZOIA","ALL","63",1756,1829,3585
"43005","TRANS NZOIA","ALL","64",1189,1313,2502
"43006","TRANS NZOIA","ALL","60-64",8807,9082,17889
"43007","TRANS NZOIA","ALL","65",1676,1835,3511
"43008","TRANS NZOIA","ALL","66",998,1082,2080
"43009","TRANS NZOIA","ALL","67",1486,1686,3172
"43010","TRANS NZOIA","ALL","68",731,696,1427
"43011","TRANS NZOIA","ALL","69",1246,1241,2487
"43012","TRANS NZOIA","ALL","65-69",6137,6540,12677
"43013","TRANS NZOIA","ALL","70",1176,1371,2547
"43014","TRANS NZOIA","ALL","71",1039,1122,2161
"43015","TRANS NZOIA","ALL","72",812,754,1566
"43016","TRANS NZOIA","ALL","73",760,825,1585
"43017","TRANS NZOIA","ALL","74",584,706,1290
"43018","TRANS NZOIA","ALL","70-74",4371,4778,9149
"43019","TRANS NZOIA","ALL","75",601,739,1340
"43020","TRANS NZOIA","ALL","76",483,652,1135
"43021","TRANS NZOIA","ALL","77",584,733,1317
"43022","TRANS NZOIA","ALL","78",326,365,691
"43023","TRANS NZOIA","ALL","79",353,571,924
"43024","TRANS NZOIA","ALL","75-79",2347,3060,5407
"43025","TRANS NZOIA","ALL","80",457,582,1039
"43026","TRANS NZOIA","ALL","81",270,349,619
"43027","TRANS NZOIA","ALL","82",259,318,577
"43028","TRANS NZOIA","ALL","83",344,400,744
"43029","TRANS NZOIA","ALL","84",228,293,521
"43030","TRANS NZOIA","ALL","80-84",1558,1942,3500
"43031","TRANS NZOIA","ALL","85",216,326,542
"43032","TRANS NZOIA","ALL","86",151,214,365
"43033","TRANS NZOIA","ALL","87",231,334,565
"43034","TRANS NZOIA","ALL","88",108,114,222
"43035","TRANS NZOIA","ALL","89",180,330,510
"43036","TRANS NZOIA","ALL","85-89",886,1318,2204
"43037","TRANS NZOIA","ALL","90",60,150,210
"43038","TRANS NZOIA","ALL","91",102,121,223
"43039","TRANS NZOIA","ALL","92",64,51,115
"43040","TRANS NZOIA","ALL","93",58,80,138
"43041","TRANS NZOIA","ALL","94",38,52,90
"43042","TRANS NZOIA","ALL","90-94",322,454,776
"43043","TRANS NZOIA","ALL","95",84,119,203
"43044","TRANS NZOIA","ALL","96",25,51,76
"43045","TRANS NZOIA","ALL","97",41,52,93
"43046","TRANS NZOIA","ALL","98",15,26,41
"43047","TRANS NZOIA","ALL","99",24,60,84
"43048","TRANS NZOIA","ALL","95-99",189,308,497
"43049","TRANS NZOIA","ALL","100+",31,125,156
"43050","TRANS NZOIA","ALL","Not Stated",1,3,4
"43051","TRANS NZOIA","TRANS NZOIA WEST","Total",101198,101174,202372
"43052","TRANS NZOIA","TRANS NZOIA WEST","0",2503,2501,5004
"43053","TRANS NZOIA","TRANS NZOIA WEST","1",2715,2593,5308
"43054","TRANS NZOIA","TRANS NZOIA WEST","2",2631,2602,5233
"43055","TRANS NZOIA","TRANS NZOIA WEST","3",2911,2845,5756
"43056","TRANS NZOIA","TRANS NZOIA WEST","4",2919,2800,5719
"43057","TRANS NZOIA","TRANS NZOIA WEST","0 - 4",13679,13341,27020
"43058","TRANS NZOIA","TRANS NZOIA WEST","5",2943,2891,5834
"43059","TRANS NZOIA","TRANS NZOIA WEST","6",2954,2903,5857
"43060","TRANS NZOIA","TRANS NZOIA WEST","7",2801,2853,5654
"43061","TRANS NZOIA","TRANS NZOIA WEST","8",2654,2687,5341
"43062","TRANS NZOIA","TRANS NZOIA WEST","9",3026,3184,6210
"43063","TRANS NZOIA","TRANS NZOIA WEST","5-9",14378,14518,28896
"43064","TRANS NZOIA","TRANS NZOIA WEST","10",3059,2779,5838
"43065","TRANS NZOIA","TRANS NZOIA WEST","11",2704,2846,5550
"43066","TRANS NZOIA","TRANS NZOIA WEST","12",3098,2881,5979
"43067","TRANS NZOIA","TRANS NZOIA WEST","13",2901,3070,5971
"43068","TRANS NZOIA","TRANS NZOIA WEST","14",2832,2763,5595
"43069","TRANS NZOIA","TRANS NZOIA WEST","10 -14",14594,14339,28933
"43070","TRANS NZOIA","TRANS NZOIA WEST","15",2846,2748,5594
"43071","TRANS NZOIA","TRANS NZOIA WEST","16",2525,2486,5011
"43072","TRANS NZOIA","TRANS NZOIA WEST","17",2706,2595,5301
"43073","TRANS NZOIA","TRANS NZOIA WEST","18",2058,2023,4081
"43074","TRANS NZOIA","TRANS NZOIA WEST","19",2211,2298,4509
"43075","TRANS NZOIA","TRANS NZOIA WEST","15-19",12346,12150,24496
"43076","TRANS NZOIA","TRANS NZOIA WEST","20",2007,2071,4078
"43077","TRANS NZOIA","TRANS NZOIA WEST","21",1754,1865,3619
"43078","TRANS NZOIA","TRANS NZOIA WEST","22",1760,1976,3736
"43079","TRANS NZOIA","TRANS NZOIA WEST","23",1841,2059,3900
"43080","TRANS NZOIA","TRANS NZOIA WEST","24",1657,1860,3517
"43081","TRANS NZOIA","TRANS NZOIA WEST","20-24",9019,9831,18850
"43082","TRANS NZOIA","TRANS NZOIA WEST","25",1855,2034,3889
"43083","TRANS NZOIA","TRANS NZOIA WEST","26",1535,1673,3208
"43084","TRANS NZOIA","TRANS NZOIA WEST","27",1751,1734,3485
"43085","TRANS NZOIA","TRANS NZOIA WEST","28",1273,1386,2659
"43086","TRANS NZOIA","TRANS NZOIA WEST","29",1400,1447,2847
"43087","TRANS NZOIA","TRANS NZOIA WEST","25-29",7814,8274,16088
"43088","TRANS NZOIA","TRANS NZOIA WEST","30",1786,1762,3548
"43089","TRANS NZOIA","TRANS NZOIA WEST","31",1271,1315,2586
"43090","TRANS NZOIA","TRANS NZOIA WEST","32",1655,1715,3370
"43091","TRANS NZOIA","TRANS NZOIA WEST","33",1291,1375,2666
"43092","TRANS NZOIA","TRANS NZOIA WEST","34",1178,1181,2359
"43093","TRANS NZOIA","TRANS NZOIA WEST","30-34",7181,7348,14529
"43094","TRANS NZOIA","TRANS NZOIA WEST","35",1432,1385,2817
"43095","TRANS NZOIA","TRANS NZOIA WEST","36",1050,904,1954
"43096","TRANS NZOIA","TRANS NZOIA WEST","37",1034,903,1937
"43097","TRANS NZOIA","TRANS NZOIA WEST","38",810,702,1512
"43098","TRANS NZOIA","TRANS NZOIA WEST","39",894,744,1638
"43099","TRANS NZOIA","TRANS NZOIA WEST","35-39",5220,4638,9858
"43100","TRANS NZOIA","TRANS NZOIA WEST","40",1025,957,1982
"43101","TRANS NZOIA","TRANS NZOIA WEST","41",1008,1019,2027
"43102","TRANS NZOIA","TRANS NZOIA WEST","42",1035,1031,2066
"43103","TRANS NZOIA","TRANS NZOIA WEST","43",936,923,1859
"43104","TRANS NZOIA","TRANS NZOIA WEST","44",683,604,1287
"43105","TRANS NZOIA","TRANS NZOIA WEST","40-44",4687,4534,9221
"43106","TRANS NZOIA","TRANS NZOIA WEST","45",1085,896,1981
"43107","TRANS NZOIA","TRANS NZOIA WEST","46",721,635,1356
"43108","TRANS NZOIA","TRANS NZOIA WEST","47",744,707,1451
"43109","TRANS NZOIA","TRANS NZOIA WEST","48",515,455,970
"43110","TRANS NZOIA","TRANS NZOIA WEST","49",603,520,1123
"43111","TRANS NZOIA","TRANS NZOIA WEST","45-49",3668,3213,6881
"43112","TRANS NZOIA","TRANS NZOIA WEST","50",599,556,1155
"43113","TRANS NZOIA","TRANS NZOIA WEST","51",562,512,1074
"43114","TRANS NZOIA","TRANS NZOIA WEST","52",447,477,924
"43115","TRANS NZOIA","TRANS NZOIA WEST","53",433,380,813
"43116","TRANS NZOIA","TRANS NZOIA WEST","54",434,405,839
"43117","TRANS NZOIA","TRANS NZOIA WEST","50-54",2475,2330,4805
"43118","TRANS NZOIA","TRANS NZOIA WEST","55",420,414,834
"43119","TRANS NZOIA","TRANS NZOIA WEST","56",416,446,862
"43120","TRANS NZOIA","TRANS NZOIA WEST","57",446,490,936
"43121","TRANS NZOIA","TRANS NZOIA WEST","58",345,331,676
"43122","TRANS NZOIA","TRANS NZOIA WEST","59",462,424,886
"43123","TRANS NZOIA","TRANS NZOIA WEST","55-59",2089,2105,4194
"43124","TRANS NZOIA","TRANS NZOIA WEST","60",428,346,774
"43125","TRANS NZOIA","TRANS NZOIA WEST","61",350,353,703
"43126","TRANS NZOIA","TRANS NZOIA WEST","62",256,254,510
"43127","TRANS NZOIA","TRANS NZOIA WEST","63",297,310,607
"43128","TRANS NZOIA","TRANS NZOIA WEST","64",193,212,405
"43129","TRANS NZOIA","TRANS NZOIA WEST","60-64",1524,1475,2999
"43130","TRANS NZOIA","TRANS NZOIA WEST","65",283,327,610
"43131","TRANS NZOIA","TRANS NZOIA WEST","66",160,182,342
"43132","TRANS NZOIA","TRANS NZOIA WEST","67",237,273,510
"43133","TRANS NZOIA","TRANS NZOIA WEST","68",95,101,196
"43134","TRANS NZOIA","TRANS NZOIA WEST","69",208,217,425
"43135","TRANS NZOIA","TRANS NZOIA WEST","65-69",983,1100,2083
"43136","TRANS NZOIA","TRANS NZOIA WEST","70",202,205,407
"43137","TRANS NZOIA","TRANS NZOIA WEST","71",167,178,345
"43138","TRANS NZOIA","TRANS NZOIA WEST","72",107,122,229
"43139","TRANS NZOIA","TRANS NZOIA WEST","73",114,137,251
"43140","TRANS NZOIA","TRANS NZOIA WEST","74",87,105,192
"43141","TRANS NZOIA","TRANS NZOIA WEST","70-74",677,747,1424
"43142","TRANS NZOIA","TRANS NZOIA WEST","75",100,131,231
"43143","TRANS NZOIA","TRANS NZOIA WEST","76",81,105,186
"43144","TRANS NZOIA","TRANS NZOIA WEST","77",106,145,251
"43145","TRANS NZOIA","TRANS NZOIA WEST","78",47,64,111
"43146","TRANS NZOIA","TRANS NZOIA WEST","79",59,78,137
"43147","TRANS NZOIA","TRANS NZOIA WEST","75-79",393,523,916
"43148","TRANS NZOIA","TRANS NZOIA WEST","80",62,81,143
"43149","TRANS NZOIA","TRANS NZOIA WEST","81",46,58,104
"43150","TRANS NZOIA","TRANS NZOIA WEST","82",43,42,85
"43151","TRANS NZOIA","TRANS NZOIA WEST","83",56,85,141
"43152","TRANS NZOIA","TRANS NZOIA WEST","84",39,45,84
"43153","TRANS NZOIA","TRANS NZOIA WEST","80-84",246,311,557
"43154","TRANS NZOIA","TRANS NZOIA WEST","85",34,58,92
"43155","TRANS NZOIA","TRANS NZOIA WEST","86",28,42,70
"43156","TRANS NZOIA","TRANS NZOIA WEST","87",31,67,98
"43157","TRANS NZOIA","TRANS NZOIA WEST","88",11,22,33
"43158","TRANS NZOIA","TRANS NZOIA WEST","89",26,53,79
"43159","TRANS NZOIA","TRANS NZOIA WEST","85-89",130,242,372
"43160","TRANS NZOIA","TRANS NZOIA WEST","90",11,24,35
"43161","TRANS NZOIA","TRANS NZOIA WEST","91",17,24,41
"43162","TRANS NZOIA","TRANS NZOIA WEST","92",15,6,21
"43163","TRANS NZOIA","TRANS NZOIA WEST","93",10,18,28
"43164","TRANS NZOIA","TRANS NZOIA WEST","94",7,4,11
"43165","TRANS NZOIA","TRANS NZOIA WEST","90-94",60,76,136
"43166","TRANS NZOIA","TRANS NZOIA WEST","95",16,21,37
"43167","TRANS NZOIA","TRANS NZOIA WEST","96",4,6,10
"43168","TRANS NZOIA","TRANS NZOIA WEST","97",7,12,19
"43169","TRANS NZOIA","TRANS NZOIA WEST","98",3,4,7
"43170","TRANS NZOIA","TRANS NZOIA WEST","99",3,16,19
"43171","TRANS NZOIA","TRANS NZOIA WEST","95-99",33,59,92
"43172","TRANS NZOIA","TRANS NZOIA WEST","100+",2,18,20
"43173","TRANS NZOIA","TRANS NZOIA WEST","Not Stated",NA,2,2
"43174","TRANS NZOIA","TRANS NZOIA EAST","Total",113498,116029,229527
"43175","TRANS NZOIA","TRANS NZOIA EAST","0",2830,2639,5469
"43176","TRANS NZOIA","TRANS NZOIA EAST","1",2834,2691,5525
"43177","TRANS NZOIA","TRANS NZOIA EAST","2",2888,2823,5711
"43178","TRANS NZOIA","TRANS NZOIA EAST","3",3128,3074,6202
"43179","TRANS NZOIA","TRANS NZOIA EAST","4",3310,3054,6364
"43180","TRANS NZOIA","TRANS NZOIA EAST","0 - 4",14990,14281,29271
"43181","TRANS NZOIA","TRANS NZOIA EAST","5",3182,3059,6241
"43182","TRANS NZOIA","TRANS NZOIA EAST","6",3215,3299,6514
"43183","TRANS NZOIA","TRANS NZOIA EAST","7",3311,3270,6581
"43184","TRANS NZOIA","TRANS NZOIA EAST","8",3106,3052,6158
"43185","TRANS NZOIA","TRANS NZOIA EAST","9",3613,3570,7183
"43186","TRANS NZOIA","TRANS NZOIA EAST","5-9",16427,16250,32677
"43187","TRANS NZOIA","TRANS NZOIA EAST","10",3595,3438,7033
"43188","TRANS NZOIA","TRANS NZOIA EAST","11",3414,3360,6774
"43189","TRANS NZOIA","TRANS NZOIA EAST","12",3743,3606,7349
"43190","TRANS NZOIA","TRANS NZOIA EAST","13",3718,3596,7314
"43191","TRANS NZOIA","TRANS NZOIA EAST","14",3508,3550,7058
"43192","TRANS NZOIA","TRANS NZOIA EAST","10 -14",17978,17550,35528
"43193","TRANS NZOIA","TRANS NZOIA EAST","15",3368,3287,6655
"43194","TRANS NZOIA","TRANS NZOIA EAST","16",3243,3166,6409
"43195","TRANS NZOIA","TRANS NZOIA EAST","17",3352,3076,6428
"43196","TRANS NZOIA","TRANS NZOIA EAST","18",2518,2377,4895
"43197","TRANS NZOIA","TRANS NZOIA EAST","19",2886,2530,5416
"43198","TRANS NZOIA","TRANS NZOIA EAST","15-19",15367,14436,29803
"43199","TRANS NZOIA","TRANS NZOIA EAST","20",2374,2270,4644
"43200","TRANS NZOIA","TRANS NZOIA EAST","21",1976,1976,3952
"43201","TRANS NZOIA","TRANS NZOIA EAST","22",1799,1843,3642
"43202","TRANS NZOIA","TRANS NZOIA EAST","23",1727,1864,3591
"43203","TRANS NZOIA","TRANS NZOIA EAST","24",1528,1735,3263
"43204","TRANS NZOIA","TRANS NZOIA EAST","20-24",9404,9688,19092
"43205","TRANS NZOIA","TRANS NZOIA EAST","25",1607,1782,3389
"43206","TRANS NZOIA","TRANS NZOIA EAST","26",1278,1573,2851
"43207","TRANS NZOIA","TRANS NZOIA EAST","27",1360,1498,2858
"43208","TRANS NZOIA","TRANS NZOIA EAST","28",1043,1238,2281
"43209","TRANS NZOIA","TRANS NZOIA EAST","29",1212,1397,2609
"43210","TRANS NZOIA","TRANS NZOIA EAST","25-29",6500,7488,13988
"43211","TRANS NZOIA","TRANS NZOIA EAST","30",1479,1761,3240
"43212","TRANS NZOIA","TRANS NZOIA EAST","31",1130,1323,2453
"43213","TRANS NZOIA","TRANS NZOIA EAST","32",1453,1713,3166
"43214","TRANS NZOIA","TRANS NZOIA EAST","33",1182,1547,2729
"43215","TRANS NZOIA","TRANS NZOIA EAST","34",1132,1334,2466
"43216","TRANS NZOIA","TRANS NZOIA EAST","30-34",6376,7678,14054
"43217","TRANS NZOIA","TRANS NZOIA EAST","35",1519,1578,3097
"43218","TRANS NZOIA","TRANS NZOIA EAST","36",1087,1081,2168
"43219","TRANS NZOIA","TRANS NZOIA EAST","37",1079,1030,2109
"43220","TRANS NZOIA","TRANS NZOIA EAST","38",821,851,1672
"43221","TRANS NZOIA","TRANS NZOIA EAST","39",849,888,1737
"43222","TRANS NZOIA","TRANS NZOIA EAST","35-39",5355,5428,10783
"43223","TRANS NZOIA","TRANS NZOIA EAST","40",1097,1208,2305
"43224","TRANS NZOIA","TRANS NZOIA EAST","41",1024,1112,2136
"43225","TRANS NZOIA","TRANS NZOIA EAST","42",1068,1091,2159
"43226","TRANS NZOIA","TRANS NZOIA EAST","43",956,1046,2002
"43227","TRANS NZOIA","TRANS NZOIA EAST","44",731,780,1511
"43228","TRANS NZOIA","TRANS NZOIA EAST","40-44",4876,5237,10113
"43229","TRANS NZOIA","TRANS NZOIA EAST","45",1091,1162,2253
"43230","TRANS NZOIA","TRANS NZOIA EAST","46",790,851,1641
"43231","TRANS NZOIA","TRANS NZOIA EAST","47",841,888,1729
"43232","TRANS NZOIA","TRANS NZOIA EAST","48",545,570,1115
"43233","TRANS NZOIA","TRANS NZOIA EAST","49",691,738,1429
"43234","TRANS NZOIA","TRANS NZOIA EAST","45-49",3958,4209,8167
"43235","TRANS NZOIA","TRANS NZOIA EAST","50",774,846,1620
"43236","TRANS NZOIA","TRANS NZOIA EAST","51",595,683,1278
"43237","TRANS NZOIA","TRANS NZOIA EAST","52",554,630,1184
"43238","TRANS NZOIA","TRANS NZOIA EAST","53",510,537,1047
"43239","TRANS NZOIA","TRANS NZOIA EAST","54",580,604,1184
"43240","TRANS NZOIA","TRANS NZOIA EAST","50-54",3013,3300,6313
"43241","TRANS NZOIA","TRANS NZOIA EAST","55",560,567,1127
"43242","TRANS NZOIA","TRANS NZOIA EAST","56",540,613,1153
"43243","TRANS NZOIA","TRANS NZOIA EAST","57",549,750,1299
"43244","TRANS NZOIA","TRANS NZOIA EAST","58",509,624,1133
"43245","TRANS NZOIA","TRANS NZOIA EAST","59",586,598,1184
"43246","TRANS NZOIA","TRANS NZOIA EAST","55-59",2744,3152,5896
"43247","TRANS NZOIA","TRANS NZOIA EAST","60",607,603,1210
"43248","TRANS NZOIA","TRANS NZOIA EAST","61",500,505,1005
"43249","TRANS NZOIA","TRANS NZOIA EAST","62",404,375,779
"43250","TRANS NZOIA","TRANS NZOIA EAST","63",433,394,827
"43251","TRANS NZOIA","TRANS NZOIA EAST","64",309,334,643
"43252","TRANS NZOIA","TRANS NZOIA EAST","60-64",2253,2211,4464
"43253","TRANS NZOIA","TRANS NZOIA EAST","65",433,478,911
"43254","TRANS NZOIA","TRANS NZOIA EAST","66",243,267,510
"43255","TRANS NZOIA","TRANS NZOIA EAST","67",397,439,836
"43256","TRANS NZOIA","TRANS NZOIA EAST","68",188,194,382
"43257","TRANS NZOIA","TRANS NZOIA EAST","69",315,333,648
"43258","TRANS NZOIA","TRANS NZOIA EAST","65-69",1576,1711,3287
"43259","TRANS NZOIA","TRANS NZOIA EAST","70",336,435,771
"43260","TRANS NZOIA","TRANS NZOIA EAST","71",290,315,605
"43261","TRANS NZOIA","TRANS NZOIA EAST","72",229,211,440
"43262","TRANS NZOIA","TRANS NZOIA EAST","73",207,206,413
"43263","TRANS NZOIA","TRANS NZOIA EAST","74",153,189,342
"43264","TRANS NZOIA","TRANS NZOIA EAST","70-74",1215,1356,2571
"43265","TRANS NZOIA","TRANS NZOIA EAST","75",144,200,344
"43266","TRANS NZOIA","TRANS NZOIA EAST","76",129,189,318
"43267","TRANS NZOIA","TRANS NZOIA EAST","77",148,179,327
"43268","TRANS NZOIA","TRANS NZOIA EAST","78",88,104,192
"43269","TRANS NZOIA","TRANS NZOIA EAST","79",103,189,292
"43270","TRANS NZOIA","TRANS NZOIA EAST","75-79",612,861,1473
"43271","TRANS NZOIA","TRANS NZOIA EAST","80",137,165,302
"43272","TRANS NZOIA","TRANS NZOIA EAST","81",74,91,165
"43273","TRANS NZOIA","TRANS NZOIA EAST","82",67,94,161
"43274","TRANS NZOIA","TRANS NZOIA EAST","83",90,104,194
"43275","TRANS NZOIA","TRANS NZOIA EAST","84",79,99,178
"43276","TRANS NZOIA","TRANS NZOIA EAST","80-84",447,553,1000
"43277","TRANS NZOIA","TRANS NZOIA EAST","85",46,85,131
"43278","TRANS NZOIA","TRANS NZOIA EAST","86",40,53,93
"43279","TRANS NZOIA","TRANS NZOIA EAST","87",67,91,158
"43280","TRANS NZOIA","TRANS NZOIA EAST","88",35,36,71
"43281","TRANS NZOIA","TRANS NZOIA EAST","89",47,97,144
"43282","TRANS NZOIA","TRANS NZOIA EAST","85-89",235,362,597
"43283","TRANS NZOIA","TRANS NZOIA EAST","90",23,55,78
"43284","TRANS NZOIA","TRANS NZOIA EAST","91",24,32,56
"43285","TRANS NZOIA","TRANS NZOIA EAST","92",19,18,37
"43286","TRANS NZOIA","TRANS NZOIA EAST","93",16,20,36
"43287","TRANS NZOIA","TRANS NZOIA EAST","94",12,19,31
"43288","TRANS NZOIA","TRANS NZOIA EAST","90-94",94,144,238
"43289","TRANS NZOIA","TRANS NZOIA EAST","95",30,37,67
"43290","TRANS NZOIA","TRANS NZOIA EAST","96",10,17,27
"43291","TRANS NZOIA","TRANS NZOIA EAST","97",14,17,31
"43292","TRANS NZOIA","TRANS NZOIA EAST","98",6,7,13
"43293","TRANS NZOIA","TRANS NZOIA EAST","99",9,19,28
"43294","TRANS NZOIA","TRANS NZOIA EAST","95-99",69,97,166
"43295","TRANS NZOIA","TRANS NZOIA EAST","100+",9,37,46
"43296","TRANS NZOIA","TRANS NZOIA EAST","Not Stated",NA,NA,NA
"43297","TRANS NZOIA","KWANZA","Total",100234,103584,203818
"43298","TRANS NZOIA","KWANZA","0",2089,2083,4172
"43299","TRANS NZOIA","KWANZA","1",2770,2837,5607
"43300","TRANS NZOIA","KWANZA","2",2674,2671,5345
"43301","TRANS NZOIA","KWANZA","3",2973,2935,5908
"43302","TRANS NZOIA","KWANZA","4",2919,2952,5871
"43303","TRANS NZOIA","KWANZA","0 - 4",13425,13478,26903
"43304","TRANS NZOIA","KWANZA","5",3024,2841,5865
"43305","TRANS NZOIA","KWANZA","6",3009,2985,5994
"43306","TRANS NZOIA","KWANZA","7",3091,3076,6167
"43307","TRANS NZOIA","KWANZA","8",2891,2825,5716
"43308","TRANS NZOIA","KWANZA","9",3321,3173,6494
"43309","TRANS NZOIA","KWANZA","5-9",15336,14900,30236
"43310","TRANS NZOIA","KWANZA","10",3287,3060,6347
"43311","TRANS NZOIA","KWANZA","11",2981,3107,6088
"43312","TRANS NZOIA","KWANZA","12",3229,3123,6352
"43313","TRANS NZOIA","KWANZA","13",3187,3225,6412
"43314","TRANS NZOIA","KWANZA","14",3181,3075,6256
"43315","TRANS NZOIA","KWANZA","10 -14",15865,15590,31455
"43316","TRANS NZOIA","KWANZA","15",2926,2931,5857
"43317","TRANS NZOIA","KWANZA","16",2693,2673,5366
"43318","TRANS NZOIA","KWANZA","17",2844,2600,5444
"43319","TRANS NZOIA","KWANZA","18",2089,2009,4098
"43320","TRANS NZOIA","KWANZA","19",2374,2193,4567
"43321","TRANS NZOIA","KWANZA","15-19",12926,12406,25332
"43322","TRANS NZOIA","KWANZA","20",1892,2045,3937
"43323","TRANS NZOIA","KWANZA","21",1612,1677,3289
"43324","TRANS NZOIA","KWANZA","22",1541,1700,3241
"43325","TRANS NZOIA","KWANZA","23",1495,1803,3298
"43326","TRANS NZOIA","KWANZA","24",1333,1588,2921
"43327","TRANS NZOIA","KWANZA","20-24",7873,8813,16686
"43328","TRANS NZOIA","KWANZA","25",1442,1777,3219
"43329","TRANS NZOIA","KWANZA","26",1189,1543,2732
"43330","TRANS NZOIA","KWANZA","27",1283,1548,2831
"43331","TRANS NZOIA","KWANZA","28",1077,1262,2339
"43332","TRANS NZOIA","KWANZA","29",1159,1386,2545
"43333","TRANS NZOIA","KWANZA","25-29",6150,7516,13666
"43334","TRANS NZOIA","KWANZA","30",1374,1695,3069
"43335","TRANS NZOIA","KWANZA","31",1005,1149,2154
"43336","TRANS NZOIA","KWANZA","32",1357,1562,2919
"43337","TRANS NZOIA","KWANZA","33",1025,1332,2357
"43338","TRANS NZOIA","KWANZA","34",1049,1175,2224
"43339","TRANS NZOIA","KWANZA","30-34",5810,6913,12723
"43340","TRANS NZOIA","KWANZA","35",1300,1364,2664
"43341","TRANS NZOIA","KWANZA","36",945,986,1931
"43342","TRANS NZOIA","KWANZA","37",1006,926,1932
"43343","TRANS NZOIA","KWANZA","38",763,746,1509
"43344","TRANS NZOIA","KWANZA","39",926,821,1747
"43345","TRANS NZOIA","KWANZA","35-39",4940,4843,9783
"43346","TRANS NZOIA","KWANZA","40",1078,990,2068
"43347","TRANS NZOIA","KWANZA","41",920,935,1855
"43348","TRANS NZOIA","KWANZA","42",1009,937,1946
"43349","TRANS NZOIA","KWANZA","43",859,866,1725
"43350","TRANS NZOIA","KWANZA","44",658,665,1323
"43351","TRANS NZOIA","KWANZA","40-44",4524,4393,8917
"43352","TRANS NZOIA","KWANZA","45",887,919,1806
"43353","TRANS NZOIA","KWANZA","46",652,635,1287
"43354","TRANS NZOIA","KWANZA","47",699,710,1409
"43355","TRANS NZOIA","KWANZA","48",518,545,1063
"43356","TRANS NZOIA","KWANZA","49",580,551,1131
"43357","TRANS NZOIA","KWANZA","45-49",3336,3360,6696
"43358","TRANS NZOIA","KWANZA","50",666,727,1393
"43359","TRANS NZOIA","KWANZA","51",505,599,1104
"43360","TRANS NZOIA","KWANZA","52",483,532,1015
"43361","TRANS NZOIA","KWANZA","53",451,506,957
"43362","TRANS NZOIA","KWANZA","54",440,468,908
"43363","TRANS NZOIA","KWANZA","50-54",2545,2832,5377
"43364","TRANS NZOIA","KWANZA","55",457,475,932
"43365","TRANS NZOIA","KWANZA","56",418,518,936
"43366","TRANS NZOIA","KWANZA","57",427,618,1045
"43367","TRANS NZOIA","KWANZA","58",358,470,828
"43368","TRANS NZOIA","KWANZA","59",461,458,919
"43369","TRANS NZOIA","KWANZA","55-59",2121,2539,4660
"43370","TRANS NZOIA","KWANZA","60",478,508,986
"43371","TRANS NZOIA","KWANZA","61",396,446,842
"43372","TRANS NZOIA","KWANZA","62",317,346,663
"43373","TRANS NZOIA","KWANZA","63",365,427,792
"43374","TRANS NZOIA","KWANZA","64",277,300,577
"43375","TRANS NZOIA","KWANZA","60-64",1833,2027,3860
"43376","TRANS NZOIA","KWANZA","65",364,379,743
"43377","TRANS NZOIA","KWANZA","66",221,246,467
"43378","TRANS NZOIA","KWANZA","67",337,373,710
"43379","TRANS NZOIA","KWANZA","68",164,137,301
"43380","TRANS NZOIA","KWANZA","69",277,268,545
"43381","TRANS NZOIA","KWANZA","65-69",1363,1403,2766
"43382","TRANS NZOIA","KWANZA","70",256,299,555
"43383","TRANS NZOIA","KWANZA","71",222,244,466
"43384","TRANS NZOIA","KWANZA","72",195,197,392
"43385","TRANS NZOIA","KWANZA","73",179,181,360
"43386","TRANS NZOIA","KWANZA","74",131,157,288
"43387","TRANS NZOIA","KWANZA","70-74",983,1078,2061
"43388","TRANS NZOIA","KWANZA","75",134,165,299
"43389","TRANS NZOIA","KWANZA","76",122,151,273
"43390","TRANS NZOIA","KWANZA","77",128,152,280
"43391","TRANS NZOIA","KWANZA","78",81,84,165
"43392","TRANS NZOIA","KWANZA","79",78,100,178
"43393","TRANS NZOIA","KWANZA","75-79",543,652,1195
"43394","TRANS NZOIA","KWANZA","80",105,135,240
"43395","TRANS NZOIA","KWANZA","81",64,75,139
"43396","TRANS NZOIA","KWANZA","82",58,67,125
"43397","TRANS NZOIA","KWANZA","83",77,91,168
"43398","TRANS NZOIA","KWANZA","84",48,52,100
"43399","TRANS NZOIA","KWANZA","80-84",352,420,772
"43400","TRANS NZOIA","KWANZA","85",51,58,109
"43401","TRANS NZOIA","KWANZA","86",36,48,84
"43402","TRANS NZOIA","KWANZA","87",44,62,106
"43403","TRANS NZOIA","KWANZA","88",23,22,45
"43404","TRANS NZOIA","KWANZA","89",46,68,114
"43405","TRANS NZOIA","KWANZA","85-89",200,258,458
"43406","TRANS NZOIA","KWANZA","90",12,29,41
"43407","TRANS NZOIA","KWANZA","91",24,26,50
"43408","TRANS NZOIA","KWANZA","92",15,15,30
"43409","TRANS NZOIA","KWANZA","93",9,11,20
"43410","TRANS NZOIA","KWANZA","94",6,11,17
"43411","TRANS NZOIA","KWANZA","90-94",66,92,158
"43412","TRANS NZOIA","KWANZA","95",14,20,34
"43413","TRANS NZOIA","KWANZA","96",5,9,14
"43414","TRANS NZOIA","KWANZA","97",6,11,17
"43415","TRANS NZOIA","KWANZA","98",2,3,5
"43416","TRANS NZOIA","KWANZA","99",6,7,13
"43417","TRANS NZOIA","KWANZA","95-99",33,50,83
"43418","TRANS NZOIA","KWANZA","100+",9,21,30
"43419","TRANS NZOIA","KWANZA","Not Stated",1,NA,1
"43420","TRANS NZOIA","ENDEBESS","Total",56090,55689,111779
"43421","TRANS NZOIA","ENDEBESS","0",1579,1569,3148
"43422","TRANS NZOIA","ENDEBESS","1",1489,1519,3008
"43423","TRANS NZOIA","ENDEBESS","2",1533,1546,3079
"43424","TRANS NZOIA","ENDEBESS","3",1720,1704,3424
"43425","TRANS NZOIA","ENDEBESS","4",1757,1646,3403
"43426","TRANS NZOIA","ENDEBESS","0 - 4",8078,7984,16062
"43427","TRANS NZOIA","ENDEBESS","5",1877,1790,3667
"43428","TRANS NZOIA","ENDEBESS","6",1859,1819,3678
"43429","TRANS NZOIA","ENDEBESS","7",1686,1742,3428
"43430","TRANS NZOIA","ENDEBESS","8",1666,1727,3393
"43431","TRANS NZOIA","ENDEBESS","9",1890,1825,3715
"43432","TRANS NZOIA","ENDEBESS","5-9",8978,8903,17881
"43433","TRANS NZOIA","ENDEBESS","10",1905,1860,3765
"43434","TRANS NZOIA","ENDEBESS","11",1665,1720,3385
"43435","TRANS NZOIA","ENDEBESS","12",1924,1770,3694
"43436","TRANS NZOIA","ENDEBESS","13",1841,1756,3597
"43437","TRANS NZOIA","ENDEBESS","14",1724,1584,3308
"43438","TRANS NZOIA","ENDEBESS","10 -14",9059,8690,17749
"43439","TRANS NZOIA","ENDEBESS","15",1724,1586,3310
"43440","TRANS NZOIA","ENDEBESS","16",1497,1481,2978
"43441","TRANS NZOIA","ENDEBESS","17",1572,1474,3046
"43442","TRANS NZOIA","ENDEBESS","18",1176,973,2149
"43443","TRANS NZOIA","ENDEBESS","19",1286,1233,2519
"43444","TRANS NZOIA","ENDEBESS","15-19",7255,6747,14002
"43445","TRANS NZOIA","ENDEBESS","20",1042,1132,2174
"43446","TRANS NZOIA","ENDEBESS","21",838,985,1823
"43447","TRANS NZOIA","ENDEBESS","22",851,969,1820
"43448","TRANS NZOIA","ENDEBESS","23",911,975,1886
"43449","TRANS NZOIA","ENDEBESS","24",783,789,1572
"43450","TRANS NZOIA","ENDEBESS","20-24",4425,4850,9275
"43451","TRANS NZOIA","ENDEBESS","25",899,865,1764
"43452","TRANS NZOIA","ENDEBESS","26",714,759,1473
"43453","TRANS NZOIA","ENDEBESS","27",780,837,1617
"43454","TRANS NZOIA","ENDEBESS","28",565,584,1149
"43455","TRANS NZOIA","ENDEBESS","29",686,695,1381
"43456","TRANS NZOIA","ENDEBESS","25-29",3644,3740,7384
"43457","TRANS NZOIA","ENDEBESS","30",717,802,1519
"43458","TRANS NZOIA","ENDEBESS","31",626,703,1329
"43459","TRANS NZOIA","ENDEBESS","32",785,840,1625
"43460","TRANS NZOIA","ENDEBESS","33",654,662,1316
"43461","TRANS NZOIA","ENDEBESS","34",535,560,1095
"43462","TRANS NZOIA","ENDEBESS","30-34",3317,3567,6884
"43463","TRANS NZOIA","ENDEBESS","35",728,665,1393
"43464","TRANS NZOIA","ENDEBESS","36",442,462,904
"43465","TRANS NZOIA","ENDEBESS","37",527,450,977
"43466","TRANS NZOIA","ENDEBESS","38",400,318,718
"43467","TRANS NZOIA","ENDEBESS","39",468,388,856
"43468","TRANS NZOIA","ENDEBESS","35-39",2565,2283,4848
"43469","TRANS NZOIA","ENDEBESS","40",481,425,906
"43470","TRANS NZOIA","ENDEBESS","41",472,511,983
"43471","TRANS NZOIA","ENDEBESS","42",508,503,1011
"43472","TRANS NZOIA","ENDEBESS","43",436,500,936
"43473","TRANS NZOIA","ENDEBESS","44",325,351,676
"43474","TRANS NZOIA","ENDEBESS","40-44",2222,2290,4512
"43475","TRANS NZOIA","ENDEBESS","45",481,461,942
"43476","TRANS NZOIA","ENDEBESS","46",406,335,741
"43477","TRANS NZOIA","ENDEBESS","47",365,352,717
"43478","TRANS NZOIA","ENDEBESS","48",248,250,498
"43479","TRANS NZOIA","ENDEBESS","49",293,264,557
"43480","TRANS NZOIA","ENDEBESS","45-49",1793,1662,3455
"43481","TRANS NZOIA","ENDEBESS","50",294,301,595
"43482","TRANS NZOIA","ENDEBESS","51",292,296,588
"43483","TRANS NZOIA","ENDEBESS","52",262,234,496
"43484","TRANS NZOIA","ENDEBESS","53",246,252,498
"43485","TRANS NZOIA","ENDEBESS","54",213,234,447
"43486","TRANS NZOIA","ENDEBESS","50-54",1307,1317,2624
"43487","TRANS NZOIA","ENDEBESS","55",220,223,443
"43488","TRANS NZOIA","ENDEBESS","56",201,209,410
"43489","TRANS NZOIA","ENDEBESS","57",216,273,489
"43490","TRANS NZOIA","ENDEBESS","58",184,199,383
"43491","TRANS NZOIA","ENDEBESS","59",257,244,501
"43492","TRANS NZOIA","ENDEBESS","55-59",1078,1148,2226
"43493","TRANS NZOIA","ENDEBESS","60",222,206,428
"43494","TRANS NZOIA","ENDEBESS","61",206,187,393
"43495","TRANS NZOIA","ENDEBESS","62",154,147,301
"43496","TRANS NZOIA","ENDEBESS","63",191,190,381
"43497","TRANS NZOIA","ENDEBESS","64",107,111,218
"43498","TRANS NZOIA","ENDEBESS","60-64",880,841,1721
"43499","TRANS NZOIA","ENDEBESS","65",154,176,330
"43500","TRANS NZOIA","ENDEBESS","66",107,93,200
"43501","TRANS NZOIA","ENDEBESS","67",140,159,299
"43502","TRANS NZOIA","ENDEBESS","68",71,55,126
"43503","TRANS NZOIA","ENDEBESS","69",113,111,224
"43504","TRANS NZOIA","ENDEBESS","65-69",585,594,1179
"43505","TRANS NZOIA","ENDEBESS","70",95,111,206
"43506","TRANS NZOIA","ENDEBESS","71",96,99,195
"43507","TRANS NZOIA","ENDEBESS","72",75,59,134
"43508","TRANS NZOIA","ENDEBESS","73",67,71,138
"43509","TRANS NZOIA","ENDEBESS","74",61,67,128
"43510","TRANS NZOIA","ENDEBESS","70-74",394,407,801
"43511","TRANS NZOIA","ENDEBESS","75",63,73,136
"43512","TRANS NZOIA","ENDEBESS","76",45,55,100
"43513","TRANS NZOIA","ENDEBESS","77",54,68,122
"43514","TRANS NZOIA","ENDEBESS","78",29,25,54
"43515","TRANS NZOIA","ENDEBESS","79",24,68,92
"43516","TRANS NZOIA","ENDEBESS","75-79",215,289,504
"43517","TRANS NZOIA","ENDEBESS","80",49,54,103
"43518","TRANS NZOIA","ENDEBESS","81",23,37,60
"43519","TRANS NZOIA","ENDEBESS","82",26,21,47
"43520","TRANS NZOIA","ENDEBESS","83",44,22,66
"43521","TRANS NZOIA","ENDEBESS","84",9,24,33
"43522","TRANS NZOIA","ENDEBESS","80-84",151,158,309
"43523","TRANS NZOIA","ENDEBESS","85",23,35,58
"43524","TRANS NZOIA","ENDEBESS","86",14,20,34
"43525","TRANS NZOIA","ENDEBESS","87",20,17,37
"43526","TRANS NZOIA","ENDEBESS","88",10,11,21
"43527","TRANS NZOIA","ENDEBESS","89",19,35,54
"43528","TRANS NZOIA","ENDEBESS","85-89",86,118,204
"43529","TRANS NZOIA","ENDEBESS","90",5,16,21
"43530","TRANS NZOIA","ENDEBESS","91",10,13,23
"43531","TRANS NZOIA","ENDEBESS","92",2,3,5
"43532","TRANS NZOIA","ENDEBESS","93",8,11,19
"43533","TRANS NZOIA","ENDEBESS","94",4,8,12
"43534","TRANS NZOIA","ENDEBESS","90-94",29,51,80
"43535","TRANS NZOIA","ENDEBESS","95",13,16,29
"43536","TRANS NZOIA","ENDEBESS","96",NA,3,3
"43537","TRANS NZOIA","ENDEBESS","97",7,2,9
"43538","TRANS NZOIA","ENDEBESS","98",4,3,7
"43539","TRANS NZOIA","ENDEBESS","99",2,9,11
"43540","TRANS NZOIA","ENDEBESS","95-99",26,33,59
"43541","TRANS NZOIA","ENDEBESS","100+",3,17,20
"43542","TRANS NZOIA","ENDEBESS","Not Stated",NA,NA,NA
"43543","TRANS NZOIA","KIMININI","Total",118087,124730,242817
"43544","TRANS NZOIA","KIMININI","0",2951,2963,5914
"43545","TRANS NZOIA","KIMININI","1",2844,2955,5799
"43546","TRANS NZOIA","KIMININI","2",3053,2888,5941
"43547","TRANS NZOIA","KIMININI","3",3120,3223,6343
"43548","TRANS NZOIA","KIMININI","4",3186,3119,6305
"43549","TRANS NZOIA","KIMININI","0 - 4",15154,15148,30302
"43550","TRANS NZOIA","KIMININI","5",3255,3230,6485
"43551","TRANS NZOIA","KIMININI","6",3340,3319,6659
"43552","TRANS NZOIA","KIMININI","7",3297,3357,6654
"43553","TRANS NZOIA","KIMININI","8",3110,3351,6461
"43554","TRANS NZOIA","KIMININI","9",3514,3459,6973
"43555","TRANS NZOIA","KIMININI","5-9",16516,16716,33232
"43556","TRANS NZOIA","KIMININI","10",3686,3659,7345
"43557","TRANS NZOIA","KIMININI","11",3170,3502,6672
"43558","TRANS NZOIA","KIMININI","12",3574,3677,7251
"43559","TRANS NZOIA","KIMININI","13",3672,3649,7321
"43560","TRANS NZOIA","KIMININI","14",3558,3536,7094
"43561","TRANS NZOIA","KIMININI","10 -14",17660,18023,35683
"43562","TRANS NZOIA","KIMININI","15",3457,3429,6886
"43563","TRANS NZOIA","KIMININI","16",3233,3195,6428
"43564","TRANS NZOIA","KIMININI","17",3473,3268,6741
"43565","TRANS NZOIA","KIMININI","18",2720,2527,5247
"43566","TRANS NZOIA","KIMININI","19",2852,2757,5609
"43567","TRANS NZOIA","KIMININI","15-19",15735,15176,30911
"43568","TRANS NZOIA","KIMININI","20",2403,2482,4885
"43569","TRANS NZOIA","KIMININI","21",2042,2159,4201
"43570","TRANS NZOIA","KIMININI","22",1923,2187,4110
"43571","TRANS NZOIA","KIMININI","23",1918,2289,4207
"43572","TRANS NZOIA","KIMININI","24",1750,2052,3802
"43573","TRANS NZOIA","KIMININI","20-24",10036,11169,21205
"43574","TRANS NZOIA","KIMININI","25",1888,2190,4078
"43575","TRANS NZOIA","KIMININI","26",1418,1792,3210
"43576","TRANS NZOIA","KIMININI","27",1594,1889,3483
"43577","TRANS NZOIA","KIMININI","28",1237,1581,2818
"43578","TRANS NZOIA","KIMININI","29",1480,1754,3234
"43579","TRANS NZOIA","KIMININI","25-29",7617,9206,16823
"43580","TRANS NZOIA","KIMININI","30",1754,2103,3857
"43581","TRANS NZOIA","KIMININI","31",1295,1577,2872
"43582","TRANS NZOIA","KIMININI","32",1674,1981,3655
"43583","TRANS NZOIA","KIMININI","33",1405,1753,3158
"43584","TRANS NZOIA","KIMININI","34",1303,1505,2808
"43585","TRANS NZOIA","KIMININI","30-34",7431,8919,16350
"43586","TRANS NZOIA","KIMININI","35",1617,1590,3207
"43587","TRANS NZOIA","KIMININI","36",1144,1280,2424
"43588","TRANS NZOIA","KIMININI","37",1222,1182,2404
"43589","TRANS NZOIA","KIMININI","38",975,958,1933
"43590","TRANS NZOIA","KIMININI","39",1017,1051,2068
"43591","TRANS NZOIA","KIMININI","35-39",5975,6061,12036
"43592","TRANS NZOIA","KIMININI","40",1229,1229,2458
"43593","TRANS NZOIA","KIMININI","41",1175,1289,2464
"43594","TRANS NZOIA","KIMININI","42",1201,1289,2490
"43595","TRANS NZOIA","KIMININI","43",1083,1189,2272
"43596","TRANS NZOIA","KIMININI","44",789,834,1623
"43597","TRANS NZOIA","KIMININI","40-44",5477,5830,11307
"43598","TRANS NZOIA","KIMININI","45",1144,1212,2356
"43599","TRANS NZOIA","KIMININI","46",811,856,1667
"43600","TRANS NZOIA","KIMININI","47",829,890,1719
"43601","TRANS NZOIA","KIMININI","48",623,631,1254
"43602","TRANS NZOIA","KIMININI","49",705,776,1481
"43603","TRANS NZOIA","KIMININI","45-49",4112,4365,8477
"43604","TRANS NZOIA","KIMININI","50",791,841,1632
"43605","TRANS NZOIA","KIMININI","51",702,791,1493
"43606","TRANS NZOIA","KIMININI","52",621,716,1337
"43607","TRANS NZOIA","KIMININI","53",516,619,1135
"43608","TRANS NZOIA","KIMININI","54",549,671,1220
"43609","TRANS NZOIA","KIMININI","50-54",3179,3638,6817
"43610","TRANS NZOIA","KIMININI","55",616,588,1204
"43611","TRANS NZOIA","KIMININI","56",540,648,1188
"43612","TRANS NZOIA","KIMININI","57",568,820,1388
"43613","TRANS NZOIA","KIMININI","58",497,522,1019
"43614","TRANS NZOIA","KIMININI","59",635,685,1320
"43615","TRANS NZOIA","KIMININI","55-59",2856,3263,6119
"43616","TRANS NZOIA","KIMININI","60",594,651,1245
"43617","TRANS NZOIA","KIMININI","61",508,532,1040
"43618","TRANS NZOIA","KIMININI","62",442,481,923
"43619","TRANS NZOIA","KIMININI","63",470,508,978
"43620","TRANS NZOIA","KIMININI","64",303,356,659
"43621","TRANS NZOIA","KIMININI","60-64",2317,2528,4845
"43622","TRANS NZOIA","KIMININI","65",442,475,917
"43623","TRANS NZOIA","KIMININI","66",267,294,561
"43624","TRANS NZOIA","KIMININI","67",375,442,817
"43625","TRANS NZOIA","KIMININI","68",213,209,422
"43626","TRANS NZOIA","KIMININI","69",333,312,645
"43627","TRANS NZOIA","KIMININI","65-69",1630,1732,3362
"43628","TRANS NZOIA","KIMININI","70",287,321,608
"43629","TRANS NZOIA","KIMININI","71",264,286,550
"43630","TRANS NZOIA","KIMININI","72",206,165,371
"43631","TRANS NZOIA","KIMININI","73",193,230,423
"43632","TRANS NZOIA","KIMININI","74",152,188,340
"43633","TRANS NZOIA","KIMININI","70-74",1102,1190,2292
"43634","TRANS NZOIA","KIMININI","75",160,170,330
"43635","TRANS NZOIA","KIMININI","76",106,152,258
"43636","TRANS NZOIA","KIMININI","77",148,189,337
"43637","TRANS NZOIA","KIMININI","78",81,88,169
"43638","TRANS NZOIA","KIMININI","79",89,136,225
"43639","TRANS NZOIA","KIMININI","75-79",584,735,1319
"43640","TRANS NZOIA","KIMININI","80",104,147,251
"43641","TRANS NZOIA","KIMININI","81",63,88,151
"43642","TRANS NZOIA","KIMININI","82",65,94,159
"43643","TRANS NZOIA","KIMININI","83",77,98,175
"43644","TRANS NZOIA","KIMININI","84",53,73,126
"43645","TRANS NZOIA","KIMININI","80-84",362,500,862
"43646","TRANS NZOIA","KIMININI","85",62,90,152
"43647","TRANS NZOIA","KIMININI","86",33,51,84
"43648","TRANS NZOIA","KIMININI","87",69,97,166
"43649","TRANS NZOIA","KIMININI","88",29,23,52
"43650","TRANS NZOIA","KIMININI","89",42,77,119
"43651","TRANS NZOIA","KIMININI","85-89",235,338,573
"43652","TRANS NZOIA","KIMININI","90",9,26,35
"43653","TRANS NZOIA","KIMININI","91",27,26,53
"43654","TRANS NZOIA","KIMININI","92",13,9,22
"43655","TRANS NZOIA","KIMININI","93",15,20,35
"43656","TRANS NZOIA","KIMININI","94",9,10,19
"43657","TRANS NZOIA","KIMININI","90-94",73,91,164
"43658","TRANS NZOIA","KIMININI","95",11,25,36
"43659","TRANS NZOIA","KIMININI","96",6,16,22
"43660","TRANS NZOIA","KIMININI","97",7,10,17
"43661","TRANS NZOIA","KIMININI","98",NA,9,9
"43662","TRANS NZOIA","KIMININI","99",4,9,13
"43663","TRANS NZOIA","KIMININI","95-99",28,69,97
"43664","TRANS NZOIA","KIMININI","100+",8,32,40
"43665","TRANS NZOIA","KIMININI","Not Stated",NA,1,1
"43666","TURKANA","ALL","Total",478087,448868,926955
"43667","TURKANA","ALL","0",9945,9883,19828
"43668","TURKANA","ALL","1",11069,10750,21819
"43669","TURKANA","ALL","2",14501,14403,28904
"43670","TURKANA","ALL","3",15092,14998,30090
"43671","TURKANA","ALL","4",15544,15244,30788
"43672","TURKANA","ALL","0 - 4",66151,65278,131429
"43673","TURKANA","ALL","5",16240,15570,31810
"43674","TURKANA","ALL","6",15752,15207,30959
"43675","TURKANA","ALL","7",13655,13076,26731
"43676","TURKANA","ALL","8",16151,15481,31632
"43677","TURKANA","ALL","9",12241,11752,23993
"43678","TURKANA","ALL","5-9",74039,71086,145125
"43679","TURKANA","ALL","10",20635,19553,40188
"43680","TURKANA","ALL","11",10173,10730,20903
"43681","TURKANA","ALL","12",17278,14355,31633
"43682","TURKANA","ALL","13",13244,11213,24457
"43683","TURKANA","ALL","14",13783,11294,25077
"43684","TURKANA","ALL","10 -14",75113,67145,142258
"43685","TURKANA","ALL","15",17535,13559,31094
"43686","TURKANA","ALL","16",13211,10511,23722
"43687","TURKANA","ALL","17",12581,9283,21864
"43688","TURKANA","ALL","18",13631,10768,24399
"43689","TURKANA","ALL","19",9965,8279,18244
"43690","TURKANA","ALL","15-19",66923,52400,119323
"43691","TURKANA","ALL","20",16833,13535,30368
"43692","TURKANA","ALL","21",8319,7225,15544
"43693","TURKANA","ALL","22",9120,8108,17228
"43694","TURKANA","ALL","23",8462,7559,16021
"43695","TURKANA","ALL","24",8249,7180,15429
"43696","TURKANA","ALL","20-24",50983,43607,94590
"43697","TURKANA","ALL","25",11861,10385,22246
"43698","TURKANA","ALL","26",6989,7259,14248
"43699","TURKANA","ALL","27",6929,6782,13711
"43700","TURKANA","ALL","28",6697,6095,12792
"43701","TURKANA","ALL","29",6380,6440,12820
"43702","TURKANA","ALL","25-29",38856,36961,75817
"43703","TURKANA","ALL","30",11421,11283,22704
"43704","TURKANA","ALL","31",3850,4249,8099
"43705","TURKANA","ALL","32",5189,5303,10492
"43706","TURKANA","ALL","33",3710,4288,7998
"43707","TURKANA","ALL","34",3774,4228,8002
"43708","TURKANA","ALL","30-34",27944,29351,57295
"43709","TURKANA","ALL","35",6749,6853,13602
"43710","TURKANA","ALL","36",3240,3663,6903
"43711","TURKANA","ALL","37",2932,3090,6022
"43712","TURKANA","ALL","38",2748,2864,5612
"43713","TURKANA","ALL","39",3686,4162,7848
"43714","TURKANA","ALL","35-39",19355,20632,39987
"43715","TURKANA","ALL","40",7027,5651,12678
"43716","TURKANA","ALL","41",2706,3274,5980
"43717","TURKANA","ALL","42",3175,3097,6272
"43718","TURKANA","ALL","43",2059,2313,4372
"43719","TURKANA","ALL","44",1782,1984,3766
"43720","TURKANA","ALL","40-44",16749,16319,33068
"43721","TURKANA","ALL","45",4205,3852,8057
"43722","TURKANA","ALL","46",2197,2600,4797
"43723","TURKANA","ALL","47",1846,1710,3556
"43724","TURKANA","ALL","48",1532,1393,2925
"43725","TURKANA","ALL","49",2075,2222,4297
"43726","TURKANA","ALL","45-49",11855,11777,23632
"43727","TURKANA","ALL","50",4240,3618,7858
"43728","TURKANA","ALL","51",1233,1319,2552
"43729","TURKANA","ALL","52",1341,1237,2578
"43730","TURKANA","ALL","53",931,960,1891
"43731","TURKANA","ALL","54",1170,1338,2508
"43732","TURKANA","ALL","50-54",8915,8472,17387
"43733","TURKANA","ALL","55",1488,1452,2940
"43734","TURKANA","ALL","56",1287,1285,2572
"43735","TURKANA","ALL","57",850,933,1783
"43736","TURKANA","ALL","58",759,828,1587
"43737","TURKANA","ALL","59",1290,1837,3127
"43738","TURKANA","ALL","55-59",5674,6335,12009
"43739","TURKANA","ALL","60",2465,2499,4964
"43740","TURKANA","ALL","61",892,1207,2099
"43741","TURKANA","ALL","62",760,857,1617
"43742","TURKANA","ALL","63",763,1106,1869
"43743","TURKANA","ALL","64",573,686,1259
"43744","TURKANA","ALL","60-64",5453,6355,11808
"43745","TURKANA","ALL","65",1059,1364,2423
"43746","TURKANA","ALL","66",428,493,921
"43747","TURKANA","ALL","67",621,737,1358
"43748","TURKANA","ALL","68",466,496,962
"43749","TURKANA","ALL","69",981,1453,2434
"43750","TURKANA","ALL","65-69",3555,4543,8098
"43751","TURKANA","ALL","70",1505,1708,3213
"43752","TURKANA","ALL","71",488,838,1326
"43753","TURKANA","ALL","72",422,533,955
"43754","TURKANA","ALL","73",301,474,775
"43755","TURKANA","ALL","74",555,699,1254
"43756","TURKANA","ALL","70-74",3271,4252,7523
"43757","TURKANA","ALL","75",421,491,912
"43758","TURKANA","ALL","76",221,279,500
"43759","TURKANA","ALL","77",220,311,531
"43760","TURKANA","ALL","78",192,237,429
"43761","TURKANA","ALL","79",520,695,1215
"43762","TURKANA","ALL","75-79",1574,2013,3587
"43763","TURKANA","ALL","80",519,625,1144
"43764","TURKANA","ALL","81",142,238,380
"43765","TURKANA","ALL","82",76,110,186
"43766","TURKANA","ALL","83",77,158,235
"43767","TURKANA","ALL","84",108,178,286
"43768","TURKANA","ALL","80-84",922,1309,2231
"43769","TURKANA","ALL","85",132,152,284
"43770","TURKANA","ALL","86",46,63,109
"43771","TURKANA","ALL","87",78,78,156
"43772","TURKANA","ALL","88",31,45,76
"43773","TURKANA","ALL","89",194,276,470
"43774","TURKANA","ALL","85-89",481,614,1095
"43775","TURKANA","ALL","90",74,120,194
"43776","TURKANA","ALL","91",36,49,85
"43777","TURKANA","ALL","92",19,19,38
"43778","TURKANA","ALL","93",8,30,38
"43779","TURKANA","ALL","94",24,25,49
"43780","TURKANA","ALL","90-94",161,243,404
"43781","TURKANA","ALL","95",25,47,72
"43782","TURKANA","ALL","96",12,16,28
"43783","TURKANA","ALL","97",9,15,24
"43784","TURKANA","ALL","98",11,10,21
"43785","TURKANA","ALL","99",24,29,53
"43786","TURKANA","ALL","95-99",81,117,198
"43787","TURKANA","ALL","100+",31,57,88
"43788","TURKANA","ALL","Not Stated",1,2,3
"43789","TURKANA","KIBISH","Total",18651,18117,36768
"43790","TURKANA","KIBISH","0",321,323,644
"43791","TURKANA","KIBISH","1",463,437,900
"43792","TURKANA","KIBISH","2",602,664,1266
"43793","TURKANA","KIBISH","3",674,694,1368
"43794","TURKANA","KIBISH","4",683,671,1354
"43795","TURKANA","KIBISH","0 - 4",2743,2789,5532
"43796","TURKANA","KIBISH","5",724,721,1445
"43797","TURKANA","KIBISH","6",695,665,1360
"43798","TURKANA","KIBISH","7",574,560,1134
"43799","TURKANA","KIBISH","8",731,697,1428
"43800","TURKANA","KIBISH","9",509,439,948
"43801","TURKANA","KIBISH","5-9",3233,3082,6315
"43802","TURKANA","KIBISH","10",979,903,1882
"43803","TURKANA","KIBISH","11",359,397,756
"43804","TURKANA","KIBISH","12",718,588,1306
"43805","TURKANA","KIBISH","13",512,398,910
"43806","TURKANA","KIBISH","14",520,412,932
"43807","TURKANA","KIBISH","10 -14",3088,2698,5786
"43808","TURKANA","KIBISH","15",781,614,1395
"43809","TURKANA","KIBISH","16",497,378,875
"43810","TURKANA","KIBISH","17",494,327,821
"43811","TURKANA","KIBISH","18",585,441,1026
"43812","TURKANA","KIBISH","19",357,326,683
"43813","TURKANA","KIBISH","15-19",2714,2086,4800
"43814","TURKANA","KIBISH","20",739,547,1286
"43815","TURKANA","KIBISH","21",324,256,580
"43816","TURKANA","KIBISH","22",343,296,639
"43817","TURKANA","KIBISH","23",338,339,677
"43818","TURKANA","KIBISH","24",363,303,666
"43819","TURKANA","KIBISH","20-24",2107,1741,3848
"43820","TURKANA","KIBISH","25",391,394,785
"43821","TURKANA","KIBISH","26",225,279,504
"43822","TURKANA","KIBISH","27",231,279,510
"43823","TURKANA","KIBISH","28",241,237,478
"43824","TURKANA","KIBISH","29",265,325,590
"43825","TURKANA","KIBISH","25-29",1353,1514,2867
"43826","TURKANA","KIBISH","30",411,552,963
"43827","TURKANA","KIBISH","31",127,168,295
"43828","TURKANA","KIBISH","32",115,152,267
"43829","TURKANA","KIBISH","33",86,117,203
"43830","TURKANA","KIBISH","34",122,190,312
"43831","TURKANA","KIBISH","30-34",861,1179,2040
"43832","TURKANA","KIBISH","35",196,181,377
"43833","TURKANA","KIBISH","36",85,119,204
"43834","TURKANA","KIBISH","37",73,120,193
"43835","TURKANA","KIBISH","38",106,103,209
"43836","TURKANA","KIBISH","39",179,243,422
"43837","TURKANA","KIBISH","35-39",639,766,1405
"43838","TURKANA","KIBISH","40",268,237,505
"43839","TURKANA","KIBISH","41",77,121,198
"43840","TURKANA","KIBISH","42",79,71,150
"43841","TURKANA","KIBISH","43",62,72,134
"43842","TURKANA","KIBISH","44",46,68,114
"43843","TURKANA","KIBISH","40-44",532,569,1101
"43844","TURKANA","KIBISH","45",111,111,222
"43845","TURKANA","KIBISH","46",49,54,103
"43846","TURKANA","KIBISH","47",53,87,140
"43847","TURKANA","KIBISH","48",81,64,145
"43848","TURKANA","KIBISH","49",90,137,227
"43849","TURKANA","KIBISH","45-49",384,453,837
"43850","TURKANA","KIBISH","50",176,116,292
"43851","TURKANA","KIBISH","51",33,69,102
"43852","TURKANA","KIBISH","52",42,41,83
"43853","TURKANA","KIBISH","53",21,32,53
"43854","TURKANA","KIBISH","54",50,56,106
"43855","TURKANA","KIBISH","50-54",322,314,636
"43856","TURKANA","KIBISH","55",48,50,98
"43857","TURKANA","KIBISH","56",50,68,118
"43858","TURKANA","KIBISH","57",35,26,61
"43859","TURKANA","KIBISH","58",37,35,72
"43860","TURKANA","KIBISH","59",51,97,148
"43861","TURKANA","KIBISH","55-59",221,276,497
"43862","TURKANA","KIBISH","60",77,80,157
"43863","TURKANA","KIBISH","61",35,48,83
"43864","TURKANA","KIBISH","62",30,42,72
"43865","TURKANA","KIBISH","63",25,35,60
"43866","TURKANA","KIBISH","64",25,27,52
"43867","TURKANA","KIBISH","60-64",192,232,424
"43868","TURKANA","KIBISH","65",27,31,58
"43869","TURKANA","KIBISH","66",9,16,25
"43870","TURKANA","KIBISH","67",14,25,39
"43871","TURKANA","KIBISH","68",14,13,27
"43872","TURKANA","KIBISH","69",30,57,87
"43873","TURKANA","KIBISH","65-69",94,142,236
"43874","TURKANA","KIBISH","70",34,39,73
"43875","TURKANA","KIBISH","71",10,42,52
"43876","TURKANA","KIBISH","72",9,14,23
"43877","TURKANA","KIBISH","73",7,15,22
"43878","TURKANA","KIBISH","74",18,32,50
"43879","TURKANA","KIBISH","70-74",78,142,220
"43880","TURKANA","KIBISH","75",5,6,11
"43881","TURKANA","KIBISH","76",5,4,9
"43882","TURKANA","KIBISH","77",11,19,30
"43883","TURKANA","KIBISH","78",2,2,4
"43884","TURKANA","KIBISH","79",19,33,52
"43885","TURKANA","KIBISH","75-79",42,64,106
"43886","TURKANA","KIBISH","80",9,14,23
"43887","TURKANA","KIBISH","81",1,12,13
"43888","TURKANA","KIBISH","82",1,2,3
"43889","TURKANA","KIBISH","83",4,11,15
"43890","TURKANA","KIBISH","84",5,9,14
"43891","TURKANA","KIBISH","80-84",20,48,68
"43892","TURKANA","KIBISH","85",2,1,3
"43893","TURKANA","KIBISH","86",2,1,3
"43894","TURKANA","KIBISH","87",3,2,5
"43895","TURKANA","KIBISH","88",1,3,4
"43896","TURKANA","KIBISH","89",11,8,19
"43897","TURKANA","KIBISH","85-89",19,15,34
"43898","TURKANA","KIBISH","90",3,2,5
"43899","TURKANA","KIBISH","91",NA,4,4
"43900","TURKANA","KIBISH","92",1,NA,1
"43901","TURKANA","KIBISH","93",NA,NA,NA
"43902","TURKANA","KIBISH","94",1,1,2
"43903","TURKANA","KIBISH","90-94",5,7,12
"43904","TURKANA","KIBISH","95",1,NA,1
"43905","TURKANA","KIBISH","96",NA,NA,NA
"43906","TURKANA","KIBISH","97",NA,NA,NA
"43907","TURKANA","KIBISH","98",1,NA,1
"43908","TURKANA","KIBISH","99",1,NA,1
"43909","TURKANA","KIBISH","95-99",3,NA,3
"43910","TURKANA","KIBISH","100+",1,NA,1
"43911","TURKANA","KIBISH","Not Stated",NA,NA,NA
"43912","TURKANA","LOIMA","Total",54341,53453,107794
"43913","TURKANA","LOIMA","0",1087,1160,2247
"43914","TURKANA","LOIMA","1",1325,1265,2590
"43915","TURKANA","LOIMA","2",1847,1782,3629
"43916","TURKANA","LOIMA","3",1842,1861,3703
"43917","TURKANA","LOIMA","4",1922,1876,3798
"43918","TURKANA","LOIMA","0 - 4",8023,7944,15967
"43919","TURKANA","LOIMA","5",2076,1974,4050
"43920","TURKANA","LOIMA","6",2076,1926,4002
"43921","TURKANA","LOIMA","7",1685,1608,3293
"43922","TURKANA","LOIMA","8",2085,1965,4050
"43923","TURKANA","LOIMA","9",1445,1288,2733
"43924","TURKANA","LOIMA","5-9",9367,8761,18128
"43925","TURKANA","LOIMA","10",2715,2360,5075
"43926","TURKANA","LOIMA","11",1122,1141,2263
"43927","TURKANA","LOIMA","12",2020,1689,3709
"43928","TURKANA","LOIMA","13",1444,1243,2687
"43929","TURKANA","LOIMA","14",1443,1210,2653
"43930","TURKANA","LOIMA","10 -14",8744,7643,16387
"43931","TURKANA","LOIMA","15",2093,1535,3628
"43932","TURKANA","LOIMA","16",1374,1115,2489
"43933","TURKANA","LOIMA","17",1186,883,2069
"43934","TURKANA","LOIMA","18",1489,1193,2682
"43935","TURKANA","LOIMA","19",864,704,1568
"43936","TURKANA","LOIMA","15-19",7006,5430,12436
"43937","TURKANA","LOIMA","20",1862,1551,3413
"43938","TURKANA","LOIMA","21",648,589,1237
"43939","TURKANA","LOIMA","22",811,869,1680
"43940","TURKANA","LOIMA","23",817,783,1600
"43941","TURKANA","LOIMA","24",781,736,1517
"43942","TURKANA","LOIMA","20-24",4919,4528,9447
"43943","TURKANA","LOIMA","25",1330,1320,2650
"43944","TURKANA","LOIMA","26",841,1014,1855
"43945","TURKANA","LOIMA","27",657,707,1364
"43946","TURKANA","LOIMA","28",694,703,1397
"43947","TURKANA","LOIMA","29",723,823,1546
"43948","TURKANA","LOIMA","25-29",4245,4567,8812
"43949","TURKANA","LOIMA","30",1341,1479,2820
"43950","TURKANA","LOIMA","31",391,528,919
"43951","TURKANA","LOIMA","32",495,598,1093
"43952","TURKANA","LOIMA","33",400,552,952
"43953","TURKANA","LOIMA","34",406,483,889
"43954","TURKANA","LOIMA","30-34",3033,3640,6673
"43955","TURKANA","LOIMA","35",769,863,1632
"43956","TURKANA","LOIMA","36",352,432,784
"43957","TURKANA","LOIMA","37",291,307,598
"43958","TURKANA","LOIMA","38",237,311,548
"43959","TURKANA","LOIMA","39",410,462,872
"43960","TURKANA","LOIMA","35-39",2059,2375,4434
"43961","TURKANA","LOIMA","40",850,763,1613
"43962","TURKANA","LOIMA","41",248,402,650
"43963","TURKANA","LOIMA","42",360,465,825
"43964","TURKANA","LOIMA","43",231,347,578
"43965","TURKANA","LOIMA","44",206,262,468
"43966","TURKANA","LOIMA","40-44",1895,2239,4134
"43967","TURKANA","LOIMA","45",456,492,948
"43968","TURKANA","LOIMA","46",265,364,629
"43969","TURKANA","LOIMA","47",191,178,369
"43970","TURKANA","LOIMA","48",140,129,269
"43971","TURKANA","LOIMA","49",221,265,486
"43972","TURKANA","LOIMA","45-49",1273,1428,2701
"43973","TURKANA","LOIMA","50",499,452,951
"43974","TURKANA","LOIMA","51",150,147,297
"43975","TURKANA","LOIMA","52",130,144,274
"43976","TURKANA","LOIMA","53",94,147,241
"43977","TURKANA","LOIMA","54",117,198,315
"43978","TURKANA","LOIMA","50-54",990,1088,2078
"43979","TURKANA","LOIMA","55",147,181,328
"43980","TURKANA","LOIMA","56",135,158,293
"43981","TURKANA","LOIMA","57",91,137,228
"43982","TURKANA","LOIMA","58",64,96,160
"43983","TURKANA","LOIMA","59",163,256,419
"43984","TURKANA","LOIMA","55-59",600,828,1428
"43985","TURKANA","LOIMA","60",323,372,695
"43986","TURKANA","LOIMA","61",110,208,318
"43987","TURKANA","LOIMA","62",79,117,196
"43988","TURKANA","LOIMA","63",113,157,270
"43989","TURKANA","LOIMA","64",73,112,185
"43990","TURKANA","LOIMA","60-64",698,966,1664
"43991","TURKANA","LOIMA","65",147,187,334
"43992","TURKANA","LOIMA","66",73,83,156
"43993","TURKANA","LOIMA","67",88,103,191
"43994","TURKANA","LOIMA","68",52,55,107
"43995","TURKANA","LOIMA","69",140,224,364
"43996","TURKANA","LOIMA","65-69",500,652,1152
"43997","TURKANA","LOIMA","70",205,244,449
"43998","TURKANA","LOIMA","71",78,147,225
"43999","TURKANA","LOIMA","72",59,81,140
"44000","TURKANA","LOIMA","73",43,80,123
"44001","TURKANA","LOIMA","74",121,148,269
"44002","TURKANA","LOIMA","70-74",506,700,1206
"44003","TURKANA","LOIMA","75",63,67,130
"44004","TURKANA","LOIMA","76",25,48,73
"44005","TURKANA","LOIMA","77",42,48,90
"44006","TURKANA","LOIMA","78",25,40,65
"44007","TURKANA","LOIMA","79",72,101,173
"44008","TURKANA","LOIMA","75-79",227,304,531
"44009","TURKANA","LOIMA","80",86,86,172
"44010","TURKANA","LOIMA","81",26,53,79
"44011","TURKANA","LOIMA","82",13,20,33
"44012","TURKANA","LOIMA","83",11,14,25
"44013","TURKANA","LOIMA","84",8,26,34
"44014","TURKANA","LOIMA","80-84",144,199,343
"44015","TURKANA","LOIMA","85",22,18,40
"44016","TURKANA","LOIMA","86",4,11,15
"44017","TURKANA","LOIMA","87",18,24,42
"44018","TURKANA","LOIMA","88",2,7,9
"44019","TURKANA","LOIMA","89",26,42,68
"44020","TURKANA","LOIMA","85-89",72,102,174
"44021","TURKANA","LOIMA","90",10,18,28
"44022","TURKANA","LOIMA","91",11,6,17
"44023","TURKANA","LOIMA","92",3,2,5
"44024","TURKANA","LOIMA","93",1,2,3
"44025","TURKANA","LOIMA","94",2,4,6
"44026","TURKANA","LOIMA","90-94",27,32,59
"44027","TURKANA","LOIMA","95",1,6,7
"44028","TURKANA","LOIMA","96",1,4,5
"44029","TURKANA","LOIMA","97",2,5,7
"44030","TURKANA","LOIMA","98",2,1,3
"44031","TURKANA","LOIMA","99",3,2,5
"44032","TURKANA","LOIMA","95-99",9,18,27
"44033","TURKANA","LOIMA","100+",4,9,13
"44034","TURKANA","LOIMA","Not Stated",NA,NA,NA
"44035","TURKANA","TURKANA CENTRAL","Total",93145,92160,185305
"44036","TURKANA","TURKANA CENTRAL","0",2743,2658,5401
"44037","TURKANA","TURKANA CENTRAL","1",2804,2624,5428
"44038","TURKANA","TURKANA CENTRAL","2",3121,3094,6215
"44039","TURKANA","TURKANA CENTRAL","3",3252,3272,6524
"44040","TURKANA","TURKANA CENTRAL","4",3373,3152,6525
"44041","TURKANA","TURKANA CENTRAL","0 - 4",15293,14800,30093
"44042","TURKANA","TURKANA CENTRAL","5",3315,3149,6464
"44043","TURKANA","TURKANA CENTRAL","6",3110,3011,6121
"44044","TURKANA","TURKANA CENTRAL","7",2751,2628,5379
"44045","TURKANA","TURKANA CENTRAL","8",2822,2849,5671
"44046","TURKANA","TURKANA CENTRAL","9",2302,2246,4548
"44047","TURKANA","TURKANA CENTRAL","5-9",14300,13883,28183
"44048","TURKANA","TURKANA CENTRAL","10",3502,3500,7002
"44049","TURKANA","TURKANA CENTRAL","11",1991,2081,4072
"44050","TURKANA","TURKANA CENTRAL","12",2996,2662,5658
"44051","TURKANA","TURKANA CENTRAL","13",2433,2296,4729
"44052","TURKANA","TURKANA CENTRAL","14",2380,2193,4573
"44053","TURKANA","TURKANA CENTRAL","10 -14",13302,12732,26034
"44054","TURKANA","TURKANA CENTRAL","15",2840,2579,5419
"44055","TURKANA","TURKANA CENTRAL","16",2199,2125,4324
"44056","TURKANA","TURKANA CENTRAL","17",2259,1950,4209
"44057","TURKANA","TURKANA CENTRAL","18",2191,2033,4224
"44058","TURKANA","TURKANA CENTRAL","19",1787,1722,3509
"44059","TURKANA","TURKANA CENTRAL","15-19",11276,10409,21685
"44060","TURKANA","TURKANA CENTRAL","20",2454,2645,5099
"44061","TURKANA","TURKANA CENTRAL","21",1709,1745,3454
"44062","TURKANA","TURKANA CENTRAL","22",1747,1759,3506
"44063","TURKANA","TURKANA CENTRAL","23",1695,1796,3491
"44064","TURKANA","TURKANA CENTRAL","24",1716,1607,3323
"44065","TURKANA","TURKANA CENTRAL","20-24",9321,9552,18873
"44066","TURKANA","TURKANA CENTRAL","25",2316,2239,4555
"44067","TURKANA","TURKANA CENTRAL","26",1580,1657,3237
"44068","TURKANA","TURKANA CENTRAL","27",1504,1541,3045
"44069","TURKANA","TURKANA CENTRAL","28",1295,1121,2416
"44070","TURKANA","TURKANA CENTRAL","29",1259,1202,2461
"44071","TURKANA","TURKANA CENTRAL","25-29",7954,7760,15714
"44072","TURKANA","TURKANA CENTRAL","30",2034,1767,3801
"44073","TURKANA","TURKANA CENTRAL","31",820,847,1667
"44074","TURKANA","TURKANA CENTRAL","32",1150,1179,2329
"44075","TURKANA","TURKANA CENTRAL","33",895,1046,1941
"44076","TURKANA","TURKANA CENTRAL","34",863,919,1782
"44077","TURKANA","TURKANA CENTRAL","30-34",5762,5758,11520
"44078","TURKANA","TURKANA CENTRAL","35",1394,1424,2818
"44079","TURKANA","TURKANA CENTRAL","36",742,727,1469
"44080","TURKANA","TURKANA CENTRAL","37",687,686,1373
"44081","TURKANA","TURKANA CENTRAL","38",540,435,975
"44082","TURKANA","TURKANA CENTRAL","39",651,526,1177
"44083","TURKANA","TURKANA CENTRAL","35-39",4014,3798,7812
"44084","TURKANA","TURKANA CENTRAL","40",1144,867,2011
"44085","TURKANA","TURKANA CENTRAL","41",796,945,1741
"44086","TURKANA","TURKANA CENTRAL","42",716,777,1493
"44087","TURKANA","TURKANA CENTRAL","43",494,525,1019
"44088","TURKANA","TURKANA CENTRAL","44",374,454,828
"44089","TURKANA","TURKANA CENTRAL","40-44",3524,3568,7092
"44090","TURKANA","TURKANA CENTRAL","45",779,685,1464
"44091","TURKANA","TURKANA CENTRAL","46",516,667,1183
"44092","TURKANA","TURKANA CENTRAL","47",375,324,699
"44093","TURKANA","TURKANA CENTRAL","48",293,240,533
"44094","TURKANA","TURKANA CENTRAL","49",415,402,817
"44095","TURKANA","TURKANA CENTRAL","45-49",2378,2318,4696
"44096","TURKANA","TURKANA CENTRAL","50",678,619,1297
"44097","TURKANA","TURKANA CENTRAL","51",242,243,485
"44098","TURKANA","TURKANA CENTRAL","52",295,273,568
"44099","TURKANA","TURKANA CENTRAL","53",211,200,411
"44100","TURKANA","TURKANA CENTRAL","54",258,303,561
"44101","TURKANA","TURKANA CENTRAL","50-54",1684,1638,3322
"44102","TURKANA","TURKANA CENTRAL","55",281,274,555
"44103","TURKANA","TURKANA CENTRAL","56",257,288,545
"44104","TURKANA","TURKANA CENTRAL","57",186,216,402
"44105","TURKANA","TURKANA CENTRAL","58",131,165,296
"44106","TURKANA","TURKANA CENTRAL","59",253,397,650
"44107","TURKANA","TURKANA CENTRAL","55-59",1108,1340,2448
"44108","TURKANA","TURKANA CENTRAL","60",419,475,894
"44109","TURKANA","TURKANA CENTRAL","61",214,310,524
"44110","TURKANA","TURKANA CENTRAL","62",177,196,373
"44111","TURKANA","TURKANA CENTRAL","63",172,276,448
"44112","TURKANA","TURKANA CENTRAL","64",124,167,291
"44113","TURKANA","TURKANA CENTRAL","60-64",1106,1424,2530
"44114","TURKANA","TURKANA CENTRAL","65",214,341,555
"44115","TURKANA","TURKANA CENTRAL","66",99,116,215
"44116","TURKANA","TURKANA CENTRAL","67",126,161,287
"44117","TURKANA","TURKANA CENTRAL","68",95,98,193
"44118","TURKANA","TURKANA CENTRAL","69",209,353,562
"44119","TURKANA","TURKANA CENTRAL","65-69",743,1069,1812
"44120","TURKANA","TURKANA CENTRAL","70",310,400,710
"44121","TURKANA","TURKANA CENTRAL","71",109,202,311
"44122","TURKANA","TURKANA CENTRAL","72",77,127,204
"44123","TURKANA","TURKANA CENTRAL","73",76,117,193
"44124","TURKANA","TURKANA CENTRAL","74",107,172,279
"44125","TURKANA","TURKANA CENTRAL","70-74",679,1018,1697
"44126","TURKANA","TURKANA CENTRAL","75",80,118,198
"44127","TURKANA","TURKANA CENTRAL","76",52,64,116
"44128","TURKANA","TURKANA CENTRAL","77",45,90,135
"44129","TURKANA","TURKANA CENTRAL","78",38,53,91
"44130","TURKANA","TURKANA CENTRAL","79",117,170,287
"44131","TURKANA","TURKANA CENTRAL","75-79",332,495,827
"44132","TURKANA","TURKANA CENTRAL","80",97,168,265
"44133","TURKANA","TURKANA CENTRAL","81",36,54,90
"44134","TURKANA","TURKANA CENTRAL","82",13,19,32
"44135","TURKANA","TURKANA CENTRAL","83",26,41,67
"44136","TURKANA","TURKANA CENTRAL","84",30,55,85
"44137","TURKANA","TURKANA CENTRAL","80-84",202,337,539
"44138","TURKANA","TURKANA CENTRAL","85",29,45,74
"44139","TURKANA","TURKANA CENTRAL","86",10,7,17
"44140","TURKANA","TURKANA CENTRAL","87",19,13,32
"44141","TURKANA","TURKANA CENTRAL","88",6,12,18
"44142","TURKANA","TURKANA CENTRAL","89",42,67,109
"44143","TURKANA","TURKANA CENTRAL","85-89",106,144,250
"44144","TURKANA","TURKANA CENTRAL","90",16,30,46
"44145","TURKANA","TURKANA CENTRAL","91",7,13,20
"44146","TURKANA","TURKANA CENTRAL","92",5,7,12
"44147","TURKANA","TURKANA CENTRAL","93",1,9,10
"44148","TURKANA","TURKANA CENTRAL","94",4,6,10
"44149","TURKANA","TURKANA CENTRAL","90-94",33,65,98
"44150","TURKANA","TURKANA CENTRAL","95",5,11,16
"44151","TURKANA","TURKANA CENTRAL","96",3,2,5
"44152","TURKANA","TURKANA CENTRAL","97",3,5,8
"44153","TURKANA","TURKANA CENTRAL","98",2,5,7
"44154","TURKANA","TURKANA CENTRAL","99",5,8,13
"44155","TURKANA","TURKANA CENTRAL","95-99",18,31,49
"44156","TURKANA","TURKANA CENTRAL","100+",9,20,29
"44157","TURKANA","TURKANA CENTRAL","Not Stated",1,1,2
"44158","TURKANA","TURKANA EAST","Total",76871,61643,138514
"44159","TURKANA","TURKANA EAST","0",787,816,1603
"44160","TURKANA","TURKANA EAST","1",1152,1130,2282
"44161","TURKANA","TURKANA EAST","2",1838,1717,3555
"44162","TURKANA","TURKANA EAST","3",1790,1626,3416
"44163","TURKANA","TURKANA EAST","4",1924,1912,3836
"44164","TURKANA","TURKANA EAST","0 - 4",7491,7201,14692
"44165","TURKANA","TURKANA EAST","5",2138,1945,4083
"44166","TURKANA","TURKANA EAST","6",2114,2043,4157
"44167","TURKANA","TURKANA EAST","7",1902,1646,3548
"44168","TURKANA","TURKANA EAST","8",2485,2370,4855
"44169","TURKANA","TURKANA EAST","9",1849,1764,3613
"44170","TURKANA","TURKANA EAST","5-9",10488,9768,20256
"44171","TURKANA","TURKANA EAST","10",3732,3463,7195
"44172","TURKANA","TURKANA EAST","11",1557,1629,3186
"44173","TURKANA","TURKANA EAST","12",3134,2237,5371
"44174","TURKANA","TURKANA EAST","13",2299,1623,3922
"44175","TURKANA","TURKANA EAST","14",2692,1718,4410
"44176","TURKANA","TURKANA EAST","10 -14",13414,10670,24084
"44177","TURKANA","TURKANA EAST","15",3272,2172,5444
"44178","TURKANA","TURKANA EAST","16",2707,1691,4398
"44179","TURKANA","TURKANA EAST","17",2391,1421,3812
"44180","TURKANA","TURKANA EAST","18",2636,1823,4459
"44181","TURKANA","TURKANA EAST","19",1782,1207,2989
"44182","TURKANA","TURKANA EAST","15-19",12788,8314,21102
"44183","TURKANA","TURKANA EAST","20",4120,2242,6362
"44184","TURKANA","TURKANA EAST","21",1581,1090,2671
"44185","TURKANA","TURKANA EAST","22",1447,1048,2495
"44186","TURKANA","TURKANA EAST","23",1474,1130,2604
"44187","TURKANA","TURKANA EAST","24",1458,1036,2494
"44188","TURKANA","TURKANA EAST","20-24",10080,6546,16626
"44189","TURKANA","TURKANA EAST","25",2189,1469,3658
"44190","TURKANA","TURKANA EAST","26",1089,921,2010
"44191","TURKANA","TURKANA EAST","27",1006,867,1873
"44192","TURKANA","TURKANA EAST","28",1170,969,2139
"44193","TURKANA","TURKANA EAST","29",929,854,1783
"44194","TURKANA","TURKANA EAST","25-29",6383,5080,11463
"44195","TURKANA","TURKANA EAST","30",2054,1745,3799
"44196","TURKANA","TURKANA EAST","31",514,429,943
"44197","TURKANA","TURKANA EAST","32",757,683,1440
"44198","TURKANA","TURKANA EAST","33",485,433,918
"44199","TURKANA","TURKANA EAST","34",484,530,1014
"44200","TURKANA","TURKANA EAST","30-34",4294,3820,8114
"44201","TURKANA","TURKANA EAST","35",1073,1026,2099
"44202","TURKANA","TURKANA EAST","36",465,558,1023
"44203","TURKANA","TURKANA EAST","37",360,359,719
"44204","TURKANA","TURKANA EAST","38",453,500,953
"44205","TURKANA","TURKANA EAST","39",474,527,1001
"44206","TURKANA","TURKANA EAST","35-39",2825,2970,5795
"44207","TURKANA","TURKANA EAST","40",1260,1019,2279
"44208","TURKANA","TURKANA EAST","41",311,344,655
"44209","TURKANA","TURKANA EAST","42",521,398,919
"44210","TURKANA","TURKANA EAST","43",299,284,583
"44211","TURKANA","TURKANA EAST","44",243,234,477
"44212","TURKANA","TURKANA EAST","40-44",2634,2279,4913
"44213","TURKANA","TURKANA EAST","45",728,613,1341
"44214","TURKANA","TURKANA EAST","46",312,288,600
"44215","TURKANA","TURKANA EAST","47",301,233,534
"44216","TURKANA","TURKANA EAST","48",242,205,447
"44217","TURKANA","TURKANA EAST","49",372,260,632
"44218","TURKANA","TURKANA EAST","45-49",1955,1599,3554
"44219","TURKANA","TURKANA EAST","50",844,601,1445
"44220","TURKANA","TURKANA EAST","51",181,116,297
"44221","TURKANA","TURKANA EAST","52",249,139,388
"44222","TURKANA","TURKANA EAST","53",145,88,233
"44223","TURKANA","TURKANA EAST","54",156,103,259
"44224","TURKANA","TURKANA EAST","50-54",1575,1047,2622
"44225","TURKANA","TURKANA EAST","55",256,191,447
"44226","TURKANA","TURKANA EAST","56",197,147,344
"44227","TURKANA","TURKANA EAST","57",127,89,216
"44228","TURKANA","TURKANA EAST","58",145,133,278
"44229","TURKANA","TURKANA EAST","59",174,186,360
"44230","TURKANA","TURKANA EAST","55-59",899,746,1645
"44231","TURKANA","TURKANA EAST","60",489,326,815
"44232","TURKANA","TURKANA EAST","61",95,74,169
"44233","TURKANA","TURKANA EAST","62",102,100,202
"44234","TURKANA","TURKANA EAST","63",106,115,221
"44235","TURKANA","TURKANA EAST","64",69,44,113
"44236","TURKANA","TURKANA EAST","60-64",861,659,1520
"44237","TURKANA","TURKANA EAST","65",131,120,251
"44238","TURKANA","TURKANA EAST","66",47,34,81
"44239","TURKANA","TURKANA EAST","67",71,64,135
"44240","TURKANA","TURKANA EAST","68",76,56,132
"44241","TURKANA","TURKANA EAST","69",119,131,250
"44242","TURKANA","TURKANA EAST","65-69",444,405,849
"44243","TURKANA","TURKANA EAST","70",208,133,341
"44244","TURKANA","TURKANA EAST","71",65,46,111
"44245","TURKANA","TURKANA EAST","72",63,39,102
"44246","TURKANA","TURKANA EAST","73",22,24,46
"44247","TURKANA","TURKANA EAST","74",40,37,77
"44248","TURKANA","TURKANA EAST","70-74",398,279,677
"44249","TURKANA","TURKANA EAST","75",48,36,84
"44250","TURKANA","TURKANA EAST","76",24,16,40
"44251","TURKANA","TURKANA EAST","77",16,14,30
"44252","TURKANA","TURKANA EAST","78",26,16,42
"44253","TURKANA","TURKANA EAST","79",67,41,108
"44254","TURKANA","TURKANA EAST","75-79",181,123,304
"44255","TURKANA","TURKANA EAST","80",51,42,93
"44256","TURKANA","TURKANA EAST","81",9,5,14
"44257","TURKANA","TURKANA EAST","82",4,6,10
"44258","TURKANA","TURKANA EAST","83",5,8,13
"44259","TURKANA","TURKANA EAST","84",11,8,19
"44260","TURKANA","TURKANA EAST","80-84",80,69,149
"44261","TURKANA","TURKANA EAST","85",23,14,37
"44262","TURKANA","TURKANA EAST","86",4,5,9
"44263","TURKANA","TURKANA EAST","87",6,7,13
"44264","TURKANA","TURKANA EAST","88",5,5,10
"44265","TURKANA","TURKANA EAST","89",18,16,34
"44266","TURKANA","TURKANA EAST","85-89",56,47,103
"44267","TURKANA","TURKANA EAST","90",8,7,15
"44268","TURKANA","TURKANA EAST","91",4,1,5
"44269","TURKANA","TURKANA EAST","92",2,NA,2
"44270","TURKANA","TURKANA EAST","93",NA,NA,NA
"44271","TURKANA","TURKANA EAST","94",2,NA,2
"44272","TURKANA","TURKANA EAST","90-94",16,8,24
"44273","TURKANA","TURKANA EAST","95",5,8,13
"44274","TURKANA","TURKANA EAST","96",1,NA,1
"44275","TURKANA","TURKANA EAST","97",NA,NA,NA
"44276","TURKANA","TURKANA EAST","98",NA,NA,NA
"44277","TURKANA","TURKANA EAST","99",1,2,3
"44278","TURKANA","TURKANA EAST","95-99",7,10,17
"44279","TURKANA","TURKANA EAST","100+",2,3,5
"44280","TURKANA","TURKANA EAST","Not Stated",NA,NA,NA
"44281","TURKANA","TURKANA NORTH","Total",32810,32408,65218
"44282","TURKANA","TURKANA NORTH","0",951,851,1802
"44283","TURKANA","TURKANA NORTH","1",838,777,1615
"44284","TURKANA","TURKANA NORTH","2",1225,1107,2332
"44285","TURKANA","TURKANA NORTH","3",1217,1230,2447
"44286","TURKANA","TURKANA NORTH","4",1253,1204,2457
"44287","TURKANA","TURKANA NORTH","0 - 4",5484,5169,10653
"44288","TURKANA","TURKANA NORTH","5",1350,1205,2555
"44289","TURKANA","TURKANA NORTH","6",1184,1216,2400
"44290","TURKANA","TURKANA NORTH","7",1114,1050,2164
"44291","TURKANA","TURKANA NORTH","8",1237,1132,2369
"44292","TURKANA","TURKANA NORTH","9",912,847,1759
"44293","TURKANA","TURKANA NORTH","5-9",5797,5450,11247
"44294","TURKANA","TURKANA NORTH","10",1563,1447,3010
"44295","TURKANA","TURKANA NORTH","11",628,697,1325
"44296","TURKANA","TURKANA NORTH","12",1261,1056,2317
"44297","TURKANA","TURKANA NORTH","13",881,747,1628
"44298","TURKANA","TURKANA NORTH","14",841,680,1521
"44299","TURKANA","TURKANA NORTH","10 -14",5174,4627,9801
"44300","TURKANA","TURKANA NORTH","15",1191,890,2081
"44301","TURKANA","TURKANA NORTH","16",699,596,1295
"44302","TURKANA","TURKANA NORTH","17",705,489,1194
"44303","TURKANA","TURKANA NORTH","18",662,545,1207
"44304","TURKANA","TURKANA NORTH","19",527,425,952
"44305","TURKANA","TURKANA NORTH","15-19",3784,2945,6729
"44306","TURKANA","TURKANA NORTH","20",925,837,1762
"44307","TURKANA","TURKANA NORTH","21",429,493,922
"44308","TURKANA","TURKANA NORTH","22",551,544,1095
"44309","TURKANA","TURKANA NORTH","23",451,464,915
"44310","TURKANA","TURKANA NORTH","24",423,462,885
"44311","TURKANA","TURKANA NORTH","20-24",2779,2800,5579
"44312","TURKANA","TURKANA NORTH","25",832,718,1550
"44313","TURKANA","TURKANA NORTH","26",448,541,989
"44314","TURKANA","TURKANA NORTH","27",416,458,874
"44315","TURKANA","TURKANA NORTH","28",355,324,679
"44316","TURKANA","TURKANA NORTH","29",457,564,1021
"44317","TURKANA","TURKANA NORTH","25-29",2508,2605,5113
"44318","TURKANA","TURKANA NORTH","30",673,721,1394
"44319","TURKANA","TURKANA NORTH","31",294,444,738
"44320","TURKANA","TURKANA NORTH","32",322,401,723
"44321","TURKANA","TURKANA NORTH","33",219,243,462
"44322","TURKANA","TURKANA NORTH","34",239,263,502
"44323","TURKANA","TURKANA NORTH","30-34",1747,2072,3819
"44324","TURKANA","TURKANA NORTH","35",453,467,920
"44325","TURKANA","TURKANA NORTH","36",215,271,486
"44326","TURKANA","TURKANA NORTH","37",180,189,369
"44327","TURKANA","TURKANA NORTH","38",155,155,310
"44328","TURKANA","TURKANA NORTH","39",302,393,695
"44329","TURKANA","TURKANA NORTH","35-39",1305,1475,2780
"44330","TURKANA","TURKANA NORTH","40",398,314,712
"44331","TURKANA","TURKANA NORTH","41",176,223,399
"44332","TURKANA","TURKANA NORTH","42",189,187,376
"44333","TURKANA","TURKANA NORTH","43",118,206,324
"44334","TURKANA","TURKANA NORTH","44",100,139,239
"44335","TURKANA","TURKANA NORTH","40-44",981,1069,2050
"44336","TURKANA","TURKANA NORTH","45",314,310,624
"44337","TURKANA","TURKANA NORTH","46",121,204,325
"44338","TURKANA","TURKANA NORTH","47",134,152,286
"44339","TURKANA","TURKANA NORTH","48",92,103,195
"44340","TURKANA","TURKANA NORTH","49",163,259,422
"44341","TURKANA","TURKANA NORTH","45-49",824,1028,1852
"44342","TURKANA","TURKANA NORTH","50",291,288,579
"44343","TURKANA","TURKANA NORTH","51",97,147,244
"44344","TURKANA","TURKANA NORTH","52",83,91,174
"44345","TURKANA","TURKANA NORTH","53",80,77,157
"44346","TURKANA","TURKANA NORTH","54",101,121,222
"44347","TURKANA","TURKANA NORTH","50-54",652,724,1376
"44348","TURKANA","TURKANA NORTH","55",91,87,178
"44349","TURKANA","TURKANA NORTH","56",78,97,175
"44350","TURKANA","TURKANA NORTH","57",51,76,127
"44351","TURKANA","TURKANA NORTH","58",59,54,113
"44352","TURKANA","TURKANA NORTH","59",110,190,300
"44353","TURKANA","TURKANA NORTH","55-59",389,504,893
"44354","TURKANA","TURKANA NORTH","60",169,199,368
"44355","TURKANA","TURKANA NORTH","61",70,139,209
"44356","TURKANA","TURKANA NORTH","62",68,93,161
"44357","TURKANA","TURKANA NORTH","63",60,119,179
"44358","TURKANA","TURKANA NORTH","64",52,68,120
"44359","TURKANA","TURKANA NORTH","60-64",419,618,1037
"44360","TURKANA","TURKANA NORTH","65",82,112,194
"44361","TURKANA","TURKANA NORTH","66",34,47,81
"44362","TURKANA","TURKANA NORTH","67",57,67,124
"44363","TURKANA","TURKANA NORTH","68",41,46,87
"44364","TURKANA","TURKANA NORTH","69",114,165,279
"44365","TURKANA","TURKANA NORTH","65-69",328,437,765
"44366","TURKANA","TURKANA NORTH","70",130,137,267
"44367","TURKANA","TURKANA NORTH","71",48,95,143
"44368","TURKANA","TURKANA NORTH","72",38,58,96
"44369","TURKANA","TURKANA NORTH","73",32,47,79
"44370","TURKANA","TURKANA NORTH","74",50,66,116
"44371","TURKANA","TURKANA NORTH","70-74",298,403,701
"44372","TURKANA","TURKANA NORTH","75",31,36,67
"44373","TURKANA","TURKANA NORTH","76",20,29,49
"44374","TURKANA","TURKANA NORTH","77",19,31,50
"44375","TURKANA","TURKANA NORTH","78",21,24,45
"44376","TURKANA","TURKANA NORTH","79",60,88,148
"44377","TURKANA","TURKANA NORTH","75-79",151,208,359
"44378","TURKANA","TURKANA NORTH","80",51,53,104
"44379","TURKANA","TURKANA NORTH","81",13,32,45
"44380","TURKANA","TURKANA NORTH","82",13,18,31
"44381","TURKANA","TURKANA NORTH","83",6,24,30
"44382","TURKANA","TURKANA NORTH","84",11,20,31
"44383","TURKANA","TURKANA NORTH","80-84",94,147,241
"44384","TURKANA","TURKANA NORTH","85",15,14,29
"44385","TURKANA","TURKANA NORTH","86",3,6,9
"44386","TURKANA","TURKANA NORTH","87",8,7,15
"44387","TURKANA","TURKANA NORTH","88",2,7,9
"44388","TURKANA","TURKANA NORTH","89",28,48,76
"44389","TURKANA","TURKANA NORTH","85-89",56,82,138
"44390","TURKANA","TURKANA NORTH","90",9,15,24
"44391","TURKANA","TURKANA NORTH","91",6,6,12
"44392","TURKANA","TURKANA NORTH","92",2,1,3
"44393","TURKANA","TURKANA NORTH","93",2,3,5
"44394","TURKANA","TURKANA NORTH","94",4,4,8
"44395","TURKANA","TURKANA NORTH","90-94",23,29,52
"44396","TURKANA","TURKANA NORTH","95",4,3,7
"44397","TURKANA","TURKANA NORTH","96",1,NA,1
"44398","TURKANA","TURKANA NORTH","97",2,NA,2
"44399","TURKANA","TURKANA NORTH","98",2,2,4
"44400","TURKANA","TURKANA NORTH","99",4,7,11
"44401","TURKANA","TURKANA NORTH","95-99",13,12,25
"44402","TURKANA","TURKANA NORTH","100+",4,4,8
"44403","TURKANA","TURKANA NORTH","Not Stated",NA,NA,NA
"44404","TURKANA","TURKANA SOUTH","Total",78402,75329,153731
"44405","TURKANA","TURKANA SOUTH","0",1453,1505,2958
"44406","TURKANA","TURKANA SOUTH","1",1628,1633,3261
"44407","TURKANA","TURKANA SOUTH","2",2208,2400,4608
"44408","TURKANA","TURKANA SOUTH","3",2404,2562,4966
"44409","TURKANA","TURKANA SOUTH","4",2475,2519,4994
"44410","TURKANA","TURKANA SOUTH","0 - 4",10168,10619,20787
"44411","TURKANA","TURKANA SOUTH","5",2620,2647,5267
"44412","TURKANA","TURKANA SOUTH","6",2542,2549,5091
"44413","TURKANA","TURKANA SOUTH","7",2024,2199,4223
"44414","TURKANA","TURKANA SOUTH","8",2813,2794,5607
"44415","TURKANA","TURKANA SOUTH","9",1964,2001,3965
"44416","TURKANA","TURKANA SOUTH","5-9",11963,12190,24153
"44417","TURKANA","TURKANA SOUTH","10",3455,3607,7062
"44418","TURKANA","TURKANA SOUTH","11",1648,1967,3615
"44419","TURKANA","TURKANA SOUTH","12",2940,2646,5586
"44420","TURKANA","TURKANA SOUTH","13",2174,1969,4143
"44421","TURKANA","TURKANA SOUTH","14",2244,2064,4308
"44422","TURKANA","TURKANA SOUTH","10 -14",12461,12253,24714
"44423","TURKANA","TURKANA SOUTH","15",3122,2527,5649
"44424","TURKANA","TURKANA SOUTH","16",2236,1860,4096
"44425","TURKANA","TURKANA SOUTH","17",2188,1669,3857
"44426","TURKANA","TURKANA SOUTH","18",2399,1998,4397
"44427","TURKANA","TURKANA SOUTH","19",1506,1307,2813
"44428","TURKANA","TURKANA SOUTH","15-19",11451,9361,20812
"44429","TURKANA","TURKANA SOUTH","20",2630,2372,5002
"44430","TURKANA","TURKANA SOUTH","21",1254,1135,2389
"44431","TURKANA","TURKANA SOUTH","22",1319,1216,2535
"44432","TURKANA","TURKANA SOUTH","23",1286,1114,2400
"44433","TURKANA","TURKANA SOUTH","24",1242,1046,2288
"44434","TURKANA","TURKANA SOUTH","20-24",7731,6883,14614
"44435","TURKANA","TURKANA SOUTH","25",1939,1718,3657
"44436","TURKANA","TURKANA SOUTH","26",983,1043,2026
"44437","TURKANA","TURKANA SOUTH","27",947,967,1914
"44438","TURKANA","TURKANA SOUTH","28",1141,1148,2289
"44439","TURKANA","TURKANA SOUTH","29",909,780,1689
"44440","TURKANA","TURKANA SOUTH","25-29",5919,5656,11575
"44441","TURKANA","TURKANA SOUTH","30",1996,2055,4051
"44442","TURKANA","TURKANA SOUTH","31",562,535,1097
"44443","TURKANA","TURKANA SOUTH","32",903,832,1735
"44444","TURKANA","TURKANA SOUTH","33",529,559,1088
"44445","TURKANA","TURKANA SOUTH","34",543,609,1152
"44446","TURKANA","TURKANA SOUTH","30-34",4533,4590,9123
"44447","TURKANA","TURKANA SOUTH","35",1219,1155,2374
"44448","TURKANA","TURKANA SOUTH","36",522,585,1107
"44449","TURKANA","TURKANA SOUTH","37",478,451,929
"44450","TURKANA","TURKANA SOUTH","38",492,504,996
"44451","TURKANA","TURKANA SOUTH","39",501,521,1022
"44452","TURKANA","TURKANA SOUTH","35-39",3212,3216,6428
"44453","TURKANA","TURKANA SOUTH","40",1360,1071,2431
"44454","TURKANA","TURKANA SOUTH","41",399,379,778
"44455","TURKANA","TURKANA SOUTH","42",571,523,1094
"44456","TURKANA","TURKANA SOUTH","43",321,307,628
"44457","TURKANA","TURKANA SOUTH","44",276,232,508
"44458","TURKANA","TURKANA SOUTH","40-44",2927,2512,5439
"44459","TURKANA","TURKANA SOUTH","45",869,712,1581
"44460","TURKANA","TURKANA SOUTH","46",409,455,864
"44461","TURKANA","TURKANA SOUTH","47",317,266,583
"44462","TURKANA","TURKANA SOUTH","48",320,287,607
"44463","TURKANA","TURKANA SOUTH","49",289,259,548
"44464","TURKANA","TURKANA SOUTH","45-49",2204,1979,4183
"44465","TURKANA","TURKANA SOUTH","50",811,641,1452
"44466","TURKANA","TURKANA SOUTH","51",201,183,384
"44467","TURKANA","TURKANA SOUTH","52",264,202,466
"44468","TURKANA","TURKANA SOUTH","53",156,132,288
"44469","TURKANA","TURKANA SOUTH","54",174,213,387
"44470","TURKANA","TURKANA SOUTH","50-54",1606,1371,2977
"44471","TURKANA","TURKANA SOUTH","55",284,264,548
"44472","TURKANA","TURKANA SOUTH","56",253,234,487
"44473","TURKANA","TURKANA SOUTH","57",159,154,313
"44474","TURKANA","TURKANA SOUTH","58",168,152,320
"44475","TURKANA","TURKANA SOUTH","59",199,272,471
"44476","TURKANA","TURKANA SOUTH","55-59",1063,1076,2139
"44477","TURKANA","TURKANA SOUTH","60",476,479,955
"44478","TURKANA","TURKANA SOUTH","61",152,197,349
"44479","TURKANA","TURKANA SOUTH","62",134,146,280
"44480","TURKANA","TURKANA SOUTH","63",146,175,321
"44481","TURKANA","TURKANA SOUTH","64",95,109,204
"44482","TURKANA","TURKANA SOUTH","60-64",1003,1106,2109
"44483","TURKANA","TURKANA SOUTH","65",237,260,497
"44484","TURKANA","TURKANA SOUTH","66",77,78,155
"44485","TURKANA","TURKANA SOUTH","67",150,138,288
"44486","TURKANA","TURKANA SOUTH","68",105,108,213
"44487","TURKANA","TURKANA SOUTH","69",163,213,376
"44488","TURKANA","TURKANA SOUTH","65-69",732,797,1529
"44489","TURKANA","TURKANA SOUTH","70",358,419,777
"44490","TURKANA","TURKANA SOUTH","71",91,132,223
"44491","TURKANA","TURKANA SOUTH","72",110,114,224
"44492","TURKANA","TURKANA SOUTH","73",64,93,157
"44493","TURKANA","TURKANA SOUTH","74",106,93,199
"44494","TURKANA","TURKANA SOUTH","70-74",729,851,1580
"44495","TURKANA","TURKANA SOUTH","75",92,130,222
"44496","TURKANA","TURKANA SOUTH","76",56,61,117
"44497","TURKANA","TURKANA SOUTH","77",45,39,84
"44498","TURKANA","TURKANA SOUTH","78",50,47,97
"44499","TURKANA","TURKANA SOUTH","79",95,120,215
"44500","TURKANA","TURKANA SOUTH","75-79",338,397,735
"44501","TURKANA","TURKANA SOUTH","80",135,154,289
"44502","TURKANA","TURKANA SOUTH","81",34,29,63
"44503","TURKANA","TURKANA SOUTH","82",14,21,35
"44504","TURKANA","TURKANA SOUTH","83",11,30,41
"44505","TURKANA","TURKANA SOUTH","84",22,31,53
"44506","TURKANA","TURKANA SOUTH","80-84",216,265,481
"44507","TURKANA","TURKANA SOUTH","85",26,35,61
"44508","TURKANA","TURKANA SOUTH","86",12,12,24
"44509","TURKANA","TURKANA SOUTH","87",8,16,24
"44510","TURKANA","TURKANA SOUTH","88",8,5,13
"44511","TURKANA","TURKANA SOUTH","89",35,46,81
"44512","TURKANA","TURKANA SOUTH","85-89",89,114,203
"44513","TURKANA","TURKANA SOUTH","90",16,29,45
"44514","TURKANA","TURKANA SOUTH","91",3,9,12
"44515","TURKANA","TURKANA SOUTH","92",2,4,6
"44516","TURKANA","TURKANA SOUTH","93",2,5,7
"44517","TURKANA","TURKANA SOUTH","94",7,6,13
"44518","TURKANA","TURKANA SOUTH","90-94",30,53,83
"44519","TURKANA","TURKANA SOUTH","95",8,12,20
"44520","TURKANA","TURKANA SOUTH","96",2,9,11
"44521","TURKANA","TURKANA SOUTH","97",2,2,4
"44522","TURKANA","TURKANA SOUTH","98",2,2,4
"44523","TURKANA","TURKANA SOUTH","99",5,4,9
"44524","TURKANA","TURKANA SOUTH","95-99",19,29,48
"44525","TURKANA","TURKANA SOUTH","100+",8,11,19
"44526","TURKANA","TURKANA SOUTH","Not Stated",NA,NA,NA
"44527","TURKANA","TURKANA WEST","Total",123867,115758,239625
"44528","TURKANA","TURKANA WEST","0",2603,2570,5173
"44529","TURKANA","TURKANA WEST","1",2859,2884,5743
"44530","TURKANA","TURKANA WEST","2",3660,3639,7299
"44531","TURKANA","TURKANA WEST","3",3913,3753,7666
"44532","TURKANA","TURKANA WEST","4",3914,3910,7824
"44533","TURKANA","TURKANA WEST","0 - 4",16949,16756,33705
"44534","TURKANA","TURKANA WEST","5",4017,3929,7946
"44535","TURKANA","TURKANA WEST","6",4031,3797,7828
"44536","TURKANA","TURKANA WEST","7",3605,3385,6990
"44537","TURKANA","TURKANA WEST","8",3978,3674,7652
"44538","TURKANA","TURKANA WEST","9",3260,3167,6427
"44539","TURKANA","TURKANA WEST","5-9",18891,17952,36843
"44540","TURKANA","TURKANA WEST","10",4689,4273,8962
"44541","TURKANA","TURKANA WEST","11",2868,2818,5686
"44542","TURKANA","TURKANA WEST","12",4209,3477,7686
"44543","TURKANA","TURKANA WEST","13",3501,2937,6438
"44544","TURKANA","TURKANA WEST","14",3663,3017,6680
"44545","TURKANA","TURKANA WEST","10 -14",18930,16522,35452
"44546","TURKANA","TURKANA WEST","15",4236,3242,7478
"44547","TURKANA","TURKANA WEST","16",3499,2746,6245
"44548","TURKANA","TURKANA WEST","17",3358,2544,5902
"44549","TURKANA","TURKANA WEST","18",3669,2735,6404
"44550","TURKANA","TURKANA WEST","19",3142,2588,5730
"44551","TURKANA","TURKANA WEST","15-19",17904,13855,31759
"44552","TURKANA","TURKANA WEST","20",4103,3341,7444
"44553","TURKANA","TURKANA WEST","21",2374,1917,4291
"44554","TURKANA","TURKANA WEST","22",2902,2376,5278
"44555","TURKANA","TURKANA WEST","23",2401,1933,4334
"44556","TURKANA","TURKANA WEST","24",2266,1990,4256
"44557","TURKANA","TURKANA WEST","20-24",14046,11557,25603
"44558","TURKANA","TURKANA WEST","25",2864,2527,5391
"44559","TURKANA","TURKANA WEST","26",1823,1804,3627
"44560","TURKANA","TURKANA WEST","27",2168,1963,4131
"44561","TURKANA","TURKANA WEST","28",1801,1593,3394
"44562","TURKANA","TURKANA WEST","29",1838,1892,3730
"44563","TURKANA","TURKANA WEST","25-29",10494,9779,20273
"44564","TURKANA","TURKANA WEST","30",2912,2964,5876
"44565","TURKANA","TURKANA WEST","31",1142,1298,2440
"44566","TURKANA","TURKANA WEST","32",1447,1458,2905
"44567","TURKANA","TURKANA WEST","33",1096,1338,2434
"44568","TURKANA","TURKANA WEST","34",1117,1234,2351
"44569","TURKANA","TURKANA WEST","30-34",7714,8292,16006
"44570","TURKANA","TURKANA WEST","35",1645,1737,3382
"44571","TURKANA","TURKANA WEST","36",859,971,1830
"44572","TURKANA","TURKANA WEST","37",863,978,1841
"44573","TURKANA","TURKANA WEST","38",765,856,1621
"44574","TURKANA","TURKANA WEST","39",1169,1490,2659
"44575","TURKANA","TURKANA WEST","35-39",5301,6032,11333
"44576","TURKANA","TURKANA WEST","40",1747,1380,3127
"44577","TURKANA","TURKANA WEST","41",699,860,1559
"44578","TURKANA","TURKANA WEST","42",739,676,1415
"44579","TURKANA","TURKANA WEST","43",534,572,1106
"44580","TURKANA","TURKANA WEST","44",537,595,1132
"44581","TURKANA","TURKANA WEST","40-44",4256,4083,8339
"44582","TURKANA","TURKANA WEST","45",948,929,1877
"44583","TURKANA","TURKANA WEST","46",525,568,1093
"44584","TURKANA","TURKANA WEST","47",475,470,945
"44585","TURKANA","TURKANA WEST","48",364,365,729
"44586","TURKANA","TURKANA WEST","49",525,640,1165
"44587","TURKANA","TURKANA WEST","45-49",2837,2972,5809
"44588","TURKANA","TURKANA WEST","50",941,901,1842
"44589","TURKANA","TURKANA WEST","51",329,414,743
"44590","TURKANA","TURKANA WEST","52",278,347,625
"44591","TURKANA","TURKANA WEST","53",224,284,508
"44592","TURKANA","TURKANA WEST","54",314,344,658
"44593","TURKANA","TURKANA WEST","50-54",2086,2290,4376
"44594","TURKANA","TURKANA WEST","55",381,405,786
"44595","TURKANA","TURKANA WEST","56",317,293,610
"44596","TURKANA","TURKANA WEST","57",201,235,436
"44597","TURKANA","TURKANA WEST","58",155,193,348
"44598","TURKANA","TURKANA WEST","59",340,439,779
"44599","TURKANA","TURKANA WEST","55-59",1394,1565,2959
"44600","TURKANA","TURKANA WEST","60",512,568,1080
"44601","TURKANA","TURKANA WEST","61",216,231,447
"44602","TURKANA","TURKANA WEST","62",170,163,333
"44603","TURKANA","TURKANA WEST","63",141,229,370
"44604","TURKANA","TURKANA WEST","64",135,159,294
"44605","TURKANA","TURKANA WEST","60-64",1174,1350,2524
"44606","TURKANA","TURKANA WEST","65",221,313,534
"44607","TURKANA","TURKANA WEST","66",89,119,208
"44608","TURKANA","TURKANA WEST","67",115,179,294
"44609","TURKANA","TURKANA WEST","68",83,120,203
"44610","TURKANA","TURKANA WEST","69",206,310,516
"44611","TURKANA","TURKANA WEST","65-69",714,1041,1755
"44612","TURKANA","TURKANA WEST","70",260,336,596
"44613","TURKANA","TURKANA WEST","71",87,174,261
"44614","TURKANA","TURKANA WEST","72",66,100,166
"44615","TURKANA","TURKANA WEST","73",57,98,155
"44616","TURKANA","TURKANA WEST","74",113,151,264
"44617","TURKANA","TURKANA WEST","70-74",583,859,1442
"44618","TURKANA","TURKANA WEST","75",102,98,200
"44619","TURKANA","TURKANA WEST","76",39,57,96
"44620","TURKANA","TURKANA WEST","77",42,70,112
"44621","TURKANA","TURKANA WEST","78",30,55,85
"44622","TURKANA","TURKANA WEST","79",90,142,232
"44623","TURKANA","TURKANA WEST","75-79",303,422,725
"44624","TURKANA","TURKANA WEST","80",90,108,198
"44625","TURKANA","TURKANA WEST","81",23,53,76
"44626","TURKANA","TURKANA WEST","82",18,24,42
"44627","TURKANA","TURKANA WEST","83",14,30,44
"44628","TURKANA","TURKANA WEST","84",21,29,50
"44629","TURKANA","TURKANA WEST","80-84",166,244,410
"44630","TURKANA","TURKANA WEST","85",15,25,40
"44631","TURKANA","TURKANA WEST","86",11,21,32
"44632","TURKANA","TURKANA WEST","87",16,9,25
"44633","TURKANA","TURKANA WEST","88",7,6,13
"44634","TURKANA","TURKANA WEST","89",34,49,83
"44635","TURKANA","TURKANA WEST","85-89",83,110,193
"44636","TURKANA","TURKANA WEST","90",12,19,31
"44637","TURKANA","TURKANA WEST","91",5,10,15
"44638","TURKANA","TURKANA WEST","92",4,5,9
"44639","TURKANA","TURKANA WEST","93",2,11,13
"44640","TURKANA","TURKANA WEST","94",4,4,8
"44641","TURKANA","TURKANA WEST","90-94",27,49,76
"44642","TURKANA","TURKANA WEST","95",1,7,8
"44643","TURKANA","TURKANA WEST","96",4,1,5
"44644","TURKANA","TURKANA WEST","97",NA,3,3
"44645","TURKANA","TURKANA WEST","98",2,NA,2
"44646","TURKANA","TURKANA WEST","99",5,6,11
"44647","TURKANA","TURKANA WEST","95-99",12,17,29
"44648","TURKANA","TURKANA WEST","100+",3,10,13
"44649","TURKANA","TURKANA WEST","Not Stated",NA,1,1
"44650","UASIN GISHU","ALL","Total",580269,582889,1163158
"44651","UASIN GISHU","ALL","0",13650,13823,27473
"44652","UASIN GISHU","ALL","1",13849,13774,27623
"44653","UASIN GISHU","ALL","2",13952,13639,27591
"44654","UASIN GISHU","ALL","3",14238,14562,28800
"44655","UASIN GISHU","ALL","4",14657,14079,28736
"44656","UASIN GISHU","ALL","0 - 4",70346,69877,140223
"44657","UASIN GISHU","ALL","5",13999,13261,27260
"44658","UASIN GISHU","ALL","6",14187,14005,28192
"44659","UASIN GISHU","ALL","7",14259,13940,28199
"44660","UASIN GISHU","ALL","8",13486,13394,26880
"44661","UASIN GISHU","ALL","9",15011,15010,30021
"44662","UASIN GISHU","ALL","5-9",70942,69610,140552
"44663","UASIN GISHU","ALL","10",14899,14525,29424
"44664","UASIN GISHU","ALL","11",13880,14205,28085
"44665","UASIN GISHU","ALL","12",15311,15176,30487
"44666","UASIN GISHU","ALL","13",14909,15356,30265
"44667","UASIN GISHU","ALL","14",14327,14272,28599
"44668","UASIN GISHU","ALL","10 -14",73326,73534,146860
"44669","UASIN GISHU","ALL","15",13886,13934,27820
"44670","UASIN GISHU","ALL","16",13317,13797,27114
"44671","UASIN GISHU","ALL","17",14077,13889,27966
"44672","UASIN GISHU","ALL","18",11017,11113,22130
"44673","UASIN GISHU","ALL","19",13368,13533,26901
"44674","UASIN GISHU","ALL","15-19",65665,66266,131931
"44675","UASIN GISHU","ALL","20",11979,13076,25055
"44676","UASIN GISHU","ALL","21",12355,13206,25561
"44677","UASIN GISHU","ALL","22",12039,12951,24990
"44678","UASIN GISHU","ALL","23",12860,13946,26806
"44679","UASIN GISHU","ALL","24",12256,12947,25203
"44680","UASIN GISHU","ALL","20-24",61489,66126,127615
"44681","UASIN GISHU","ALL","25",13003,13112,26115
"44682","UASIN GISHU","ALL","26",10751,11241,21992
"44683","UASIN GISHU","ALL","27",10741,11069,21810
"44684","UASIN GISHU","ALL","28",8363,8730,17093
"44685","UASIN GISHU","ALL","29",9282,9903,19185
"44686","UASIN GISHU","ALL","25-29",52140,54055,106195
"44687","UASIN GISHU","ALL","30",10768,11468,22236
"44688","UASIN GISHU","ALL","31",8078,8307,16385
"44689","UASIN GISHU","ALL","32",10261,10835,21096
"44690","UASIN GISHU","ALL","33",8387,9235,17622
"44691","UASIN GISHU","ALL","34",7816,8298,16114
"44692","UASIN GISHU","ALL","30-34",45310,48143,93453
"44693","UASIN GISHU","ALL","35",10039,9778,19817
"44694","UASIN GISHU","ALL","36",6872,6301,13173
"44695","UASIN GISHU","ALL","37",7072,6239,13311
"44696","UASIN GISHU","ALL","38",5188,4797,9985
"44697","UASIN GISHU","ALL","39",6214,5718,11932
"44698","UASIN GISHU","ALL","35-39",35385,32833,68218
"44699","UASIN GISHU","ALL","40",6989,6336,13325
"44700","UASIN GISHU","ALL","41",6794,5958,12752
"44701","UASIN GISHU","ALL","42",6256,5646,11902
"44702","UASIN GISHU","ALL","43",5243,5191,10434
"44703","UASIN GISHU","ALL","44",4262,3927,8189
"44704","UASIN GISHU","ALL","40-44",29544,27058,56602
"44705","UASIN GISHU","ALL","45",6936,6068,13004
"44706","UASIN GISHU","ALL","46",4710,4431,9141
"44707","UASIN GISHU","ALL","47",4880,4528,9408
"44708","UASIN GISHU","ALL","48",3169,2945,6114
"44709","UASIN GISHU","ALL","49",3990,3704,7694
"44710","UASIN GISHU","ALL","45-49",23685,21676,45361
"44711","UASIN GISHU","ALL","50",4214,3829,8043
"44712","UASIN GISHU","ALL","51",3353,3057,6410
"44713","UASIN GISHU","ALL","52",2937,2757,5694
"44714","UASIN GISHU","ALL","53",2354,2152,4506
"44715","UASIN GISHU","ALL","54",2708,2415,5123
"44716","UASIN GISHU","ALL","50-54",15566,14210,29776
"44717","UASIN GISHU","ALL","55",2641,2085,4726
"44718","UASIN GISHU","ALL","56",2373,2429,4802
"44719","UASIN GISHU","ALL","57",2520,3012,5532
"44720","UASIN GISHU","ALL","58",2312,2613,4925
"44721","UASIN GISHU","ALL","59",2498,2293,4791
"44722","UASIN GISHU","ALL","55-59",12344,12432,24776
"44723","UASIN GISHU","ALL","60",2448,2376,4824
"44724","UASIN GISHU","ALL","61",1878,1875,3753
"44725","UASIN GISHU","ALL","62",1531,1493,3024
"44726","UASIN GISHU","ALL","63",1497,1552,3049
"44727","UASIN GISHU","ALL","64",1165,1166,2331
"44728","UASIN GISHU","ALL","60-64",8519,8462,16981
"44729","UASIN GISHU","ALL","65",1677,1741,3418
"44730","UASIN GISHU","ALL","66",956,1055,2011
"44731","UASIN GISHU","ALL","67",1678,1782,3460
"44732","UASIN GISHU","ALL","68",723,714,1437
"44733","UASIN GISHU","ALL","69",1153,1164,2317
"44734","UASIN GISHU","ALL","65-69",6187,6456,12643
"44735","UASIN GISHU","ALL","70",1223,1439,2662
"44736","UASIN GISHU","ALL","71",991,1004,1995
"44737","UASIN GISHU","ALL","72",733,701,1434
"44738","UASIN GISHU","ALL","73",650,597,1247
"44739","UASIN GISHU","ALL","74",626,733,1359
"44740","UASIN GISHU","ALL","70-74",4223,4474,8697
"44741","UASIN GISHU","ALL","75",604,792,1396
"44742","UASIN GISHU","ALL","76",622,824,1446
"44743","UASIN GISHU","ALL","77",538,586,1124
"44744","UASIN GISHU","ALL","78",298,310,608
"44745","UASIN GISHU","ALL","79",443,700,1143
"44746","UASIN GISHU","ALL","75-79",2505,3212,5717
"44747","UASIN GISHU","ALL","80",474,697,1171
"44748","UASIN GISHU","ALL","81",268,390,658
"44749","UASIN GISHU","ALL","82",265,232,497
"44750","UASIN GISHU","ALL","83",281,313,594
"44751","UASIN GISHU","ALL","84",260,385,645
"44752","UASIN GISHU","ALL","80-84",1548,2017,3565
"44753","UASIN GISHU","ALL","85",206,335,541
"44754","UASIN GISHU","ALL","86",153,205,358
"44755","UASIN GISHU","ALL","87",181,219,400
"44756","UASIN GISHU","ALL","88",103,111,214
"44757","UASIN GISHU","ALL","89",181,388,569
"44758","UASIN GISHU","ALL","85-89",824,1258,2082
"44759","UASIN GISHU","ALL","90",107,215,322
"44760","UASIN GISHU","ALL","91",80,115,195
"44761","UASIN GISHU","ALL","92",67,75,142
"44762","UASIN GISHU","ALL","93",76,64,140
"44763","UASIN GISHU","ALL","94",45,106,151
"44764","UASIN GISHU","ALL","90-94",375,575,950
"44765","UASIN GISHU","ALL","95",124,164,288
"44766","UASIN GISHU","ALL","96",34,53,87
"44767","UASIN GISHU","ALL","97",46,59,105
"44768","UASIN GISHU","ALL","98",25,24,49
"44769","UASIN GISHU","ALL","99",35,94,129
"44770","UASIN GISHU","ALL","95-99",264,394,658
"44771","UASIN GISHU","ALL","100+",73,218,291
"44772","UASIN GISHU","ALL","Not Stated",9,3,12
"44773","UASIN GISHU","AINABKOI","Total",68348,69835,138183
"44774","UASIN GISHU","AINABKOI","0",1634,1719,3353
"44775","UASIN GISHU","AINABKOI","1",1603,1510,3113
"44776","UASIN GISHU","AINABKOI","2",1612,1525,3137
"44777","UASIN GISHU","AINABKOI","3",1696,1785,3481
"44778","UASIN GISHU","AINABKOI","4",1690,1600,3290
"44779","UASIN GISHU","AINABKOI","0 - 4",8235,8139,16374
"44780","UASIN GISHU","AINABKOI","5",1628,1599,3227
"44781","UASIN GISHU","AINABKOI","6",1623,1623,3246
"44782","UASIN GISHU","AINABKOI","7",1726,1692,3418
"44783","UASIN GISHU","AINABKOI","8",1554,1547,3101
"44784","UASIN GISHU","AINABKOI","9",1761,1777,3538
"44785","UASIN GISHU","AINABKOI","5-9",8292,8238,16530
"44786","UASIN GISHU","AINABKOI","10",1825,1707,3532
"44787","UASIN GISHU","AINABKOI","11",1690,1634,3324
"44788","UASIN GISHU","AINABKOI","12",1771,1754,3525
"44789","UASIN GISHU","AINABKOI","13",1751,1835,3586
"44790","UASIN GISHU","AINABKOI","14",1723,1807,3530
"44791","UASIN GISHU","AINABKOI","10 -14",8760,8737,17497
"44792","UASIN GISHU","AINABKOI","15",1600,1775,3375
"44793","UASIN GISHU","AINABKOI","16",1595,1669,3264
"44794","UASIN GISHU","AINABKOI","17",1676,1652,3328
"44795","UASIN GISHU","AINABKOI","18",1343,1330,2673
"44796","UASIN GISHU","AINABKOI","19",1604,1683,3287
"44797","UASIN GISHU","AINABKOI","15-19",7818,8109,15927
"44798","UASIN GISHU","AINABKOI","20",1382,1493,2875
"44799","UASIN GISHU","AINABKOI","21",1409,1529,2938
"44800","UASIN GISHU","AINABKOI","22",1364,1456,2820
"44801","UASIN GISHU","AINABKOI","23",1420,1574,2994
"44802","UASIN GISHU","AINABKOI","24",1342,1483,2825
"44803","UASIN GISHU","AINABKOI","20-24",6917,7535,14452
"44804","UASIN GISHU","AINABKOI","25",1424,1514,2938
"44805","UASIN GISHU","AINABKOI","26",1267,1224,2491
"44806","UASIN GISHU","AINABKOI","27",1209,1277,2486
"44807","UASIN GISHU","AINABKOI","28",939,980,1919
"44808","UASIN GISHU","AINABKOI","29",1055,1164,2219
"44809","UASIN GISHU","AINABKOI","25-29",5894,6159,12053
"44810","UASIN GISHU","AINABKOI","30",1252,1361,2613
"44811","UASIN GISHU","AINABKOI","31",904,999,1903
"44812","UASIN GISHU","AINABKOI","32",1145,1302,2447
"44813","UASIN GISHU","AINABKOI","33",979,1103,2082
"44814","UASIN GISHU","AINABKOI","34",929,1002,1931
"44815","UASIN GISHU","AINABKOI","30-34",5209,5767,10976
"44816","UASIN GISHU","AINABKOI","35",1218,1250,2468
"44817","UASIN GISHU","AINABKOI","36",811,749,1560
"44818","UASIN GISHU","AINABKOI","37",831,779,1610
"44819","UASIN GISHU","AINABKOI","38",642,657,1299
"44820","UASIN GISHU","AINABKOI","39",709,693,1402
"44821","UASIN GISHU","AINABKOI","35-39",4211,4128,8339
"44822","UASIN GISHU","AINABKOI","40",816,831,1647
"44823","UASIN GISHU","AINABKOI","41",849,723,1572
"44824","UASIN GISHU","AINABKOI","42",728,694,1422
"44825","UASIN GISHU","AINABKOI","43",646,635,1281
"44826","UASIN GISHU","AINABKOI","44",507,504,1011
"44827","UASIN GISHU","AINABKOI","40-44",3546,3387,6933
"44828","UASIN GISHU","AINABKOI","45",860,750,1610
"44829","UASIN GISHU","AINABKOI","46",558,563,1121
"44830","UASIN GISHU","AINABKOI","47",586,589,1175
"44831","UASIN GISHU","AINABKOI","48",414,378,792
"44832","UASIN GISHU","AINABKOI","49",489,462,951
"44833","UASIN GISHU","AINABKOI","45-49",2907,2742,5649
"44834","UASIN GISHU","AINABKOI","50",556,507,1063
"44835","UASIN GISHU","AINABKOI","51",392,379,771
"44836","UASIN GISHU","AINABKOI","52",410,364,774
"44837","UASIN GISHU","AINABKOI","53",287,245,532
"44838","UASIN GISHU","AINABKOI","54",331,315,646
"44839","UASIN GISHU","AINABKOI","50-54",1976,1810,3786
"44840","UASIN GISHU","AINABKOI","55",345,249,594
"44841","UASIN GISHU","AINABKOI","56",269,271,540
"44842","UASIN GISHU","AINABKOI","57",296,397,693
"44843","UASIN GISHU","AINABKOI","58",275,365,640
"44844","UASIN GISHU","AINABKOI","59",291,267,558
"44845","UASIN GISHU","AINABKOI","55-59",1476,1549,3025
"44846","UASIN GISHU","AINABKOI","60",332,321,653
"44847","UASIN GISHU","AINABKOI","61",228,207,435
"44848","UASIN GISHU","AINABKOI","62",183,182,365
"44849","UASIN GISHU","AINABKOI","63",178,200,378
"44850","UASIN GISHU","AINABKOI","64",150,152,302
"44851","UASIN GISHU","AINABKOI","60-64",1071,1062,2133
"44852","UASIN GISHU","AINABKOI","65",195,231,426
"44853","UASIN GISHU","AINABKOI","66",124,119,243
"44854","UASIN GISHU","AINABKOI","67",223,244,467
"44855","UASIN GISHU","AINABKOI","68",86,99,185
"44856","UASIN GISHU","AINABKOI","69",124,140,264
"44857","UASIN GISHU","AINABKOI","65-69",752,833,1585
"44858","UASIN GISHU","AINABKOI","70",149,223,372
"44859","UASIN GISHU","AINABKOI","71",120,103,223
"44860","UASIN GISHU","AINABKOI","72",96,102,198
"44861","UASIN GISHU","AINABKOI","73",83,70,153
"44862","UASIN GISHU","AINABKOI","74",84,108,192
"44863","UASIN GISHU","AINABKOI","70-74",532,606,1138
"44864","UASIN GISHU","AINABKOI","75",100,100,200
"44865","UASIN GISHU","AINABKOI","76",79,105,184
"44866","UASIN GISHU","AINABKOI","77",62,83,145
"44867","UASIN GISHU","AINABKOI","78",41,45,86
"44868","UASIN GISHU","AINABKOI","79",54,101,155
"44869","UASIN GISHU","AINABKOI","75-79",336,434,770
"44870","UASIN GISHU","AINABKOI","80",72,112,184
"44871","UASIN GISHU","AINABKOI","81",29,47,76
"44872","UASIN GISHU","AINABKOI","82",36,32,68
"44873","UASIN GISHU","AINABKOI","83",44,39,83
"44874","UASIN GISHU","AINABKOI","84",43,54,97
"44875","UASIN GISHU","AINABKOI","80-84",224,284,508
"44876","UASIN GISHU","AINABKOI","85",19,43,62
"44877","UASIN GISHU","AINABKOI","86",27,19,46
"44878","UASIN GISHU","AINABKOI","87",22,33,55
"44879","UASIN GISHU","AINABKOI","88",11,24,35
"44880","UASIN GISHU","AINABKOI","89",27,41,68
"44881","UASIN GISHU","AINABKOI","85-89",106,160,266
"44882","UASIN GISHU","AINABKOI","90",25,27,52
"44883","UASIN GISHU","AINABKOI","91",8,13,21
"44884","UASIN GISHU","AINABKOI","92",6,10,16
"44885","UASIN GISHU","AINABKOI","93",8,8,16
"44886","UASIN GISHU","AINABKOI","94",6,17,23
"44887","UASIN GISHU","AINABKOI","90-94",53,75,128
"44888","UASIN GISHU","AINABKOI","95",10,22,32
"44889","UASIN GISHU","AINABKOI","96",7,7,14
"44890","UASIN GISHU","AINABKOI","97",4,8,12
"44891","UASIN GISHU","AINABKOI","98",3,3,6
"44892","UASIN GISHU","AINABKOI","99",3,10,13
"44893","UASIN GISHU","AINABKOI","95-99",27,50,77
"44894","UASIN GISHU","AINABKOI","100+",6,30,36
"44895","UASIN GISHU","AINABKOI","Not Stated",NA,1,1
"44896","UASIN GISHU","KAPSERET","Total",99650,98845,198495
"44897","UASIN GISHU","KAPSERET","0",2354,2360,4714
"44898","UASIN GISHU","KAPSERET","1",2370,2323,4693
"44899","UASIN GISHU","KAPSERET","2",2366,2289,4655
"44900","UASIN GISHU","KAPSERET","3",2333,2321,4654
"44901","UASIN GISHU","KAPSERET","4",2316,2243,4559
"44902","UASIN GISHU","KAPSERET","0 - 4",11739,11536,23275
"44903","UASIN GISHU","KAPSERET","5",2171,2087,4258
"44904","UASIN GISHU","KAPSERET","6",2216,2190,4406
"44905","UASIN GISHU","KAPSERET","7",2160,2180,4340
"44906","UASIN GISHU","KAPSERET","8",2103,2202,4305
"44907","UASIN GISHU","KAPSERET","9",2335,2365,4700
"44908","UASIN GISHU","KAPSERET","5-9",10985,11024,22009
"44909","UASIN GISHU","KAPSERET","10",2182,2294,4476
"44910","UASIN GISHU","KAPSERET","11",2029,2085,4114
"44911","UASIN GISHU","KAPSERET","12",2336,2334,4670
"44912","UASIN GISHU","KAPSERET","13",2240,2290,4530
"44913","UASIN GISHU","KAPSERET","14",2130,2131,4261
"44914","UASIN GISHU","KAPSERET","10 -14",10917,11134,22051
"44915","UASIN GISHU","KAPSERET","15",2038,2000,4038
"44916","UASIN GISHU","KAPSERET","16",1881,2090,3971
"44917","UASIN GISHU","KAPSERET","17",2042,2213,4255
"44918","UASIN GISHU","KAPSERET","18",1689,1870,3559
"44919","UASIN GISHU","KAPSERET","19",2086,2354,4440
"44920","UASIN GISHU","KAPSERET","15-19",9736,10527,20263
"44921","UASIN GISHU","KAPSERET","20",2141,2548,4689
"44922","UASIN GISHU","KAPSERET","21",2269,2684,4953
"44923","UASIN GISHU","KAPSERET","22",2297,2602,4899
"44924","UASIN GISHU","KAPSERET","23",2583,2877,5460
"44925","UASIN GISHU","KAPSERET","24",2459,2629,5088
"44926","UASIN GISHU","KAPSERET","20-24",11749,13340,25089
"44927","UASIN GISHU","KAPSERET","25",2568,2603,5171
"44928","UASIN GISHU","KAPSERET","26",2143,2208,4351
"44929","UASIN GISHU","KAPSERET","27",2133,2223,4356
"44930","UASIN GISHU","KAPSERET","28",1780,1770,3550
"44931","UASIN GISHU","KAPSERET","29",1924,1926,3850
"44932","UASIN GISHU","KAPSERET","25-29",10548,10730,21278
"44933","UASIN GISHU","KAPSERET","30",2254,2201,4455
"44934","UASIN GISHU","KAPSERET","31",1674,1556,3230
"44935","UASIN GISHU","KAPSERET","32",2021,2049,4070
"44936","UASIN GISHU","KAPSERET","33",1643,1652,3295
"44937","UASIN GISHU","KAPSERET","34",1536,1558,3094
"44938","UASIN GISHU","KAPSERET","30-34",9128,9016,18144
"44939","UASIN GISHU","KAPSERET","35",1929,1828,3757
"44940","UASIN GISHU","KAPSERET","36",1355,1221,2576
"44941","UASIN GISHU","KAPSERET","37",1312,1145,2457
"44942","UASIN GISHU","KAPSERET","38",1058,954,2012
"44943","UASIN GISHU","KAPSERET","39",1233,1122,2355
"44944","UASIN GISHU","KAPSERET","35-39",6887,6270,13157
"44945","UASIN GISHU","KAPSERET","40",1360,1188,2548
"44946","UASIN GISHU","KAPSERET","41",1232,1015,2247
"44947","UASIN GISHU","KAPSERET","42",1159,997,2156
"44948","UASIN GISHU","KAPSERET","43",1012,904,1916
"44949","UASIN GISHU","KAPSERET","44",798,666,1464
"44950","UASIN GISHU","KAPSERET","40-44",5561,4770,10331
"44951","UASIN GISHU","KAPSERET","45",1184,937,2121
"44952","UASIN GISHU","KAPSERET","46",839,682,1521
"44953","UASIN GISHU","KAPSERET","47",866,699,1565
"44954","UASIN GISHU","KAPSERET","48",591,469,1060
"44955","UASIN GISHU","KAPSERET","49",752,584,1336
"44956","UASIN GISHU","KAPSERET","45-49",4232,3371,7603
"44957","UASIN GISHU","KAPSERET","50",795,638,1433
"44958","UASIN GISHU","KAPSERET","51",599,465,1064
"44959","UASIN GISHU","KAPSERET","52",522,430,952
"44960","UASIN GISHU","KAPSERET","53",391,317,708
"44961","UASIN GISHU","KAPSERET","54",461,382,843
"44962","UASIN GISHU","KAPSERET","50-54",2768,2232,5000
"44963","UASIN GISHU","KAPSERET","55",461,294,755
"44964","UASIN GISHU","KAPSERET","56",417,380,797
"44965","UASIN GISHU","KAPSERET","57",470,417,887
"44966","UASIN GISHU","KAPSERET","58",333,319,652
"44967","UASIN GISHU","KAPSERET","59",395,341,736
"44968","UASIN GISHU","KAPSERET","55-59",2076,1751,3827
"44969","UASIN GISHU","KAPSERET","60",392,311,703
"44970","UASIN GISHU","KAPSERET","61",287,220,507
"44971","UASIN GISHU","KAPSERET","62",250,192,442
"44972","UASIN GISHU","KAPSERET","63",230,186,416
"44973","UASIN GISHU","KAPSERET","64",180,143,323
"44974","UASIN GISHU","KAPSERET","60-64",1339,1052,2391
"44975","UASIN GISHU","KAPSERET","65",239,188,427
"44976","UASIN GISHU","KAPSERET","66",129,133,262
"44977","UASIN GISHU","KAPSERET","67",223,200,423
"44978","UASIN GISHU","KAPSERET","68",109,93,202
"44979","UASIN GISHU","KAPSERET","69",163,130,293
"44980","UASIN GISHU","KAPSERET","65-69",863,744,1607
"44981","UASIN GISHU","KAPSERET","70",150,164,314
"44982","UASIN GISHU","KAPSERET","71",123,105,228
"44983","UASIN GISHU","KAPSERET","72",98,76,174
"44984","UASIN GISHU","KAPSERET","73",78,80,158
"44985","UASIN GISHU","KAPSERET","74",78,75,153
"44986","UASIN GISHU","KAPSERET","70-74",527,500,1027
"44987","UASIN GISHU","KAPSERET","75",76,83,159
"44988","UASIN GISHU","KAPSERET","76",57,92,149
"44989","UASIN GISHU","KAPSERET","77",55,69,124
"44990","UASIN GISHU","KAPSERET","78",38,36,74
"44991","UASIN GISHU","KAPSERET","79",54,82,136
"44992","UASIN GISHU","KAPSERET","75-79",280,362,642
"44993","UASIN GISHU","KAPSERET","80",44,70,114
"44994","UASIN GISHU","KAPSERET","81",32,42,74
"44995","UASIN GISHU","KAPSERET","82",29,24,53
"44996","UASIN GISHU","KAPSERET","83",31,37,68
"44997","UASIN GISHU","KAPSERET","84",27,39,66
"44998","UASIN GISHU","KAPSERET","80-84",163,212,375
"44999","UASIN GISHU","KAPSERET","85",21,42,63
"45000","UASIN GISHU","KAPSERET","86",10,21,31
"45001","UASIN GISHU","KAPSERET","87",17,20,37
"45002","UASIN GISHU","KAPSERET","88",10,11,21
"45003","UASIN GISHU","KAPSERET","89",19,42,61
"45004","UASIN GISHU","KAPSERET","85-89",77,136,213
"45005","UASIN GISHU","KAPSERET","90",7,20,27
"45006","UASIN GISHU","KAPSERET","91",11,20,31
"45007","UASIN GISHU","KAPSERET","92",5,9,14
"45008","UASIN GISHU","KAPSERET","93",7,8,15
"45009","UASIN GISHU","KAPSERET","94",4,11,15
"45010","UASIN GISHU","KAPSERET","90-94",34,68,102
"45011","UASIN GISHU","KAPSERET","95",16,17,33
"45012","UASIN GISHU","KAPSERET","96",5,6,11
"45013","UASIN GISHU","KAPSERET","97",4,5,9
"45014","UASIN GISHU","KAPSERET","98",2,2,4
"45015","UASIN GISHU","KAPSERET","99",2,13,15
"45016","UASIN GISHU","KAPSERET","95-99",29,43,72
"45017","UASIN GISHU","KAPSERET","100+",10,25,35
"45018","UASIN GISHU","KAPSERET","Not Stated",2,2,4
"45019","UASIN GISHU","KESSES","Total",74301,74493,148794
"45020","UASIN GISHU","KESSES","0",1711,1778,3489
"45021","UASIN GISHU","KESSES","1",1720,1682,3402
"45022","UASIN GISHU","KESSES","2",1798,1740,3538
"45023","UASIN GISHU","KESSES","3",1781,1792,3573
"45024","UASIN GISHU","KESSES","4",1946,1892,3838
"45025","UASIN GISHU","KESSES","0 - 4",8956,8884,17840
"45026","UASIN GISHU","KESSES","5",1917,1754,3671
"45027","UASIN GISHU","KESSES","6",1983,1853,3836
"45028","UASIN GISHU","KESSES","7",2000,1764,3764
"45029","UASIN GISHU","KESSES","8",1834,1878,3712
"45030","UASIN GISHU","KESSES","9",2079,2060,4139
"45031","UASIN GISHU","KESSES","5-9",9813,9309,19122
"45032","UASIN GISHU","KESSES","10",2086,2037,4123
"45033","UASIN GISHU","KESSES","11",1984,1931,3915
"45034","UASIN GISHU","KESSES","12",2192,2149,4341
"45035","UASIN GISHU","KESSES","13",2118,2084,4202
"45036","UASIN GISHU","KESSES","14",2037,2013,4050
"45037","UASIN GISHU","KESSES","10 -14",10417,10214,20631
"45038","UASIN GISHU","KESSES","15",2029,1918,3947
"45039","UASIN GISHU","KESSES","16",1943,1997,3940
"45040","UASIN GISHU","KESSES","17",2033,1880,3913
"45041","UASIN GISHU","KESSES","18",1497,1430,2927
"45042","UASIN GISHU","KESSES","19",1687,1595,3282
"45043","UASIN GISHU","KESSES","15-19",9189,8820,18009
"45044","UASIN GISHU","KESSES","20",1496,1417,2913
"45045","UASIN GISHU","KESSES","21",1486,1499,2985
"45046","UASIN GISHU","KESSES","22",1435,1381,2816
"45047","UASIN GISHU","KESSES","23",1480,1463,2943
"45048","UASIN GISHU","KESSES","24",1389,1469,2858
"45049","UASIN GISHU","KESSES","20-24",7286,7229,14515
"45050","UASIN GISHU","KESSES","25",1485,1413,2898
"45051","UASIN GISHU","KESSES","26",1087,1237,2324
"45052","UASIN GISHU","KESSES","27",1250,1197,2447
"45053","UASIN GISHU","KESSES","28",894,960,1854
"45054","UASIN GISHU","KESSES","29",936,1130,2066
"45055","UASIN GISHU","KESSES","25-29",5652,5937,11589
"45056","UASIN GISHU","KESSES","30",1102,1262,2364
"45057","UASIN GISHU","KESSES","31",856,899,1755
"45058","UASIN GISHU","KESSES","32",1092,1305,2397
"45059","UASIN GISHU","KESSES","33",962,1119,2081
"45060","UASIN GISHU","KESSES","34",847,969,1816
"45061","UASIN GISHU","KESSES","30-34",4859,5554,10413
"45062","UASIN GISHU","KESSES","35",1132,1228,2360
"45063","UASIN GISHU","KESSES","36",771,704,1475
"45064","UASIN GISHU","KESSES","37",832,747,1579
"45065","UASIN GISHU","KESSES","38",574,541,1115
"45066","UASIN GISHU","KESSES","39",719,725,1444
"45067","UASIN GISHU","KESSES","35-39",4028,3945,7973
"45068","UASIN GISHU","KESSES","40",863,764,1627
"45069","UASIN GISHU","KESSES","41",854,763,1617
"45070","UASIN GISHU","KESSES","42",712,672,1384
"45071","UASIN GISHU","KESSES","43",630,670,1300
"45072","UASIN GISHU","KESSES","44",530,530,1060
"45073","UASIN GISHU","KESSES","40-44",3589,3399,6988
"45074","UASIN GISHU","KESSES","45",850,834,1684
"45075","UASIN GISHU","KESSES","46",612,602,1214
"45076","UASIN GISHU","KESSES","47",612,623,1235
"45077","UASIN GISHU","KESSES","48",356,399,755
"45078","UASIN GISHU","KESSES","49",476,521,997
"45079","UASIN GISHU","KESSES","45-49",2906,2979,5885
"45080","UASIN GISHU","KESSES","50",549,522,1071
"45081","UASIN GISHU","KESSES","51",465,446,911
"45082","UASIN GISHU","KESSES","52",365,386,751
"45083","UASIN GISHU","KESSES","53",319,350,669
"45084","UASIN GISHU","KESSES","54",408,332,740
"45085","UASIN GISHU","KESSES","50-54",2106,2036,4142
"45086","UASIN GISHU","KESSES","55",353,313,666
"45087","UASIN GISHU","KESSES","56",344,349,693
"45088","UASIN GISHU","KESSES","57",336,427,763
"45089","UASIN GISHU","KESSES","58",354,420,774
"45090","UASIN GISHU","KESSES","59",309,346,655
"45091","UASIN GISHU","KESSES","55-59",1696,1855,3551
"45092","UASIN GISHU","KESSES","60",357,359,716
"45093","UASIN GISHU","KESSES","61",281,316,597
"45094","UASIN GISHU","KESSES","62",220,233,453
"45095","UASIN GISHU","KESSES","63",193,215,408
"45096","UASIN GISHU","KESSES","64",168,186,354
"45097","UASIN GISHU","KESSES","60-64",1219,1309,2528
"45098","UASIN GISHU","KESSES","65",237,270,507
"45099","UASIN GISHU","KESSES","66",156,145,301
"45100","UASIN GISHU","KESSES","67",279,258,537
"45101","UASIN GISHU","KESSES","68",112,103,215
"45102","UASIN GISHU","KESSES","69",193,182,375
"45103","UASIN GISHU","KESSES","65-69",977,958,1935
"45104","UASIN GISHU","KESSES","70",204,245,449
"45105","UASIN GISHU","KESSES","71",151,176,327
"45106","UASIN GISHU","KESSES","72",120,97,217
"45107","UASIN GISHU","KESSES","73",96,93,189
"45108","UASIN GISHU","KESSES","74",98,135,233
"45109","UASIN GISHU","KESSES","70-74",669,746,1415
"45110","UASIN GISHU","KESSES","75",85,137,222
"45111","UASIN GISHU","KESSES","76",96,138,234
"45112","UASIN GISHU","KESSES","77",101,83,184
"45113","UASIN GISHU","KESSES","78",53,49,102
"45114","UASIN GISHU","KESSES","79",79,123,202
"45115","UASIN GISHU","KESSES","75-79",414,530,944
"45116","UASIN GISHU","KESSES","80",73,127,200
"45117","UASIN GISHU","KESSES","81",56,83,139
"45118","UASIN GISHU","KESSES","82",52,31,83
"45119","UASIN GISHU","KESSES","83",34,51,85
"45120","UASIN GISHU","KESSES","84",36,66,102
"45121","UASIN GISHU","KESSES","80-84",251,358,609
"45122","UASIN GISHU","KESSES","85",36,52,88
"45123","UASIN GISHU","KESSES","86",25,32,57
"45124","UASIN GISHU","KESSES","87",33,42,75
"45125","UASIN GISHU","KESSES","88",15,20,35
"45126","UASIN GISHU","KESSES","89",34,77,111
"45127","UASIN GISHU","KESSES","85-89",143,223,366
"45128","UASIN GISHU","KESSES","90",17,40,57
"45129","UASIN GISHU","KESSES","91",20,24,44
"45130","UASIN GISHU","KESSES","92",15,21,36
"45131","UASIN GISHU","KESSES","93",10,9,19
"45132","UASIN GISHU","KESSES","94",11,19,30
"45133","UASIN GISHU","KESSES","90-94",73,113,186
"45134","UASIN GISHU","KESSES","95",23,25,48
"45135","UASIN GISHU","KESSES","96",1,9,10
"45136","UASIN GISHU","KESSES","97",9,7,16
"45137","UASIN GISHU","KESSES","98",5,5,10
"45138","UASIN GISHU","KESSES","99",5,18,23
"45139","UASIN GISHU","KESSES","95-99",43,64,107
"45140","UASIN GISHU","KESSES","100+",14,31,45
"45141","UASIN GISHU","KESSES","Not Stated",1,NA,1
"45142","UASIN GISHU","MOIBEN","Total",90309,91027,181336
"45143","UASIN GISHU","MOIBEN","0",2198,2209,4407
"45144","UASIN GISHU","MOIBEN","1",2150,2256,4406
"45145","UASIN GISHU","MOIBEN","2",2108,2034,4142
"45146","UASIN GISHU","MOIBEN","3",2201,2225,4426
"45147","UASIN GISHU","MOIBEN","4",2278,2211,4489
"45148","UASIN GISHU","MOIBEN","0 - 4",10935,10935,21870
"45149","UASIN GISHU","MOIBEN","5",2028,1940,3968
"45150","UASIN GISHU","MOIBEN","6",2081,2074,4155
"45151","UASIN GISHU","MOIBEN","7",2048,2084,4132
"45152","UASIN GISHU","MOIBEN","8",1959,1879,3838
"45153","UASIN GISHU","MOIBEN","9",2233,2234,4467
"45154","UASIN GISHU","MOIBEN","5-9",10349,10211,20560
"45155","UASIN GISHU","MOIBEN","10",2162,2035,4197
"45156","UASIN GISHU","MOIBEN","11",2077,2121,4198
"45157","UASIN GISHU","MOIBEN","12",2178,2240,4418
"45158","UASIN GISHU","MOIBEN","13",2199,2280,4479
"45159","UASIN GISHU","MOIBEN","14",2080,2096,4176
"45160","UASIN GISHU","MOIBEN","10 -14",10696,10772,21468
"45161","UASIN GISHU","MOIBEN","15",2095,2152,4247
"45162","UASIN GISHU","MOIBEN","16",2023,2043,4066
"45163","UASIN GISHU","MOIBEN","17",2164,2206,4370
"45164","UASIN GISHU","MOIBEN","18",1630,1760,3390
"45165","UASIN GISHU","MOIBEN","19",2129,2217,4346
"45166","UASIN GISHU","MOIBEN","15-19",10041,10378,20419
"45167","UASIN GISHU","MOIBEN","20",1881,2192,4073
"45168","UASIN GISHU","MOIBEN","21",1997,2205,4202
"45169","UASIN GISHU","MOIBEN","22",1944,2132,4076
"45170","UASIN GISHU","MOIBEN","23",2094,2430,4524
"45171","UASIN GISHU","MOIBEN","24",2089,2317,4406
"45172","UASIN GISHU","MOIBEN","20-24",10005,11276,21281
"45173","UASIN GISHU","MOIBEN","25",2192,2286,4478
"45174","UASIN GISHU","MOIBEN","26",1870,2000,3870
"45175","UASIN GISHU","MOIBEN","27",1808,1831,3639
"45176","UASIN GISHU","MOIBEN","28",1420,1516,2936
"45177","UASIN GISHU","MOIBEN","29",1656,1646,3302
"45178","UASIN GISHU","MOIBEN","25-29",8946,9279,18225
"45179","UASIN GISHU","MOIBEN","30",1981,1866,3847
"45180","UASIN GISHU","MOIBEN","31",1401,1319,2720
"45181","UASIN GISHU","MOIBEN","32",1744,1701,3445
"45182","UASIN GISHU","MOIBEN","33",1410,1487,2897
"45183","UASIN GISHU","MOIBEN","34",1231,1285,2516
"45184","UASIN GISHU","MOIBEN","30-34",7767,7658,15425
"45185","UASIN GISHU","MOIBEN","35",1693,1521,3214
"45186","UASIN GISHU","MOIBEN","36",1051,923,1974
"45187","UASIN GISHU","MOIBEN","37",1116,941,2057
"45188","UASIN GISHU","MOIBEN","38",770,649,1419
"45189","UASIN GISHU","MOIBEN","39",1004,848,1852
"45190","UASIN GISHU","MOIBEN","35-39",5634,4882,10516
"45191","UASIN GISHU","MOIBEN","40",1085,952,2037
"45192","UASIN GISHU","MOIBEN","41",1016,908,1924
"45193","UASIN GISHU","MOIBEN","42",968,860,1828
"45194","UASIN GISHU","MOIBEN","43",788,740,1528
"45195","UASIN GISHU","MOIBEN","44",595,551,1146
"45196","UASIN GISHU","MOIBEN","40-44",4452,4011,8463
"45197","UASIN GISHU","MOIBEN","45",1129,999,2128
"45198","UASIN GISHU","MOIBEN","46",709,664,1373
"45199","UASIN GISHU","MOIBEN","47",793,670,1463
"45200","UASIN GISHU","MOIBEN","48",479,460,939
"45201","UASIN GISHU","MOIBEN","49",593,550,1143
"45202","UASIN GISHU","MOIBEN","45-49",3703,3343,7046
"45203","UASIN GISHU","MOIBEN","50",629,571,1200
"45204","UASIN GISHU","MOIBEN","51",494,453,947
"45205","UASIN GISHU","MOIBEN","52",399,427,826
"45206","UASIN GISHU","MOIBEN","53",313,305,618
"45207","UASIN GISHU","MOIBEN","54",449,370,819
"45208","UASIN GISHU","MOIBEN","50-54",2284,2126,4410
"45209","UASIN GISHU","MOIBEN","55",375,320,695
"45210","UASIN GISHU","MOIBEN","56",341,357,698
"45211","UASIN GISHU","MOIBEN","57",371,435,806
"45212","UASIN GISHU","MOIBEN","58",376,424,800
"45213","UASIN GISHU","MOIBEN","59",400,332,732
"45214","UASIN GISHU","MOIBEN","55-59",1863,1868,3731
"45215","UASIN GISHU","MOIBEN","60",366,378,744
"45216","UASIN GISHU","MOIBEN","61",283,296,579
"45217","UASIN GISHU","MOIBEN","62",213,225,438
"45218","UASIN GISHU","MOIBEN","63",193,236,429
"45219","UASIN GISHU","MOIBEN","64",163,182,345
"45220","UASIN GISHU","MOIBEN","60-64",1218,1317,2535
"45221","UASIN GISHU","MOIBEN","65",251,258,509
"45222","UASIN GISHU","MOIBEN","66",137,150,287
"45223","UASIN GISHU","MOIBEN","67",243,276,519
"45224","UASIN GISHU","MOIBEN","68",114,102,216
"45225","UASIN GISHU","MOIBEN","69",161,205,366
"45226","UASIN GISHU","MOIBEN","65-69",906,991,1897
"45227","UASIN GISHU","MOIBEN","70",183,239,422
"45228","UASIN GISHU","MOIBEN","71",136,175,311
"45229","UASIN GISHU","MOIBEN","72",109,109,218
"45230","UASIN GISHU","MOIBEN","73",91,81,172
"45231","UASIN GISHU","MOIBEN","74",104,111,215
"45232","UASIN GISHU","MOIBEN","70-74",623,715,1338
"45233","UASIN GISHU","MOIBEN","75",82,135,217
"45234","UASIN GISHU","MOIBEN","76",99,102,201
"45235","UASIN GISHU","MOIBEN","77",84,84,168
"45236","UASIN GISHU","MOIBEN","78",38,53,91
"45237","UASIN GISHU","MOIBEN","79",72,137,209
"45238","UASIN GISHU","MOIBEN","75-79",375,511,886
"45239","UASIN GISHU","MOIBEN","80",87,129,216
"45240","UASIN GISHU","MOIBEN","81",37,74,111
"45241","UASIN GISHU","MOIBEN","82",49,35,84
"45242","UASIN GISHU","MOIBEN","83",44,52,96
"45243","UASIN GISHU","MOIBEN","84",41,69,110
"45244","UASIN GISHU","MOIBEN","80-84",258,359,617
"45245","UASIN GISHU","MOIBEN","85",40,66,106
"45246","UASIN GISHU","MOIBEN","86",15,33,48
"45247","UASIN GISHU","MOIBEN","87",37,27,64
"45248","UASIN GISHU","MOIBEN","88",12,13,25
"45249","UASIN GISHU","MOIBEN","89",29,71,100
"45250","UASIN GISHU","MOIBEN","85-89",133,210,343
"45251","UASIN GISHU","MOIBEN","90",21,41,62
"45252","UASIN GISHU","MOIBEN","91",14,18,32
"45253","UASIN GISHU","MOIBEN","92",11,7,18
"45254","UASIN GISHU","MOIBEN","93",13,13,26
"45255","UASIN GISHU","MOIBEN","94",7,14,21
"45256","UASIN GISHU","MOIBEN","90-94",66,93,159
"45257","UASIN GISHU","MOIBEN","95",18,29,47
"45258","UASIN GISHU","MOIBEN","96",1,8,9
"45259","UASIN GISHU","MOIBEN","97",10,5,15
"45260","UASIN GISHU","MOIBEN","98",5,2,7
"45261","UASIN GISHU","MOIBEN","99",9,14,23
"45262","UASIN GISHU","MOIBEN","95-99",43,58,101
"45263","UASIN GISHU","MOIBEN","100+",12,34,46
"45264","UASIN GISHU","MOIBEN","Not Stated",NA,NA,NA
"45265","UASIN GISHU","SOY","Total",114082,115007,229089
"45266","UASIN GISHU","SOY","0",2759,2733,5492
"45267","UASIN GISHU","SOY","1",2701,2688,5389
"45268","UASIN GISHU","SOY","2",2847,2838,5685
"45269","UASIN GISHU","SOY","3",2985,3030,6015
"45270","UASIN GISHU","SOY","4",3074,2889,5963
"45271","UASIN GISHU","SOY","0 - 4",14366,14178,28544
"45272","UASIN GISHU","SOY","5",2904,2773,5677
"45273","UASIN GISHU","SOY","6",3013,3015,6028
"45274","UASIN GISHU","SOY","7",3000,2986,5986
"45275","UASIN GISHU","SOY","8",2884,2864,5748
"45276","UASIN GISHU","SOY","9",3293,3217,6510
"45277","UASIN GISHU","SOY","5-9",15094,14855,29949
"45278","UASIN GISHU","SOY","10",3278,3054,6332
"45279","UASIN GISHU","SOY","11",3123,3152,6275
"45280","UASIN GISHU","SOY","12",3403,3275,6678
"45281","UASIN GISHU","SOY","13",3299,3310,6609
"45282","UASIN GISHU","SOY","14",3227,3064,6291
"45283","UASIN GISHU","SOY","10 -14",16330,15855,32185
"45284","UASIN GISHU","SOY","15",3141,3012,6153
"45285","UASIN GISHU","SOY","16",2967,2974,5941
"45286","UASIN GISHU","SOY","17",3122,2831,5953
"45287","UASIN GISHU","SOY","18",2422,2196,4618
"45288","UASIN GISHU","SOY","19",2898,2656,5554
"45289","UASIN GISHU","SOY","15-19",14550,13669,28219
"45290","UASIN GISHU","SOY","20",2376,2442,4818
"45291","UASIN GISHU","SOY","21",2303,2368,4671
"45292","UASIN GISHU","SOY","22",2078,2258,4336
"45293","UASIN GISHU","SOY","23",2102,2334,4436
"45294","UASIN GISHU","SOY","24",1943,2127,4070
"45295","UASIN GISHU","SOY","20-24",10802,11529,22331
"45296","UASIN GISHU","SOY","25",2137,2170,4307
"45297","UASIN GISHU","SOY","26",1663,1772,3435
"45298","UASIN GISHU","SOY","27",1779,1875,3654
"45299","UASIN GISHU","SOY","28",1331,1298,2629
"45300","UASIN GISHU","SOY","29",1556,1627,3183
"45301","UASIN GISHU","SOY","25-29",8466,8742,17208
"45302","UASIN GISHU","SOY","30",1645,1934,3579
"45303","UASIN GISHU","SOY","31",1401,1538,2939
"45304","UASIN GISHU","SOY","32",1730,1852,3582
"45305","UASIN GISHU","SOY","33",1448,1758,3206
"45306","UASIN GISHU","SOY","34",1391,1582,2973
"45307","UASIN GISHU","SOY","30-34",7615,8664,16279
"45308","UASIN GISHU","SOY","35",1702,1740,3442
"45309","UASIN GISHU","SOY","36",1189,1131,2320
"45310","UASIN GISHU","SOY","37",1231,1098,2329
"45311","UASIN GISHU","SOY","38",892,772,1664
"45312","UASIN GISHU","SOY","39",1123,1033,2156
"45313","UASIN GISHU","SOY","35-39",6137,5774,11911
"45314","UASIN GISHU","SOY","40",1150,1115,2265
"45315","UASIN GISHU","SOY","41",1253,1160,2413
"45316","UASIN GISHU","SOY","42",1169,1114,2283
"45317","UASIN GISHU","SOY","43",970,1054,2024
"45318","UASIN GISHU","SOY","44",789,771,1560
"45319","UASIN GISHU","SOY","40-44",5331,5214,10545
"45320","UASIN GISHU","SOY","45",1306,1216,2522
"45321","UASIN GISHU","SOY","46",904,956,1860
"45322","UASIN GISHU","SOY","47",878,930,1808
"45323","UASIN GISHU","SOY","48",580,592,1172
"45324","UASIN GISHU","SOY","49",735,825,1560
"45325","UASIN GISHU","SOY","45-49",4403,4519,8922
"45326","UASIN GISHU","SOY","50",742,735,1477
"45327","UASIN GISHU","SOY","51",631,666,1297
"45328","UASIN GISHU","SOY","52",570,562,1132
"45329","UASIN GISHU","SOY","53",453,479,932
"45330","UASIN GISHU","SOY","54",471,503,974
"45331","UASIN GISHU","SOY","50-54",2867,2945,5812
"45332","UASIN GISHU","SOY","55",509,426,935
"45333","UASIN GISHU","SOY","56",439,464,903
"45334","UASIN GISHU","SOY","57",493,696,1189
"45335","UASIN GISHU","SOY","58",502,560,1062
"45336","UASIN GISHU","SOY","59",537,501,1038
"45337","UASIN GISHU","SOY","55-59",2480,2647,5127
"45338","UASIN GISHU","SOY","60",496,527,1023
"45339","UASIN GISHU","SOY","61",405,420,825
"45340","UASIN GISHU","SOY","62",330,359,689
"45341","UASIN GISHU","SOY","63",357,395,752
"45342","UASIN GISHU","SOY","64",256,277,533
"45343","UASIN GISHU","SOY","60-64",1844,1978,3822
"45344","UASIN GISHU","SOY","65",356,428,784
"45345","UASIN GISHU","SOY","66",207,254,461
"45346","UASIN GISHU","SOY","67",401,440,841
"45347","UASIN GISHU","SOY","68",143,162,305
"45348","UASIN GISHU","SOY","69",280,270,550
"45349","UASIN GISHU","SOY","65-69",1387,1554,2941
"45350","UASIN GISHU","SOY","70",277,318,595
"45351","UASIN GISHU","SOY","71",255,245,500
"45352","UASIN GISHU","SOY","72",163,178,341
"45353","UASIN GISHU","SOY","73",174,151,325
"45354","UASIN GISHU","SOY","74",135,165,300
"45355","UASIN GISHU","SOY","70-74",1004,1057,2061
"45356","UASIN GISHU","SOY","75",159,193,352
"45357","UASIN GISHU","SOY","76",156,221,377
"45358","UASIN GISHU","SOY","77",128,152,280
"45359","UASIN GISHU","SOY","78",75,74,149
"45360","UASIN GISHU","SOY","79",112,144,256
"45361","UASIN GISHU","SOY","75-79",630,784,1414
"45362","UASIN GISHU","SOY","80",114,158,272
"45363","UASIN GISHU","SOY","81",56,80,136
"45364","UASIN GISHU","SOY","82",49,56,105
"45365","UASIN GISHU","SOY","83",79,76,155
"45366","UASIN GISHU","SOY","84",69,84,153
"45367","UASIN GISHU","SOY","80-84",367,454,821
"45368","UASIN GISHU","SOY","85",62,78,140
"45369","UASIN GISHU","SOY","86",39,60,99
"45370","UASIN GISHU","SOY","87",34,62,96
"45371","UASIN GISHU","SOY","88",40,25,65
"45372","UASIN GISHU","SOY","89",44,92,136
"45373","UASIN GISHU","SOY","85-89",219,317,536
"45374","UASIN GISHU","SOY","90",24,45,69
"45375","UASIN GISHU","SOY","91",20,27,47
"45376","UASIN GISHU","SOY","92",18,17,35
"45377","UASIN GISHU","SOY","93",25,13,38
"45378","UASIN GISHU","SOY","94",9,31,40
"45379","UASIN GISHU","SOY","90-94",96,133,229
"45380","UASIN GISHU","SOY","95",36,35,71
"45381","UASIN GISHU","SOY","96",14,15,29
"45382","UASIN GISHU","SOY","97",10,20,30
"45383","UASIN GISHU","SOY","98",4,6,10
"45384","UASIN GISHU","SOY","99",11,18,29
"45385","UASIN GISHU","SOY","95-99",75,94,169
"45386","UASIN GISHU","SOY","100+",15,45,60
"45387","UASIN GISHU","SOY","Not Stated",4,NA,4
"45388","UASIN GISHU","TURBO","Total",133579,133682,267261
"45389","UASIN GISHU","TURBO","0",2994,3024,6018
"45390","UASIN GISHU","TURBO","1",3305,3315,6620
"45391","UASIN GISHU","TURBO","2",3221,3213,6434
"45392","UASIN GISHU","TURBO","3",3242,3409,6651
"45393","UASIN GISHU","TURBO","4",3353,3244,6597
"45394","UASIN GISHU","TURBO","0 - 4",16115,16205,32320
"45395","UASIN GISHU","TURBO","5",3351,3108,6459
"45396","UASIN GISHU","TURBO","6",3271,3250,6521
"45397","UASIN GISHU","TURBO","7",3325,3234,6559
"45398","UASIN GISHU","TURBO","8",3152,3024,6176
"45399","UASIN GISHU","TURBO","9",3310,3357,6667
"45400","UASIN GISHU","TURBO","5-9",16409,15973,32382
"45401","UASIN GISHU","TURBO","10",3366,3398,6764
"45402","UASIN GISHU","TURBO","11",2977,3282,6259
"45403","UASIN GISHU","TURBO","12",3431,3424,6855
"45404","UASIN GISHU","TURBO","13",3302,3557,6859
"45405","UASIN GISHU","TURBO","14",3130,3161,6291
"45406","UASIN GISHU","TURBO","10 -14",16206,16822,33028
"45407","UASIN GISHU","TURBO","15",2983,3077,6060
"45408","UASIN GISHU","TURBO","16",2908,3024,5932
"45409","UASIN GISHU","TURBO","17",3040,3107,6147
"45410","UASIN GISHU","TURBO","18",2436,2527,4963
"45411","UASIN GISHU","TURBO","19",2964,3028,5992
"45412","UASIN GISHU","TURBO","15-19",14331,14763,29094
"45413","UASIN GISHU","TURBO","20",2703,2984,5687
"45414","UASIN GISHU","TURBO","21",2891,2921,5812
"45415","UASIN GISHU","TURBO","22",2921,3122,6043
"45416","UASIN GISHU","TURBO","23",3181,3268,6449
"45417","UASIN GISHU","TURBO","24",3034,2922,5956
"45418","UASIN GISHU","TURBO","20-24",14730,15217,29947
"45419","UASIN GISHU","TURBO","25",3197,3126,6323
"45420","UASIN GISHU","TURBO","26",2721,2800,5521
"45421","UASIN GISHU","TURBO","27",2562,2666,5228
"45422","UASIN GISHU","TURBO","28",1999,2206,4205
"45423","UASIN GISHU","TURBO","29",2155,2410,4565
"45424","UASIN GISHU","TURBO","25-29",12634,13208,25842
"45425","UASIN GISHU","TURBO","30",2534,2844,5378
"45426","UASIN GISHU","TURBO","31",1842,1996,3838
"45427","UASIN GISHU","TURBO","32",2529,2626,5155
"45428","UASIN GISHU","TURBO","33",1945,2116,4061
"45429","UASIN GISHU","TURBO","34",1882,1902,3784
"45430","UASIN GISHU","TURBO","30-34",10732,11484,22216
"45431","UASIN GISHU","TURBO","35",2365,2211,4576
"45432","UASIN GISHU","TURBO","36",1695,1573,3268
"45433","UASIN GISHU","TURBO","37",1750,1529,3279
"45434","UASIN GISHU","TURBO","38",1252,1224,2476
"45435","UASIN GISHU","TURBO","39",1426,1297,2723
"45436","UASIN GISHU","TURBO","35-39",8488,7834,16322
"45437","UASIN GISHU","TURBO","40",1715,1486,3201
"45438","UASIN GISHU","TURBO","41",1590,1389,2979
"45439","UASIN GISHU","TURBO","42",1520,1309,2829
"45440","UASIN GISHU","TURBO","43",1197,1188,2385
"45441","UASIN GISHU","TURBO","44",1043,905,1948
"45442","UASIN GISHU","TURBO","40-44",7065,6277,13342
"45443","UASIN GISHU","TURBO","45",1607,1332,2939
"45444","UASIN GISHU","TURBO","46",1088,964,2052
"45445","UASIN GISHU","TURBO","47",1145,1017,2162
"45446","UASIN GISHU","TURBO","48",749,647,1396
"45447","UASIN GISHU","TURBO","49",945,762,1707
"45448","UASIN GISHU","TURBO","45-49",5534,4722,10256
"45449","UASIN GISHU","TURBO","50",943,856,1799
"45450","UASIN GISHU","TURBO","51",772,648,1420
"45451","UASIN GISHU","TURBO","52",671,588,1259
"45452","UASIN GISHU","TURBO","53",591,456,1047
"45453","UASIN GISHU","TURBO","54",588,513,1101
"45454","UASIN GISHU","TURBO","50-54",3565,3061,6626
"45455","UASIN GISHU","TURBO","55",598,483,1081
"45456","UASIN GISHU","TURBO","56",563,608,1171
"45457","UASIN GISHU","TURBO","57",554,640,1194
"45458","UASIN GISHU","TURBO","58",472,525,997
"45459","UASIN GISHU","TURBO","59",566,506,1072
"45460","UASIN GISHU","TURBO","55-59",2753,2762,5515
"45461","UASIN GISHU","TURBO","60",505,480,985
"45462","UASIN GISHU","TURBO","61",394,416,810
"45463","UASIN GISHU","TURBO","62",335,302,637
"45464","UASIN GISHU","TURBO","63",346,320,666
"45465","UASIN GISHU","TURBO","64",248,226,474
"45466","UASIN GISHU","TURBO","60-64",1828,1744,3572
"45467","UASIN GISHU","TURBO","65",399,366,765
"45468","UASIN GISHU","TURBO","66",203,254,457
"45469","UASIN GISHU","TURBO","67",309,364,673
"45470","UASIN GISHU","TURBO","68",159,155,314
"45471","UASIN GISHU","TURBO","69",232,237,469
"45472","UASIN GISHU","TURBO","65-69",1302,1376,2678
"45473","UASIN GISHU","TURBO","70",260,250,510
"45474","UASIN GISHU","TURBO","71",206,200,406
"45475","UASIN GISHU","TURBO","72",147,139,286
"45476","UASIN GISHU","TURBO","73",128,122,250
"45477","UASIN GISHU","TURBO","74",127,139,266
"45478","UASIN GISHU","TURBO","70-74",868,850,1718
"45479","UASIN GISHU","TURBO","75",102,144,246
"45480","UASIN GISHU","TURBO","76",135,166,301
"45481","UASIN GISHU","TURBO","77",108,115,223
"45482","UASIN GISHU","TURBO","78",53,53,106
"45483","UASIN GISHU","TURBO","79",72,113,185
"45484","UASIN GISHU","TURBO","75-79",470,591,1061
"45485","UASIN GISHU","TURBO","80",84,101,185
"45486","UASIN GISHU","TURBO","81",58,64,122
"45487","UASIN GISHU","TURBO","82",50,54,104
"45488","UASIN GISHU","TURBO","83",49,58,107
"45489","UASIN GISHU","TURBO","84",44,73,117
"45490","UASIN GISHU","TURBO","80-84",285,350,635
"45491","UASIN GISHU","TURBO","85",28,54,82
"45492","UASIN GISHU","TURBO","86",37,40,77
"45493","UASIN GISHU","TURBO","87",38,35,73
"45494","UASIN GISHU","TURBO","88",15,18,33
"45495","UASIN GISHU","TURBO","89",28,65,93
"45496","UASIN GISHU","TURBO","85-89",146,212,358
"45497","UASIN GISHU","TURBO","90",13,42,55
"45498","UASIN GISHU","TURBO","91",7,13,20
"45499","UASIN GISHU","TURBO","92",12,11,23
"45500","UASIN GISHU","TURBO","93",13,13,26
"45501","UASIN GISHU","TURBO","94",8,14,22
"45502","UASIN GISHU","TURBO","90-94",53,93,146
"45503","UASIN GISHU","TURBO","95",21,36,57
"45504","UASIN GISHU","TURBO","96",6,8,14
"45505","UASIN GISHU","TURBO","97",9,14,23
"45506","UASIN GISHU","TURBO","98",6,6,12
"45507","UASIN GISHU","TURBO","99",5,21,26
"45508","UASIN GISHU","TURBO","95-99",47,85,132
"45509","UASIN GISHU","TURBO","100+",16,53,69
"45510","UASIN GISHU","TURBO","Not Stated",2,NA,2
"45511","VIHIGA","ALL","Total",283678,306323,590001
"45512","VIHIGA","ALL","0",5909,6233,12142
"45513","VIHIGA","ALL","1",6106,6266,12372
"45514","VIHIGA","ALL","2",6310,6372,12682
"45515","VIHIGA","ALL","3",6810,6772,13582
"45516","VIHIGA","ALL","4",6920,6940,13860
"45517","VIHIGA","ALL","0 - 4",32055,32583,64638
"45518","VIHIGA","ALL","5",7275,6943,14218
"45519","VIHIGA","ALL","6",7468,7629,15097
"45520","VIHIGA","ALL","7",7893,8111,16004
"45521","VIHIGA","ALL","8",7687,7908,15595
"45522","VIHIGA","ALL","9",8544,8666,17210
"45523","VIHIGA","ALL","5-9",38867,39257,78124
"45524","VIHIGA","ALL","10",8719,8484,17203
"45525","VIHIGA","ALL","11",8327,8719,17046
"45526","VIHIGA","ALL","12",9233,9136,18369
"45527","VIHIGA","ALL","13",8960,9240,18200
"45528","VIHIGA","ALL","14",8442,8399,16841
"45529","VIHIGA","ALL","10 -14",43681,43978,87659
"45530","VIHIGA","ALL","15",8219,8180,16399
"45531","VIHIGA","ALL","16",8025,8077,16102
"45532","VIHIGA","ALL","17",8141,7776,15917
"45533","VIHIGA","ALL","18",6585,6323,12908
"45534","VIHIGA","ALL","19",6489,6105,12594
"45535","VIHIGA","ALL","15-19",37459,36461,73920
"45536","VIHIGA","ALL","20",5416,5508,10924
"45537","VIHIGA","ALL","21",4347,4389,8736
"45538","VIHIGA","ALL","22",4042,4230,8272
"45539","VIHIGA","ALL","23",3759,4270,8029
"45540","VIHIGA","ALL","24",3321,3797,7118
"45541","VIHIGA","ALL","20-24",20885,22194,43079
"45542","VIHIGA","ALL","25",3270,3951,7221
"45543","VIHIGA","ALL","26",2872,3616,6488
"45544","VIHIGA","ALL","27",3049,3705,6754
"45545","VIHIGA","ALL","28",2680,3205,5885
"45546","VIHIGA","ALL","29",2786,3382,6168
"45547","VIHIGA","ALL","25-29",14657,17859,32516
"45548","VIHIGA","ALL","30",3544,4476,8020
"45549","VIHIGA","ALL","31",2583,3313,5896
"45550","VIHIGA","ALL","32",3316,4165,7481
"45551","VIHIGA","ALL","33",2771,3388,6159
"45552","VIHIGA","ALL","34",2718,3143,5861
"45553","VIHIGA","ALL","30-34",14932,18485,33417
"45554","VIHIGA","ALL","35",3304,3669,6973
"45555","VIHIGA","ALL","36",2550,2893,5443
"45556","VIHIGA","ALL","37",2791,2907,5698
"45557","VIHIGA","ALL","38",2194,2365,4559
"45558","VIHIGA","ALL","39",2467,2637,5104
"45559","VIHIGA","ALL","35-39",13306,14471,27777
"45560","VIHIGA","ALL","40",2848,3112,5960
"45561","VIHIGA","ALL","41",2558,2824,5382
"45562","VIHIGA","ALL","42",2653,3050,5703
"45563","VIHIGA","ALL","43",2359,2694,5053
"45564","VIHIGA","ALL","44",1958,2036,3994
"45565","VIHIGA","ALL","40-44",12376,13716,26092
"45566","VIHIGA","ALL","45",2577,2732,5309
"45567","VIHIGA","ALL","46",2149,2262,4411
"45568","VIHIGA","ALL","47",2328,2546,4874
"45569","VIHIGA","ALL","48",1711,1779,3490
"45570","VIHIGA","ALL","49",1843,2089,3932
"45571","VIHIGA","ALL","45-49",10608,11408,22016
"45572","VIHIGA","ALL","50",2208,2716,4924
"45573","VIHIGA","ALL","51",1838,2274,4112
"45574","VIHIGA","ALL","52",1712,1977,3689
"45575","VIHIGA","ALL","53",1439,1786,3225
"45576","VIHIGA","ALL","54",1644,1970,3614
"45577","VIHIGA","ALL","50-54",8841,10723,19564
"45578","VIHIGA","ALL","55",1791,2048,3839
"45579","VIHIGA","ALL","56",1687,2113,3800
"45580","VIHIGA","ALL","57",1711,2547,4258
"45581","VIHIGA","ALL","58",1353,1740,3093
"45582","VIHIGA","ALL","59",1760,2152,3912
"45583","VIHIGA","ALL","55-59",8302,10600,18902
"45584","VIHIGA","ALL","60",1845,2452,4297
"45585","VIHIGA","ALL","61",1750,1919,3669
"45586","VIHIGA","ALL","62",1599,1804,3403
"45587","VIHIGA","ALL","63",1588,1958,3546
"45588","VIHIGA","ALL","64",1413,1665,3078
"45589","VIHIGA","ALL","60-64",8195,9798,17993
"45590","VIHIGA","ALL","65",1779,2127,3906
"45591","VIHIGA","ALL","66",1250,1481,2731
"45592","VIHIGA","ALL","67",1702,2021,3723
"45593","VIHIGA","ALL","68",876,1021,1897
"45594","VIHIGA","ALL","69",1352,1487,2839
"45595","VIHIGA","ALL","65-69",6959,8137,15096
"45596","VIHIGA","ALL","70",1588,1914,3502
"45597","VIHIGA","ALL","71",1179,1133,2312
"45598","VIHIGA","ALL","72",1075,1151,2226
"45599","VIHIGA","ALL","73",898,1012,1910
"45600","VIHIGA","ALL","74",842,970,1812
"45601","VIHIGA","ALL","70-74",5582,6180,11762
"45602","VIHIGA","ALL","75",605,914,1519
"45603","VIHIGA","ALL","76",746,1253,1999
"45604","VIHIGA","ALL","77",678,871,1549
"45605","VIHIGA","ALL","78",442,488,930
"45606","VIHIGA","ALL","79",556,771,1327
"45607","VIHIGA","ALL","75-79",3027,4297,7324
"45608","VIHIGA","ALL","80",523,915,1438
"45609","VIHIGA","ALL","81",426,619,1045
"45610","VIHIGA","ALL","82",412,546,958
"45611","VIHIGA","ALL","83",396,614,1010
"45612","VIHIGA","ALL","84",345,483,828
"45613","VIHIGA","ALL","80-84",2102,3177,5279
"45614","VIHIGA","ALL","85",271,483,754
"45615","VIHIGA","ALL","86",250,416,666
"45616","VIHIGA","ALL","87",285,450,735
"45617","VIHIGA","ALL","88",164,194,358
"45618","VIHIGA","ALL","89",188,366,554
"45619","VIHIGA","ALL","85-89",1158,1909,3067
"45620","VIHIGA","ALL","90",137,165,302
"45621","VIHIGA","ALL","91",124,185,309
"45622","VIHIGA","ALL","92",86,125,211
"45623","VIHIGA","ALL","93",69,87,156
"45624","VIHIGA","ALL","94",48,80,128
"45625","VIHIGA","ALL","90-94",464,642,1106
"45626","VIHIGA","ALL","95",57,127,184
"45627","VIHIGA","ALL","96",32,65,97
"45628","VIHIGA","ALL","97",43,75,118
"45629","VIHIGA","ALL","98",19,25,44
"45630","VIHIGA","ALL","99",18,55,73
"45631","VIHIGA","ALL","95-99",169,347,516
"45632","VIHIGA","ALL","100+",47,98,145
"45633","VIHIGA","ALL","Not Stated",6,3,9
"45634","VIHIGA","EMUHAYA","Total",46507,50633,97140
"45635","VIHIGA","EMUHAYA","0",1020,1013,2033
"45636","VIHIGA","EMUHAYA","1",1010,1049,2059
"45637","VIHIGA","EMUHAYA","2",1039,1098,2137
"45638","VIHIGA","EMUHAYA","3",1180,1160,2340
"45639","VIHIGA","EMUHAYA","4",1172,1176,2348
"45640","VIHIGA","EMUHAYA","0 - 4",5421,5496,10917
"45641","VIHIGA","EMUHAYA","5",1309,1162,2471
"45642","VIHIGA","EMUHAYA","6",1327,1323,2650
"45643","VIHIGA","EMUHAYA","7",1336,1452,2788
"45644","VIHIGA","EMUHAYA","8",1335,1377,2712
"45645","VIHIGA","EMUHAYA","9",1396,1421,2817
"45646","VIHIGA","EMUHAYA","5-9",6703,6735,13438
"45647","VIHIGA","EMUHAYA","10",1507,1489,2996
"45648","VIHIGA","EMUHAYA","11",1483,1419,2902
"45649","VIHIGA","EMUHAYA","12",1597,1590,3187
"45650","VIHIGA","EMUHAYA","13",1486,1620,3106
"45651","VIHIGA","EMUHAYA","14",1369,1420,2789
"45652","VIHIGA","EMUHAYA","10 -14",7442,7538,14980
"45653","VIHIGA","EMUHAYA","15",1430,1332,2762
"45654","VIHIGA","EMUHAYA","16",1293,1296,2589
"45655","VIHIGA","EMUHAYA","17",1311,1246,2557
"45656","VIHIGA","EMUHAYA","18",1031,1051,2082
"45657","VIHIGA","EMUHAYA","19",1083,988,2071
"45658","VIHIGA","EMUHAYA","15-19",6148,5913,12061
"45659","VIHIGA","EMUHAYA","20",814,908,1722
"45660","VIHIGA","EMUHAYA","21",679,735,1414
"45661","VIHIGA","EMUHAYA","22",632,667,1299
"45662","VIHIGA","EMUHAYA","23",515,676,1191
"45663","VIHIGA","EMUHAYA","24",483,611,1094
"45664","VIHIGA","EMUHAYA","20-24",3123,3597,6720
"45665","VIHIGA","EMUHAYA","25",481,655,1136
"45666","VIHIGA","EMUHAYA","26",449,581,1030
"45667","VIHIGA","EMUHAYA","27",486,603,1089
"45668","VIHIGA","EMUHAYA","28",440,519,959
"45669","VIHIGA","EMUHAYA","29",403,520,923
"45670","VIHIGA","EMUHAYA","25-29",2259,2878,5137
"45671","VIHIGA","EMUHAYA","30",553,706,1259
"45672","VIHIGA","EMUHAYA","31",388,525,913
"45673","VIHIGA","EMUHAYA","32",550,660,1210
"45674","VIHIGA","EMUHAYA","33",427,537,964
"45675","VIHIGA","EMUHAYA","34",440,473,913
"45676","VIHIGA","EMUHAYA","30-34",2358,2901,5259
"45677","VIHIGA","EMUHAYA","35",491,564,1055
"45678","VIHIGA","EMUHAYA","36",380,400,780
"45679","VIHIGA","EMUHAYA","37",392,464,856
"45680","VIHIGA","EMUHAYA","38",321,349,670
"45681","VIHIGA","EMUHAYA","39",389,393,782
"45682","VIHIGA","EMUHAYA","35-39",1973,2170,4143
"45683","VIHIGA","EMUHAYA","40",443,501,944
"45684","VIHIGA","EMUHAYA","41",386,467,853
"45685","VIHIGA","EMUHAYA","42",377,469,846
"45686","VIHIGA","EMUHAYA","43",311,416,727
"45687","VIHIGA","EMUHAYA","44",306,298,604
"45688","VIHIGA","EMUHAYA","40-44",1823,2151,3974
"45689","VIHIGA","EMUHAYA","45",384,457,841
"45690","VIHIGA","EMUHAYA","46",345,361,706
"45691","VIHIGA","EMUHAYA","47",401,416,817
"45692","VIHIGA","EMUHAYA","48",254,277,531
"45693","VIHIGA","EMUHAYA","49",274,376,650
"45694","VIHIGA","EMUHAYA","45-49",1658,1887,3545
"45695","VIHIGA","EMUHAYA","50",380,493,873
"45696","VIHIGA","EMUHAYA","51",305,376,681
"45697","VIHIGA","EMUHAYA","52",289,302,591
"45698","VIHIGA","EMUHAYA","53",248,325,573
"45699","VIHIGA","EMUHAYA","54",272,312,584
"45700","VIHIGA","EMUHAYA","50-54",1494,1808,3302
"45701","VIHIGA","EMUHAYA","55",300,330,630
"45702","VIHIGA","EMUHAYA","56",305,361,666
"45703","VIHIGA","EMUHAYA","57",318,489,807
"45704","VIHIGA","EMUHAYA","58",205,278,483
"45705","VIHIGA","EMUHAYA","59",290,332,622
"45706","VIHIGA","EMUHAYA","55-59",1418,1790,3208
"45707","VIHIGA","EMUHAYA","60",314,442,756
"45708","VIHIGA","EMUHAYA","61",262,311,573
"45709","VIHIGA","EMUHAYA","62",294,295,589
"45710","VIHIGA","EMUHAYA","63",268,296,564
"45711","VIHIGA","EMUHAYA","64",272,272,544
"45712","VIHIGA","EMUHAYA","60-64",1410,1616,3026
"45713","VIHIGA","EMUHAYA","65",310,358,668
"45714","VIHIGA","EMUHAYA","66",220,252,472
"45715","VIHIGA","EMUHAYA","67",299,377,676
"45716","VIHIGA","EMUHAYA","68",144,179,323
"45717","VIHIGA","EMUHAYA","69",223,227,450
"45718","VIHIGA","EMUHAYA","65-69",1196,1393,2589
"45719","VIHIGA","EMUHAYA","70",313,365,678
"45720","VIHIGA","EMUHAYA","71",210,181,391
"45721","VIHIGA","EMUHAYA","72",171,168,339
"45722","VIHIGA","EMUHAYA","73",125,146,271
"45723","VIHIGA","EMUHAYA","74",116,153,269
"45724","VIHIGA","EMUHAYA","70-74",935,1013,1948
"45725","VIHIGA","EMUHAYA","75",107,179,286
"45726","VIHIGA","EMUHAYA","76",139,230,369
"45727","VIHIGA","EMUHAYA","77",97,159,256
"45728","VIHIGA","EMUHAYA","78",77,79,156
"45729","VIHIGA","EMUHAYA","79",82,131,213
"45730","VIHIGA","EMUHAYA","75-79",502,778,1280
"45731","VIHIGA","EMUHAYA","80",84,180,264
"45732","VIHIGA","EMUHAYA","81",66,99,165
"45733","VIHIGA","EMUHAYA","82",68,107,175
"45734","VIHIGA","EMUHAYA","83",58,79,137
"45735","VIHIGA","EMUHAYA","84",74,75,149
"45736","VIHIGA","EMUHAYA","80-84",350,540,890
"45737","VIHIGA","EMUHAYA","85",47,76,123
"45738","VIHIGA","EMUHAYA","86",37,77,114
"45739","VIHIGA","EMUHAYA","87",47,58,105
"45740","VIHIGA","EMUHAYA","88",28,25,53
"45741","VIHIGA","EMUHAYA","89",30,47,77
"45742","VIHIGA","EMUHAYA","85-89",189,283,472
"45743","VIHIGA","EMUHAYA","90",28,28,56
"45744","VIHIGA","EMUHAYA","91",20,21,41
"45745","VIHIGA","EMUHAYA","92",9,17,26
"45746","VIHIGA","EMUHAYA","93",7,8,15
"45747","VIHIGA","EMUHAYA","94",7,8,15
"45748","VIHIGA","EMUHAYA","90-94",71,82,153
"45749","VIHIGA","EMUHAYA","95",11,17,28
"45750","VIHIGA","EMUHAYA","96",6,8,14
"45751","VIHIGA","EMUHAYA","97",5,9,14
"45752","VIHIGA","EMUHAYA","98",3,2,5
"45753","VIHIGA","EMUHAYA","99",4,13,17
"45754","VIHIGA","EMUHAYA","95-99",29,49,78
"45755","VIHIGA","EMUHAYA","100+",4,15,19
"45756","VIHIGA","EMUHAYA","Not Stated",1,NA,1
"45757","VIHIGA","VIHIGA","Total",45788,49501,95289
"45758","VIHIGA","VIHIGA","0",918,1028,1946
"45759","VIHIGA","VIHIGA","1",1027,967,1994
"45760","VIHIGA","VIHIGA","2",975,968,1943
"45761","VIHIGA","VIHIGA","3",1069,1042,2111
"45762","VIHIGA","VIHIGA","4",1087,1096,2183
"45763","VIHIGA","VIHIGA","0 - 4",5076,5101,10177
"45764","VIHIGA","VIHIGA","5",1165,1082,2247
"45765","VIHIGA","VIHIGA","6",1207,1210,2417
"45766","VIHIGA","VIHIGA","7",1209,1229,2438
"45767","VIHIGA","VIHIGA","8",1246,1209,2455
"45768","VIHIGA","VIHIGA","9",1357,1403,2760
"45769","VIHIGA","VIHIGA","5-9",6184,6133,12317
"45770","VIHIGA","VIHIGA","10",1343,1353,2696
"45771","VIHIGA","VIHIGA","11",1291,1353,2644
"45772","VIHIGA","VIHIGA","12",1434,1385,2819
"45773","VIHIGA","VIHIGA","13",1411,1465,2876
"45774","VIHIGA","VIHIGA","14",1323,1297,2620
"45775","VIHIGA","VIHIGA","10 -14",6802,6853,13655
"45776","VIHIGA","VIHIGA","15",1327,1315,2642
"45777","VIHIGA","VIHIGA","16",1199,1283,2482
"45778","VIHIGA","VIHIGA","17",1323,1290,2613
"45779","VIHIGA","VIHIGA","18",1024,1007,2031
"45780","VIHIGA","VIHIGA","19",1008,975,1983
"45781","VIHIGA","VIHIGA","15-19",5881,5870,11751
"45782","VIHIGA","VIHIGA","20",938,842,1780
"45783","VIHIGA","VIHIGA","21",736,723,1459
"45784","VIHIGA","VIHIGA","22",683,682,1365
"45785","VIHIGA","VIHIGA","23",662,709,1371
"45786","VIHIGA","VIHIGA","24",532,622,1154
"45787","VIHIGA","VIHIGA","20-24",3551,3578,7129
"45788","VIHIGA","VIHIGA","25",528,641,1169
"45789","VIHIGA","VIHIGA","26",518,602,1120
"45790","VIHIGA","VIHIGA","27",483,623,1106
"45791","VIHIGA","VIHIGA","28",408,532,940
"45792","VIHIGA","VIHIGA","29",491,595,1086
"45793","VIHIGA","VIHIGA","25-29",2428,2993,5421
"45794","VIHIGA","VIHIGA","30",569,706,1275
"45795","VIHIGA","VIHIGA","31",432,571,1003
"45796","VIHIGA","VIHIGA","32",547,702,1249
"45797","VIHIGA","VIHIGA","33",412,587,999
"45798","VIHIGA","VIHIGA","34",435,522,957
"45799","VIHIGA","VIHIGA","30-34",2395,3088,5483
"45800","VIHIGA","VIHIGA","35",572,613,1185
"45801","VIHIGA","VIHIGA","36",414,507,921
"45802","VIHIGA","VIHIGA","37",488,478,966
"45803","VIHIGA","VIHIGA","38",380,431,811
"45804","VIHIGA","VIHIGA","39",421,503,924
"45805","VIHIGA","VIHIGA","35-39",2275,2532,4807
"45806","VIHIGA","VIHIGA","40",465,548,1013
"45807","VIHIGA","VIHIGA","41",410,477,887
"45808","VIHIGA","VIHIGA","42",406,488,894
"45809","VIHIGA","VIHIGA","43",402,430,832
"45810","VIHIGA","VIHIGA","44",311,352,663
"45811","VIHIGA","VIHIGA","40-44",1994,2295,4289
"45812","VIHIGA","VIHIGA","45",471,456,927
"45813","VIHIGA","VIHIGA","46",361,360,721
"45814","VIHIGA","VIHIGA","47",373,429,802
"45815","VIHIGA","VIHIGA","48",310,307,617
"45816","VIHIGA","VIHIGA","49",325,316,641
"45817","VIHIGA","VIHIGA","45-49",1840,1868,3708
"45818","VIHIGA","VIHIGA","50",392,468,860
"45819","VIHIGA","VIHIGA","51",287,397,684
"45820","VIHIGA","VIHIGA","52",266,330,596
"45821","VIHIGA","VIHIGA","53",226,292,518
"45822","VIHIGA","VIHIGA","54",274,341,615
"45823","VIHIGA","VIHIGA","50-54",1445,1828,3273
"45824","VIHIGA","VIHIGA","55",277,338,615
"45825","VIHIGA","VIHIGA","56",272,360,632
"45826","VIHIGA","VIHIGA","57",272,376,648
"45827","VIHIGA","VIHIGA","58",221,294,515
"45828","VIHIGA","VIHIGA","59",295,356,651
"45829","VIHIGA","VIHIGA","55-59",1337,1724,3061
"45830","VIHIGA","VIHIGA","60",306,388,694
"45831","VIHIGA","VIHIGA","61",279,268,547
"45832","VIHIGA","VIHIGA","62",267,298,565
"45833","VIHIGA","VIHIGA","63",260,342,602
"45834","VIHIGA","VIHIGA","64",232,255,487
"45835","VIHIGA","VIHIGA","60-64",1344,1551,2895
"45836","VIHIGA","VIHIGA","65",303,339,642
"45837","VIHIGA","VIHIGA","66",202,226,428
"45838","VIHIGA","VIHIGA","67",264,327,591
"45839","VIHIGA","VIHIGA","68",152,159,311
"45840","VIHIGA","VIHIGA","69",231,264,495
"45841","VIHIGA","VIHIGA","65-69",1152,1315,2467
"45842","VIHIGA","VIHIGA","70",261,314,575
"45843","VIHIGA","VIHIGA","71",193,192,385
"45844","VIHIGA","VIHIGA","72",187,181,368
"45845","VIHIGA","VIHIGA","73",155,189,344
"45846","VIHIGA","VIHIGA","74",139,133,272
"45847","VIHIGA","VIHIGA","70-74",935,1009,1944
"45848","VIHIGA","VIHIGA","75",97,138,235
"45849","VIHIGA","VIHIGA","76",105,207,312
"45850","VIHIGA","VIHIGA","77",115,139,254
"45851","VIHIGA","VIHIGA","78",74,77,151
"45852","VIHIGA","VIHIGA","79",82,124,206
"45853","VIHIGA","VIHIGA","75-79",473,685,1158
"45854","VIHIGA","VIHIGA","80",85,148,233
"45855","VIHIGA","VIHIGA","81",67,118,185
"45856","VIHIGA","VIHIGA","82",64,78,142
"45857","VIHIGA","VIHIGA","83",69,115,184
"45858","VIHIGA","VIHIGA","84",62,85,147
"45859","VIHIGA","VIHIGA","80-84",347,544,891
"45860","VIHIGA","VIHIGA","85",56,90,146
"45861","VIHIGA","VIHIGA","86",55,67,122
"45862","VIHIGA","VIHIGA","87",46,72,118
"45863","VIHIGA","VIHIGA","88",18,42,60
"45864","VIHIGA","VIHIGA","89",31,59,90
"45865","VIHIGA","VIHIGA","85-89",206,330,536
"45866","VIHIGA","VIHIGA","90",26,29,55
"45867","VIHIGA","VIHIGA","91",28,33,61
"45868","VIHIGA","VIHIGA","92",14,28,42
"45869","VIHIGA","VIHIGA","93",18,20,38
"45870","VIHIGA","VIHIGA","94",5,20,25
"45871","VIHIGA","VIHIGA","90-94",91,130,221
"45872","VIHIGA","VIHIGA","95",8,19,27
"45873","VIHIGA","VIHIGA","96",5,10,15
"45874","VIHIGA","VIHIGA","97",4,19,23
"45875","VIHIGA","VIHIGA","98",1,5,6
"45876","VIHIGA","VIHIGA","99",3,6,9
"45877","VIHIGA","VIHIGA","95-99",21,59,80
"45878","VIHIGA","VIHIGA","100+",9,15,24
"45879","VIHIGA","VIHIGA","Not Stated",2,NA,2
"45880","VIHIGA","SABATIA","Total",62944,68683,131627
"45881","VIHIGA","SABATIA","0",1307,1355,2662
"45882","VIHIGA","SABATIA","1",1294,1365,2659
"45883","VIHIGA","SABATIA","2",1410,1420,2830
"45884","VIHIGA","SABATIA","3",1454,1445,2899
"45885","VIHIGA","SABATIA","4",1482,1560,3042
"45886","VIHIGA","SABATIA","0 - 4",6947,7145,14092
"45887","VIHIGA","SABATIA","5",1623,1559,3182
"45888","VIHIGA","SABATIA","6",1570,1662,3232
"45889","VIHIGA","SABATIA","7",1739,1793,3532
"45890","VIHIGA","SABATIA","8",1642,1711,3353
"45891","VIHIGA","SABATIA","9",1851,1926,3777
"45892","VIHIGA","SABATIA","5-9",8425,8651,17076
"45893","VIHIGA","SABATIA","10",1862,1805,3667
"45894","VIHIGA","SABATIA","11",1845,2009,3854
"45895","VIHIGA","SABATIA","12",1951,2000,3951
"45896","VIHIGA","SABATIA","13",2002,2045,4047
"45897","VIHIGA","SABATIA","14",1773,1874,3647
"45898","VIHIGA","SABATIA","10 -14",9433,9733,19166
"45899","VIHIGA","SABATIA","15",1801,1845,3646
"45900","VIHIGA","SABATIA","16",1764,1790,3554
"45901","VIHIGA","SABATIA","17",1900,1744,3644
"45902","VIHIGA","SABATIA","18",1543,1463,3006
"45903","VIHIGA","SABATIA","19",1506,1356,2862
"45904","VIHIGA","SABATIA","15-19",8514,8198,16712
"45905","VIHIGA","SABATIA","20",1239,1215,2454
"45906","VIHIGA","SABATIA","21",960,981,1941
"45907","VIHIGA","SABATIA","22",959,927,1886
"45908","VIHIGA","SABATIA","23",823,966,1789
"45909","VIHIGA","SABATIA","24",771,851,1622
"45910","VIHIGA","SABATIA","20-24",4752,4940,9692
"45911","VIHIGA","SABATIA","25",755,847,1602
"45912","VIHIGA","SABATIA","26",619,790,1409
"45913","VIHIGA","SABATIA","27",681,799,1480
"45914","VIHIGA","SABATIA","28",614,695,1309
"45915","VIHIGA","SABATIA","29",602,768,1370
"45916","VIHIGA","SABATIA","25-29",3271,3899,7170
"45917","VIHIGA","SABATIA","30",785,1023,1808
"45918","VIHIGA","SABATIA","31",551,715,1266
"45919","VIHIGA","SABATIA","32",704,920,1624
"45920","VIHIGA","SABATIA","33",662,719,1381
"45921","VIHIGA","SABATIA","34",628,715,1343
"45922","VIHIGA","SABATIA","30-34",3330,4092,7422
"45923","VIHIGA","SABATIA","35",723,849,1572
"45924","VIHIGA","SABATIA","36",567,693,1260
"45925","VIHIGA","SABATIA","37",627,686,1313
"45926","VIHIGA","SABATIA","38",514,576,1090
"45927","VIHIGA","SABATIA","39",579,622,1201
"45928","VIHIGA","SABATIA","35-39",3010,3426,6436
"45929","VIHIGA","SABATIA","40",669,712,1381
"45930","VIHIGA","SABATIA","41",573,629,1202
"45931","VIHIGA","SABATIA","42",604,696,1300
"45932","VIHIGA","SABATIA","43",541,592,1133
"45933","VIHIGA","SABATIA","44",438,474,912
"45934","VIHIGA","SABATIA","40-44",2825,3103,5928
"45935","VIHIGA","SABATIA","45",595,650,1245
"45936","VIHIGA","SABATIA","46",485,531,1016
"45937","VIHIGA","SABATIA","47",543,585,1128
"45938","VIHIGA","SABATIA","48",378,386,764
"45939","VIHIGA","SABATIA","49",434,485,919
"45940","VIHIGA","SABATIA","45-49",2435,2637,5072
"45941","VIHIGA","SABATIA","50",463,599,1062
"45942","VIHIGA","SABATIA","51",412,491,903
"45943","VIHIGA","SABATIA","52",396,437,833
"45944","VIHIGA","SABATIA","53",327,386,713
"45945","VIHIGA","SABATIA","54",400,468,868
"45946","VIHIGA","SABATIA","50-54",1998,2381,4379
"45947","VIHIGA","SABATIA","55",358,465,823
"45948","VIHIGA","SABATIA","56",374,495,869
"45949","VIHIGA","SABATIA","57",362,578,940
"45950","VIHIGA","SABATIA","58",283,388,671
"45951","VIHIGA","SABATIA","59",390,501,891
"45952","VIHIGA","SABATIA","55-59",1767,2427,4194
"45953","VIHIGA","SABATIA","60",374,556,930
"45954","VIHIGA","SABATIA","61",356,436,792
"45955","VIHIGA","SABATIA","62",352,431,783
"45956","VIHIGA","SABATIA","63",328,438,766
"45957","VIHIGA","SABATIA","64",297,429,726
"45958","VIHIGA","SABATIA","60-64",1707,2290,3997
"45959","VIHIGA","SABATIA","65",389,493,882
"45960","VIHIGA","SABATIA","66",271,341,612
"45961","VIHIGA","SABATIA","67",377,460,837
"45962","VIHIGA","SABATIA","68",234,248,482
"45963","VIHIGA","SABATIA","69",316,330,646
"45964","VIHIGA","SABATIA","65-69",1587,1872,3459
"45965","VIHIGA","SABATIA","70",352,408,760
"45966","VIHIGA","SABATIA","71",273,256,529
"45967","VIHIGA","SABATIA","72",237,313,550
"45968","VIHIGA","SABATIA","73",227,275,502
"45969","VIHIGA","SABATIA","74",199,246,445
"45970","VIHIGA","SABATIA","70-74",1288,1498,2786
"45971","VIHIGA","SABATIA","75",125,189,314
"45972","VIHIGA","SABATIA","76",174,281,455
"45973","VIHIGA","SABATIA","77",176,191,367
"45974","VIHIGA","SABATIA","78",101,111,212
"45975","VIHIGA","SABATIA","79",138,172,310
"45976","VIHIGA","SABATIA","75-79",714,944,1658
"45977","VIHIGA","SABATIA","80",130,190,320
"45978","VIHIGA","SABATIA","81",104,141,245
"45979","VIHIGA","SABATIA","82",107,128,235
"45980","VIHIGA","SABATIA","83",93,146,239
"45981","VIHIGA","SABATIA","84",64,105,169
"45982","VIHIGA","SABATIA","80-84",498,710,1208
"45983","VIHIGA","SABATIA","85",57,102,159
"45984","VIHIGA","SABATIA","86",61,102,163
"45985","VIHIGA","SABATIA","87",76,107,183
"45986","VIHIGA","SABATIA","88",42,40,82
"45987","VIHIGA","SABATIA","89",37,85,122
"45988","VIHIGA","SABATIA","85-89",273,436,709
"45989","VIHIGA","SABATIA","90",35,41,76
"45990","VIHIGA","SABATIA","91",28,60,88
"45991","VIHIGA","SABATIA","92",18,32,50
"45992","VIHIGA","SABATIA","93",17,28,45
"45993","VIHIGA","SABATIA","94",12,17,29
"45994","VIHIGA","SABATIA","90-94",110,178,288
"45995","VIHIGA","SABATIA","95",11,35,46
"45996","VIHIGA","SABATIA","96",8,17,25
"45997","VIHIGA","SABATIA","97",12,19,31
"45998","VIHIGA","SABATIA","98",3,6,9
"45999","VIHIGA","SABATIA","99",5,14,19
"46000","VIHIGA","SABATIA","95-99",39,91,130
"46001","VIHIGA","SABATIA","100+",19,31,50
"46002","VIHIGA","SABATIA","Not Stated",2,1,3
"46003","VIHIGA","LUANDA","Total",51525,55165,106690
"46004","VIHIGA","LUANDA","0",1097,1195,2292
"46005","VIHIGA","LUANDA","1",1085,1168,2253
"46006","VIHIGA","LUANDA","2",1162,1199,2361
"46007","VIHIGA","LUANDA","3",1323,1252,2575
"46008","VIHIGA","LUANDA","4",1267,1196,2463
"46009","VIHIGA","LUANDA","0 - 4",5934,6010,11944
"46010","VIHIGA","LUANDA","5",1264,1282,2546
"46011","VIHIGA","LUANDA","6",1349,1365,2714
"46012","VIHIGA","LUANDA","7",1446,1474,2920
"46013","VIHIGA","LUANDA","8",1369,1399,2768
"46014","VIHIGA","LUANDA","9",1550,1517,3067
"46015","VIHIGA","LUANDA","5-9",6978,7037,14015
"46016","VIHIGA","LUANDA","10",1593,1579,3172
"46017","VIHIGA","LUANDA","11",1469,1587,3056
"46018","VIHIGA","LUANDA","12",1760,1716,3476
"46019","VIHIGA","LUANDA","13",1590,1634,3224
"46020","VIHIGA","LUANDA","14",1562,1455,3017
"46021","VIHIGA","LUANDA","10 -14",7974,7971,15945
"46022","VIHIGA","LUANDA","15",1412,1416,2828
"46023","VIHIGA","LUANDA","16",1461,1408,2869
"46024","VIHIGA","LUANDA","17",1370,1310,2680
"46025","VIHIGA","LUANDA","18",1077,1011,2088
"46026","VIHIGA","LUANDA","19",1069,1121,2190
"46027","VIHIGA","LUANDA","15-19",6389,6266,12655
"46028","VIHIGA","LUANDA","20",899,994,1893
"46029","VIHIGA","LUANDA","21",731,775,1506
"46030","VIHIGA","LUANDA","22",698,847,1545
"46031","VIHIGA","LUANDA","23",702,798,1500
"46032","VIHIGA","LUANDA","24",621,763,1384
"46033","VIHIGA","LUANDA","20-24",3651,4177,7828
"46034","VIHIGA","LUANDA","25",636,796,1432
"46035","VIHIGA","LUANDA","26",525,729,1254
"46036","VIHIGA","LUANDA","27",611,718,1329
"46037","VIHIGA","LUANDA","28",513,611,1124
"46038","VIHIGA","LUANDA","29",534,640,1174
"46039","VIHIGA","LUANDA","25-29",2819,3494,6313
"46040","VIHIGA","LUANDA","30",717,903,1620
"46041","VIHIGA","LUANDA","31",501,609,1110
"46042","VIHIGA","LUANDA","32",614,766,1380
"46043","VIHIGA","LUANDA","33",507,625,1132
"46044","VIHIGA","LUANDA","34",489,565,1054
"46045","VIHIGA","LUANDA","30-34",2828,3468,6296
"46046","VIHIGA","LUANDA","35",659,704,1363
"46047","VIHIGA","LUANDA","36",487,528,1015
"46048","VIHIGA","LUANDA","37",530,515,1045
"46049","VIHIGA","LUANDA","38",401,393,794
"46050","VIHIGA","LUANDA","39",451,440,891
"46051","VIHIGA","LUANDA","35-39",2528,2580,5108
"46052","VIHIGA","LUANDA","40",551,554,1105
"46053","VIHIGA","LUANDA","41",500,492,992
"46054","VIHIGA","LUANDA","42",490,475,965
"46055","VIHIGA","LUANDA","43",455,462,917
"46056","VIHIGA","LUANDA","44",383,361,744
"46057","VIHIGA","LUANDA","40-44",2379,2344,4723
"46058","VIHIGA","LUANDA","45",462,452,914
"46059","VIHIGA","LUANDA","46",340,404,744
"46060","VIHIGA","LUANDA","47",406,421,827
"46061","VIHIGA","LUANDA","48",329,286,615
"46062","VIHIGA","LUANDA","49",308,336,644
"46063","VIHIGA","LUANDA","45-49",1845,1899,3744
"46064","VIHIGA","LUANDA","50",426,516,942
"46065","VIHIGA","LUANDA","51",342,420,762
"46066","VIHIGA","LUANDA","52",311,335,646
"46067","VIHIGA","LUANDA","53",243,319,562
"46068","VIHIGA","LUANDA","54",273,333,606
"46069","VIHIGA","LUANDA","50-54",1595,1923,3518
"46070","VIHIGA","LUANDA","55",363,390,753
"46071","VIHIGA","LUANDA","56",316,388,704
"46072","VIHIGA","LUANDA","57",313,474,787
"46073","VIHIGA","LUANDA","58",263,307,570
"46074","VIHIGA","LUANDA","59",335,385,720
"46075","VIHIGA","LUANDA","55-59",1590,1944,3534
"46076","VIHIGA","LUANDA","60",368,496,864
"46077","VIHIGA","LUANDA","61",374,382,756
"46078","VIHIGA","LUANDA","62",288,287,575
"46079","VIHIGA","LUANDA","63",299,362,661
"46080","VIHIGA","LUANDA","64",264,285,549
"46081","VIHIGA","LUANDA","60-64",1593,1812,3405
"46082","VIHIGA","LUANDA","65",349,399,748
"46083","VIHIGA","LUANDA","66",253,263,516
"46084","VIHIGA","LUANDA","67",345,339,684
"46085","VIHIGA","LUANDA","68",139,161,300
"46086","VIHIGA","LUANDA","69",229,272,501
"46087","VIHIGA","LUANDA","65-69",1315,1434,2749
"46088","VIHIGA","LUANDA","70",283,395,678
"46089","VIHIGA","LUANDA","71",207,204,411
"46090","VIHIGA","LUANDA","72",186,173,359
"46091","VIHIGA","LUANDA","73",151,161,312
"46092","VIHIGA","LUANDA","74",149,166,315
"46093","VIHIGA","LUANDA","70-74",976,1099,2075
"46094","VIHIGA","LUANDA","75",116,139,255
"46095","VIHIGA","LUANDA","76",117,195,312
"46096","VIHIGA","LUANDA","77",113,146,259
"46097","VIHIGA","LUANDA","78",58,81,139
"46098","VIHIGA","LUANDA","79",84,123,207
"46099","VIHIGA","LUANDA","75-79",488,684,1172
"46100","VIHIGA","LUANDA","80",106,188,294
"46101","VIHIGA","LUANDA","81",53,92,145
"46102","VIHIGA","LUANDA","82",75,89,164
"46103","VIHIGA","LUANDA","83",81,98,179
"46104","VIHIGA","LUANDA","84",58,93,151
"46105","VIHIGA","LUANDA","80-84",373,560,933
"46106","VIHIGA","LUANDA","85",49,80,129
"46107","VIHIGA","LUANDA","86",39,60,99
"46108","VIHIGA","LUANDA","87",36,78,114
"46109","VIHIGA","LUANDA","88",26,34,60
"46110","VIHIGA","LUANDA","89",29,58,87
"46111","VIHIGA","LUANDA","85-89",179,310,489
"46112","VIHIGA","LUANDA","90",17,25,42
"46113","VIHIGA","LUANDA","91",17,22,39
"46114","VIHIGA","LUANDA","92",14,14,28
"46115","VIHIGA","LUANDA","93",8,15,23
"46116","VIHIGA","LUANDA","94",9,14,23
"46117","VIHIGA","LUANDA","90-94",65,90,155
"46118","VIHIGA","LUANDA","95",10,25,35
"46119","VIHIGA","LUANDA","96",5,7,12
"46120","VIHIGA","LUANDA","97",3,11,14
"46121","VIHIGA","LUANDA","98",3,4,7
"46122","VIHIGA","LUANDA","99",1,6,7
"46123","VIHIGA","LUANDA","95-99",22,53,75
"46124","VIHIGA","LUANDA","100+",3,8,11
"46125","VIHIGA","LUANDA","Not Stated",1,2,3
"46126","VIHIGA","HAMISI","Total",76901,82337,159238
"46127","VIHIGA","HAMISI","0",1566,1642,3208
"46128","VIHIGA","HAMISI","1",1690,1717,3407
"46129","VIHIGA","HAMISI","2",1724,1687,3411
"46130","VIHIGA","HAMISI","3",1784,1873,3657
"46131","VIHIGA","HAMISI","4",1912,1912,3824
"46132","VIHIGA","HAMISI","0 - 4",8676,8831,17507
"46133","VIHIGA","HAMISI","5",1914,1858,3772
"46134","VIHIGA","HAMISI","6",2015,2069,4084
"46135","VIHIGA","HAMISI","7",2163,2163,4326
"46136","VIHIGA","HAMISI","8",2095,2212,4307
"46137","VIHIGA","HAMISI","9",2390,2399,4789
"46138","VIHIGA","HAMISI","5-9",10577,10701,21278
"46139","VIHIGA","HAMISI","10",2414,2258,4672
"46140","VIHIGA","HAMISI","11",2239,2351,4590
"46141","VIHIGA","HAMISI","12",2491,2445,4936
"46142","VIHIGA","HAMISI","13",2471,2476,4947
"46143","VIHIGA","HAMISI","14",2415,2353,4768
"46144","VIHIGA","HAMISI","10 -14",12030,11883,23913
"46145","VIHIGA","HAMISI","15",2249,2272,4521
"46146","VIHIGA","HAMISI","16",2308,2300,4608
"46147","VIHIGA","HAMISI","17",2237,2186,4423
"46148","VIHIGA","HAMISI","18",1910,1791,3701
"46149","VIHIGA","HAMISI","19",1823,1665,3488
"46150","VIHIGA","HAMISI","15-19",10527,10214,20741
"46151","VIHIGA","HAMISI","20",1526,1549,3075
"46152","VIHIGA","HAMISI","21",1241,1175,2416
"46153","VIHIGA","HAMISI","22",1070,1106,2176
"46154","VIHIGA","HAMISI","23",1057,1121,2178
"46155","VIHIGA","HAMISI","24",914,950,1864
"46156","VIHIGA","HAMISI","20-24",5808,5901,11709
"46157","VIHIGA","HAMISI","25",870,1012,1882
"46158","VIHIGA","HAMISI","26",760,914,1674
"46159","VIHIGA","HAMISI","27",786,962,1748
"46160","VIHIGA","HAMISI","28",705,848,1553
"46161","VIHIGA","HAMISI","29",756,859,1615
"46162","VIHIGA","HAMISI","25-29",3877,4595,8472
"46163","VIHIGA","HAMISI","30",920,1137,2057
"46164","VIHIGA","HAMISI","31",711,893,1604
"46165","VIHIGA","HAMISI","32",901,1116,2017
"46166","VIHIGA","HAMISI","33",763,920,1683
"46167","VIHIGA","HAMISI","34",726,868,1594
"46168","VIHIGA","HAMISI","30-34",4021,4934,8955
"46169","VIHIGA","HAMISI","35",859,938,1797
"46170","VIHIGA","HAMISI","36",702,765,1467
"46171","VIHIGA","HAMISI","37",752,764,1516
"46172","VIHIGA","HAMISI","38",576,616,1192
"46173","VIHIGA","HAMISI","39",627,679,1306
"46174","VIHIGA","HAMISI","35-39",3516,3762,7278
"46175","VIHIGA","HAMISI","40",720,797,1517
"46176","VIHIGA","HAMISI","41",689,759,1448
"46177","VIHIGA","HAMISI","42",776,922,1698
"46178","VIHIGA","HAMISI","43",650,794,1444
"46179","VIHIGA","HAMISI","44",520,551,1071
"46180","VIHIGA","HAMISI","40-44",3355,3823,7178
"46181","VIHIGA","HAMISI","45",665,717,1382
"46182","VIHIGA","HAMISI","46",618,606,1224
"46183","VIHIGA","HAMISI","47",605,695,1300
"46184","VIHIGA","HAMISI","48",439,523,962
"46185","VIHIGA","HAMISI","49",501,576,1077
"46186","VIHIGA","HAMISI","45-49",2828,3117,5945
"46187","VIHIGA","HAMISI","50",546,640,1186
"46188","VIHIGA","HAMISI","51",492,590,1082
"46189","VIHIGA","HAMISI","52",450,573,1023
"46190","VIHIGA","HAMISI","53",395,464,859
"46191","VIHIGA","HAMISI","54",424,516,940
"46192","VIHIGA","HAMISI","50-54",2307,2783,5090
"46193","VIHIGA","HAMISI","55",493,525,1018
"46194","VIHIGA","HAMISI","56",420,509,929
"46195","VIHIGA","HAMISI","57",445,630,1075
"46196","VIHIGA","HAMISI","58",381,473,854
"46197","VIHIGA","HAMISI","59",450,578,1028
"46198","VIHIGA","HAMISI","55-59",2189,2715,4904
"46199","VIHIGA","HAMISI","60",483,570,1053
"46200","VIHIGA","HAMISI","61",479,522,1001
"46201","VIHIGA","HAMISI","62",398,493,891
"46202","VIHIGA","HAMISI","63",433,520,953
"46203","VIHIGA","HAMISI","64",348,424,772
"46204","VIHIGA","HAMISI","60-64",2141,2529,4670
"46205","VIHIGA","HAMISI","65",428,538,966
"46206","VIHIGA","HAMISI","66",304,399,703
"46207","VIHIGA","HAMISI","67",417,518,935
"46208","VIHIGA","HAMISI","68",207,274,481
"46209","VIHIGA","HAMISI","69",353,394,747
"46210","VIHIGA","HAMISI","65-69",1709,2123,3832
"46211","VIHIGA","HAMISI","70",379,432,811
"46212","VIHIGA","HAMISI","71",296,300,596
"46213","VIHIGA","HAMISI","72",294,316,610
"46214","VIHIGA","HAMISI","73",240,241,481
"46215","VIHIGA","HAMISI","74",239,272,511
"46216","VIHIGA","HAMISI","70-74",1448,1561,3009
"46217","VIHIGA","HAMISI","75",160,269,429
"46218","VIHIGA","HAMISI","76",211,340,551
"46219","VIHIGA","HAMISI","77",177,236,413
"46220","VIHIGA","HAMISI","78",132,140,272
"46221","VIHIGA","HAMISI","79",170,221,391
"46222","VIHIGA","HAMISI","75-79",850,1206,2056
"46223","VIHIGA","HAMISI","80",118,209,327
"46224","VIHIGA","HAMISI","81",136,169,305
"46225","VIHIGA","HAMISI","82",98,144,242
"46226","VIHIGA","HAMISI","83",95,176,271
"46227","VIHIGA","HAMISI","84",87,125,212
"46228","VIHIGA","HAMISI","80-84",534,823,1357
"46229","VIHIGA","HAMISI","85",62,135,197
"46230","VIHIGA","HAMISI","86",58,110,168
"46231","VIHIGA","HAMISI","87",80,135,215
"46232","VIHIGA","HAMISI","88",50,53,103
"46233","VIHIGA","HAMISI","89",61,117,178
"46234","VIHIGA","HAMISI","85-89",311,550,861
"46235","VIHIGA","HAMISI","90",31,42,73
"46236","VIHIGA","HAMISI","91",31,49,80
"46237","VIHIGA","HAMISI","92",31,34,65
"46238","VIHIGA","HAMISI","93",19,16,35
"46239","VIHIGA","HAMISI","94",15,21,36
"46240","VIHIGA","HAMISI","90-94",127,162,289
"46241","VIHIGA","HAMISI","95",17,31,48
"46242","VIHIGA","HAMISI","96",8,23,31
"46243","VIHIGA","HAMISI","97",19,17,36
"46244","VIHIGA","HAMISI","98",9,8,17
"46245","VIHIGA","HAMISI","99",5,16,21
"46246","VIHIGA","HAMISI","95-99",58,95,153
"46247","VIHIGA","HAMISI","100+",12,29,41
"46248","VIHIGA","HAMISI","Not Stated",NA,NA,NA
"46249","VIHIGA","KAKAMEGA FOREST","Total",13,4,17
"46250","VIHIGA","KAKAMEGA FOREST","0",1,NA,1
"46251","VIHIGA","KAKAMEGA FOREST","1",NA,NA,NA
"46252","VIHIGA","KAKAMEGA FOREST","2",NA,NA,NA
"46253","VIHIGA","KAKAMEGA FOREST","3",NA,NA,NA
"46254","VIHIGA","KAKAMEGA FOREST","4",NA,NA,NA
"46255","VIHIGA","KAKAMEGA FOREST","0 - 4",1,NA,1
"46256","VIHIGA","KAKAMEGA FOREST","5",NA,NA,NA
"46257","VIHIGA","KAKAMEGA FOREST","6",NA,NA,NA
"46258","VIHIGA","KAKAMEGA FOREST","7",NA,NA,NA
"46259","VIHIGA","KAKAMEGA FOREST","8",NA,NA,NA
"46260","VIHIGA","KAKAMEGA FOREST","9",NA,NA,NA
"46261","VIHIGA","KAKAMEGA FOREST","5-9",NA,NA,NA
"46262","VIHIGA","KAKAMEGA FOREST","10",NA,NA,NA
"46263","VIHIGA","KAKAMEGA FOREST","11",NA,NA,NA
"46264","VIHIGA","KAKAMEGA FOREST","12",NA,NA,NA
"46265","VIHIGA","KAKAMEGA FOREST","13",NA,NA,NA
"46266","VIHIGA","KAKAMEGA FOREST","14",NA,NA,NA
"46267","VIHIGA","KAKAMEGA FOREST","10 -14",NA,NA,NA
"46268","VIHIGA","KAKAMEGA FOREST","15",NA,NA,NA
"46269","VIHIGA","KAKAMEGA FOREST","16",NA,NA,NA
"46270","VIHIGA","KAKAMEGA FOREST","17",NA,NA,NA
"46271","VIHIGA","KAKAMEGA FOREST","18",NA,NA,NA
"46272","VIHIGA","KAKAMEGA FOREST","19",NA,NA,NA
"46273","VIHIGA","KAKAMEGA FOREST","15-19",NA,NA,NA
"46274","VIHIGA","KAKAMEGA FOREST","20",NA,NA,NA
"46275","VIHIGA","KAKAMEGA FOREST","21",NA,NA,NA
"46276","VIHIGA","KAKAMEGA FOREST","22",NA,1,1
"46277","VIHIGA","KAKAMEGA FOREST","23",NA,NA,NA
"46278","VIHIGA","KAKAMEGA FOREST","24",NA,NA,NA
"46279","VIHIGA","KAKAMEGA FOREST","20-24",NA,NA,NA
"46280","VIHIGA","KAKAMEGA FOREST","25",NA,NA,NA
"46281","VIHIGA","KAKAMEGA FOREST","26",1,NA,1
"46282","VIHIGA","KAKAMEGA FOREST","27",2,NA,2
"46283","VIHIGA","KAKAMEGA FOREST","28",NA,NA,NA
"46284","VIHIGA","KAKAMEGA FOREST","29",NA,NA,NA
"46285","VIHIGA","KAKAMEGA FOREST","25-29",3,NA,3
"46286","VIHIGA","KAKAMEGA FOREST","30",NA,1,1
"46287","VIHIGA","KAKAMEGA FOREST","31",NA,NA,NA
"46288","VIHIGA","KAKAMEGA FOREST","32",NA,1,1
"46289","VIHIGA","KAKAMEGA FOREST","33",NA,NA,NA
"46290","VIHIGA","KAKAMEGA FOREST","34",NA,NA,NA
"46291","VIHIGA","KAKAMEGA FOREST","30-34",NA,2,2
"46292","VIHIGA","KAKAMEGA FOREST","35",NA,1,1
"46293","VIHIGA","KAKAMEGA FOREST","36",NA,NA,NA
"46294","VIHIGA","KAKAMEGA FOREST","37",2,NA,2
"46295","VIHIGA","KAKAMEGA FOREST","38",2,NA,2
"46296","VIHIGA","KAKAMEGA FOREST","39",NA,NA,NA
"46297","VIHIGA","KAKAMEGA FOREST","35-39",4,1,5
"46298","VIHIGA","KAKAMEGA FOREST","40",NA,NA,NA
"46299","VIHIGA","KAKAMEGA FOREST","41",NA,NA,NA
"46300","VIHIGA","KAKAMEGA FOREST","42",NA,NA,NA
"46301","VIHIGA","KAKAMEGA FOREST","43",NA,NA,NA
"46302","VIHIGA","KAKAMEGA FOREST","44",NA,NA,NA
"46303","VIHIGA","KAKAMEGA FOREST","40-44",NA,NA,NA
"46304","VIHIGA","KAKAMEGA FOREST","45",NA,NA,NA
"46305","VIHIGA","KAKAMEGA FOREST","46",NA,NA,NA
"46306","VIHIGA","KAKAMEGA FOREST","47",NA,NA,NA
"46307","VIHIGA","KAKAMEGA FOREST","48",1,NA,1
"46308","VIHIGA","KAKAMEGA FOREST","49",1,NA,1
"46309","VIHIGA","KAKAMEGA FOREST","45-49",2,NA,2
"46310","VIHIGA","KAKAMEGA FOREST","50",1,NA,1
"46311","VIHIGA","KAKAMEGA FOREST","51",NA,NA,NA
"46312","VIHIGA","KAKAMEGA FOREST","52",NA,NA,NA
"46313","VIHIGA","KAKAMEGA FOREST","53",NA,NA,NA
"46314","VIHIGA","KAKAMEGA FOREST","54",1,NA,1
"46315","VIHIGA","KAKAMEGA FOREST","50-54",2,NA,2
"46316","VIHIGA","KAKAMEGA FOREST","55",NA,NA,NA
"46317","VIHIGA","KAKAMEGA FOREST","56",NA,NA,NA
"46318","VIHIGA","KAKAMEGA FOREST","57",1,NA,1
"46319","VIHIGA","KAKAMEGA FOREST","58",NA,NA,NA
"46320","VIHIGA","KAKAMEGA FOREST","59",NA,NA,NA
"46321","VIHIGA","KAKAMEGA FOREST","55-59",1,NA,1
"46322","VIHIGA","KAKAMEGA FOREST","60",NA,NA,NA
"46323","VIHIGA","KAKAMEGA FOREST","61",NA,NA,NA
"46324","VIHIGA","KAKAMEGA FOREST","62",NA,NA,NA
"46325","VIHIGA","KAKAMEGA FOREST","63",NA,NA,NA
"46326","VIHIGA","KAKAMEGA FOREST","64",NA,NA,NA
"46327","VIHIGA","KAKAMEGA FOREST","60-64",NA,NA,NA
"46328","VIHIGA","KAKAMEGA FOREST","65",NA,NA,NA
"46329","VIHIGA","KAKAMEGA FOREST","66",NA,NA,NA
"46330","VIHIGA","KAKAMEGA FOREST","67",NA,NA,NA
"46331","VIHIGA","KAKAMEGA FOREST","68",NA,NA,NA
"46332","VIHIGA","KAKAMEGA FOREST","69",NA,NA,NA
"46333","VIHIGA","KAKAMEGA FOREST","65-69",NA,NA,NA
"46334","VIHIGA","KAKAMEGA FOREST","70",NA,NA,NA
"46335","VIHIGA","KAKAMEGA FOREST","71",NA,NA,NA
"46336","VIHIGA","KAKAMEGA FOREST","72",NA,NA,NA
"46337","VIHIGA","KAKAMEGA FOREST","73",NA,NA,NA
"46338","VIHIGA","KAKAMEGA FOREST","74",NA,NA,NA
"46339","VIHIGA","KAKAMEGA FOREST","70-74",NA,NA,NA
"46340","VIHIGA","KAKAMEGA FOREST","75",NA,NA,NA
"46341","VIHIGA","KAKAMEGA FOREST","76",NA,NA,NA
"46342","VIHIGA","KAKAMEGA FOREST","77",NA,NA,NA
"46343","VIHIGA","KAKAMEGA FOREST","78",NA,NA,NA
"46344","VIHIGA","KAKAMEGA FOREST","79",NA,NA,NA
"46345","VIHIGA","KAKAMEGA FOREST","75-79",NA,NA,NA
"46346","VIHIGA","KAKAMEGA FOREST","80",NA,NA,NA
"46347","VIHIGA","KAKAMEGA FOREST","81",NA,NA,NA
"46348","VIHIGA","KAKAMEGA FOREST","82",NA,NA,NA
"46349","VIHIGA","KAKAMEGA FOREST","83",NA,NA,NA
"46350","VIHIGA","KAKAMEGA FOREST","84",NA,NA,NA
"46351","VIHIGA","KAKAMEGA FOREST","80-84",NA,NA,NA
"46352","VIHIGA","KAKAMEGA FOREST","85",NA,NA,NA
"46353","VIHIGA","KAKAMEGA FOREST","86",NA,NA,NA
"46354","VIHIGA","KAKAMEGA FOREST","87",NA,NA,NA
"46355","VIHIGA","KAKAMEGA FOREST","88",NA,NA,NA
"46356","VIHIGA","KAKAMEGA FOREST","89",NA,NA,NA
"46357","VIHIGA","KAKAMEGA FOREST","85-89",NA,NA,NA
"46358","VIHIGA","KAKAMEGA FOREST","90",NA,NA,NA
"46359","VIHIGA","KAKAMEGA FOREST","91",NA,NA,NA
"46360","VIHIGA","KAKAMEGA FOREST","92",NA,NA,NA
"46361","VIHIGA","KAKAMEGA FOREST","93",NA,NA,NA
"46362","VIHIGA","KAKAMEGA FOREST","94",NA,NA,NA
"46363","VIHIGA","KAKAMEGA FOREST","90-94",NA,NA,NA
"46364","VIHIGA","KAKAMEGA FOREST","95",NA,NA,NA
"46365","VIHIGA","KAKAMEGA FOREST","96",NA,NA,NA
"46366","VIHIGA","KAKAMEGA FOREST","97",NA,NA,NA
"46367","VIHIGA","KAKAMEGA FOREST","98",NA,NA,NA
"46368","VIHIGA","KAKAMEGA FOREST","99",NA,NA,NA
"46369","VIHIGA","KAKAMEGA FOREST","95-99",NA,NA,NA
"46370","VIHIGA","KAKAMEGA FOREST","100+",NA,NA,NA
"46371","VIHIGA","KAKAMEGA FOREST","Not Stated",NA,NA,NA
"46372","WAJIR","ALL","Total",415374,365840,781214
"46373","WAJIR","ALL","0",5431,5675,11106
"46374","WAJIR","ALL","1",9519,9334,18853
"46375","WAJIR","ALL","2",16905,16931,33836
"46376","WAJIR","ALL","3",12337,12288,24625
"46377","WAJIR","ALL","4",17344,17063,34407
"46378","WAJIR","ALL","0 - 4",61536,61291,122827
"46379","WAJIR","ALL","5",12543,12404,24947
"46380","WAJIR","ALL","6",17878,17105,34983
"46381","WAJIR","ALL","7",10954,10378,21332
"46382","WAJIR","ALL","8",18705,17201,35906
"46383","WAJIR","ALL","9",10305,9961,20266
"46384","WAJIR","ALL","5-9",70385,67049,137434
"46385","WAJIR","ALL","10",21285,18692,39977
"46386","WAJIR","ALL","11",8957,9219,18176
"46387","WAJIR","ALL","12",17570,12770,30340
"46388","WAJIR","ALL","13",11088,8255,19343
"46389","WAJIR","ALL","14",14306,10236,24542
"46390","WAJIR","ALL","10 -14",73206,59172,132378
"46391","WAJIR","ALL","15",14966,10348,25314
"46392","WAJIR","ALL","16",12853,9128,21981
"46393","WAJIR","ALL","17",11744,8185,19929
"46394","WAJIR","ALL","18",11799,9083,20882
"46395","WAJIR","ALL","19",5603,5138,10741
"46396","WAJIR","ALL","15-19",56965,41882,98847
"46397","WAJIR","ALL","20",12808,11571,24379
"46398","WAJIR","ALL","21",5092,4772,9864
"46399","WAJIR","ALL","22",6235,6176,12411
"46400","WAJIR","ALL","23",4761,4829,9590
"46401","WAJIR","ALL","24",4734,4622,9356
"46402","WAJIR","ALL","20-24",33630,31970,65600
"46403","WAJIR","ALL","25",8972,9267,18239
"46404","WAJIR","ALL","26",4693,4729,9422
"46405","WAJIR","ALL","27",4206,4573,8779
"46406","WAJIR","ALL","28",5662,6280,11942
"46407","WAJIR","ALL","29",3651,4080,7731
"46408","WAJIR","ALL","25-29",27184,28929,56113
"46409","WAJIR","ALL","30",11178,10834,22012
"46410","WAJIR","ALL","31",3374,3800,7174
"46411","WAJIR","ALL","32",4109,3997,8106
"46412","WAJIR","ALL","33",2630,2732,5362
"46413","WAJIR","ALL","34",2500,2525,5025
"46414","WAJIR","ALL","30-34",23791,23888,47679
"46415","WAJIR","ALL","35",6077,5908,11985
"46416","WAJIR","ALL","36",2760,2852,5612
"46417","WAJIR","ALL","37",2238,2352,4590
"46418","WAJIR","ALL","38",3064,3288,6352
"46419","WAJIR","ALL","39",2097,2177,4274
"46420","WAJIR","ALL","35-39",16236,16577,32813
"46421","WAJIR","ALL","40",8644,6321,14965
"46422","WAJIR","ALL","41",2568,2398,4966
"46423","WAJIR","ALL","42",2905,2260,5165
"46424","WAJIR","ALL","43",1686,1229,2915
"46425","WAJIR","ALL","44",1029,855,1884
"46426","WAJIR","ALL","40-44",16832,13063,29895
"46427","WAJIR","ALL","45",4084,2834,6918
"46428","WAJIR","ALL","46",1309,891,2200
"46429","WAJIR","ALL","47",1233,798,2031
"46430","WAJIR","ALL","48",1597,1110,2707
"46431","WAJIR","ALL","49",1195,772,1967
"46432","WAJIR","ALL","45-49",9418,6405,15823
"46433","WAJIR","ALL","50",4867,2723,7590
"46434","WAJIR","ALL","51",978,590,1568
"46435","WAJIR","ALL","52",1533,853,2386
"46436","WAJIR","ALL","53",734,393,1127
"46437","WAJIR","ALL","54",954,573,1527
"46438","WAJIR","ALL","50-54",9066,5132,14198
"46439","WAJIR","ALL","55",1273,710,1983
"46440","WAJIR","ALL","56",949,613,1562
"46441","WAJIR","ALL","57",695,593,1288
"46442","WAJIR","ALL","58",913,613,1526
"46443","WAJIR","ALL","59",996,580,1576
"46444","WAJIR","ALL","55-59",4826,3109,7935
"46445","WAJIR","ALL","60",2784,1440,4224
"46446","WAJIR","ALL","61",798,530,1328
"46447","WAJIR","ALL","62",634,298,932
"46448","WAJIR","ALL","63",553,293,846
"46449","WAJIR","ALL","64",447,253,700
"46450","WAJIR","ALL","60-64",5216,2814,8030
"46451","WAJIR","ALL","65",805,475,1280
"46452","WAJIR","ALL","66",329,292,621
"46453","WAJIR","ALL","67",362,191,553
"46454","WAJIR","ALL","68",394,203,597
"46455","WAJIR","ALL","69",479,225,704
"46456","WAJIR","ALL","65-69",2369,1386,3755
"46457","WAJIR","ALL","70",1247,839,2086
"46458","WAJIR","ALL","71",367,363,730
"46459","WAJIR","ALL","72",297,132,429
"46460","WAJIR","ALL","73",179,79,258
"46461","WAJIR","ALL","74",197,110,307
"46462","WAJIR","ALL","70-74",2287,1523,3810
"46463","WAJIR","ALL","75",350,192,542
"46464","WAJIR","ALL","76",162,101,263
"46465","WAJIR","ALL","77",145,65,210
"46466","WAJIR","ALL","78",176,86,262
"46467","WAJIR","ALL","79",190,85,275
"46468","WAJIR","ALL","75-79",1023,529,1552
"46469","WAJIR","ALL","80",473,399,872
"46470","WAJIR","ALL","81",144,185,329
"46471","WAJIR","ALL","82",94,46,140
"46472","WAJIR","ALL","83",70,43,113
"46473","WAJIR","ALL","84",65,46,111
"46474","WAJIR","ALL","80-84",846,719,1565
"46475","WAJIR","ALL","85",82,55,137
"46476","WAJIR","ALL","86",52,37,89
"46477","WAJIR","ALL","87",54,29,83
"46478","WAJIR","ALL","88",41,21,62
"46479","WAJIR","ALL","89",62,47,109
"46480","WAJIR","ALL","85-89",291,189,480
"46481","WAJIR","ALL","90",102,95,197
"46482","WAJIR","ALL","91",32,37,69
"46483","WAJIR","ALL","92",26,9,35
"46484","WAJIR","ALL","93",21,8,29
"46485","WAJIR","ALL","94",10,7,17
"46486","WAJIR","ALL","90-94",191,156,347
"46487","WAJIR","ALL","95",23,11,34
"46488","WAJIR","ALL","96",11,9,20
"46489","WAJIR","ALL","97",6,2,8
"46490","WAJIR","ALL","98",11,2,13
"46491","WAJIR","ALL","99",4,13,17
"46492","WAJIR","ALL","95-99",55,37,92
"46493","WAJIR","ALL","100+",20,19,39
"46494","WAJIR","ALL","Not Stated",1,1,2
"46495","WAJIR","BUNA","Total",26796,23088,49884
"46496","WAJIR","BUNA","0",331,414,745
"46497","WAJIR","BUNA","1",588,641,1229
"46498","WAJIR","BUNA","2",993,1068,2061
"46499","WAJIR","BUNA","3",652,768,1420
"46500","WAJIR","BUNA","4",1049,1113,2162
"46501","WAJIR","BUNA","0 - 4",3613,4004,7617
"46502","WAJIR","BUNA","5",697,710,1407
"46503","WAJIR","BUNA","6",1073,1098,2171
"46504","WAJIR","BUNA","7",697,636,1333
"46505","WAJIR","BUNA","8",1152,1044,2196
"46506","WAJIR","BUNA","9",687,664,1351
"46507","WAJIR","BUNA","5-9",4306,4152,8458
"46508","WAJIR","BUNA","10",1348,1172,2520
"46509","WAJIR","BUNA","11",634,653,1287
"46510","WAJIR","BUNA","12",1213,841,2054
"46511","WAJIR","BUNA","13",710,492,1202
"46512","WAJIR","BUNA","14",975,693,1668
"46513","WAJIR","BUNA","10 -14",4880,3851,8731
"46514","WAJIR","BUNA","15",964,642,1606
"46515","WAJIR","BUNA","16",884,629,1513
"46516","WAJIR","BUNA","17",716,450,1166
"46517","WAJIR","BUNA","18",856,629,1485
"46518","WAJIR","BUNA","19",455,375,830
"46519","WAJIR","BUNA","15-19",3875,2725,6600
"46520","WAJIR","BUNA","20",943,789,1732
"46521","WAJIR","BUNA","21",484,383,867
"46522","WAJIR","BUNA","22",457,376,833
"46523","WAJIR","BUNA","23",351,394,745
"46524","WAJIR","BUNA","24",417,355,772
"46525","WAJIR","BUNA","20-24",2652,2297,4949
"46526","WAJIR","BUNA","25",563,517,1080
"46527","WAJIR","BUNA","26",389,312,701
"46528","WAJIR","BUNA","27",280,283,563
"46529","WAJIR","BUNA","28",385,387,772
"46530","WAJIR","BUNA","29",285,241,526
"46531","WAJIR","BUNA","25-29",1902,1740,3642
"46532","WAJIR","BUNA","30",634,584,1218
"46533","WAJIR","BUNA","31",193,176,369
"46534","WAJIR","BUNA","32",270,251,521
"46535","WAJIR","BUNA","33",161,158,319
"46536","WAJIR","BUNA","34",188,193,381
"46537","WAJIR","BUNA","30-34",1446,1362,2808
"46538","WAJIR","BUNA","35",323,298,621
"46539","WAJIR","BUNA","36",205,179,384
"46540","WAJIR","BUNA","37",115,117,232
"46541","WAJIR","BUNA","38",187,198,385
"46542","WAJIR","BUNA","39",177,156,333
"46543","WAJIR","BUNA","35-39",1007,948,1955
"46544","WAJIR","BUNA","40",441,354,795
"46545","WAJIR","BUNA","41",128,106,234
"46546","WAJIR","BUNA","42",216,173,389
"46547","WAJIR","BUNA","43",112,84,196
"46548","WAJIR","BUNA","44",73,68,141
"46549","WAJIR","BUNA","40-44",970,785,1755
"46550","WAJIR","BUNA","45",235,162,397
"46551","WAJIR","BUNA","46",99,62,161
"46552","WAJIR","BUNA","47",84,59,143
"46553","WAJIR","BUNA","48",88,70,158
"46554","WAJIR","BUNA","49",104,46,150
"46555","WAJIR","BUNA","45-49",610,399,1009
"46556","WAJIR","BUNA","50",266,127,393
"46557","WAJIR","BUNA","51",49,23,72
"46558","WAJIR","BUNA","52",114,42,156
"46559","WAJIR","BUNA","53",54,26,80
"46560","WAJIR","BUNA","54",63,48,111
"46561","WAJIR","BUNA","50-54",546,266,812
"46562","WAJIR","BUNA","55",70,48,118
"46563","WAJIR","BUNA","56",68,34,102
"46564","WAJIR","BUNA","57",53,23,76
"46565","WAJIR","BUNA","58",51,46,97
"46566","WAJIR","BUNA","59",64,49,113
"46567","WAJIR","BUNA","55-59",306,200,506
"46568","WAJIR","BUNA","60",158,77,235
"46569","WAJIR","BUNA","61",32,27,59
"46570","WAJIR","BUNA","62",38,14,52
"46571","WAJIR","BUNA","63",37,20,57
"46572","WAJIR","BUNA","64",26,14,40
"46573","WAJIR","BUNA","60-64",291,152,443
"46574","WAJIR","BUNA","65",40,18,58
"46575","WAJIR","BUNA","66",23,18,41
"46576","WAJIR","BUNA","67",21,15,36
"46577","WAJIR","BUNA","68",26,10,36
"46578","WAJIR","BUNA","69",33,16,49
"46579","WAJIR","BUNA","65-69",143,77,220
"46580","WAJIR","BUNA","70",73,26,99
"46581","WAJIR","BUNA","71",17,24,41
"46582","WAJIR","BUNA","72",15,5,20
"46583","WAJIR","BUNA","73",13,6,19
"46584","WAJIR","BUNA","74",11,5,16
"46585","WAJIR","BUNA","70-74",129,66,195
"46586","WAJIR","BUNA","75",26,4,30
"46587","WAJIR","BUNA","76",6,5,11
"46588","WAJIR","BUNA","77",8,6,14
"46589","WAJIR","BUNA","78",5,4,9
"46590","WAJIR","BUNA","79",16,4,20
"46591","WAJIR","BUNA","75-79",61,23,84
"46592","WAJIR","BUNA","80",18,7,25
"46593","WAJIR","BUNA","81",6,9,15
"46594","WAJIR","BUNA","82",10,2,12
"46595","WAJIR","BUNA","83",2,2,4
"46596","WAJIR","BUNA","84",4,1,5
"46597","WAJIR","BUNA","80-84",40,21,61
"46598","WAJIR","BUNA","85",5,2,7
"46599","WAJIR","BUNA","86",1,2,3
"46600","WAJIR","BUNA","87",4,3,7
"46601","WAJIR","BUNA","88",NA,NA,NA
"46602","WAJIR","BUNA","89",NA,7,7
"46603","WAJIR","BUNA","85-89",10,14,24
"46604","WAJIR","BUNA","90",2,2,4
"46605","WAJIR","BUNA","91",3,3,6
"46606","WAJIR","BUNA","92",3,NA,3
"46607","WAJIR","BUNA","93",NA,NA,NA
"46608","WAJIR","BUNA","94",NA,NA,NA
"46609","WAJIR","BUNA","90-94",8,5,13
"46610","WAJIR","BUNA","95",1,NA,1
"46611","WAJIR","BUNA","96",NA,NA,NA
"46612","WAJIR","BUNA","97",NA,NA,NA
"46613","WAJIR","BUNA","98",NA,NA,NA
"46614","WAJIR","BUNA","99",NA,NA,NA
"46615","WAJIR","BUNA","95-99",1,NA,1
"46616","WAJIR","BUNA","100+",NA,1,1
"46617","WAJIR","BUNA","Not Stated",NA,NA,NA
"46618","WAJIR","ELDAS","Total",45028,44069,89097
"46619","WAJIR","ELDAS","0",387,468,855
"46620","WAJIR","ELDAS","1",903,1062,1965
"46621","WAJIR","ELDAS","2",1729,2170,3899
"46622","WAJIR","ELDAS","3",1218,1556,2774
"46623","WAJIR","ELDAS","4",1895,2302,4197
"46624","WAJIR","ELDAS","0 - 4",6132,7558,13690
"46625","WAJIR","ELDAS","5",1265,1529,2794
"46626","WAJIR","ELDAS","6",2039,2268,4307
"46627","WAJIR","ELDAS","7",1188,1379,2567
"46628","WAJIR","ELDAS","8",2111,2306,4417
"46629","WAJIR","ELDAS","9",1217,1343,2560
"46630","WAJIR","ELDAS","5-9",7820,8825,16645
"46631","WAJIR","ELDAS","10",2384,2423,4807
"46632","WAJIR","ELDAS","11",1030,1269,2299
"46633","WAJIR","ELDAS","12",1995,1693,3688
"46634","WAJIR","ELDAS","13",1193,939,2132
"46635","WAJIR","ELDAS","14",1635,1363,2998
"46636","WAJIR","ELDAS","10 -14",8237,7687,15924
"46637","WAJIR","ELDAS","15",1441,1142,2583
"46638","WAJIR","ELDAS","16",1429,1030,2459
"46639","WAJIR","ELDAS","17",1132,797,1929
"46640","WAJIR","ELDAS","18",1247,935,2182
"46641","WAJIR","ELDAS","19",572,457,1029
"46642","WAJIR","ELDAS","15-19",5821,4361,10182
"46643","WAJIR","ELDAS","20",1346,1205,2551
"46644","WAJIR","ELDAS","21",535,500,1035
"46645","WAJIR","ELDAS","22",580,637,1217
"46646","WAJIR","ELDAS","23",453,467,920
"46647","WAJIR","ELDAS","24",473,550,1023
"46648","WAJIR","ELDAS","20-24",3387,3359,6746
"46649","WAJIR","ELDAS","25",911,976,1887
"46650","WAJIR","ELDAS","26",525,523,1048
"46651","WAJIR","ELDAS","27",492,515,1007
"46652","WAJIR","ELDAS","28",562,643,1205
"46653","WAJIR","ELDAS","29",417,504,921
"46654","WAJIR","ELDAS","25-29",2907,3161,6068
"46655","WAJIR","ELDAS","30",1151,1257,2408
"46656","WAJIR","ELDAS","31",458,535,993
"46657","WAJIR","ELDAS","32",454,479,933
"46658","WAJIR","ELDAS","33",317,401,718
"46659","WAJIR","ELDAS","34",295,383,678
"46660","WAJIR","ELDAS","30-34",2675,3055,5730
"46661","WAJIR","ELDAS","35",624,632,1256
"46662","WAJIR","ELDAS","36",299,360,659
"46663","WAJIR","ELDAS","37",305,362,667
"46664","WAJIR","ELDAS","38",344,480,824
"46665","WAJIR","ELDAS","39",278,326,604
"46666","WAJIR","ELDAS","35-39",1850,2160,4010
"46667","WAJIR","ELDAS","40",1102,872,1974
"46668","WAJIR","ELDAS","41",382,322,704
"46669","WAJIR","ELDAS","42",340,261,601
"46670","WAJIR","ELDAS","43",190,148,338
"46671","WAJIR","ELDAS","44",157,133,290
"46672","WAJIR","ELDAS","40-44",2171,1736,3907
"46673","WAJIR","ELDAS","45",454,285,739
"46674","WAJIR","ELDAS","46",179,105,284
"46675","WAJIR","ELDAS","47",149,112,261
"46676","WAJIR","ELDAS","48",188,109,297
"46677","WAJIR","ELDAS","49",144,71,215
"46678","WAJIR","ELDAS","45-49",1114,682,1796
"46679","WAJIR","ELDAS","50",517,285,802
"46680","WAJIR","ELDAS","51",138,73,211
"46681","WAJIR","ELDAS","52",184,96,280
"46682","WAJIR","ELDAS","53",76,43,119
"46683","WAJIR","ELDAS","54",106,50,156
"46684","WAJIR","ELDAS","50-54",1021,547,1568
"46685","WAJIR","ELDAS","55",130,67,197
"46686","WAJIR","ELDAS","56",102,52,154
"46687","WAJIR","ELDAS","57",71,64,135
"46688","WAJIR","ELDAS","58",103,49,152
"46689","WAJIR","ELDAS","59",103,51,154
"46690","WAJIR","ELDAS","55-59",509,283,792
"46691","WAJIR","ELDAS","60",298,132,430
"46692","WAJIR","ELDAS","61",122,59,181
"46693","WAJIR","ELDAS","62",83,24,107
"46694","WAJIR","ELDAS","63",40,31,71
"46695","WAJIR","ELDAS","64",52,26,78
"46696","WAJIR","ELDAS","60-64",595,272,867
"46697","WAJIR","ELDAS","65",65,37,102
"46698","WAJIR","ELDAS","66",39,27,66
"46699","WAJIR","ELDAS","67",37,18,55
"46700","WAJIR","ELDAS","68",31,18,49
"46701","WAJIR","ELDAS","69",52,16,68
"46702","WAJIR","ELDAS","65-69",224,116,340
"46703","WAJIR","ELDAS","70",140,56,196
"46704","WAJIR","ELDAS","71",59,28,87
"46705","WAJIR","ELDAS","72",36,14,50
"46706","WAJIR","ELDAS","73",18,6,24
"46707","WAJIR","ELDAS","74",21,13,34
"46708","WAJIR","ELDAS","70-74",274,117,391
"46709","WAJIR","ELDAS","75",30,16,46
"46710","WAJIR","ELDAS","76",17,9,26
"46711","WAJIR","ELDAS","77",12,5,17
"46712","WAJIR","ELDAS","78",16,12,28
"46713","WAJIR","ELDAS","79",33,5,38
"46714","WAJIR","ELDAS","75-79",108,47,155
"46715","WAJIR","ELDAS","80",59,38,97
"46716","WAJIR","ELDAS","81",28,15,43
"46717","WAJIR","ELDAS","82",13,2,15
"46718","WAJIR","ELDAS","83",8,5,13
"46719","WAJIR","ELDAS","84",12,6,18
"46720","WAJIR","ELDAS","80-84",120,66,186
"46721","WAJIR","ELDAS","85",6,3,9
"46722","WAJIR","ELDAS","86",7,3,10
"46723","WAJIR","ELDAS","87",5,4,9
"46724","WAJIR","ELDAS","88",7,2,9
"46725","WAJIR","ELDAS","89",9,4,13
"46726","WAJIR","ELDAS","85-89",34,16,50
"46727","WAJIR","ELDAS","90",17,9,26
"46728","WAJIR","ELDAS","91",4,5,9
"46729","WAJIR","ELDAS","92",2,1,3
"46730","WAJIR","ELDAS","93",NA,NA,NA
"46731","WAJIR","ELDAS","94",1,NA,1
"46732","WAJIR","ELDAS","90-94",24,15,39
"46733","WAJIR","ELDAS","95",3,NA,3
"46734","WAJIR","ELDAS","96",1,1,2
"46735","WAJIR","ELDAS","97",NA,1,1
"46736","WAJIR","ELDAS","98",NA,1,1
"46737","WAJIR","ELDAS","99",1,1,2
"46738","WAJIR","ELDAS","95-99",5,4,9
"46739","WAJIR","ELDAS","100+",NA,2,2
"46740","WAJIR","ELDAS","Not Stated",NA,NA,NA
"46741","WAJIR","HABASWEIN","Total",94613,79505,174118
"46742","WAJIR","HABASWEIN","0",1448,1242,2690
"46743","WAJIR","HABASWEIN","1",2261,1858,4119
"46744","WAJIR","HABASWEIN","2",4265,3594,7859
"46745","WAJIR","HABASWEIN","3",3242,2702,5944
"46746","WAJIR","HABASWEIN","4",4104,3445,7549
"46747","WAJIR","HABASWEIN","0 - 4",15320,12841,28161
"46748","WAJIR","HABASWEIN","5",3224,2626,5850
"46749","WAJIR","HABASWEIN","6",4207,3357,7564
"46750","WAJIR","HABASWEIN","7",2608,2068,4676
"46751","WAJIR","HABASWEIN","8",4298,3362,7660
"46752","WAJIR","HABASWEIN","9",2352,1975,4327
"46753","WAJIR","HABASWEIN","5-9",16689,13388,30077
"46754","WAJIR","HABASWEIN","10",4646,3741,8387
"46755","WAJIR","HABASWEIN","11",2033,1768,3801
"46756","WAJIR","HABASWEIN","12",3604,2463,6067
"46757","WAJIR","HABASWEIN","13",2357,1777,4134
"46758","WAJIR","HABASWEIN","14",2950,2076,5026
"46759","WAJIR","HABASWEIN","10 -14",15590,11825,27415
"46760","WAJIR","HABASWEIN","15",3131,2200,5331
"46761","WAJIR","HABASWEIN","16",2671,1829,4500
"46762","WAJIR","HABASWEIN","17",2336,1739,4075
"46763","WAJIR","HABASWEIN","18",2481,2040,4521
"46764","WAJIR","HABASWEIN","19",1181,1262,2443
"46765","WAJIR","HABASWEIN","15-19",11800,9070,20870
"46766","WAJIR","HABASWEIN","20",2809,2875,5684
"46767","WAJIR","HABASWEIN","21",1005,1129,2134
"46768","WAJIR","HABASWEIN","22",1363,1525,2888
"46769","WAJIR","HABASWEIN","23",1047,1178,2225
"46770","WAJIR","HABASWEIN","24",951,1126,2077
"46771","WAJIR","HABASWEIN","20-24",7175,7833,15008
"46772","WAJIR","HABASWEIN","25",2001,2291,4292
"46773","WAJIR","HABASWEIN","26",1035,1183,2218
"46774","WAJIR","HABASWEIN","27",959,1066,2025
"46775","WAJIR","HABASWEIN","28",1377,1592,2969
"46776","WAJIR","HABASWEIN","29",886,968,1854
"46777","WAJIR","HABASWEIN","25-29",6258,7100,13358
"46778","WAJIR","HABASWEIN","30",2929,2888,5817
"46779","WAJIR","HABASWEIN","31",712,741,1453
"46780","WAJIR","HABASWEIN","32",1005,876,1881
"46781","WAJIR","HABASWEIN","33",539,523,1062
"46782","WAJIR","HABASWEIN","34",571,497,1068
"46783","WAJIR","HABASWEIN","30-34",5756,5525,11281
"46784","WAJIR","HABASWEIN","35",1457,1429,2886
"46785","WAJIR","HABASWEIN","36",630,667,1297
"46786","WAJIR","HABASWEIN","37",537,582,1119
"46787","WAJIR","HABASWEIN","38",734,771,1505
"46788","WAJIR","HABASWEIN","39",555,537,1092
"46789","WAJIR","HABASWEIN","35-39",3913,3986,7899
"46790","WAJIR","HABASWEIN","40",2160,1580,3740
"46791","WAJIR","HABASWEIN","41",545,541,1086
"46792","WAJIR","HABASWEIN","42",648,461,1109
"46793","WAJIR","HABASWEIN","43",418,303,721
"46794","WAJIR","HABASWEIN","44",211,177,388
"46795","WAJIR","HABASWEIN","40-44",3982,3062,7044
"46796","WAJIR","HABASWEIN","45",919,674,1593
"46797","WAJIR","HABASWEIN","46",278,201,479
"46798","WAJIR","HABASWEIN","47",312,154,466
"46799","WAJIR","HABASWEIN","48",406,229,635
"46800","WAJIR","HABASWEIN","49",267,166,433
"46801","WAJIR","HABASWEIN","45-49",2182,1424,3606
"46802","WAJIR","HABASWEIN","50",1102,678,1780
"46803","WAJIR","HABASWEIN","51",212,100,312
"46804","WAJIR","HABASWEIN","52",362,210,572
"46805","WAJIR","HABASWEIN","53",195,93,288
"46806","WAJIR","HABASWEIN","54",216,109,325
"46807","WAJIR","HABASWEIN","50-54",2087,1190,3277
"46808","WAJIR","HABASWEIN","55",292,146,438
"46809","WAJIR","HABASWEIN","56",216,144,360
"46810","WAJIR","HABASWEIN","57",153,142,295
"46811","WAJIR","HABASWEIN","58",223,128,351
"46812","WAJIR","HABASWEIN","59",232,98,330
"46813","WAJIR","HABASWEIN","55-59",1116,658,1774
"46814","WAJIR","HABASWEIN","60",631,332,963
"46815","WAJIR","HABASWEIN","61",187,98,285
"46816","WAJIR","HABASWEIN","62",140,78,218
"46817","WAJIR","HABASWEIN","63",116,57,173
"46818","WAJIR","HABASWEIN","64",112,56,168
"46819","WAJIR","HABASWEIN","60-64",1186,621,1807
"46820","WAJIR","HABASWEIN","65",198,111,309
"46821","WAJIR","HABASWEIN","66",65,55,120
"46822","WAJIR","HABASWEIN","67",73,43,116
"46823","WAJIR","HABASWEIN","68",88,30,118
"46824","WAJIR","HABASWEIN","69",102,46,148
"46825","WAJIR","HABASWEIN","65-69",526,285,811
"46826","WAJIR","HABASWEIN","70",266,202,468
"46827","WAJIR","HABASWEIN","71",84,60,144
"46828","WAJIR","HABASWEIN","72",58,32,90
"46829","WAJIR","HABASWEIN","73",39,18,57
"46830","WAJIR","HABASWEIN","74",49,22,71
"46831","WAJIR","HABASWEIN","70-74",496,334,830
"46832","WAJIR","HABASWEIN","75",82,38,120
"46833","WAJIR","HABASWEIN","76",46,19,65
"46834","WAJIR","HABASWEIN","77",36,13,49
"46835","WAJIR","HABASWEIN","78",40,20,60
"46836","WAJIR","HABASWEIN","79",39,16,55
"46837","WAJIR","HABASWEIN","75-79",243,106,349
"46838","WAJIR","HABASWEIN","80",110,113,223
"46839","WAJIR","HABASWEIN","81",24,34,58
"46840","WAJIR","HABASWEIN","82",18,11,29
"46841","WAJIR","HABASWEIN","83",13,5,18
"46842","WAJIR","HABASWEIN","84",8,10,18
"46843","WAJIR","HABASWEIN","80-84",173,173,346
"46844","WAJIR","HABASWEIN","85",18,13,31
"46845","WAJIR","HABASWEIN","86",14,6,20
"46846","WAJIR","HABASWEIN","87",3,5,8
"46847","WAJIR","HABASWEIN","88",9,NA,9
"46848","WAJIR","HABASWEIN","89",7,9,16
"46849","WAJIR","HABASWEIN","85-89",51,33,84
"46850","WAJIR","HABASWEIN","90",28,29,57
"46851","WAJIR","HABASWEIN","91",7,6,13
"46852","WAJIR","HABASWEIN","92",8,2,10
"46853","WAJIR","HABASWEIN","93",3,1,4
"46854","WAJIR","HABASWEIN","94",4,2,6
"46855","WAJIR","HABASWEIN","90-94",50,40,90
"46856","WAJIR","HABASWEIN","95",6,2,8
"46857","WAJIR","HABASWEIN","96",6,2,8
"46858","WAJIR","HABASWEIN","97",2,1,3
"46859","WAJIR","HABASWEIN","98",1,NA,1
"46860","WAJIR","HABASWEIN","99",NA,3,3
"46861","WAJIR","HABASWEIN","95-99",15,8,23
"46862","WAJIR","HABASWEIN","100+",5,3,8
"46863","WAJIR","HABASWEIN","Not Stated",NA,NA,NA
"46864","WAJIR","TARBAJ","Total",26856,29776,56632
"46865","WAJIR","TARBAJ","0",553,768,1321
"46866","WAJIR","TARBAJ","1",661,896,1557
"46867","WAJIR","TARBAJ","2",1235,1622,2857
"46868","WAJIR","TARBAJ","3",874,1147,2021
"46869","WAJIR","TARBAJ","4",1240,1612,2852
"46870","WAJIR","TARBAJ","0 - 4",4563,6045,10608
"46871","WAJIR","TARBAJ","5",843,1068,1911
"46872","WAJIR","TARBAJ","6",1290,1612,2902
"46873","WAJIR","TARBAJ","7",729,891,1620
"46874","WAJIR","TARBAJ","8",1290,1576,2866
"46875","WAJIR","TARBAJ","9",665,791,1456
"46876","WAJIR","TARBAJ","5-9",4817,5938,10755
"46877","WAJIR","TARBAJ","10",1389,1624,3013
"46878","WAJIR","TARBAJ","11",557,693,1250
"46879","WAJIR","TARBAJ","12",1119,1135,2254
"46880","WAJIR","TARBAJ","13",644,670,1314
"46881","WAJIR","TARBAJ","14",892,886,1778
"46882","WAJIR","TARBAJ","10 -14",4601,5008,9609
"46883","WAJIR","TARBAJ","15",896,797,1693
"46884","WAJIR","TARBAJ","16",809,802,1611
"46885","WAJIR","TARBAJ","17",651,646,1297
"46886","WAJIR","TARBAJ","18",762,721,1483
"46887","WAJIR","TARBAJ","19",330,387,717
"46888","WAJIR","TARBAJ","15-19",3448,3353,6801
"46889","WAJIR","TARBAJ","20",793,871,1664
"46890","WAJIR","TARBAJ","21",359,384,743
"46891","WAJIR","TARBAJ","22",386,469,855
"46892","WAJIR","TARBAJ","23",332,347,679
"46893","WAJIR","TARBAJ","24",234,293,527
"46894","WAJIR","TARBAJ","20-24",2104,2364,4468
"46895","WAJIR","TARBAJ","25",581,611,1192
"46896","WAJIR","TARBAJ","26",278,329,607
"46897","WAJIR","TARBAJ","27",272,388,660
"46898","WAJIR","TARBAJ","28",301,377,678
"46899","WAJIR","TARBAJ","29",212,296,508
"46900","WAJIR","TARBAJ","25-29",1644,2001,3645
"46901","WAJIR","TARBAJ","30",661,674,1335
"46902","WAJIR","TARBAJ","31",241,351,592
"46903","WAJIR","TARBAJ","32",258,330,588
"46904","WAJIR","TARBAJ","33",213,223,436
"46905","WAJIR","TARBAJ","34",159,177,336
"46906","WAJIR","TARBAJ","30-34",1532,1755,3287
"46907","WAJIR","TARBAJ","35",420,418,838
"46908","WAJIR","TARBAJ","36",149,142,291
"46909","WAJIR","TARBAJ","37",151,170,321
"46910","WAJIR","TARBAJ","38",168,205,373
"46911","WAJIR","TARBAJ","39",118,117,235
"46912","WAJIR","TARBAJ","35-39",1006,1052,2058
"46913","WAJIR","TARBAJ","40",518,403,921
"46914","WAJIR","TARBAJ","41",174,174,348
"46915","WAJIR","TARBAJ","42",173,164,337
"46916","WAJIR","TARBAJ","43",89,80,169
"46917","WAJIR","TARBAJ","44",57,44,101
"46918","WAJIR","TARBAJ","40-44",1011,865,1876
"46919","WAJIR","TARBAJ","45",248,170,418
"46920","WAJIR","TARBAJ","46",63,54,117
"46921","WAJIR","TARBAJ","47",46,42,88
"46922","WAJIR","TARBAJ","48",80,83,163
"46923","WAJIR","TARBAJ","49",85,59,144
"46924","WAJIR","TARBAJ","45-49",522,408,930
"46925","WAJIR","TARBAJ","50",302,176,478
"46926","WAJIR","TARBAJ","51",56,50,106
"46927","WAJIR","TARBAJ","52",96,59,155
"46928","WAJIR","TARBAJ","53",36,27,63
"46929","WAJIR","TARBAJ","54",52,31,83
"46930","WAJIR","TARBAJ","50-54",542,343,885
"46931","WAJIR","TARBAJ","55",65,39,104
"46932","WAJIR","TARBAJ","56",47,27,74
"46933","WAJIR","TARBAJ","57",41,39,80
"46934","WAJIR","TARBAJ","58",51,33,84
"46935","WAJIR","TARBAJ","59",46,38,84
"46936","WAJIR","TARBAJ","55-59",250,176,426
"46937","WAJIR","TARBAJ","60",164,80,244
"46938","WAJIR","TARBAJ","61",75,44,119
"46939","WAJIR","TARBAJ","62",42,23,65
"46940","WAJIR","TARBAJ","63",40,21,61
"46941","WAJIR","TARBAJ","64",35,24,59
"46942","WAJIR","TARBAJ","60-64",356,192,548
"46943","WAJIR","TARBAJ","65",58,30,88
"46944","WAJIR","TARBAJ","66",20,18,38
"46945","WAJIR","TARBAJ","67",22,8,30
"46946","WAJIR","TARBAJ","68",18,11,29
"46947","WAJIR","TARBAJ","69",39,23,62
"46948","WAJIR","TARBAJ","65-69",157,90,247
"46949","WAJIR","TARBAJ","70",72,59,131
"46950","WAJIR","TARBAJ","71",30,26,56
"46951","WAJIR","TARBAJ","72",17,5,22
"46952","WAJIR","TARBAJ","73",18,4,22
"46953","WAJIR","TARBAJ","74",13,3,16
"46954","WAJIR","TARBAJ","70-74",150,97,247
"46955","WAJIR","TARBAJ","75",22,11,33
"46956","WAJIR","TARBAJ","76",16,4,20
"46957","WAJIR","TARBAJ","77",4,3,7
"46958","WAJIR","TARBAJ","78",8,4,12
"46959","WAJIR","TARBAJ","79",14,8,22
"46960","WAJIR","TARBAJ","75-79",64,30,94
"46961","WAJIR","TARBAJ","80",35,24,59
"46962","WAJIR","TARBAJ","81",7,5,12
"46963","WAJIR","TARBAJ","82",5,1,6
"46964","WAJIR","TARBAJ","83",4,2,6
"46965","WAJIR","TARBAJ","84",3,5,8
"46966","WAJIR","TARBAJ","80-84",54,37,91
"46967","WAJIR","TARBAJ","85",8,4,12
"46968","WAJIR","TARBAJ","86",1,2,3
"46969","WAJIR","TARBAJ","87",2,NA,2
"46970","WAJIR","TARBAJ","88",8,1,9
"46971","WAJIR","TARBAJ","89",4,2,6
"46972","WAJIR","TARBAJ","85-89",23,9,32
"46973","WAJIR","TARBAJ","90",5,5,10
"46974","WAJIR","TARBAJ","91",2,3,5
"46975","WAJIR","TARBAJ","92",NA,1,1
"46976","WAJIR","TARBAJ","93",2,NA,2
"46977","WAJIR","TARBAJ","94",1,1,2
"46978","WAJIR","TARBAJ","90-94",10,10,20
"46979","WAJIR","TARBAJ","95",NA,NA,NA
"46980","WAJIR","TARBAJ","96",NA,1,1
"46981","WAJIR","TARBAJ","97",NA,NA,NA
"46982","WAJIR","TARBAJ","98",NA,NA,NA
"46983","WAJIR","TARBAJ","99",NA,NA,NA
"46984","WAJIR","TARBAJ","95-99",NA,1,1
"46985","WAJIR","TARBAJ","100+",2,2,4
"46986","WAJIR","TARBAJ","Not Stated",NA,NA,NA
"46987","WAJIR","WAJIR EAST","Total",59359,51292,110651
"46988","WAJIR","WAJIR EAST","0",759,811,1570
"46989","WAJIR","WAJIR EAST","1",1328,1229,2557
"46990","WAJIR","WAJIR EAST","2",2044,1925,3969
"46991","WAJIR","WAJIR EAST","3",1580,1565,3145
"46992","WAJIR","WAJIR EAST","4",2149,2056,4205
"46993","WAJIR","WAJIR EAST","0 - 4",7860,7586,15446
"46994","WAJIR","WAJIR EAST","5",1716,1693,3409
"46995","WAJIR","WAJIR EAST","6",2172,2095,4267
"46996","WAJIR","WAJIR EAST","7",1582,1426,3008
"46997","WAJIR","WAJIR EAST","8",2462,2216,4678
"46998","WAJIR","WAJIR EAST","9",1379,1379,2758
"46999","WAJIR","WAJIR EAST","5-9",9311,8809,18120
"47000","WAJIR","WAJIR EAST","10",3032,2489,5521
"47001","WAJIR","WAJIR EAST","11",1201,1264,2465
"47002","WAJIR","WAJIR EAST","12",2511,1825,4336
"47003","WAJIR","WAJIR EAST","13",1586,1292,2878
"47004","WAJIR","WAJIR EAST","14",2053,1477,3530
"47005","WAJIR","WAJIR EAST","10 -14",10383,8347,18730
"47006","WAJIR","WAJIR EAST","15",2268,1624,3892
"47007","WAJIR","WAJIR EAST","16",1866,1415,3281
"47008","WAJIR","WAJIR EAST","17",1864,1279,3143
"47009","WAJIR","WAJIR EAST","18",1680,1274,2954
"47010","WAJIR","WAJIR EAST","19",903,792,1695
"47011","WAJIR","WAJIR EAST","15-19",8581,6384,14965
"47012","WAJIR","WAJIR EAST","20",1873,1501,3374
"47013","WAJIR","WAJIR EAST","21",809,664,1473
"47014","WAJIR","WAJIR EAST","22",983,932,1915
"47015","WAJIR","WAJIR EAST","23",811,707,1518
"47016","WAJIR","WAJIR EAST","24",731,623,1354
"47017","WAJIR","WAJIR EAST","20-24",5207,4427,9634
"47018","WAJIR","WAJIR EAST","25",1428,1331,2759
"47019","WAJIR","WAJIR EAST","26",719,637,1356
"47020","WAJIR","WAJIR EAST","27",758,698,1456
"47021","WAJIR","WAJIR EAST","28",809,792,1601
"47022","WAJIR","WAJIR EAST","29",578,536,1114
"47023","WAJIR","WAJIR EAST","25-29",4292,3994,8286
"47024","WAJIR","WAJIR EAST","30",1590,1499,3089
"47025","WAJIR","WAJIR EAST","31",563,523,1086
"47026","WAJIR","WAJIR EAST","32",649,527,1176
"47027","WAJIR","WAJIR EAST","33",421,390,811
"47028","WAJIR","WAJIR EAST","34",350,376,726
"47029","WAJIR","WAJIR EAST","30-34",3573,3315,6888
"47030","WAJIR","WAJIR EAST","35",943,907,1850
"47031","WAJIR","WAJIR EAST","36",387,391,778
"47032","WAJIR","WAJIR EAST","37",346,303,649
"47033","WAJIR","WAJIR EAST","38",377,403,780
"47034","WAJIR","WAJIR EAST","39",256,264,520
"47035","WAJIR","WAJIR EAST","35-39",2309,2268,4577
"47036","WAJIR","WAJIR EAST","40",1170,832,2002
"47037","WAJIR","WAJIR EAST","41",389,383,772
"47038","WAJIR","WAJIR EAST","42",426,339,765
"47039","WAJIR","WAJIR EAST","43",219,143,362
"47040","WAJIR","WAJIR EAST","44",149,135,284
"47041","WAJIR","WAJIR EAST","40-44",2353,1832,4185
"47042","WAJIR","WAJIR EAST","45",642,496,1138
"47043","WAJIR","WAJIR EAST","46",185,157,342
"47044","WAJIR","WAJIR EAST","47",188,142,330
"47045","WAJIR","WAJIR EAST","48",214,147,361
"47046","WAJIR","WAJIR EAST","49",165,131,296
"47047","WAJIR","WAJIR EAST","45-49",1394,1073,2467
"47048","WAJIR","WAJIR EAST","50",674,458,1132
"47049","WAJIR","WAJIR EAST","51",131,109,240
"47050","WAJIR","WAJIR EAST","52",206,142,348
"47051","WAJIR","WAJIR EAST","53",85,71,156
"47052","WAJIR","WAJIR EAST","54",150,124,274
"47053","WAJIR","WAJIR EAST","50-54",1246,904,2150
"47054","WAJIR","WAJIR EAST","55",201,136,337
"47055","WAJIR","WAJIR EAST","56",166,134,300
"47056","WAJIR","WAJIR EAST","57",134,143,277
"47057","WAJIR","WAJIR EAST","58",166,133,299
"47058","WAJIR","WAJIR EAST","59",163,130,293
"47059","WAJIR","WAJIR EAST","55-59",830,676,1506
"47060","WAJIR","WAJIR EAST","60",441,289,730
"47061","WAJIR","WAJIR EAST","61",114,142,256
"47062","WAJIR","WAJIR EAST","62",92,73,165
"47063","WAJIR","WAJIR EAST","63",105,54,159
"47064","WAJIR","WAJIR EAST","64",77,46,123
"47065","WAJIR","WAJIR EAST","60-64",829,604,1433
"47066","WAJIR","WAJIR EAST","65",145,97,242
"47067","WAJIR","WAJIR EAST","66",52,75,127
"47068","WAJIR","WAJIR EAST","67",66,38,104
"47069","WAJIR","WAJIR EAST","68",61,34,95
"47070","WAJIR","WAJIR EAST","69",79,43,122
"47071","WAJIR","WAJIR EAST","65-69",403,287,690
"47072","WAJIR","WAJIR EAST","70",203,177,380
"47073","WAJIR","WAJIR EAST","71",54,100,154
"47074","WAJIR","WAJIR EAST","72",54,27,81
"47075","WAJIR","WAJIR EAST","73",26,20,46
"47076","WAJIR","WAJIR EAST","74",35,33,68
"47077","WAJIR","WAJIR EAST","70-74",372,357,729
"47078","WAJIR","WAJIR EAST","75",54,65,119
"47079","WAJIR","WAJIR EAST","76",22,27,49
"47080","WAJIR","WAJIR EAST","77",27,15,42
"47081","WAJIR","WAJIR EAST","78",31,19,50
"47082","WAJIR","WAJIR EAST","79",26,21,47
"47083","WAJIR","WAJIR EAST","75-79",160,147,307
"47084","WAJIR","WAJIR EAST","80",73,83,156
"47085","WAJIR","WAJIR EAST","81",22,54,76
"47086","WAJIR","WAJIR EAST","82",16,13,29
"47087","WAJIR","WAJIR EAST","83",18,11,29
"47088","WAJIR","WAJIR EAST","84",11,10,21
"47089","WAJIR","WAJIR EAST","80-84",140,171,311
"47090","WAJIR","WAJIR EAST","85",18,16,34
"47091","WAJIR","WAJIR EAST","86",17,15,32
"47092","WAJIR","WAJIR EAST","87",15,7,22
"47093","WAJIR","WAJIR EAST","88",2,9,11
"47094","WAJIR","WAJIR EAST","89",19,9,28
"47095","WAJIR","WAJIR EAST","85-89",71,56,127
"47096","WAJIR","WAJIR EAST","90",14,21,35
"47097","WAJIR","WAJIR EAST","91",2,13,15
"47098","WAJIR","WAJIR EAST","92",2,1,3
"47099","WAJIR","WAJIR EAST","93",7,2,9
"47100","WAJIR","WAJIR EAST","94",2,NA,2
"47101","WAJIR","WAJIR EAST","90-94",27,37,64
"47102","WAJIR","WAJIR EAST","95",4,2,6
"47103","WAJIR","WAJIR EAST","96",2,3,5
"47104","WAJIR","WAJIR EAST","97",NA,NA,NA
"47105","WAJIR","WAJIR EAST","98",3,NA,3
"47106","WAJIR","WAJIR EAST","99",NA,5,5
"47107","WAJIR","WAJIR EAST","95-99",9,10,19
"47108","WAJIR","WAJIR EAST","100+",8,8,16
"47109","WAJIR","WAJIR EAST","Not Stated",1,NA,1
"47110","WAJIR","WAJIR NORTH","Total",31990,30209,62199
"47111","WAJIR","WAJIR NORTH","0",544,626,1170
"47112","WAJIR","WAJIR NORTH","1",768,912,1680
"47113","WAJIR","WAJIR NORTH","2",1544,1676,3220
"47114","WAJIR","WAJIR NORTH","3",1057,1132,2189
"47115","WAJIR","WAJIR NORTH","4",1545,1650,3195
"47116","WAJIR","WAJIR NORTH","0 - 4",5458,5996,11454
"47117","WAJIR","WAJIR NORTH","5",971,1113,2084
"47118","WAJIR","WAJIR NORTH","6",1511,1681,3192
"47119","WAJIR","WAJIR NORTH","7",789,885,1674
"47120","WAJIR","WAJIR NORTH","8",1555,1546,3101
"47121","WAJIR","WAJIR NORTH","9",736,751,1487
"47122","WAJIR","WAJIR NORTH","5-9",5562,5976,11538
"47123","WAJIR","WAJIR NORTH","10",1602,1589,3191
"47124","WAJIR","WAJIR NORTH","11",583,810,1393
"47125","WAJIR","WAJIR NORTH","12",1299,896,2195
"47126","WAJIR","WAJIR NORTH","13",835,561,1396
"47127","WAJIR","WAJIR NORTH","14",1022,709,1731
"47128","WAJIR","WAJIR NORTH","10 -14",5341,4565,9906
"47129","WAJIR","WAJIR NORTH","15",1095,745,1840
"47130","WAJIR","WAJIR NORTH","16",902,629,1531
"47131","WAJIR","WAJIR NORTH","17",898,665,1563
"47132","WAJIR","WAJIR NORTH","18",860,735,1595
"47133","WAJIR","WAJIR NORTH","19",352,332,684
"47134","WAJIR","WAJIR NORTH","15-19",4107,3106,7213
"47135","WAJIR","WAJIR NORTH","20",946,995,1941
"47136","WAJIR","WAJIR NORTH","21",340,339,679
"47137","WAJIR","WAJIR NORTH","22",455,533,988
"47138","WAJIR","WAJIR NORTH","23",318,350,668
"47139","WAJIR","WAJIR NORTH","24",402,397,799
"47140","WAJIR","WAJIR NORTH","20-24",2461,2614,5075
"47141","WAJIR","WAJIR NORTH","25",816,777,1593
"47142","WAJIR","WAJIR NORTH","26",345,361,706
"47143","WAJIR","WAJIR NORTH","27",364,410,774
"47144","WAJIR","WAJIR NORTH","28",415,522,937
"47145","WAJIR","WAJIR NORTH","29",227,316,543
"47146","WAJIR","WAJIR NORTH","25-29",2167,2386,4553
"47147","WAJIR","WAJIR NORTH","30",972,870,1842
"47148","WAJIR","WAJIR NORTH","31",215,239,454
"47149","WAJIR","WAJIR NORTH","32",276,279,555
"47150","WAJIR","WAJIR NORTH","33",165,230,395
"47151","WAJIR","WAJIR NORTH","34",199,186,385
"47152","WAJIR","WAJIR NORTH","30-34",1827,1804,3631
"47153","WAJIR","WAJIR NORTH","35",481,444,925
"47154","WAJIR","WAJIR NORTH","36",212,169,381
"47155","WAJIR","WAJIR NORTH","37",170,158,328
"47156","WAJIR","WAJIR NORTH","38",238,224,462
"47157","WAJIR","WAJIR NORTH","39",134,149,283
"47158","WAJIR","WAJIR NORTH","35-39",1235,1144,2379
"47159","WAJIR","WAJIR NORTH","40",693,520,1213
"47160","WAJIR","WAJIR NORTH","41",190,117,307
"47161","WAJIR","WAJIR NORTH","42",203,166,369
"47162","WAJIR","WAJIR NORTH","43",137,100,237
"47163","WAJIR","WAJIR NORTH","44",78,62,140
"47164","WAJIR","WAJIR NORTH","40-44",1301,965,2266
"47165","WAJIR","WAJIR NORTH","45",314,228,542
"47166","WAJIR","WAJIR NORTH","46",96,42,138
"47167","WAJIR","WAJIR NORTH","47",101,67,168
"47168","WAJIR","WAJIR NORTH","48",88,65,153
"47169","WAJIR","WAJIR NORTH","49",79,66,145
"47170","WAJIR","WAJIR NORTH","45-49",678,468,1146
"47171","WAJIR","WAJIR NORTH","50",350,218,568
"47172","WAJIR","WAJIR NORTH","51",57,40,97
"47173","WAJIR","WAJIR NORTH","52",90,64,154
"47174","WAJIR","WAJIR NORTH","53",51,23,74
"47175","WAJIR","WAJIR NORTH","54",81,63,144
"47176","WAJIR","WAJIR NORTH","50-54",629,408,1037
"47177","WAJIR","WAJIR NORTH","55",118,73,191
"47178","WAJIR","WAJIR NORTH","56",53,29,82
"47179","WAJIR","WAJIR NORTH","57",42,42,84
"47180","WAJIR","WAJIR NORTH","58",46,39,85
"47181","WAJIR","WAJIR NORTH","59",66,56,122
"47182","WAJIR","WAJIR NORTH","55-59",325,239,564
"47183","WAJIR","WAJIR NORTH","60",222,93,315
"47184","WAJIR","WAJIR NORTH","61",40,42,82
"47185","WAJIR","WAJIR NORTH","62",39,12,51
"47186","WAJIR","WAJIR NORTH","63",34,24,58
"47187","WAJIR","WAJIR NORTH","64",27,13,40
"47188","WAJIR","WAJIR NORTH","60-64",362,184,546
"47189","WAJIR","WAJIR NORTH","65",66,31,97
"47190","WAJIR","WAJIR NORTH","66",16,19,35
"47191","WAJIR","WAJIR NORTH","67",23,13,36
"47192","WAJIR","WAJIR NORTH","68",30,13,43
"47193","WAJIR","WAJIR NORTH","69",34,28,62
"47194","WAJIR","WAJIR NORTH","65-69",169,104,273
"47195","WAJIR","WAJIR NORTH","70",110,59,169
"47196","WAJIR","WAJIR NORTH","71",37,39,76
"47197","WAJIR","WAJIR NORTH","72",17,11,28
"47198","WAJIR","WAJIR NORTH","73",10,6,16
"47199","WAJIR","WAJIR NORTH","74",13,10,23
"47200","WAJIR","WAJIR NORTH","70-74",187,125,312
"47201","WAJIR","WAJIR NORTH","75",25,11,36
"47202","WAJIR","WAJIR NORTH","76",6,11,17
"47203","WAJIR","WAJIR NORTH","77",15,5,20
"47204","WAJIR","WAJIR NORTH","78",17,4,21
"47205","WAJIR","WAJIR NORTH","79",19,10,29
"47206","WAJIR","WAJIR NORTH","75-79",82,41,123
"47207","WAJIR","WAJIR NORTH","80",33,25,58
"47208","WAJIR","WAJIR NORTH","81",16,22,38
"47209","WAJIR","WAJIR NORTH","82",4,7,11
"47210","WAJIR","WAJIR NORTH","83",5,5,10
"47211","WAJIR","WAJIR NORTH","84",6,3,9
"47212","WAJIR","WAJIR NORTH","80-84",64,62,126
"47213","WAJIR","WAJIR NORTH","85",4,3,7
"47214","WAJIR","WAJIR NORTH","86",NA,4,4
"47215","WAJIR","WAJIR NORTH","87",5,2,7
"47216","WAJIR","WAJIR NORTH","88",2,1,3
"47217","WAJIR","WAJIR NORTH","89",6,2,8
"47218","WAJIR","WAJIR NORTH","85-89",17,12,29
"47219","WAJIR","WAJIR NORTH","90",7,5,12
"47220","WAJIR","WAJIR NORTH","91",2,2,4
"47221","WAJIR","WAJIR NORTH","92",1,2,3
"47222","WAJIR","WAJIR NORTH","93",1,NA,1
"47223","WAJIR","WAJIR NORTH","94",1,NA,1
"47224","WAJIR","WAJIR NORTH","90-94",12,9,21
"47225","WAJIR","WAJIR NORTH","95",2,1,3
"47226","WAJIR","WAJIR NORTH","96",1,NA,1
"47227","WAJIR","WAJIR NORTH","97",NA,NA,NA
"47228","WAJIR","WAJIR NORTH","98",3,NA,3
"47229","WAJIR","WAJIR NORTH","99",NA,NA,NA
"47230","WAJIR","WAJIR NORTH","95-99",6,1,7
"47231","WAJIR","WAJIR NORTH","100+",NA,NA,NA
"47232","WAJIR","WAJIR NORTH","Not Stated",NA,NA,NA
"47233","WAJIR","WAJIR SOUTH","Total",64947,51864,116811
"47234","WAJIR","WAJIR SOUTH","0",591,550,1141
"47235","WAJIR","WAJIR SOUTH","1",1423,1218,2641
"47236","WAJIR","WAJIR SOUTH","2",2504,2318,4822
"47237","WAJIR","WAJIR SOUTH","3",1873,1633,3506
"47238","WAJIR","WAJIR SOUTH","4",2591,2248,4839
"47239","WAJIR","WAJIR SOUTH","0 - 4",8982,7967,16949
"47240","WAJIR","WAJIR SOUTH","5",1930,1704,3634
"47241","WAJIR","WAJIR SOUTH","6",2615,2166,4781
"47242","WAJIR","WAJIR SOUTH","7",1594,1360,2954
"47243","WAJIR","WAJIR SOUTH","8",2728,2181,4909
"47244","WAJIR","WAJIR SOUTH","9",1594,1337,2931
"47245","WAJIR","WAJIR SOUTH","5-9",10461,8748,19209
"47246","WAJIR","WAJIR SOUTH","10",3178,2302,5480
"47247","WAJIR","WAJIR SOUTH","11",1433,1169,2602
"47248","WAJIR","WAJIR SOUTH","12",2640,1623,4263
"47249","WAJIR","WAJIR SOUTH","13",1762,1110,2872
"47250","WAJIR","WAJIR SOUTH","14",2153,1278,3431
"47251","WAJIR","WAJIR SOUTH","10 -14",11166,7482,18648
"47252","WAJIR","WAJIR SOUTH","15",2365,1464,3829
"47253","WAJIR","WAJIR SOUTH","16",1903,1210,3113
"47254","WAJIR","WAJIR SOUTH","17",1985,1277,3262
"47255","WAJIR","WAJIR SOUTH","18",1867,1389,3256
"47256","WAJIR","WAJIR SOUTH","19",915,842,1757
"47257","WAJIR","WAJIR SOUTH","15-19",9035,6182,15217
"47258","WAJIR","WAJIR SOUTH","20",2114,1741,3855
"47259","WAJIR","WAJIR SOUTH","21",756,780,1536
"47260","WAJIR","WAJIR SOUTH","22",1008,965,1973
"47261","WAJIR","WAJIR SOUTH","23",761,796,1557
"47262","WAJIR","WAJIR SOUTH","24",793,687,1480
"47263","WAJIR","WAJIR SOUTH","20-24",5432,4969,10401
"47264","WAJIR","WAJIR SOUTH","25",1528,1653,3181
"47265","WAJIR","WAJIR SOUTH","26",771,776,1547
"47266","WAJIR","WAJIR SOUTH","27",536,607,1143
"47267","WAJIR","WAJIR SOUTH","28",1036,1182,2218
"47268","WAJIR","WAJIR SOUTH","29",584,692,1276
"47269","WAJIR","WAJIR SOUTH","25-29",4455,4910,9365
"47270","WAJIR","WAJIR SOUTH","30",1929,1818,3747
"47271","WAJIR","WAJIR SOUTH","31",444,498,942
"47272","WAJIR","WAJIR SOUTH","32",721,782,1503
"47273","WAJIR","WAJIR SOUTH","33",437,412,849
"47274","WAJIR","WAJIR SOUTH","34",385,396,781
"47275","WAJIR","WAJIR SOUTH","30-34",3916,3906,7822
"47276","WAJIR","WAJIR SOUTH","35",1048,987,2035
"47277","WAJIR","WAJIR SOUTH","36",439,487,926
"47278","WAJIR","WAJIR SOUTH","37",303,331,634
"47279","WAJIR","WAJIR SOUTH","38",614,604,1218
"47280","WAJIR","WAJIR SOUTH","39",323,357,680
"47281","WAJIR","WAJIR SOUTH","35-39",2727,2766,5493
"47282","WAJIR","WAJIR SOUTH","40",1554,1001,2555
"47283","WAJIR","WAJIR SOUTH","41",302,287,589
"47284","WAJIR","WAJIR SOUTH","42",481,339,820
"47285","WAJIR","WAJIR SOUTH","43",334,187,521
"47286","WAJIR","WAJIR SOUTH","44",159,117,276
"47287","WAJIR","WAJIR SOUTH","40-44",2830,1931,4761
"47288","WAJIR","WAJIR SOUTH","45",729,484,1213
"47289","WAJIR","WAJIR SOUTH","46",248,133,381
"47290","WAJIR","WAJIR SOUTH","47",187,125,312
"47291","WAJIR","WAJIR SOUTH","48",348,251,599
"47292","WAJIR","WAJIR SOUTH","49",193,130,323
"47293","WAJIR","WAJIR SOUTH","45-49",1705,1123,2828
"47294","WAJIR","WAJIR SOUTH","50",1039,414,1453
"47295","WAJIR","WAJIR SOUTH","51",179,84,263
"47296","WAJIR","WAJIR SOUTH","52",268,121,389
"47297","WAJIR","WAJIR SOUTH","53",136,46,182
"47298","WAJIR","WAJIR SOUTH","54",147,59,206
"47299","WAJIR","WAJIR SOUTH","50-54",1769,724,2493
"47300","WAJIR","WAJIR SOUTH","55",208,108,316
"47301","WAJIR","WAJIR SOUTH","56",159,88,247
"47302","WAJIR","WAJIR SOUTH","57",92,63,155
"47303","WAJIR","WAJIR SOUTH","58",129,75,204
"47304","WAJIR","WAJIR SOUTH","59",109,42,151
"47305","WAJIR","WAJIR SOUTH","55-59",697,376,1073
"47306","WAJIR","WAJIR SOUTH","60",473,200,673
"47307","WAJIR","WAJIR SOUTH","61",89,45,134
"47308","WAJIR","WAJIR SOUTH","62",106,26,132
"47309","WAJIR","WAJIR SOUTH","63",93,28,121
"47310","WAJIR","WAJIR SOUTH","64",55,20,75
"47311","WAJIR","WAJIR SOUTH","60-64",816,319,1135
"47312","WAJIR","WAJIR SOUTH","65",115,69,184
"47313","WAJIR","WAJIR SOUTH","66",50,30,80
"47314","WAJIR","WAJIR SOUTH","67",46,15,61
"47315","WAJIR","WAJIR SOUTH","68",73,33,106
"47316","WAJIR","WAJIR SOUTH","69",60,16,76
"47317","WAJIR","WAJIR SOUTH","65-69",344,163,507
"47318","WAJIR","WAJIR SOUTH","70",196,83,279
"47319","WAJIR","WAJIR SOUTH","71",27,31,58
"47320","WAJIR","WAJIR SOUTH","72",53,15,68
"47321","WAJIR","WAJIR SOUTH","73",22,9,31
"47322","WAJIR","WAJIR SOUTH","74",16,8,24
"47323","WAJIR","WAJIR SOUTH","70-74",314,146,460
"47324","WAJIR","WAJIR SOUTH","75",41,12,53
"47325","WAJIR","WAJIR SOUTH","76",15,10,25
"47326","WAJIR","WAJIR SOUTH","77",17,6,23
"47327","WAJIR","WAJIR SOUTH","78",30,11,41
"47328","WAJIR","WAJIR SOUTH","79",17,7,24
"47329","WAJIR","WAJIR SOUTH","75-79",120,46,166
"47330","WAJIR","WAJIR SOUTH","80",63,33,96
"47331","WAJIR","WAJIR SOUTH","81",16,18,34
"47332","WAJIR","WAJIR SOUTH","82",8,5,13
"47333","WAJIR","WAJIR SOUTH","83",6,7,13
"47334","WAJIR","WAJIR SOUTH","84",9,3,12
"47335","WAJIR","WAJIR SOUTH","80-84",102,66,168
"47336","WAJIR","WAJIR SOUTH","85",13,3,16
"47337","WAJIR","WAJIR SOUTH","86",4,1,5
"47338","WAJIR","WAJIR SOUTH","87",8,3,11
"47339","WAJIR","WAJIR SOUTH","88",3,4,7
"47340","WAJIR","WAJIR SOUTH","89",11,4,15
"47341","WAJIR","WAJIR SOUTH","85-89",39,15,54
"47342","WAJIR","WAJIR SOUTH","90",17,11,28
"47343","WAJIR","WAJIR SOUTH","91",3,2,5
"47344","WAJIR","WAJIR SOUTH","92",4,2,6
"47345","WAJIR","WAJIR SOUTH","93",3,4,7
"47346","WAJIR","WAJIR SOUTH","94",NA,NA,NA
"47347","WAJIR","WAJIR SOUTH","90-94",27,19,46
"47348","WAJIR","WAJIR SOUTH","95",6,3,9
"47349","WAJIR","WAJIR SOUTH","96",NA,NA,NA
"47350","WAJIR","WAJIR SOUTH","97",NA,NA,NA
"47351","WAJIR","WAJIR SOUTH","98",1,1,2
"47352","WAJIR","WAJIR SOUTH","99",1,1,2
"47353","WAJIR","WAJIR SOUTH","95-99",8,5,13
"47354","WAJIR","WAJIR SOUTH","100+",2,1,3
"47355","WAJIR","WAJIR SOUTH","Not Stated",NA,NA,NA
"47356","WAJIR","WAJIR WEST","Total",65785,56037,121822
"47357","WAJIR","WAJIR WEST","0",818,796,1614
"47358","WAJIR","WAJIR WEST","1",1587,1518,3105
"47359","WAJIR","WAJIR WEST","2",2591,2558,5149
"47360","WAJIR","WAJIR WEST","3",1841,1785,3626
"47361","WAJIR","WAJIR WEST","4",2771,2637,5408
"47362","WAJIR","WAJIR WEST","0 - 4",9608,9294,18902
"47363","WAJIR","WAJIR WEST","5",1897,1961,3858
"47364","WAJIR","WAJIR WEST","6",2971,2828,5799
"47365","WAJIR","WAJIR WEST","7",1767,1733,3500
"47366","WAJIR","WAJIR WEST","8",3109,2970,6079
"47367","WAJIR","WAJIR WEST","9",1675,1721,3396
"47368","WAJIR","WAJIR WEST","5-9",11419,11213,22632
"47369","WAJIR","WAJIR WEST","10",3706,3352,7058
"47370","WAJIR","WAJIR WEST","11",1486,1593,3079
"47371","WAJIR","WAJIR WEST","12",3189,2294,5483
"47372","WAJIR","WAJIR WEST","13",2001,1414,3415
"47373","WAJIR","WAJIR WEST","14",2626,1754,4380
"47374","WAJIR","WAJIR WEST","10 -14",13008,10407,23415
"47375","WAJIR","WAJIR WEST","15",2806,1734,4540
"47376","WAJIR","WAJIR WEST","16",2389,1584,3973
"47377","WAJIR","WAJIR WEST","17",2162,1332,3494
"47378","WAJIR","WAJIR WEST","18",2046,1360,3406
"47379","WAJIR","WAJIR WEST","19",895,691,1586
"47380","WAJIR","WAJIR WEST","15-19",10298,6701,16999
"47381","WAJIR","WAJIR WEST","20",1984,1594,3578
"47382","WAJIR","WAJIR WEST","21",804,593,1397
"47383","WAJIR","WAJIR WEST","22",1003,739,1742
"47384","WAJIR","WAJIR WEST","23",688,590,1278
"47385","WAJIR","WAJIR WEST","24",733,591,1324
"47386","WAJIR","WAJIR WEST","20-24",5212,4107,9319
"47387","WAJIR","WAJIR WEST","25",1144,1111,2255
"47388","WAJIR","WAJIR WEST","26",631,608,1239
"47389","WAJIR","WAJIR WEST","27",545,606,1151
"47390","WAJIR","WAJIR WEST","28",777,785,1562
"47391","WAJIR","WAJIR WEST","29",462,527,989
"47392","WAJIR","WAJIR WEST","25-29",3559,3637,7196
"47393","WAJIR","WAJIR WEST","30",1312,1244,2556
"47394","WAJIR","WAJIR WEST","31",548,737,1285
"47395","WAJIR","WAJIR WEST","32",476,473,949
"47396","WAJIR","WAJIR WEST","33",377,395,772
"47397","WAJIR","WAJIR WEST","34",353,317,670
"47398","WAJIR","WAJIR WEST","30-34",3066,3166,6232
"47399","WAJIR","WAJIR WEST","35",781,793,1574
"47400","WAJIR","WAJIR WEST","36",439,457,896
"47401","WAJIR","WAJIR WEST","37",311,329,640
"47402","WAJIR","WAJIR WEST","38",402,403,805
"47403","WAJIR","WAJIR WEST","39",256,271,527
"47404","WAJIR","WAJIR WEST","35-39",2189,2253,4442
"47405","WAJIR","WAJIR WEST","40",1006,759,1765
"47406","WAJIR","WAJIR WEST","41",458,468,926
"47407","WAJIR","WAJIR WEST","42",418,357,775
"47408","WAJIR","WAJIR WEST","43",187,184,371
"47409","WAJIR","WAJIR WEST","44",145,119,264
"47410","WAJIR","WAJIR WEST","40-44",2214,1887,4101
"47411","WAJIR","WAJIR WEST","45",543,335,878
"47412","WAJIR","WAJIR WEST","46",161,137,298
"47413","WAJIR","WAJIR WEST","47",166,97,263
"47414","WAJIR","WAJIR WEST","48",185,156,341
"47415","WAJIR","WAJIR WEST","49",158,103,261
"47416","WAJIR","WAJIR WEST","45-49",1213,828,2041
"47417","WAJIR","WAJIR WEST","50",617,367,984
"47418","WAJIR","WAJIR WEST","51",156,111,267
"47419","WAJIR","WAJIR WEST","52",213,119,332
"47420","WAJIR","WAJIR WEST","53",101,64,165
"47421","WAJIR","WAJIR WEST","54",139,89,228
"47422","WAJIR","WAJIR WEST","50-54",1226,750,1976
"47423","WAJIR","WAJIR WEST","55",189,93,282
"47424","WAJIR","WAJIR WEST","56",138,105,243
"47425","WAJIR","WAJIR WEST","57",109,77,186
"47426","WAJIR","WAJIR WEST","58",144,110,254
"47427","WAJIR","WAJIR WEST","59",213,116,329
"47428","WAJIR","WAJIR WEST","55-59",793,501,1294
"47429","WAJIR","WAJIR WEST","60",397,237,634
"47430","WAJIR","WAJIR WEST","61",139,73,212
"47431","WAJIR","WAJIR WEST","62",94,48,142
"47432","WAJIR","WAJIR WEST","63",88,58,146
"47433","WAJIR","WAJIR WEST","64",63,54,117
"47434","WAJIR","WAJIR WEST","60-64",781,470,1251
"47435","WAJIR","WAJIR WEST","65",118,82,200
"47436","WAJIR","WAJIR WEST","66",64,50,114
"47437","WAJIR","WAJIR WEST","67",74,41,115
"47438","WAJIR","WAJIR WEST","68",67,54,121
"47439","WAJIR","WAJIR WEST","69",80,37,117
"47440","WAJIR","WAJIR WEST","65-69",403,264,667
"47441","WAJIR","WAJIR WEST","70",187,177,364
"47442","WAJIR","WAJIR WEST","71",59,55,114
"47443","WAJIR","WAJIR WEST","72",47,23,70
"47444","WAJIR","WAJIR WEST","73",33,10,43
"47445","WAJIR","WAJIR WEST","74",39,16,55
"47446","WAJIR","WAJIR WEST","70-74",365,281,646
"47447","WAJIR","WAJIR WEST","75",70,35,105
"47448","WAJIR","WAJIR WEST","76",34,16,50
"47449","WAJIR","WAJIR WEST","77",26,12,38
"47450","WAJIR","WAJIR WEST","78",29,12,41
"47451","WAJIR","WAJIR WEST","79",26,14,40
"47452","WAJIR","WAJIR WEST","75-79",185,89,274
"47453","WAJIR","WAJIR WEST","80",82,76,158
"47454","WAJIR","WAJIR WEST","81",25,28,53
"47455","WAJIR","WAJIR WEST","82",20,5,25
"47456","WAJIR","WAJIR WEST","83",14,6,20
"47457","WAJIR","WAJIR WEST","84",12,8,20
"47458","WAJIR","WAJIR WEST","80-84",153,123,276
"47459","WAJIR","WAJIR WEST","85",10,11,21
"47460","WAJIR","WAJIR WEST","86",8,4,12
"47461","WAJIR","WAJIR WEST","87",12,5,17
"47462","WAJIR","WAJIR WEST","88",10,4,14
"47463","WAJIR","WAJIR WEST","89",6,10,16
"47464","WAJIR","WAJIR WEST","85-89",46,34,80
"47465","WAJIR","WAJIR WEST","90",12,13,25
"47466","WAJIR","WAJIR WEST","91",9,3,12
"47467","WAJIR","WAJIR WEST","92",6,NA,6
"47468","WAJIR","WAJIR WEST","93",5,1,6
"47469","WAJIR","WAJIR WEST","94",1,4,5
"47470","WAJIR","WAJIR WEST","90-94",33,21,54
"47471","WAJIR","WAJIR WEST","95",1,3,4
"47472","WAJIR","WAJIR WEST","96",1,2,3
"47473","WAJIR","WAJIR WEST","97",4,NA,4
"47474","WAJIR","WAJIR WEST","98",3,NA,3
"47475","WAJIR","WAJIR WEST","99",2,3,5
"47476","WAJIR","WAJIR WEST","95-99",11,8,19
"47477","WAJIR","WAJIR WEST","100+",3,2,5
"47478","WAJIR","WAJIR WEST","Not Stated",NA,1,1
"47479","WEST POKOT","ALL","Total",307013,314213,621226
"47480","WEST POKOT","ALL","0",9944,10068,20012
"47481","WEST POKOT","ALL","1",10844,10679,21523
"47482","WEST POKOT","ALL","2",12012,11859,23871
"47483","WEST POKOT","ALL","3",11956,12116,24072
"47484","WEST POKOT","ALL","4",12403,12109,24512
"47485","WEST POKOT","ALL","0 - 4",57159,56831,113990
"47486","WEST POKOT","ALL","5",11595,11247,22842
"47487","WEST POKOT","ALL","6",12055,12450,24505
"47488","WEST POKOT","ALL","7",10228,10188,20416
"47489","WEST POKOT","ALL","8",11236,11538,22774
"47490","WEST POKOT","ALL","9",8989,8797,17786
"47491","WEST POKOT","ALL","5-9",54103,54220,108323
"47492","WEST POKOT","ALL","10",12534,12691,25225
"47493","WEST POKOT","ALL","11",7362,7991,15353
"47494","WEST POKOT","ALL","12",10841,10177,21018
"47495","WEST POKOT","ALL","13",8525,8358,16883
"47496","WEST POKOT","ALL","14",8586,8109,16695
"47497","WEST POKOT","ALL","10 -14",47848,47326,95174
"47498","WEST POKOT","ALL","15",9210,8460,17670
"47499","WEST POKOT","ALL","16",7305,7025,14330
"47500","WEST POKOT","ALL","17",6465,5905,12370
"47501","WEST POKOT","ALL","18",6075,6032,12107
"47502","WEST POKOT","ALL","19",5636,5668,11304
"47503","WEST POKOT","ALL","15-19",34691,33090,67781
"47504","WEST POKOT","ALL","20",6932,8079,15011
"47505","WEST POKOT","ALL","21",4697,5151,9848
"47506","WEST POKOT","ALL","22",4280,5008,9288
"47507","WEST POKOT","ALL","23",4988,5490,10478
"47508","WEST POKOT","ALL","24",4214,4734,8948
"47509","WEST POKOT","ALL","20-24",25111,28462,53573
"47510","WEST POKOT","ALL","25",5955,6540,12495
"47511","WEST POKOT","ALL","26",3835,4089,7924
"47512","WEST POKOT","ALL","27",3924,3993,7917
"47513","WEST POKOT","ALL","28",3122,3597,6719
"47514","WEST POKOT","ALL","29",3317,3737,7054
"47515","WEST POKOT","ALL","25-29",20153,21956,42109
"47516","WEST POKOT","ALL","30",5449,6038,11487
"47517","WEST POKOT","ALL","31",3052,3355,6407
"47518","WEST POKOT","ALL","32",3391,3450,6841
"47519","WEST POKOT","ALL","33",2852,3059,5911
"47520","WEST POKOT","ALL","34",2390,2493,4883
"47521","WEST POKOT","ALL","30-34",17134,18395,35529
"47522","WEST POKOT","ALL","35",4570,4685,9255
"47523","WEST POKOT","ALL","36",1835,1777,3612
"47524","WEST POKOT","ALL","37",1750,1651,3401
"47525","WEST POKOT","ALL","38",1262,1346,2608
"47526","WEST POKOT","ALL","39",1688,1574,3262
"47527","WEST POKOT","ALL","35-39",11105,11033,22138
"47528","WEST POKOT","ALL","40",2950,2874,5824
"47529","WEST POKOT","ALL","41",1998,1917,3915
"47530","WEST POKOT","ALL","42",2192,2143,4335
"47531","WEST POKOT","ALL","43",1521,1632,3153
"47532","WEST POKOT","ALL","44",1058,1163,2221
"47533","WEST POKOT","ALL","40-44",9719,9729,19448
"47534","WEST POKOT","ALL","45",2931,2860,5791
"47535","WEST POKOT","ALL","46",1805,1730,3535
"47536","WEST POKOT","ALL","47",1477,1400,2877
"47537","WEST POKOT","ALL","48",1026,890,1916
"47538","WEST POKOT","ALL","49",1391,1490,2881
"47539","WEST POKOT","ALL","45-49",8630,8370,17000
"47540","WEST POKOT","ALL","50",2384,2384,4768
"47541","WEST POKOT","ALL","51",1027,1020,2047
"47542","WEST POKOT","ALL","52",841,887,1728
"47543","WEST POKOT","ALL","53",619,621,1240
"47544","WEST POKOT","ALL","54",924,959,1883
"47545","WEST POKOT","ALL","50-54",5795,5871,11666
"47546","WEST POKOT","ALL","55",1154,1123,2277
"47547","WEST POKOT","ALL","56",907,805,1712
"47548","WEST POKOT","ALL","57",680,674,1354
"47549","WEST POKOT","ALL","58",590,637,1227
"47550","WEST POKOT","ALL","59",787,1031,1818
"47551","WEST POKOT","ALL","55-59",4118,4270,8388
"47552","WEST POKOT","ALL","60",1462,1819,3281
"47553","WEST POKOT","ALL","61",650,772,1422
"47554","WEST POKOT","ALL","62",519,581,1100
"47555","WEST POKOT","ALL","63",595,775,1370
"47556","WEST POKOT","ALL","64",516,553,1069
"47557","WEST POKOT","ALL","60-64",3742,4500,8242
"47558","WEST POKOT","ALL","65",907,1270,2177
"47559","WEST POKOT","ALL","66",400,459,859
"47560","WEST POKOT","ALL","67",612,591,1203
"47561","WEST POKOT","ALL","68",345,382,727
"47562","WEST POKOT","ALL","69",716,1070,1786
"47563","WEST POKOT","ALL","65-69",2980,3772,6752
"47564","WEST POKOT","ALL","70",1078,1294,2372
"47565","WEST POKOT","ALL","71",422,588,1010
"47566","WEST POKOT","ALL","72",383,383,766
"47567","WEST POKOT","ALL","73",262,328,590
"47568","WEST POKOT","ALL","74",311,459,770
"47569","WEST POKOT","ALL","70-74",2456,3052,5508
"47570","WEST POKOT","ALL","75",369,443,812
"47571","WEST POKOT","ALL","76",186,186,372
"47572","WEST POKOT","ALL","77",186,209,395
"47573","WEST POKOT","ALL","78",111,137,248
"47574","WEST POKOT","ALL","79",265,435,700
"47575","WEST POKOT","ALL","75-79",1117,1410,2527
"47576","WEST POKOT","ALL","80",304,470,774
"47577","WEST POKOT","ALL","81",98,131,229
"47578","WEST POKOT","ALL","82",67,84,151
"47579","WEST POKOT","ALL","83",71,118,189
"47580","WEST POKOT","ALL","84",76,138,214
"47581","WEST POKOT","ALL","80-84",616,941,1557
"47582","WEST POKOT","ALL","85",83,132,215
"47583","WEST POKOT","ALL","86",35,43,78
"47584","WEST POKOT","ALL","87",42,60,102
"47585","WEST POKOT","ALL","88",27,51,78
"47586","WEST POKOT","ALL","89",91,195,286
"47587","WEST POKOT","ALL","85-89",278,481,759
"47588","WEST POKOT","ALL","90",62,127,189
"47589","WEST POKOT","ALL","91",26,47,73
"47590","WEST POKOT","ALL","92",14,17,31
"47591","WEST POKOT","ALL","93",15,37,52
"47592","WEST POKOT","ALL","94",24,27,51
"47593","WEST POKOT","ALL","90-94",141,255,396
"47594","WEST POKOT","ALL","95",33,48,81
"47595","WEST POKOT","ALL","96",12,17,29
"47596","WEST POKOT","ALL","97",7,17,24
"47597","WEST POKOT","ALL","98",9,11,20
"47598","WEST POKOT","ALL","99",16,47,63
"47599","WEST POKOT","ALL","95-99",77,140,217
"47600","WEST POKOT","ALL","100+",38,108,146
"47601","WEST POKOT","ALL","Not Stated",2,1,3
"47602","WEST POKOT","KIPKOMO","Total",50923,51703,102626
"47603","WEST POKOT","KIPKOMO","0",1715,1756,3471
"47604","WEST POKOT","KIPKOMO","1",1831,1684,3515
"47605","WEST POKOT","KIPKOMO","2",1903,1864,3767
"47606","WEST POKOT","KIPKOMO","3",1973,1983,3956
"47607","WEST POKOT","KIPKOMO","4",1979,1912,3891
"47608","WEST POKOT","KIPKOMO","0 - 4",9401,9199,18600
"47609","WEST POKOT","KIPKOMO","5",1928,1813,3741
"47610","WEST POKOT","KIPKOMO","6",1946,1967,3913
"47611","WEST POKOT","KIPKOMO","7",1694,1687,3381
"47612","WEST POKOT","KIPKOMO","8",1702,1703,3405
"47613","WEST POKOT","KIPKOMO","9",1612,1471,3083
"47614","WEST POKOT","KIPKOMO","5-9",8882,8641,17523
"47615","WEST POKOT","KIPKOMO","10",1828,1857,3685
"47616","WEST POKOT","KIPKOMO","11",1427,1492,2919
"47617","WEST POKOT","KIPKOMO","12",1747,1613,3360
"47618","WEST POKOT","KIPKOMO","13",1486,1543,3029
"47619","WEST POKOT","KIPKOMO","14",1496,1439,2935
"47620","WEST POKOT","KIPKOMO","10 -14",7984,7944,15928
"47621","WEST POKOT","KIPKOMO","15",1459,1509,2968
"47622","WEST POKOT","KIPKOMO","16",1241,1250,2491
"47623","WEST POKOT","KIPKOMO","17",1212,1127,2339
"47624","WEST POKOT","KIPKOMO","18",963,981,1944
"47625","WEST POKOT","KIPKOMO","19",1082,1013,2095
"47626","WEST POKOT","KIPKOMO","15-19",5957,5880,11837
"47627","WEST POKOT","KIPKOMO","20",1059,1260,2319
"47628","WEST POKOT","KIPKOMO","21",930,955,1885
"47629","WEST POKOT","KIPKOMO","22",706,810,1516
"47630","WEST POKOT","KIPKOMO","23",911,928,1839
"47631","WEST POKOT","KIPKOMO","24",736,801,1537
"47632","WEST POKOT","KIPKOMO","20-24",4342,4754,9096
"47633","WEST POKOT","KIPKOMO","25",934,937,1871
"47634","WEST POKOT","KIPKOMO","26",629,681,1310
"47635","WEST POKOT","KIPKOMO","27",651,615,1266
"47636","WEST POKOT","KIPKOMO","28",483,514,997
"47637","WEST POKOT","KIPKOMO","29",561,614,1175
"47638","WEST POKOT","KIPKOMO","25-29",3258,3361,6619
"47639","WEST POKOT","KIPKOMO","30",711,795,1506
"47640","WEST POKOT","KIPKOMO","31",474,496,970
"47641","WEST POKOT","KIPKOMO","32",473,459,932
"47642","WEST POKOT","KIPKOMO","33",444,474,918
"47643","WEST POKOT","KIPKOMO","34",398,410,808
"47644","WEST POKOT","KIPKOMO","30-34",2500,2634,5134
"47645","WEST POKOT","KIPKOMO","35",741,772,1513
"47646","WEST POKOT","KIPKOMO","36",338,311,649
"47647","WEST POKOT","KIPKOMO","37",339,324,663
"47648","WEST POKOT","KIPKOMO","38",177,190,367
"47649","WEST POKOT","KIPKOMO","39",266,276,542
"47650","WEST POKOT","KIPKOMO","35-39",1861,1873,3734
"47651","WEST POKOT","KIPKOMO","40",405,393,798
"47652","WEST POKOT","KIPKOMO","41",347,345,692
"47653","WEST POKOT","KIPKOMO","42",473,459,932
"47654","WEST POKOT","KIPKOMO","43",264,271,535
"47655","WEST POKOT","KIPKOMO","44",193,193,386
"47656","WEST POKOT","KIPKOMO","40-44",1682,1661,3343
"47657","WEST POKOT","KIPKOMO","45",500,497,997
"47658","WEST POKOT","KIPKOMO","46",341,292,633
"47659","WEST POKOT","KIPKOMO","47",299,293,592
"47660","WEST POKOT","KIPKOMO","48",134,156,290
"47661","WEST POKOT","KIPKOMO","49",230,294,524
"47662","WEST POKOT","KIPKOMO","45-49",1504,1532,3036
"47663","WEST POKOT","KIPKOMO","50",316,291,607
"47664","WEST POKOT","KIPKOMO","51",199,183,382
"47665","WEST POKOT","KIPKOMO","52",149,152,301
"47666","WEST POKOT","KIPKOMO","53",130,131,261
"47667","WEST POKOT","KIPKOMO","54",186,196,382
"47668","WEST POKOT","KIPKOMO","50-54",980,953,1933
"47669","WEST POKOT","KIPKOMO","55",191,180,371
"47670","WEST POKOT","KIPKOMO","56",171,125,296
"47671","WEST POKOT","KIPKOMO","57",108,88,196
"47672","WEST POKOT","KIPKOMO","58",104,117,221
"47673","WEST POKOT","KIPKOMO","59",150,174,324
"47674","WEST POKOT","KIPKOMO","55-59",724,684,1408
"47675","WEST POKOT","KIPKOMO","60",208,245,453
"47676","WEST POKOT","KIPKOMO","61",115,121,236
"47677","WEST POKOT","KIPKOMO","62",71,114,185
"47678","WEST POKOT","KIPKOMO","63",113,135,248
"47679","WEST POKOT","KIPKOMO","64",93,97,190
"47680","WEST POKOT","KIPKOMO","60-64",600,712,1312
"47681","WEST POKOT","KIPKOMO","65",128,215,343
"47682","WEST POKOT","KIPKOMO","66",59,73,132
"47683","WEST POKOT","KIPKOMO","67",113,92,205
"47684","WEST POKOT","KIPKOMO","68",56,75,131
"47685","WEST POKOT","KIPKOMO","69",125,209,334
"47686","WEST POKOT","KIPKOMO","65-69",481,664,1145
"47687","WEST POKOT","KIPKOMO","70",153,189,342
"47688","WEST POKOT","KIPKOMO","71",67,101,168
"47689","WEST POKOT","KIPKOMO","72",59,76,135
"47690","WEST POKOT","KIPKOMO","73",41,69,110
"47691","WEST POKOT","KIPKOMO","74",47,103,150
"47692","WEST POKOT","KIPKOMO","70-74",367,538,905
"47693","WEST POKOT","KIPKOMO","75",52,81,133
"47694","WEST POKOT","KIPKOMO","76",30,30,60
"47695","WEST POKOT","KIPKOMO","77",40,51,91
"47696","WEST POKOT","KIPKOMO","78",18,30,48
"47697","WEST POKOT","KIPKOMO","79",47,99,146
"47698","WEST POKOT","KIPKOMO","75-79",187,291,478
"47699","WEST POKOT","KIPKOMO","80",49,88,137
"47700","WEST POKOT","KIPKOMO","81",20,23,43
"47701","WEST POKOT","KIPKOMO","82",11,20,31
"47702","WEST POKOT","KIPKOMO","83",13,23,36
"47703","WEST POKOT","KIPKOMO","84",21,19,40
"47704","WEST POKOT","KIPKOMO","80-84",114,173,287
"47705","WEST POKOT","KIPKOMO","85",17,22,39
"47706","WEST POKOT","KIPKOMO","86",6,9,15
"47707","WEST POKOT","KIPKOMO","87",8,17,25
"47708","WEST POKOT","KIPKOMO","88",9,7,16
"47709","WEST POKOT","KIPKOMO","89",13,45,58
"47710","WEST POKOT","KIPKOMO","85-89",53,100,153
"47711","WEST POKOT","KIPKOMO","90",12,27,39
"47712","WEST POKOT","KIPKOMO","91",2,10,12
"47713","WEST POKOT","KIPKOMO","92",1,2,3
"47714","WEST POKOT","KIPKOMO","93",4,8,12
"47715","WEST POKOT","KIPKOMO","94",5,9,14
"47716","WEST POKOT","KIPKOMO","90-94",24,56,80
"47717","WEST POKOT","KIPKOMO","95",7,9,16
"47718","WEST POKOT","KIPKOMO","96",4,2,6
"47719","WEST POKOT","KIPKOMO","97",2,2,4
"47720","WEST POKOT","KIPKOMO","98",1,3,4
"47721","WEST POKOT","KIPKOMO","99",5,13,18
"47722","WEST POKOT","KIPKOMO","95-99",19,29,48
"47723","WEST POKOT","KIPKOMO","100+",3,24,27
"47724","WEST POKOT","KIPKOMO","Not Stated",NA,NA,NA
"47725","WEST POKOT","POKOT CENTRAL","Total",59682,59331,119013
"47726","WEST POKOT","POKOT CENTRAL","0",1990,2033,4023
"47727","WEST POKOT","POKOT CENTRAL","1",1988,1985,3973
"47728","WEST POKOT","POKOT CENTRAL","2",2366,2317,4683
"47729","WEST POKOT","POKOT CENTRAL","3",2384,2315,4699
"47730","WEST POKOT","POKOT CENTRAL","4",2446,2376,4822
"47731","WEST POKOT","POKOT CENTRAL","0 - 4",11174,11026,22200
"47732","WEST POKOT","POKOT CENTRAL","5",2283,2239,4522
"47733","WEST POKOT","POKOT CENTRAL","6",2433,2434,4867
"47734","WEST POKOT","POKOT CENTRAL","7",2060,2005,4065
"47735","WEST POKOT","POKOT CENTRAL","8",2329,2201,4530
"47736","WEST POKOT","POKOT CENTRAL","9",1732,1614,3346
"47737","WEST POKOT","POKOT CENTRAL","5-9",10837,10493,21330
"47738","WEST POKOT","POKOT CENTRAL","10",2553,2461,5014
"47739","WEST POKOT","POKOT CENTRAL","11",1356,1438,2794
"47740","WEST POKOT","POKOT CENTRAL","12",2179,1947,4126
"47741","WEST POKOT","POKOT CENTRAL","13",1629,1460,3089
"47742","WEST POKOT","POKOT CENTRAL","14",1693,1589,3282
"47743","WEST POKOT","POKOT CENTRAL","10 -14",9410,8895,18305
"47744","WEST POKOT","POKOT CENTRAL","15",1674,1523,3197
"47745","WEST POKOT","POKOT CENTRAL","16",1401,1360,2761
"47746","WEST POKOT","POKOT CENTRAL","17",1116,1018,2134
"47747","WEST POKOT","POKOT CENTRAL","18",1222,1217,2439
"47748","WEST POKOT","POKOT CENTRAL","19",1017,1013,2030
"47749","WEST POKOT","POKOT CENTRAL","15-19",6430,6131,12561
"47750","WEST POKOT","POKOT CENTRAL","20",1328,1582,2910
"47751","WEST POKOT","POKOT CENTRAL","21",790,864,1654
"47752","WEST POKOT","POKOT CENTRAL","22",744,854,1598
"47753","WEST POKOT","POKOT CENTRAL","23",882,960,1842
"47754","WEST POKOT","POKOT CENTRAL","24",738,776,1514
"47755","WEST POKOT","POKOT CENTRAL","20-24",4482,5036,9518
"47756","WEST POKOT","POKOT CENTRAL","25",1144,1202,2346
"47757","WEST POKOT","POKOT CENTRAL","26",625,695,1320
"47758","WEST POKOT","POKOT CENTRAL","27",724,703,1427
"47759","WEST POKOT","POKOT CENTRAL","28",619,769,1388
"47760","WEST POKOT","POKOT CENTRAL","29",602,698,1300
"47761","WEST POKOT","POKOT CENTRAL","25-29",3714,4067,7781
"47762","WEST POKOT","POKOT CENTRAL","30",1132,1226,2358
"47763","WEST POKOT","POKOT CENTRAL","31",513,566,1079
"47764","WEST POKOT","POKOT CENTRAL","32",630,548,1178
"47765","WEST POKOT","POKOT CENTRAL","33",592,579,1171
"47766","WEST POKOT","POKOT CENTRAL","34",474,471,945
"47767","WEST POKOT","POKOT CENTRAL","30-34",3341,3390,6731
"47768","WEST POKOT","POKOT CENTRAL","35",808,795,1603
"47769","WEST POKOT","POKOT CENTRAL","36",337,325,662
"47770","WEST POKOT","POKOT CENTRAL","37",305,261,566
"47771","WEST POKOT","POKOT CENTRAL","38",297,310,607
"47772","WEST POKOT","POKOT CENTRAL","39",295,273,568
"47773","WEST POKOT","POKOT CENTRAL","35-39",2042,1964,4006
"47774","WEST POKOT","POKOT CENTRAL","40",624,630,1254
"47775","WEST POKOT","POKOT CENTRAL","41",461,358,819
"47776","WEST POKOT","POKOT CENTRAL","42",365,359,724
"47777","WEST POKOT","POKOT CENTRAL","43",271,262,533
"47778","WEST POKOT","POKOT CENTRAL","44",183,175,358
"47779","WEST POKOT","POKOT CENTRAL","40-44",1904,1784,3688
"47780","WEST POKOT","POKOT CENTRAL","45",602,563,1165
"47781","WEST POKOT","POKOT CENTRAL","46",332,290,622
"47782","WEST POKOT","POKOT CENTRAL","47",260,241,501
"47783","WEST POKOT","POKOT CENTRAL","48",231,189,420
"47784","WEST POKOT","POKOT CENTRAL","49",275,262,537
"47785","WEST POKOT","POKOT CENTRAL","45-49",1700,1545,3245
"47786","WEST POKOT","POKOT CENTRAL","50",537,522,1059
"47787","WEST POKOT","POKOT CENTRAL","51",176,148,324
"47788","WEST POKOT","POKOT CENTRAL","52",207,133,340
"47789","WEST POKOT","POKOT CENTRAL","53",137,104,241
"47790","WEST POKOT","POKOT CENTRAL","54",170,173,343
"47791","WEST POKOT","POKOT CENTRAL","50-54",1227,1080,2307
"47792","WEST POKOT","POKOT CENTRAL","55",245,227,472
"47793","WEST POKOT","POKOT CENTRAL","56",198,161,359
"47794","WEST POKOT","POKOT CENTRAL","57",104,83,187
"47795","WEST POKOT","POKOT CENTRAL","58",125,126,251
"47796","WEST POKOT","POKOT CENTRAL","59",125,176,301
"47797","WEST POKOT","POKOT CENTRAL","55-59",797,773,1570
"47798","WEST POKOT","POKOT CENTRAL","60",265,408,673
"47799","WEST POKOT","POKOT CENTRAL","61",133,147,280
"47800","WEST POKOT","POKOT CENTRAL","62",125,92,217
"47801","WEST POKOT","POKOT CENTRAL","63",144,181,325
"47802","WEST POKOT","POKOT CENTRAL","64",121,120,241
"47803","WEST POKOT","POKOT CENTRAL","60-64",788,948,1736
"47804","WEST POKOT","POKOT CENTRAL","65",207,281,488
"47805","WEST POKOT","POKOT CENTRAL","66",81,76,157
"47806","WEST POKOT","POKOT CENTRAL","67",133,127,260
"47807","WEST POKOT","POKOT CENTRAL","68",78,84,162
"47808","WEST POKOT","POKOT CENTRAL","69",182,259,441
"47809","WEST POKOT","POKOT CENTRAL","65-69",681,827,1508
"47810","WEST POKOT","POKOT CENTRAL","70",265,327,592
"47811","WEST POKOT","POKOT CENTRAL","71",86,115,201
"47812","WEST POKOT","POKOT CENTRAL","72",108,88,196
"47813","WEST POKOT","POKOT CENTRAL","73",85,79,164
"47814","WEST POKOT","POKOT CENTRAL","74",78,81,159
"47815","WEST POKOT","POKOT CENTRAL","70-74",622,690,1312
"47816","WEST POKOT","POKOT CENTRAL","75",94,129,223
"47817","WEST POKOT","POKOT CENTRAL","76",43,42,85
"47818","WEST POKOT","POKOT CENTRAL","77",42,44,86
"47819","WEST POKOT","POKOT CENTRAL","78",28,30,58
"47820","WEST POKOT","POKOT CENTRAL","79",68,94,162
"47821","WEST POKOT","POKOT CENTRAL","75-79",275,339,614
"47822","WEST POKOT","POKOT CENTRAL","80",78,100,178
"47823","WEST POKOT","POKOT CENTRAL","81",20,25,45
"47824","WEST POKOT","POKOT CENTRAL","82",12,10,22
"47825","WEST POKOT","POKOT CENTRAL","83",19,28,47
"47826","WEST POKOT","POKOT CENTRAL","84",9,24,33
"47827","WEST POKOT","POKOT CENTRAL","80-84",138,187,325
"47828","WEST POKOT","POKOT CENTRAL","85",13,28,41
"47829","WEST POKOT","POKOT CENTRAL","86",7,5,12
"47830","WEST POKOT","POKOT CENTRAL","87",11,9,20
"47831","WEST POKOT","POKOT CENTRAL","88",6,11,17
"47832","WEST POKOT","POKOT CENTRAL","89",21,29,50
"47833","WEST POKOT","POKOT CENTRAL","85-89",58,82,140
"47834","WEST POKOT","POKOT CENTRAL","90",16,29,45
"47835","WEST POKOT","POKOT CENTRAL","91",2,5,7
"47836","WEST POKOT","POKOT CENTRAL","92",4,2,6
"47837","WEST POKOT","POKOT CENTRAL","93",4,5,9
"47838","WEST POKOT","POKOT CENTRAL","94",5,3,8
"47839","WEST POKOT","POKOT CENTRAL","90-94",31,44,75
"47840","WEST POKOT","POKOT CENTRAL","95",11,5,16
"47841","WEST POKOT","POKOT CENTRAL","96",5,5,10
"47842","WEST POKOT","POKOT CENTRAL","97",2,5,7
"47843","WEST POKOT","POKOT CENTRAL","98",1,1,2
"47844","WEST POKOT","POKOT CENTRAL","99",3,4,7
"47845","WEST POKOT","POKOT CENTRAL","95-99",22,20,42
"47846","WEST POKOT","POKOT CENTRAL","100+",9,10,19
"47847","WEST POKOT","POKOT CENTRAL","Not Stated",NA,NA,NA
"47848","WEST POKOT","POKOT NORTH","Total",64780,69702,134482
"47849","WEST POKOT","POKOT NORTH","0",2155,2258,4413
"47850","WEST POKOT","POKOT NORTH","1",2517,2583,5100
"47851","WEST POKOT","POKOT NORTH","2",2915,2931,5846
"47852","WEST POKOT","POKOT NORTH","3",2835,3003,5838
"47853","WEST POKOT","POKOT NORTH","4",2988,3013,6001
"47854","WEST POKOT","POKOT NORTH","0 - 4",13410,13788,27198
"47855","WEST POKOT","POKOT NORTH","5",2671,2725,5396
"47856","WEST POKOT","POKOT NORTH","6",2978,3243,6221
"47857","WEST POKOT","POKOT NORTH","7",2224,2309,4533
"47858","WEST POKOT","POKOT NORTH","8",2969,3156,6125
"47859","WEST POKOT","POKOT NORTH","9",1666,1752,3418
"47860","WEST POKOT","POKOT NORTH","5-9",12508,13185,25693
"47861","WEST POKOT","POKOT NORTH","10",3322,3582,6904
"47862","WEST POKOT","POKOT NORTH","11",1259,1407,2666
"47863","WEST POKOT","POKOT NORTH","12",2463,2340,4803
"47864","WEST POKOT","POKOT NORTH","13",1620,1575,3195
"47865","WEST POKOT","POKOT NORTH","14",1654,1493,3147
"47866","WEST POKOT","POKOT NORTH","10 -14",10318,10397,20715
"47867","WEST POKOT","POKOT NORTH","15",2125,1815,3940
"47868","WEST POKOT","POKOT NORTH","16",1417,1141,2558
"47869","WEST POKOT","POKOT NORTH","17",1146,929,2075
"47870","WEST POKOT","POKOT NORTH","18",1269,1330,2599
"47871","WEST POKOT","POKOT NORTH","19",820,891,1711
"47872","WEST POKOT","POKOT NORTH","15-19",6777,6106,12883
"47873","WEST POKOT","POKOT NORTH","20",1647,1991,3638
"47874","WEST POKOT","POKOT NORTH","21",749,922,1671
"47875","WEST POKOT","POKOT NORTH","22",790,1062,1852
"47876","WEST POKOT","POKOT NORTH","23",886,1089,1975
"47877","WEST POKOT","POKOT NORTH","24",734,982,1716
"47878","WEST POKOT","POKOT NORTH","20-24",4806,6046,10852
"47879","WEST POKOT","POKOT NORTH","25",1299,1659,2958
"47880","WEST POKOT","POKOT NORTH","26",728,856,1584
"47881","WEST POKOT","POKOT NORTH","27",674,803,1477
"47882","WEST POKOT","POKOT NORTH","28",625,757,1382
"47883","WEST POKOT","POKOT NORTH","29",615,812,1427
"47884","WEST POKOT","POKOT NORTH","25-29",3941,4887,8828
"47885","WEST POKOT","POKOT NORTH","30",1322,1669,2991
"47886","WEST POKOT","POKOT NORTH","31",619,794,1413
"47887","WEST POKOT","POKOT NORTH","32",646,803,1449
"47888","WEST POKOT","POKOT NORTH","33",577,688,1265
"47889","WEST POKOT","POKOT NORTH","34",389,419,808
"47890","WEST POKOT","POKOT NORTH","30-34",3553,4373,7926
"47891","WEST POKOT","POKOT NORTH","35",1126,1287,2413
"47892","WEST POKOT","POKOT NORTH","36",295,332,627
"47893","WEST POKOT","POKOT NORTH","37",250,286,536
"47894","WEST POKOT","POKOT NORTH","38",215,258,473
"47895","WEST POKOT","POKOT NORTH","39",308,315,623
"47896","WEST POKOT","POKOT NORTH","35-39",2194,2478,4672
"47897","WEST POKOT","POKOT NORTH","40",754,744,1498
"47898","WEST POKOT","POKOT NORTH","41",279,309,588
"47899","WEST POKOT","POKOT NORTH","42",372,376,748
"47900","WEST POKOT","POKOT NORTH","43",221,271,492
"47901","WEST POKOT","POKOT NORTH","44",170,194,364
"47902","WEST POKOT","POKOT NORTH","40-44",1796,1894,3690
"47903","WEST POKOT","POKOT NORTH","45",532,605,1137
"47904","WEST POKOT","POKOT NORTH","46",288,326,614
"47905","WEST POKOT","POKOT NORTH","47",199,166,365
"47906","WEST POKOT","POKOT NORTH","48",154,146,300
"47907","WEST POKOT","POKOT NORTH","49",269,289,558
"47908","WEST POKOT","POKOT NORTH","45-49",1442,1532,2974
"47909","WEST POKOT","POKOT NORTH","50",640,661,1301
"47910","WEST POKOT","POKOT NORTH","51",150,192,342
"47911","WEST POKOT","POKOT NORTH","52",128,176,304
"47912","WEST POKOT","POKOT NORTH","53",87,104,191
"47913","WEST POKOT","POKOT NORTH","54",159,159,318
"47914","WEST POKOT","POKOT NORTH","50-54",1164,1292,2456
"47915","WEST POKOT","POKOT NORTH","55",239,224,463
"47916","WEST POKOT","POKOT NORTH","56",147,141,288
"47917","WEST POKOT","POKOT NORTH","57",104,112,216
"47918","WEST POKOT","POKOT NORTH","58",85,104,189
"47919","WEST POKOT","POKOT NORTH","59",146,214,360
"47920","WEST POKOT","POKOT NORTH","55-59",721,795,1516
"47921","WEST POKOT","POKOT NORTH","60",360,436,796
"47922","WEST POKOT","POKOT NORTH","61",77,104,181
"47923","WEST POKOT","POKOT NORTH","62",78,115,193
"47924","WEST POKOT","POKOT NORTH","63",96,121,217
"47925","WEST POKOT","POKOT NORTH","64",71,85,156
"47926","WEST POKOT","POKOT NORTH","60-64",682,861,1543
"47927","WEST POKOT","POKOT NORTH","65",216,302,518
"47928","WEST POKOT","POKOT NORTH","66",99,107,206
"47929","WEST POKOT","POKOT NORTH","67",89,111,200
"47930","WEST POKOT","POKOT NORTH","68",65,78,143
"47931","WEST POKOT","POKOT NORTH","69",119,232,351
"47932","WEST POKOT","POKOT NORTH","65-69",588,830,1418
"47933","WEST POKOT","POKOT NORTH","70",262,307,569
"47934","WEST POKOT","POKOT NORTH","71",63,105,168
"47935","WEST POKOT","POKOT NORTH","72",44,79,123
"47936","WEST POKOT","POKOT NORTH","73",45,47,92
"47937","WEST POKOT","POKOT NORTH","74",58,92,150
"47938","WEST POKOT","POKOT NORTH","70-74",472,630,1102
"47939","WEST POKOT","POKOT NORTH","75",78,89,167
"47940","WEST POKOT","POKOT NORTH","76",28,36,64
"47941","WEST POKOT","POKOT NORTH","77",21,29,50
"47942","WEST POKOT","POKOT NORTH","78",24,30,54
"47943","WEST POKOT","POKOT NORTH","79",56,80,136
"47944","WEST POKOT","POKOT NORTH","75-79",207,264,471
"47945","WEST POKOT","POKOT NORTH","80",73,118,191
"47946","WEST POKOT","POKOT NORTH","81",11,25,36
"47947","WEST POKOT","POKOT NORTH","82",15,21,36
"47948","WEST POKOT","POKOT NORTH","83",5,9,14
"47949","WEST POKOT","POKOT NORTH","84",3,25,28
"47950","WEST POKOT","POKOT NORTH","80-84",107,198,305
"47951","WEST POKOT","POKOT NORTH","85",17,28,45
"47952","WEST POKOT","POKOT NORTH","86",5,9,14
"47953","WEST POKOT","POKOT NORTH","87",7,6,13
"47954","WEST POKOT","POKOT NORTH","88",3,8,11
"47955","WEST POKOT","POKOT NORTH","89",14,34,48
"47956","WEST POKOT","POKOT NORTH","85-89",46,85,131
"47957","WEST POKOT","POKOT NORTH","90",13,15,28
"47958","WEST POKOT","POKOT NORTH","91",8,12,20
"47959","WEST POKOT","POKOT NORTH","92",2,2,4
"47960","WEST POKOT","POKOT NORTH","93",3,4,7
"47961","WEST POKOT","POKOT NORTH","94",4,2,6
"47962","WEST POKOT","POKOT NORTH","90-94",30,35,65
"47963","WEST POKOT","POKOT NORTH","95",5,4,9
"47964","WEST POKOT","POKOT NORTH","96",1,3,4
"47965","WEST POKOT","POKOT NORTH","97",1,1,2
"47966","WEST POKOT","POKOT NORTH","98",1,2,3
"47967","WEST POKOT","POKOT NORTH","99",3,3,6
"47968","WEST POKOT","POKOT NORTH","95-99",11,13,24
"47969","WEST POKOT","POKOT NORTH","100+",6,13,19
"47970","WEST POKOT","POKOT NORTH","Not Stated",1,NA,1
"47971","WEST POKOT","POKOT SOUTH","Total",39808,40851,80659
"47972","WEST POKOT","POKOT SOUTH","0",1198,1223,2421
"47973","WEST POKOT","POKOT SOUTH","1",1372,1376,2748
"47974","WEST POKOT","POKOT SOUTH","2",1511,1453,2964
"47975","WEST POKOT","POKOT SOUTH","3",1543,1507,3050
"47976","WEST POKOT","POKOT SOUTH","4",1623,1490,3113
"47977","WEST POKOT","POKOT SOUTH","0 - 4",7247,7049,14296
"47978","WEST POKOT","POKOT SOUTH","5",1545,1454,2999
"47979","WEST POKOT","POKOT SOUTH","6",1487,1521,3008
"47980","WEST POKOT","POKOT SOUTH","7",1365,1306,2671
"47981","WEST POKOT","POKOT SOUTH","8",1300,1358,2658
"47982","WEST POKOT","POKOT SOUTH","9",1306,1298,2604
"47983","WEST POKOT","POKOT SOUTH","5-9",7003,6937,13940
"47984","WEST POKOT","POKOT SOUTH","10",1506,1486,2992
"47985","WEST POKOT","POKOT SOUTH","11",1109,1303,2412
"47986","WEST POKOT","POKOT SOUTH","12",1453,1312,2765
"47987","WEST POKOT","POKOT SOUTH","13",1212,1275,2487
"47988","WEST POKOT","POKOT SOUTH","14",1242,1193,2435
"47989","WEST POKOT","POKOT SOUTH","10 -14",6522,6569,13091
"47990","WEST POKOT","POKOT SOUTH","15",1282,1192,2474
"47991","WEST POKOT","POKOT SOUTH","16",1115,1082,2197
"47992","WEST POKOT","POKOT SOUTH","17",950,893,1843
"47993","WEST POKOT","POKOT SOUTH","18",779,728,1507
"47994","WEST POKOT","POKOT SOUTH","19",881,900,1781
"47995","WEST POKOT","POKOT SOUTH","15-19",5007,4795,9802
"47996","WEST POKOT","POKOT SOUTH","20",881,956,1837
"47997","WEST POKOT","POKOT SOUTH","21",690,789,1479
"47998","WEST POKOT","POKOT SOUTH","22",559,663,1222
"47999","WEST POKOT","POKOT SOUTH","23",692,727,1419
"48000","WEST POKOT","POKOT SOUTH","24",574,607,1181
"48001","WEST POKOT","POKOT SOUTH","20-24",3396,3742,7138
"48002","WEST POKOT","POKOT SOUTH","25",770,825,1595
"48003","WEST POKOT","POKOT SOUTH","26",504,524,1028
"48004","WEST POKOT","POKOT SOUTH","27",467,524,991
"48005","WEST POKOT","POKOT SOUTH","28",359,411,770
"48006","WEST POKOT","POKOT SOUTH","29",402,454,856
"48007","WEST POKOT","POKOT SOUTH","25-29",2502,2738,5240
"48008","WEST POKOT","POKOT SOUTH","30",520,611,1131
"48009","WEST POKOT","POKOT SOUTH","31",358,406,764
"48010","WEST POKOT","POKOT SOUTH","32",438,368,806
"48011","WEST POKOT","POKOT SOUTH","33",362,368,730
"48012","WEST POKOT","POKOT SOUTH","34",321,399,720
"48013","WEST POKOT","POKOT SOUTH","30-34",1999,2152,4151
"48014","WEST POKOT","POKOT SOUTH","35",491,536,1027
"48015","WEST POKOT","POKOT SOUTH","36",231,225,456
"48016","WEST POKOT","POKOT SOUTH","37",249,228,477
"48017","WEST POKOT","POKOT SOUTH","38",127,156,283
"48018","WEST POKOT","POKOT SOUTH","39",233,191,424
"48019","WEST POKOT","POKOT SOUTH","35-39",1331,1336,2667
"48020","WEST POKOT","POKOT SOUTH","40",308,277,585
"48021","WEST POKOT","POKOT SOUTH","41",282,277,559
"48022","WEST POKOT","POKOT SOUTH","42",284,285,569
"48023","WEST POKOT","POKOT SOUTH","43",189,252,441
"48024","WEST POKOT","POKOT SOUTH","44",141,188,329
"48025","WEST POKOT","POKOT SOUTH","40-44",1204,1279,2483
"48026","WEST POKOT","POKOT SOUTH","45",329,319,648
"48027","WEST POKOT","POKOT SOUTH","46",241,284,525
"48028","WEST POKOT","POKOT SOUTH","47",183,238,421
"48029","WEST POKOT","POKOT SOUTH","48",152,121,273
"48030","WEST POKOT","POKOT SOUTH","49",208,222,430
"48031","WEST POKOT","POKOT SOUTH","45-49",1113,1184,2297
"48032","WEST POKOT","POKOT SOUTH","50",198,239,437
"48033","WEST POKOT","POKOT SOUTH","51",138,127,265
"48034","WEST POKOT","POKOT SOUTH","52",88,122,210
"48035","WEST POKOT","POKOT SOUTH","53",74,89,163
"48036","WEST POKOT","POKOT SOUTH","54",110,143,253
"48037","WEST POKOT","POKOT SOUTH","50-54",608,720,1328
"48038","WEST POKOT","POKOT SOUTH","55",131,149,280
"48039","WEST POKOT","POKOT SOUTH","56",112,112,224
"48040","WEST POKOT","POKOT SOUTH","57",122,109,231
"48041","WEST POKOT","POKOT SOUTH","58",62,84,146
"48042","WEST POKOT","POKOT SOUTH","59",83,135,218
"48043","WEST POKOT","POKOT SOUTH","55-59",510,589,1099
"48044","WEST POKOT","POKOT SOUTH","60",171,215,386
"48045","WEST POKOT","POKOT SOUTH","61",98,154,252
"48046","WEST POKOT","POKOT SOUTH","62",66,82,148
"48047","WEST POKOT","POKOT SOUTH","63",59,110,169
"48048","WEST POKOT","POKOT SOUTH","64",69,83,152
"48049","WEST POKOT","POKOT SOUTH","60-64",463,644,1107
"48050","WEST POKOT","POKOT SOUTH","65",92,130,222
"48051","WEST POKOT","POKOT SOUTH","66",41,63,104
"48052","WEST POKOT","POKOT SOUTH","67",79,74,153
"48053","WEST POKOT","POKOT SOUTH","68",45,43,88
"48054","WEST POKOT","POKOT SOUTH","69",88,127,215
"48055","WEST POKOT","POKOT SOUTH","65-69",345,437,782
"48056","WEST POKOT","POKOT SOUTH","70",111,141,252
"48057","WEST POKOT","POKOT SOUTH","71",59,68,127
"48058","WEST POKOT","POKOT SOUTH","72",53,42,95
"48059","WEST POKOT","POKOT SOUTH","73",26,38,64
"48060","WEST POKOT","POKOT SOUTH","74",38,44,82
"48061","WEST POKOT","POKOT SOUTH","70-74",287,333,620
"48062","WEST POKOT","POKOT SOUTH","75",45,37,82
"48063","WEST POKOT","POKOT SOUTH","76",23,16,39
"48064","WEST POKOT","POKOT SOUTH","77",26,20,46
"48065","WEST POKOT","POKOT SOUTH","78",8,12,20
"48066","WEST POKOT","POKOT SOUTH","79",33,39,72
"48067","WEST POKOT","POKOT SOUTH","75-79",135,124,259
"48068","WEST POKOT","POKOT SOUTH","80",28,37,65
"48069","WEST POKOT","POKOT SOUTH","81",16,10,26
"48070","WEST POKOT","POKOT SOUTH","82",5,10,15
"48071","WEST POKOT","POKOT SOUTH","83",13,13,26
"48072","WEST POKOT","POKOT SOUTH","84",8,12,20
"48073","WEST POKOT","POKOT SOUTH","80-84",70,82,152
"48074","WEST POKOT","POKOT SOUTH","85",12,10,22
"48075","WEST POKOT","POKOT SOUTH","86",2,4,6
"48076","WEST POKOT","POKOT SOUTH","87",5,9,14
"48077","WEST POKOT","POKOT SOUTH","88",1,5,6
"48078","WEST POKOT","POKOT SOUTH","89",13,27,40
"48079","WEST POKOT","POKOT SOUTH","85-89",33,55,88
"48080","WEST POKOT","POKOT SOUTH","90",7,12,19
"48081","WEST POKOT","POKOT SOUTH","91",7,7,14
"48082","WEST POKOT","POKOT SOUTH","92",1,5,6
"48083","WEST POKOT","POKOT SOUTH","93",NA,7,7
"48084","WEST POKOT","POKOT SOUTH","94",6,7,13
"48085","WEST POKOT","POKOT SOUTH","90-94",21,38,59
"48086","WEST POKOT","POKOT SOUTH","95",2,9,11
"48087","WEST POKOT","POKOT SOUTH","96",1,4,5
"48088","WEST POKOT","POKOT SOUTH","97",2,3,5
"48089","WEST POKOT","POKOT SOUTH","98",NA,NA,NA
"48090","WEST POKOT","POKOT SOUTH","99",2,10,12
"48091","WEST POKOT","POKOT SOUTH","95-99",7,26,33
"48092","WEST POKOT","POKOT SOUTH","100+",5,22,27
"48093","WEST POKOT","POKOT SOUTH","Not Stated",NA,NA,NA
"48094","WEST POKOT","WEST POKOT","Total",91820,92626,184446
"48095","WEST POKOT","WEST POKOT","0",2886,2798,5684
"48096","WEST POKOT","WEST POKOT","1",3136,3051,6187
"48097","WEST POKOT","WEST POKOT","2",3317,3294,6611
"48098","WEST POKOT","WEST POKOT","3",3221,3308,6529
"48099","WEST POKOT","WEST POKOT","4",3367,3318,6685
"48100","WEST POKOT","WEST POKOT","0 - 4",15927,15769,31696
"48101","WEST POKOT","WEST POKOT","5",3168,3016,6184
"48102","WEST POKOT","WEST POKOT","6",3211,3285,6496
"48103","WEST POKOT","WEST POKOT","7",2885,2881,5766
"48104","WEST POKOT","WEST POKOT","8",2936,3120,6056
"48105","WEST POKOT","WEST POKOT","9",2673,2662,5335
"48106","WEST POKOT","WEST POKOT","5-9",14873,14964,29837
"48107","WEST POKOT","WEST POKOT","10",3325,3305,6630
"48108","WEST POKOT","WEST POKOT","11",2211,2351,4562
"48109","WEST POKOT","WEST POKOT","12",2999,2965,5964
"48110","WEST POKOT","WEST POKOT","13",2578,2505,5083
"48111","WEST POKOT","WEST POKOT","14",2501,2395,4896
"48112","WEST POKOT","WEST POKOT","10 -14",13614,13521,27135
"48113","WEST POKOT","WEST POKOT","15",2670,2421,5091
"48114","WEST POKOT","WEST POKOT","16",2131,2192,4323
"48115","WEST POKOT","WEST POKOT","17",2041,1938,3979
"48116","WEST POKOT","WEST POKOT","18",1842,1776,3618
"48117","WEST POKOT","WEST POKOT","19",1836,1851,3687
"48118","WEST POKOT","WEST POKOT","15-19",10520,10178,20698
"48119","WEST POKOT","WEST POKOT","20",2017,2290,4307
"48120","WEST POKOT","WEST POKOT","21",1538,1621,3159
"48121","WEST POKOT","WEST POKOT","22",1481,1619,3100
"48122","WEST POKOT","WEST POKOT","23",1617,1786,3403
"48123","WEST POKOT","WEST POKOT","24",1432,1568,3000
"48124","WEST POKOT","WEST POKOT","20-24",8085,8884,16969
"48125","WEST POKOT","WEST POKOT","25",1808,1917,3725
"48126","WEST POKOT","WEST POKOT","26",1349,1333,2682
"48127","WEST POKOT","WEST POKOT","27",1408,1348,2756
"48128","WEST POKOT","WEST POKOT","28",1036,1146,2182
"48129","WEST POKOT","WEST POKOT","29",1137,1159,2296
"48130","WEST POKOT","WEST POKOT","25-29",6738,6903,13641
"48131","WEST POKOT","WEST POKOT","30",1764,1737,3501
"48132","WEST POKOT","WEST POKOT","31",1088,1093,2181
"48133","WEST POKOT","WEST POKOT","32",1204,1272,2476
"48134","WEST POKOT","WEST POKOT","33",877,950,1827
"48135","WEST POKOT","WEST POKOT","34",808,794,1602
"48136","WEST POKOT","WEST POKOT","30-34",5741,5846,11587
"48137","WEST POKOT","WEST POKOT","35",1404,1295,2699
"48138","WEST POKOT","WEST POKOT","36",634,584,1218
"48139","WEST POKOT","WEST POKOT","37",607,552,1159
"48140","WEST POKOT","WEST POKOT","38",446,432,878
"48141","WEST POKOT","WEST POKOT","39",586,519,1105
"48142","WEST POKOT","WEST POKOT","35-39",3677,3382,7059
"48143","WEST POKOT","WEST POKOT","40",859,830,1689
"48144","WEST POKOT","WEST POKOT","41",629,628,1257
"48145","WEST POKOT","WEST POKOT","42",698,664,1362
"48146","WEST POKOT","WEST POKOT","43",576,576,1152
"48147","WEST POKOT","WEST POKOT","44",371,413,784
"48148","WEST POKOT","WEST POKOT","40-44",3133,3111,6244
"48149","WEST POKOT","WEST POKOT","45",968,876,1844
"48150","WEST POKOT","WEST POKOT","46",603,538,1141
"48151","WEST POKOT","WEST POKOT","47",536,462,998
"48152","WEST POKOT","WEST POKOT","48",355,278,633
"48153","WEST POKOT","WEST POKOT","49",409,423,832
"48154","WEST POKOT","WEST POKOT","45-49",2871,2577,5448
"48155","WEST POKOT","WEST POKOT","50",693,671,1364
"48156","WEST POKOT","WEST POKOT","51",364,370,734
"48157","WEST POKOT","WEST POKOT","52",269,304,573
"48158","WEST POKOT","WEST POKOT","53",191,193,384
"48159","WEST POKOT","WEST POKOT","54",299,288,587
"48160","WEST POKOT","WEST POKOT","50-54",1816,1826,3642
"48161","WEST POKOT","WEST POKOT","55",348,343,691
"48162","WEST POKOT","WEST POKOT","56",279,266,545
"48163","WEST POKOT","WEST POKOT","57",242,282,524
"48164","WEST POKOT","WEST POKOT","58",214,206,420
"48165","WEST POKOT","WEST POKOT","59",283,332,615
"48166","WEST POKOT","WEST POKOT","55-59",1366,1429,2795
"48167","WEST POKOT","WEST POKOT","60",458,515,973
"48168","WEST POKOT","WEST POKOT","61",227,246,473
"48169","WEST POKOT","WEST POKOT","62",179,178,357
"48170","WEST POKOT","WEST POKOT","63",183,228,411
"48171","WEST POKOT","WEST POKOT","64",162,168,330
"48172","WEST POKOT","WEST POKOT","60-64",1209,1335,2544
"48173","WEST POKOT","WEST POKOT","65",264,342,606
"48174","WEST POKOT","WEST POKOT","66",120,140,260
"48175","WEST POKOT","WEST POKOT","67",198,187,385
"48176","WEST POKOT","WEST POKOT","68",101,102,203
"48177","WEST POKOT","WEST POKOT","69",202,243,445
"48178","WEST POKOT","WEST POKOT","65-69",885,1014,1899
"48179","WEST POKOT","WEST POKOT","70",287,330,617
"48180","WEST POKOT","WEST POKOT","71",147,199,346
"48181","WEST POKOT","WEST POKOT","72",119,98,217
"48182","WEST POKOT","WEST POKOT","73",65,95,160
"48183","WEST POKOT","WEST POKOT","74",90,139,229
"48184","WEST POKOT","WEST POKOT","70-74",708,861,1569
"48185","WEST POKOT","WEST POKOT","75",100,107,207
"48186","WEST POKOT","WEST POKOT","76",62,62,124
"48187","WEST POKOT","WEST POKOT","77",57,65,122
"48188","WEST POKOT","WEST POKOT","78",33,35,68
"48189","WEST POKOT","WEST POKOT","79",61,123,184
"48190","WEST POKOT","WEST POKOT","75-79",313,392,705
"48191","WEST POKOT","WEST POKOT","80",76,127,203
"48192","WEST POKOT","WEST POKOT","81",31,48,79
"48193","WEST POKOT","WEST POKOT","82",24,23,47
"48194","WEST POKOT","WEST POKOT","83",21,45,66
"48195","WEST POKOT","WEST POKOT","84",35,58,93
"48196","WEST POKOT","WEST POKOT","80-84",187,301,488
"48197","WEST POKOT","WEST POKOT","85",24,44,68
"48198","WEST POKOT","WEST POKOT","86",15,16,31
"48199","WEST POKOT","WEST POKOT","87",11,19,30
"48200","WEST POKOT","WEST POKOT","88",8,20,28
"48201","WEST POKOT","WEST POKOT","89",30,60,90
"48202","WEST POKOT","WEST POKOT","85-89",88,159,247
"48203","WEST POKOT","WEST POKOT","90",14,44,58
"48204","WEST POKOT","WEST POKOT","91",7,13,20
"48205","WEST POKOT","WEST POKOT","92",6,6,12
"48206","WEST POKOT","WEST POKOT","93",4,13,17
"48207","WEST POKOT","WEST POKOT","94",4,6,10
"48208","WEST POKOT","WEST POKOT","90-94",35,82,117
"48209","WEST POKOT","WEST POKOT","95",8,21,29
"48210","WEST POKOT","WEST POKOT","96",1,3,4
"48211","WEST POKOT","WEST POKOT","97",NA,6,6
"48212","WEST POKOT","WEST POKOT","98",6,5,11
"48213","WEST POKOT","WEST POKOT","99",3,17,20
"48214","WEST POKOT","WEST POKOT","95-99",18,52,70
"48215","WEST POKOT","WEST POKOT","100+",15,39,54
"48216","WEST POKOT","WEST POKOT","Not Stated",1,1,2
